user_name,no_posts,no_comments,post_karma,comment_karma,first_date,last_date,total_activity
__SKIP__,5125,0,0,0,1645333200,915166800,5125
AbolishWork,299,2210,6057,6386,1418533200,1611982800,2509
Coier,4,1794,4352,21795,1578978000,1610773200,1798
rave2grave,59,1366,11697,15612,1508731200,1639717200,1425
Sehtriom,47,1330,51588,15980,1532577600,1612155600,1377
commiejehu,126,1210,3154,6416,1539921600,1589083200,1336
onedayitwillbedaisy,70,1175,16506,9755,1515474000,1612069200,1245
pm-me-ur-cattos,1,1142,18,9508,1567569600,1612069200,1143
WinterTrabex,283,814,65431,7692,1540526400,1612242000,1097
AutoModerator,39,1053,519,-250,1571803200,1644210000,1092
SelfHelpGenius,32,822,6534,9106,1551589200,1581742800,854
GrundrisseRespector,18,786,3594,6267,1541480400,1611982800,804
SerraTheBrineswalker,8,665,78,6728,1575349200,1591675200,673
Fireplay5,9,631,2208,4926,1553918400,1639976400,640
TeiaRabishu,0,599,0,11481,1581310800,1612069200,599
EfraimK,19,570,524,3569,1580274000,1602820800,589
nmacholl,0,581,0,545,1602129600,1609477200,581
DeepThroatModerators,0,546,0,2510,1545195600,1609304400,546
Bartholomew_Custard,0,545,0,6599,1575608400,1605589200,545
SquidCultist002,1,532,8,2783,1574485200,1608440400,533
bzrker94,19,500,2452,6241,1546750800,1612328400,519
Choicesinlife,2,516,80,3114,1576645200,1609304400,518
JustHereForGiner,0,501,0,7969,1566360000,1612069200,501
TheCassiniProjekt,38,453,1264,3630,1547874000,1611982800,491
Fuarian,6,469,129,4647,1593489600,1617940800,475
YuriRedFox6969,402,64,162305,951,1552449600,1584158400,466
Craigj0812,15,445,1929,3900,1541566800,1611982800,460
candleflame3,39,411,905,3669,1540699200,1611896400,450
WishIWasNeet2,0,446,0,5247,1561348800,1612069200,446
CarefreeInMyRV,50,390,4484,3737,1547010000,1612069200,440
TheHoneySacrifice,26,393,2689,7745,1559880000,1582952400,419
MFrealGs,39,372,1775,2656,1575349200,1604898000,411
MLPorsche,11,395,3500,2474,1571112000,1612155600,406
FightForWhatsYours,4,397,2335,4051,1593576000,1612069200,401
Greevar,1,384,207,6632,1580878800,1612155600,385
RockstarLines,3,381,5739,1124,1583470800,1608440400,384
alwaysZenryoku,0,381,0,2953,1601784000,1612155600,381
lukeluck101,1,371,46,4666,1540353600,1611810000,372
deweydean,0,371,0,3861,1567051200,1609218000,371
BudgetCartographer4,32,339,700,2699,1571803200,1608181200,371
tomsmith856,40,325,8735,5617,1549861200,1609390800,365
OrangishRed,1,364,286,3906,1576040400,1612155600,365
Wantsahusky,9,350,1061,4229,1559620800,1612328400,359
yuritopiaposadism,295,56,153345,459,1585108800,1612069200,351
paraouji,20,326,4092,4057,1552968000,1611896400,346
remindmeworkaccount,1,343,7,7722,1563854400,1595822400,344
jimmyz561,15,325,2775,2539,1593489600,1635912000,340
rulesforrebels,2,324,14,82,1550725200,1602993600,326
Dan_85,7,310,1680,4898,1524196800,1609045200,317
LordNyssa,13,300,4566,2680,1555128000,1593316800,313
Massacher,6,303,24,763,1606194000,1612242000,309
dog5and,1,307,1169,2593,1568865600,1612069200,308
MittenstheGlove,12,284,1829,2849,1562040000,1609477200,296
wavefxn22,5,288,90,2728,1575003600,1612155600,293
DilutedGatorade,0,292,0,604,1564632000,1612328400,292
Geminii27,0,292,0,3816,1401163200,1611982800,292
DavidvonR,1,286,62,1260,1573016400,1608267600,287
SpaceWizardPhteven,5,282,93,3236,1561608000,1642136400,287
JonWood007,3,284,67,1951,1424322000,1611982800,287
NEET_promoter,11,272,515,2643,1593576000,1611810000,283
vannhh,7,275,225,2373,1562817600,1612155600,282
Explodicle,0,281,0,1455,1562644800,1611896400,281
freeradicalx,9,271,1553,4114,1522900800,1611810000,280
newstart3385,0,278,0,892,1541394000,1612069200,278
CirqueKid,1,273,148,4773,1560139200,1593576000,274
jakeod27,44,228,3102,2099,1539835200,1602648000,272
WayneKrane,0,272,0,4507,1578286800,1609218000,272
dystopiarist,1,267,17,2455,1534219200,1579582800,268
blueblizzard08,4,263,611,3864,1548565200,1612155600,267
lovebrunettes,6,259,276,3145,1562558400,1600056000,265
an_thr,5,259,538,4816,1552968000,1611896400,264
SpartanLife1,19,244,1037,1593,1583298000,1611982800,263
adeliberateidler,1,261,8,4083,1566446400,1609390800,262
feelingmyage,1,255,13,3736,1566792000,1608786000,256
Rommie557,1,254,45,3479,1548738000,1608786000,255
The_Ebb_and_Flow,101,150,6890,1411,1515906000,1579669200,251
etoxQ,15,233,1176,-76,1559016000,1576558800,248
WhyWhyWhyForgetIt,39,208,1618,1255,1587873600,1608526800,247
metsakutsa,0,244,0,144,1535601600,1608267600,244
Christal68,0,243,0,1551,1572843600,1611982800,243
mg_ridgeview,5,238,79,5762,1578286800,1612069200,243
SaxeMeiningen9,3,238,123,1352,1574053200,1611810000,241
agony4ever,14,227,7614,4543,1548046800,1588737600,241
steveturkel,1,237,266,2589,1579669200,1612155600,238
Oomlotte99,3,235,122,2527,1584936000,1612069200,238
Tripping-chan,1,235,2478,1950,1582434000,1612069200,236
Camarokerie,2,231,133,4867,1576645200,1611982800,233
feelingoodwednesday,7,226,211,1923,1575522000,1609477200,233
DarkWolf164,16,215,3042,4848,1574830800,1620705600,231
AccoSpoot,33,196,21439,3472,1555387200,1609218000,229
fixerpunk,3,225,76,1044,1570248000,1609218000,228
veggeble,0,227,0,3300,1567569600,1612242000,227
six96,9,216,54946,3766,1563768000,1608008400,225
Surfif456,6,219,484,2845,1566964800,1608181200,225
Hugeknight,0,223,0,1713,1558584000,1611810000,223
ItoAy,4,218,28,1445,1568174400,1612069200,222
DJP91782,3,219,24,2736,1590120000,1612155600,222
poor_covidiot,32,190,3954,269,1585540800,1597896000,222
Compassionate_Cat,2,220,687,1714,1556424000,1569124800,222
Throwaway072318,3,216,662,2577,1548133200,1602216000,219
alicity,0,218,0,-295,1600488000,1608094800,218
dragazoid66,10,208,579,1030,1594353600,1609477200,218
monkey_sage,0,217,0,1681,1541653200,1608440400,217
RobotWelder,17,200,4374,1397,1599537600,1606626000,217
MastaPhat,7,209,356,1880,1572062400,1607835600,216
rluzz001,20,195,2384,2734,1597809600,1611896400,215
HierEncore,15,196,1931,1780,1557979200,1588305600,211
yeahbeenthere,0,210,0,2096,1575176400,1609304400,210
AnAlienFrom1955,2,208,17,969,1549947600,1605934800,210
PussyLunch,26,184,1790,1465,1564372800,1608526800,210
VincentTakeda,0,209,0,2632,1527307200,1609304400,209
goboatmen,1,205,42,1758,1547960400,1612501200,206
QueerWorf,0,204,0,1041,1566878400,1611896400,204
AdAstra9191,10,194,420,1517,1552276800,1564977600,204
Kazemel89,98,105,18389,588,1565150400,1609390800,203
untakedname,8,195,532,1144,1547355600,1608267600,203
Telomera,0,203,0,2822,1597464000,1611896400,203
CoffeeIsGood3,2,201,19,-447,1556078400,1571284800,203
yayabrazie,0,202,0,2039,1546750800,1584849600,202
SignificantChapter,1,200,6,503,1578286800,1608872400,201
CTBthanatos,3,198,894,3144,1590984000,1609304400,201
wiljc3,1,198,95,3620,1573966800,1611810000,199
Fearless_Ser,48,151,31896,1907,1568692800,1606194000,199
el_muerte17,1,198,249,3387,1561262400,1611896400,199
grenz1,1,197,18,1736,1588996800,1611982800,198
Girl_Dukat,0,195,0,1024,1586664000,1608008400,195
jacobspartan1992,6,188,191,1793,1539921600,1608786000,194
writetodeath11,16,178,6363,2536,1596945600,1607922000,194
Ellen_Kingship,21,172,6736,1205,1564718400,1612328400,193
romjpn,0,192,0,1136,1450155600,1611810000,192
AlphaOmegaWhisperer,4,187,34,3440,1563336000,1611810000,191
rhythmjones,7,183,9125,3030,1565150400,1609304400,190
joonuts,33,156,2312,1032,1469937600,1588564800,189
Azuron96,2,186,31,534,1591156800,1609390800,188
sensuallyprimitive,10,177,3770,2354,1554177600,1611982800,187
katembers,3,184,114,3577,1590120000,1611896400,187
fonz33,1,185,27,713,1455166800,1609390800,186
IunderstandMath,4,182,1171,1521,1567569600,1594785600,186
I_Am_Cha_Bu_Duo,5,179,9924,1705,1597291200,1611810000,184
Crystalraf,0,183,0,1177,1597636800,1612069200,183
destructor_rph,5,178,533,1279,1580274000,1608786000,183
Jkid,7,176,387,1311,1547614800,1603425600,183
Yamamizuki,4,179,111,2027,1547182800,1612069200,183
Crimson_Kang,2,179,146,2279,1564372800,1608699600,181
LaidBackLikeADeadFly,0,181,0,4147,1568433600,1608699600,181
_Raspootin_,64,117,21620,1161,1579669200,1609390800,181
MrJingleJangle,0,181,0,1074,1595476800,1612069200,181
SuperEnthusiastic,8,167,1028,1536,1568606400,1603425600,175
Shadows-of-Hiroshima,45,130,6027,2320,1542171600,1562040000,175
geiwosuruinu,2,172,182,1668,1571976000,1611810000,174
Soviet_Saiyan,0,173,0,1791,1574658000,1609218000,173
Gengaara,0,173,0,2046,1580706000,1611810000,173
anthropobscene,2,170,552,1352,1545022800,1605589200,172
nobody_390124,1,171,98,4257,1568260800,1608613200,172
nincomturd,0,170,0,3287,1583298000,1612155600,170
WrongYouAreNot,1,168,11,6236,1593835200,1611810000,169
scotti_bot,3,166,630,1213,1578114000,1601870400,169
RachelTheEgg,2,166,174,1962,1561694400,1581656400,168
ghotiaroma,0,166,0,2283,1557028800,1607058000,166
FireMadeFire,1,165,4,935,1577163600,1592539200,166
EWDnutz,7,157,1100,2030,1563940800,1603771200,164
ericgj,38,126,2409,533,1538539200,1595131200,164
rezzacci,0,163,0,1997,1574053200,1612069200,163
E_J_H,1,162,65,253,1561694400,1611982800,163
ProgressiveArchitect,20,140,5347,950,1598587200,1616040000,160
MakeTotalDestr0i,31,127,10508,1312,1510808400,1608267600,158
veegainz,0,158,0,2062,1528776000,1611896400,158
CouncilmanRickPrime,0,158,0,2480,1594180800,1611810000,158
CastleBravo55,0,158,0,1969,1576040400,1608958800,158
lordofthemanor87,0,158,0,1229,1594353600,1603080000,158
Beiberhole69x,0,158,0,1022,1548824400,1581224400,158
DissipationApe,4,154,4478,1738,1566446400,1579842000,158
erica_r_86,0,155,0,851,1554004800,1583899200,155
Dhampirman,3,151,612,1769,1596513600,1616817600,154
Donblon_Rebirthed,6,148,318,1510,1545195600,1612155600,154
whateverMan223,0,153,0,701,1592625600,1613538000,153
GiveMeTheTape,2,151,79,1632,1509854400,1612155600,153
Tyrilean,0,153,0,1892,1573707600,1609218000,153
dumbdingus,0,153,0,390,1561694400,1564977600,153
Rasalom,0,152,0,3246,1540180800,1611896400,152
Anarcho-anxiety,2,150,213,1007,1593316800,1611810000,152
RedRails1917,2,149,877,2250,1548910800,1606971600,151
AniMerrill,3,148,187,4221,1566360000,1585022400,151
ElegantDecline,0,149,0,1217,1594699200,1607490000,149
ashbash1119,1,146,4,1291,1550725200,1604203200,147
xan-travels,0,146,0,1376,1591502400,1607922000,146
Kormaken,10,136,2180,2183,1569988800,1607662800,146
hectorpardo,6,140,364,2528,1591934400,1612069200,146
BitsAndBobs304,3,142,152,1189,1533009600,1609218000,145
vxicepickxv,3,142,232,1886,1560571200,1608267600,145
AnomalousAvocado,1,144,18,3134,1561176000,1609131600,145
ultimatetadpole,2,143,122,2081,1571284800,1607490000,145
TheNoize,0,144,0,2888,1556510400,1582088400,144
FlamingoWalrus89,0,144,0,949,1602043200,1612155600,144
Reuben3901,2,142,78,1380,1571716800,1612069200,144
JustAnotherTroll2,0,144,0,3282,1562040000,1611810000,144
Kopachris,2,141,106,1385,1546491600,1609218000,143
Indaleciox,0,141,0,1519,1584072000,1612155600,141
FuckWorkingAJob,13,128,789,831,1556164800,1569211200,141
Dyl_pickle00,1,140,5,3575,1562644800,1608440400,141
link11020,4,137,88,1575,1588219200,1639630800,141
ideleteoften,0,140,0,2301,1563854400,1609304400,140
jeradj,0,139,0,2684,1598328000,1612155600,139
MisfitCentral,3,135,2898,1290,1586145600,1608613200,138
Fartzman,0,138,0,2178,1597896000,1607749200,138
freechurro824,3,134,308,1685,1594612800,1612155600,137
phyneas,0,137,0,1009,1564027200,1612069200,137
RadicalZen,4,133,89,640,1552795200,1557892800,137
PigMasterHedgehog,8,129,447,2861,1562472000,1574139600,137
stalkmyusername,1,135,49,1055,1569816000,1583812800,136
Blazing1,0,136,0,858,1562644800,1606453200,136
Keyboardtyper57,57,79,542,-54,1568692800,1605934800,136
west_pac,0,135,0,2004,1583643600,1609390800,135
TripleSkeet,0,134,0,757,1564027200,1586491200,134
technofrik,0,134,0,565,1575694800,1589515200,134
mpm206,2,132,255,1833,1556683200,1611896400,134
these-rmyconfessions,4,129,2063,1073,1550552400,1562040000,133
TheLeopardSociety,0,133,0,3160,1597464000,1608181200,133
arcphoenix13,0,132,0,257,1555300800,1596254400,132
freddielizzard,38,93,11460,1514,1539921600,1605070800,131
SoManyTimesBefore,1,130,61,975,1561608000,1609131600,131
milehigh73a,0,131,0,1863,1576126800,1612155600,131
dumbwaeguk,4,127,49,1377,1589947200,1607576400,131
Stop_Breeding,4,127,276,1034,1551416400,1602648000,131
coffeeandamuffin,11,119,582,868,1570507200,1609390800,130
patpowers1995,1,129,13,1228,1449118800,1565236800,130
dsch190675,3,127,97,1064,1571889600,1599192000,130
JovialPanic389,1,128,35,928,1551762000,1570939200,129
Aaod,0,129,0,705,1450674000,1607922000,129
SpecialEliteYT,12,117,563,550,1597464000,1609390800,129
TechnicalTerm6,6,123,90,2666,1583985600,1611982800,129
lilbrewdog,0,129,0,2172,1598328000,1609218000,129
Septopuss7,2,127,8,2604,1570680000,1609045200,129
EL_DIABLOW,29,99,24030,982,1546923600,1603425600,128
werubim,0,128,0,393,1543467600,1597377600,128
ManWithTheCats,0,128,0,3353,1566360000,1598068800,128
RandomQuestGiver,0,128,0,1114,1598328000,1612242000,128
nofixedideas,0,127,0,491,1539921600,1591761600,127
KailReed,4,123,1515,1819,1561694400,1599019200,127
TheOldPug,0,127,0,971,1541912400,1607490000,127
Cyanovarr,0,126,0,1467,1591502400,1611810000,126
lulululunananana,1,125,67,1222,1597896000,1607490000,126
AltPunk,3,123,88,732,1572843600,1612328400,126
dasus,0,126,0,807,1574226000,1584676800,126
Ha6il6Sa6tan,3,123,219,930,1537156800,1642395600,126
LZAtotheMZA,2,124,530,908,1562904000,1583643600,126
AliceDiableaux,2,123,423,1364,1552449600,1608958800,125
salad_bar_breath,6,119,4999,1281,1549602000,1573707600,125
HardlightCereal,3,122,1805,586,1558670400,1607662800,125
Vash712,1,124,36,1002,1585627200,1609304400,125
MoonoverMaui,4,120,1833,638,1593748800,1606194000,124
kirashi3,0,124,0,1448,1579064400,1611810000,124
i-luv-ducks,0,124,0,493,1552276800,1603857600,124
Celestial_Europe,2,121,50,1331,1563249600,1586836800,123
SocraticLunacy,9,114,3612,1427,1559620800,1586836800,123
geodood,0,123,0,819,1548565200,1608526800,123
ArizonaTucker,0,122,0,667,1591934400,1611982800,122
SB_Wife,0,122,0,878,1580878800,1612414800,122
d-s-m,7,115,179,1191,1554955200,1609650000,122
Astat1ne,0,122,0,762,1573966800,1605675600,122
Hoopy223,0,122,0,635,1599019200,1612155600,122
patty_difussa,1,121,2,696,1566878400,1606885200,122
Nefandi,0,120,0,1026,1551848400,1571544000,120
Deveak,0,120,0,1230,1585713600,1611810000,120
hesitantalien,2,118,12248,2288,1556164800,1606798800,120
Diogonni,1,119,27,909,1592539200,1612069200,120
HomarusAmericanus,2,118,62,1151,1573534800,1617163200,120
Branamp13,0,120,0,1149,1539748800,1608699600,120
MurderSuicideNChill,1,119,2281,5785,1569816000,1594699200,120
The_Orange_Bandit,0,119,0,1833,1597291200,1608786000,119
Fancy_Serial_Numbers,0,119,0,1732,1558497600,1578805200,119
Pharschnar,2,116,153,1542,1594180800,1611810000,118
TheSkyIsNotRed,8,110,657,1846,1569038400,1600401600,118
elektrybaut_trurla,4,114,141,1219,1551070800,1583384400,118
DeathbyOstrich,0,118,0,-369,1512795600,1580187600,118
TheseNthose,0,118,0,769,1552536000,1608699600,118
vetch-a-sketch,0,118,0,675,1543381200,1598328000,118
rscott71,1,117,63,925,1578805200,1606626000,118
yadayadawhatnow,4,113,36,517,1567137600,1582866000,117
RenitheGreat,30,87,12376,3795,1595649600,1608958800,117
davyjones_prisnwalit,1,116,18,652,1600488000,1612242000,117
ugly__midget,0,117,0,616,1556856000,1583557200,117
TropicalKing,7,109,82,1344,1554436800,1592280000,116
PumpkinPatchKids,1,115,17,1021,1578027600,1612069200,116
zak-something,1,115,587,2648,1593662400,1612069200,116
dubspace,3,112,94,912,1567742400,1609131600,115
faith_crusader,0,114,0,112,1596340800,1612155600,114
sutrauboju,2,112,96,1406,1549774800,1587268800,114
relaxilla420,1,112,61,2376,1582434000,1609045200,113
dildoswaggins71069,1,112,162,267,1541131200,1608181200,113
ptfsaurusrex,0,113,0,1066,1560484800,1586664000,113
auserhasnoname7,6,107,361,729,1567224000,1612069200,113
EffectiveStart,11,101,288,393,1563681600,1612069200,112
youcantunfrythings,0,112,0,2841,1555992000,1606107600,112
Snoopyjoe,0,112,0,-752,1569297600,1607749200,112
SleepNowMyThrowaway,1,111,6318,441,1578286800,1609131600,112
Butterfriedbacon,0,111,0,535,1593921600,1612155600,111
BoredRebel,8,103,483,401,1547096400,1608786000,111
Da_llluminati,4,107,608,1126,1574398800,1608872400,111
aehii,0,111,0,1475,1597982400,1611810000,111
isle_of_cats,3,108,4070,1735,1582866000,1612155600,111
Axes4Praxis,0,111,0,3927,1587528000,1609218000,111
GrunkleCoffee,1,109,1438,2198,1552536000,1608786000,110
katieleehaw,1,109,18,1803,1571198400,1612155600,110
cyranothe2nd,0,110,0,1126,1593316800,1609563600,110
Darkomega85,0,109,0,1121,1579323600,1609477200,109
ExceedinglyGayMoth,0,109,0,1756,1551330000,1589688000,109
Floppingfish1,0,108,0,732,1552363200,1611723600,108
xndpxs,0,108,0,2,1547701200,1603944000,108
youngmike85,4,104,2269,2501,1568779200,1609218000,108
HMourland,5,103,292,2672,1595822400,1609390800,108
the_bass_saxophone,2,106,28,1729,1585108800,1638507600,108
Raziel3,9,99,51,343,1550725200,1598587200,108
london_guy1234,0,108,0,435,1580878800,1612069200,108
hottestyearsonrecord,0,107,0,2764,1571716800,1609477200,107
kyoopy246,0,107,0,1498,1567483200,1590552000,107
ElGosso,0,106,0,863,1580446800,1612155600,106
MithridatesLXXVI,0,106,0,642,1570507200,1603598400,106
Weakly-chan,2,104,103,636,1582866000,1600660800,106
EXPotemkin,0,105,0,509,1578978000,1605675600,105
SymbiSpidey,4,101,230,2699,1601870400,1608786000,105
2confrontornot,21,84,7623,599,1579150800,1611810000,105
desserino,1,104,267,1243,1594872000,1609390800,105
freshcoffeecake,1,104,34,951,1597636800,1609390800,105
No1Buck,0,105,0,1038,1548306000,1569556800,105
gerykelf,5,100,245,1796,1598500800,1612069200,105
usagisnap,2,102,49,1465,1566446400,1608267600,104
AllInWithAces,0,104,0,-256,1592625600,1609304400,104
fgyoysgaxt,0,104,0,1000,1598500800,1612155600,104
modsarefascists42,0,103,0,1197,1571284800,1608613200,103
RollRollParry,9,94,871,1296,1538452800,1612069200,103
abrandis,2,101,81,1481,1578978000,1608613200,103
crap_whats_not_taken,4,99,201,1381,1595217600,1611723600,103
facebookcreepin,1,101,323,875,1602648000,1611810000,102
dev_ating,5,97,6049,485,1595563200,1608786000,102
tronaldodumpo,102,0,20983,0,1566792000,1612069200,102
KingKoopaz,0,102,0,130,1596513600,1612155600,102
Iron-Fist,0,102,0,511,1558238400,1608958800,102
rook11111,23,78,589,1076,1543122000,1604293200,101
Ylong,3,98,74,441,1540008000,1611810000,101
Zeebuoy,0,101,0,979,1579323600,1609218000,101
BespokeBellyLint,2,99,35,1095,1579496400,1600488000,101
amanor409,8,93,193,1556,1568692800,1609045200,101
myacc488,0,101,0,-1070,1557892800,1591588800,101
carter_pride,2,98,17,957,1570939200,1609218000,100
TheNextJohnCarmack,9,91,111,505,1574398800,1600056000,100
yaguarete_cm,6,94,91,694,1548306000,1583384400,100
steviekm3,8,92,144,609,1604293200,1607317200,100
wannabemeagain,7,93,907,1000,1595390400,1608440400,100
johnyj3tream,3,97,83,758,1574658000,1580446800,100
Significant-Body9006,8,92,313,718,1602129600,1612069200,100
TheDubuGuy,0,99,0,1106,1568088000,1606453200,99
BoringDisorder,0,99,0,1933,1568001600,1579755600,99
HummousTahini,3,96,271,339,1545282000,1599105600,99
Jari89,0,99,0,283,1566446400,1597464000,99
betchsayswhet,6,93,288,1115,1544072400,1581915600,99
Syflan,5,94,731,1730,1554696000,1599364800,99
Somuchthis123,2,96,90,387,1604293200,1608958800,98
Veilwinter,5,93,271,1758,1589169600,1608181200,98
iamwhiskerbiscuit,3,95,24,669,1577854800,1608008400,98
sn4ggl32th,0,97,0,1931,1560744000,1605589200,97
pillbinge,0,97,0,742,1576645200,1611896400,97
ShitFauxBrains,0,97,0,1238,1574312400,1583125200,97
somethingski,0,97,0,2474,1578718800,1609045200,97
the_ocalhoun,0,97,0,1825,1557115200,1589947200,97
rushmc1,0,97,0,1342,1559880000,1608786000,97
Qaeta,0,97,0,453,1568692800,1611982800,97
larrieuxa,0,96,0,1974,1584244800,1609131600,96
GigiVadim,29,67,2659,1266,1574226000,1642914000,96
TruthAddams,0,96,0,531,1569211200,1581051600,96
SenoraRaton,0,96,0,1575,1568088000,1608786000,96
mvong123,1,95,13,1088,1597723200,1609390800,96
laredditcensorship,0,96,0,804,1577422800,1602129600,96
WeisserGeist,2,93,1630,1585,1558497600,1606712400,95
SanFranRules,4,91,784,861,1571630400,1601179200,95
minkshaman,2,93,14,671,1557806400,1608008400,95
andoruB,55,40,650,78,1420434000,1546750800,95
barracudabones,0,95,0,814,1573448400,1611810000,95
Loreki,0,95,0,1043,1580619600,1608526800,95
pistasojka,0,95,0,-9,1607403600,1608958800,95
joey_diaz_wings,0,95,0,253,1586836800,1589342400,95
TheEPGFiles,1,93,51,1177,1566878400,1612155600,94
DeputyVanHalen74,1,93,6,1243,1568088000,1608786000,94
JedYorks,3,91,641,1186,1581051600,1608786000,94
Deviknyte,2,92,62,613,1548910800,1609390800,94
Mrpjackson,0,94,0,132,1517979600,1600574400,94
kcl97,1,93,43,1466,1553227200,1603771200,94
Communist95,0,94,0,1062,1561435200,1611896400,94
StrugglingStressBall,7,87,171,269,1603512000,1612155600,94
boro350,0,94,0,2603,1566532800,1608094800,94
princeparrotfish,12,82,8781,908,1516856400,1634529600,94
princesspoopalot,0,93,0,214,1550466000,1608094800,93
kingbr3aker,3,90,364,1017,1591848000,1609304400,93
deadalive84,0,93,0,1188,1577336400,1608267600,93
Jack_the_Rah,4,89,367,1546,1552276800,1584072000,93
AFXC1,0,93,0,2116,1585281600,1609218000,93
JeerFear,10,83,378,494,1601870400,1612069200,93
Genghis__Kant,1,92,7,1389,1557028800,1588737600,93
Gakad,5,87,210,1178,1548910800,1607317200,92
QuinnHunt,3,89,4681,494,1580792400,1608440400,92
Nullandvoid69,2,90,44,508,1569729600,1606107600,92
treble-n-bass,1,91,53,478,1585454400,1607403600,92
Jack-the-Rah,0,91,0,692,1564200000,1611810000,91
Noctis_Lightning,0,91,0,471,1558065600,1596081600,91
KillerHillzz,4,87,111,832,1570161600,1606885200,91
FirstGameFreak,0,91,0,395,1587960000,1604898000,91
Metalbass5,0,91,0,1642,1574053200,1609304400,91
hydroxypcp,0,91,0,786,1602216000,1612155600,91
Luna259,10,80,380,811,1542344400,1623038400,90
Aemmii,3,87,76,947,1601784000,1609390800,90
jamra27,0,90,0,1690,1565064000,1603684800,90
muri_cina,0,90,0,858,1600833600,1612069200,90
RariCalamari,2,88,355,70,1571630400,1611982800,90
x420PussySlayer69x,0,90,0,114,1553486400,1581397200,90
Owyn_Merrilin,0,90,0,722,1556683200,1612155600,90
PaleBlueDenizen,2,88,85,1533,1544677200,1600747200,90
xXsavagewulfXx,10,80,3040,648,1552708800,1608267600,90
ldobehardcore,0,90,0,1088,1576386000,1608613200,90
arclar,4,85,144,1294,1564977600,1608354000,89
ukiyuh,4,85,1213,1004,1585540800,1609045200,89
Comrade_Crunchy,0,89,0,2627,1564804800,1608958800,89
milpathecat,0,89,0,1044,1555905600,1561953600,89
NaturalRattle,15,74,25672,1362,1565755200,1608181200,89
Metalorg,0,88,0,1527,1567224000,1608613200,88
DoNotImposeYourWill,0,88,0,1303,1573621200,1576731600,88
hanhange,2,86,73,781,1559188800,1589860800,88
lankist,0,88,0,2596,1552107600,1597118400,88
bjones4252,0,88,0,295,1572843600,1604638800,88
slckrdmnchld,0,88,0,313,1567051200,1607922000,88
joe30h3,2,86,63,492,1566964800,1578546000,88
TELME3,0,88,0,2767,1566792000,1605330000,88
SimpleFNG,1,86,11,558,1593403200,1606885200,87
AllEmily1,0,87,0,503,1603771200,1609390800,87
TheOneTrueDonuteater,0,87,0,376,1582088400,1587873600,87
moshe-pit,0,87,0,-89,1575176400,1576818000,87
TotesMessenger,0,87,0,198,1511672400,1607922000,87
AndrewEldritchHorror,13,73,368,744,1580706000,1595649600,86
GDLuna00,11,75,53227,1190,1588478400,1608958800,86
AuthorTomFrost,6,80,213,711,1566792000,1607662800,86
casino_alcohol,0,86,0,1447,1590379200,1609477200,86
Jackman230,0,85,0,518,1606712400,1612155600,85
heartfelt24,0,85,0,-398,1569124800,1594267200,85
Jestdrum,5,80,107,463,1591588800,1607749200,85
jpowell180,0,85,0,378,1549342800,1603425600,85
ak4732,0,85,0,2480,1546837200,1605934800,85
bm96,14,71,5160,837,1554436800,1602388800,85
falling_and_laughing,3,82,38,923,1546146000,1609218000,85
bixxby,0,84,0,806,1570161600,1608440400,84
jeremiahthedamned,0,84,0,109,1578027600,1609563600,84
TheGillos,0,84,0,1503,1583470800,1603598400,84
imnos,4,80,432,1029,1546664400,1609218000,84
Jephta,0,84,0,640,1541304000,1585713600,84
holmgangCore,0,84,0,818,1601870400,1615438800,84
bek3548,0,84,0,-8,1593748800,1611982800,84
Sixers123456,8,75,410,199,1593144000,1617336000,83
summoar,13,70,1289,514,1576386000,1598846400,83
LATourGuide,0,83,0,1085,1603684800,1606971600,83
KetzerMX,1,82,23,731,1569211200,1587960000,83
BonzoTheBoss,0,83,0,501,1579150800,1609131600,83
PookiWooki,0,83,0,367,1600660800,1603252800,83
nervvves,0,82,0,1019,1580706000,1640840400,82
fascists_disagree,1,81,16,544,1580274000,1587355200,82
SileAnimus,0,82,0,812,1577854800,1609131600,82
skateologist,0,82,0,446,1591934400,1609390800,82
SusanDeyDrinker,5,77,15075,490,1604466000,1612328400,82
Sertalin,1,81,22,1447,1588996800,1596340800,82
Metaright,0,82,0,271,1556337600,1608958800,82
eschieu,0,82,0,2231,1553745600,1608958800,82
Little_Capsky,1,81,53,1449,1552449600,1583038800,82
zhyzyk7,1,81,0,-63,1577941200,1579755600,82
inevitablelizard,1,81,25,1127,1557028800,1608786000,82
lesser_futhark,0,82,0,304,1604379600,1611982800,82
RegardingReddit,0,82,0,1971,1571025600,1574658000,82
arthurrules,9,73,18637,878,1599364800,1612155600,82
mug3n,0,82,0,369,1580360400,1607403600,82
EstrangedNeko,22,60,1158,593,1572580800,1603857600,82
SouthernShao,0,82,0,-101,1585454400,1607749200,82
GrandRub,4,77,308,669,1524196800,1609390800,81
seaboigium,2,79,69,1287,1590984000,1637125200,81
rainbowbucket,0,81,0,552,1577941200,1607835600,81
ramadhammadingdong,3,78,24,456,1599624000,1609477200,81
lvluffin,0,81,0,1279,1556596800,1609218000,81
Eff9to5,4,77,66,570,1577941200,1598932800,81
_MyFeetSmell_,5,76,4451,713,1553918400,1603598400,81
JorSum,21,60,969,207,1448686800,1600660800,81
NullableThought,0,81,0,1957,1569816000,1609390800,81
3CKNomadWannabe,0,81,0,927,1577941200,1595995200,81
gavdr,0,80,0,333,1593316800,1608613200,80
Grammorphone,2,78,96,730,1558411200,1611982800,80
DrMcFoxyMD,0,80,0,513,1588046400,1608699600,80
propanetable,0,80,0,-74,1589860800,1598587200,80
ImInA_Tank_YourNot,2,78,31,688,1540612800,1563854400,80
jarsnazzy,0,80,0,1672,1421125200,1611896400,80
Dvrza,0,80,0,768,1594785600,1609390800,80
sphene_unmuzzled,0,80,0,919,1582520400,1609304400,80
CarlCarbonite,3,77,135,1508,1564113600,1603166400,80
Waja_wurr90,15,65,3395,858,1578286800,1600920000,80
ThePieWhisperer,0,80,0,1216,1449205200,1598673600,80
Heallun123,0,80,0,372,1568001600,1611896400,80
GolfClapp,0,79,0,26,1605157200,1609477200,79
anonymousguy271103_1,34,45,7428,838,1556424000,1594612800,79
robotzor,0,79,0,1413,1585627200,1620273600,79
metaironic,0,79,0,1126,1577077200,1638939600,79
TPastore10ViniciusG,1,78,7,446,1561867200,1607835600,79
Juluns,0,79,0,-209,1567828800,1579064400,79
4thstories,2,77,168,663,1546146000,1600747200,79
Plazmotech,0,79,0,-54,1575781200,1606798800,79
AnonoForReasons,4,75,170,469,1560139200,1606885200,79
UlnaTheCat,2,77,113,471,1607835600,1613538000,79
juvenilehell,9,70,2052,663,1565928000,1607662800,79
poisontongue,0,79,0,3454,1537848000,1609304400,79
horseshoemagnet,29,49,820,534,1560312000,1603598400,78
TiengAnh,2,76,5287,775,1516942800,1609390800,78
mylifeisathrowaway10,2,76,35,979,1607662800,1612155600,78
un0m,5,73,1130,1544,1559880000,1612069200,78
lasagana,0,78,0,1057,1531972800,1606366800,78
Lilaer,0,77,0,1352,1607749200,1609045200,77
ByeLongHair,1,76,110,562,1586577600,1611896400,77
unbelizeable1,0,77,0,922,1565582400,1612069200,77
psilosophist,1,76,4201,727,1596859200,1611723600,77
UnknownCitizen77,0,77,0,749,1582261200,1611982800,77
Dinoderp889,0,77,0,591,1579928400,1609390800,77
WayTooSquishy,0,77,0,690,1564286400,1602388800,77
OkBoomerWhatever,5,72,48,1125,1572930000,1573794000,77
ClosedSundays,2,75,2076,494,1561608000,1605070800,77
KarmaUK,0,77,0,1253,1560398400,1608872400,77
HeloRising,0,77,0,855,1420952400,1567310400,77
Mammoth-Stranger,3,73,42,449,1586232000,1612069200,76
OdetteSwan,0,76,0,454,1567310400,1607576400,76
thejellecatt,1,75,98,749,1594267200,1609390800,76
justthrowmeout,2,74,57,124,1550120400,1595736000,76
myegogobrrr,0,76,0,345,1591848000,1612069200,76
NotForBreakfast,0,76,0,-158,1589169600,1592884800,76
Shyassasain,0,76,0,1289,1549515600,1603080000,76
jimmyk22,0,76,0,919,1568260800,1603512000,76
ANorthernMonkey,3,72,1457,288,1603598400,1611982800,75
Trans_Girl_Crying,0,75,0,759,1552276800,1583211600,75
ModernDayHippi,1,74,73,492,1534478400,1608526800,75
officecaat,0,75,0,1093,1574658000,1612069200,75
darkmessenger84,5,70,120,575,1582866000,1606971600,75
EthanHale,12,63,335,579,1517634000,1601611200,75
tranquil21,0,74,0,864,1575176400,1607576400,74
lilomar2525,0,74,0,283,1596772800,1612242000,74
RedditorSince2000,4,70,712,957,1564027200,1606626000,74
virtualtowel5,26,48,78007,1242,1574485200,1591156800,74
twoisnumberone,0,74,0,401,1574398800,1611810000,74
Novusod,4,70,5665,1187,1572843600,1590552000,74
idapitbwidiuatabip,0,74,0,348,1550206800,1605502800,74
ruiseixas,3,71,14,212,1567656000,1612155600,74
0H0URs_000,10,64,90,538,1583899200,1605848400,74
GMID8380,0,74,0,717,1567396800,1599796800,74
Mewssbites,0,73,0,944,1578459600,1607576400,73
ChaiTRex,0,73,0,624,1547442000,1608181200,73
jimmyharbrah,0,73,0,2045,1543467600,1605502800,73
Psywrenn,3,70,285,482,1586145600,1606280400,73
georgist,1,72,56,1868,1580706000,1609390800,73
Shelmii,0,73,0,653,1590120000,1612069200,73
CuntFucksicle,0,73,0,947,1593489600,1601265600,73
hat-tippe,4,69,186,801,1568865600,1593230400,73
the_cutest_void,0,73,0,152,1599796800,1602993600,73
TigerSnakeRat,1,72,73,676,1566187200,1574744400,73
Crafty_Camel,1,71,34,1397,1573275600,1595476800,72
Shining_Kush9,10,62,1501,432,1551330000,1567656000,72
itsoktobebrazilian,0,72,0,232,1565064000,1568001600,72
dpizul,0,72,0,458,1596859200,1608699600,72
iWillNotLetYouGo,0,72,0,389,1555387200,1612242000,72
FragsturBait,1,71,15,610,1574658000,1608354000,72
aboyhasn0name,0,72,0,407,1568347200,1588996800,72
lrlOurPresident,72,0,53067,0,1559880000,1611810000,72
chaun2,0,72,0,817,1570248000,1612069200,72
mr_plopsy,4,68,310,1543,1552449600,1581570000,72
Gameofadages,0,72,0,1557,1566360000,1605848400,72
GotThaAcid5tab,0,72,0,460,1547096400,1611896400,72
StorminNormin123,0,71,0,256,1563163200,1566360000,71
DarthLeon2,0,71,0,503,1584504000,1608699600,71
quay-cur,0,71,0,2689,1591243200,1611810000,71
VoidZero1337,1,70,39,2143,1571716800,1573534800,71
JRutterbush,0,71,0,914,1566792000,1609218000,71
Viktor_Hadah,1,70,51,115,1557374400,1606626000,71
tentafill,0,71,0,1835,1591156800,1609045200,71
ThatSquareChick,0,71,0,1195,1585022400,1612155600,71
BboyPa,0,71,0,504,1547787600,1580187600,71
areyouhavingalaugh1,3,68,291,1712,1606280400,1607835600,71
bloodthorn1990,0,71,0,274,1594180800,1611982800,71
SCTN230,4,67,1801,533,1545541200,1553313600,71
bloouup,1,70,29,1340,1573880400,1609045200,71
nutxaq,0,70,0,1154,1564027200,1609304400,70
Whoops2805,2,68,96,343,1595044800,1609390800,70
MissCJ,24,46,815,413,1554868800,1587268800,70
fractalbedlam,4,66,155,635,1569124800,1581570000,70
Justicewarrior72,8,62,1100,1290,1591243200,1602561600,70
SuperBarracuda6,5,65,211,649,1562990400,1612069200,70
zap271,2,68,69,627,1541998800,1604203200,70
Bingbongs124,0,70,0,760,1570680000,1606453200,70
I_Hate_Soft_Pretzels,7,62,9601,416,1512363600,1608699600,69
human-no560,1,68,17,91,1579323600,1599105600,69
TGOTR,8,61,782,268,1599019200,1612155600,69
unreached_dream1,0,69,0,6,1583643600,1603684800,69
ApolloXLII,1,68,96,1279,1603684800,1611810000,69
AdamantiumLaced,3,66,70,-151,1554004800,1605330000,69
Mariamatic,0,69,0,1014,1549602000,1611810000,69
ketzal7,1,68,29,606,1537934400,1607317200,69
IlikeYuengling,46,23,8391,712,1595995200,1611896400,69
Racerboy427,6,63,876,721,1577854800,1608958800,69
Norseman901,5,64,1200,826,1549602000,1608786000,69
NWRockNRoll,9,60,621,647,1590033600,1612069200,69
math_salts,0,69,0,38,1580101200,1608526800,69
TheWidowTwankey,0,69,0,1891,1588046400,1609045200,69
radical_marxist,1,68,56,1138,1561521600,1591329600,69
Pessimist001,4,65,198,770,1547701200,1611118800,69
RonZero7,1,68,5,440,1604030400,1609477200,69
Stank_Lee,4,64,279,923,1561694400,1611810000,68
everything-man,0,68,0,348,1558756800,1609390800,68
Silver-Monk_Shu,8,60,1333,528,1558411200,1572930000,68
AlessandoRhazi,0,68,0,235,1551070800,1599451200,68
Koalitygainz_921,0,68,0,38,1597377600,1612587600,68
BobToEndAllBobs,0,68,0,500,1554523200,1581656400,68
HadolphAitler,9,59,198,944,1588651200,1593316800,68
Otheus,0,68,0,528,1584590400,1609218000,68
IhateJobsAlot,13,55,6651,587,1567483200,1577682000,68
OddSquirrel3,3,64,320,2612,1570507200,1608526800,67
phigr,1,66,1,649,1577854800,1608526800,67
LeftRat,0,67,0,264,1578114000,1608699600,67
1egoman,0,67,0,496,1559188800,1601524800,67
hglman,0,67,0,843,1559707200,1611982800,67
xnarutofanx,2,65,34,848,1570593600,1576731600,67
DongQuixote1,3,64,62,945,1548565200,1569297600,67
Grunge23,9,58,465,423,1552363200,1607922000,67
theotherfrazbro,1,66,19,462,1594008000,1598846400,67
Awesometjgreen,7,60,162,652,1569124800,1611637200,67
Ellesdee25,0,67,0,866,1605416400,1609304400,67
BoomeRoiD,5,62,70,1567,1582002000,1612069200,67
DarlingClementine1,0,67,0,1259,1594353600,1609390800,67
bsdcat,4,63,475,898,1576731600,1594440000,67
Jax_Gatsby,19,47,1517,145,1550034000,1608008400,66
bugworg,0,66,0,89,1566792000,1573189200,66
annieduty,3,63,303,463,1570593600,1607490000,66
Elatra,2,64,103,534,1578286800,1598414400,66
triptifan,5,61,158,428,1550293200,1591675200,66
micah_pearce,1,65,117,880,1565755200,1578978000,66
JohnnyTurbine,1,65,23,1630,1549170000,1602993600,66
mynameisegg,3,63,133,751,1567483200,1583899200,66
MyronLokus,4,62,0,-59,1579323600,1584244800,66
Faces-kun,0,66,0,665,1585627200,1608958800,66
MassiveFajiit,0,66,0,888,1558843200,1612242000,66
DRPGgod,0,65,0,-73,1573448400,1603771200,65
-LuciditySam-,0,65,0,670,1589601600,1607662800,65
uniballing,2,63,262,199,1606021200,1612155600,65
from_tralfamadore,7,58,120,165,1572580800,1582606800,65
xpseudonymx,0,65,0,542,1573621200,1602734400,65
svoodie2,0,65,0,681,1535860800,1607922000,65
DontNeedMuchMoney,5,60,153,236,1583125200,1584072000,65
timmytissue,0,65,0,489,1604030400,1611723600,65
colinthetinytornado,0,65,0,1097,1582779600,1608872400,65
Huzzahd,0,65,0,908,1566792000,1609477200,65
_FatFist_,0,65,0,190,1567137600,1608699600,65
SearchLightsInc,3,62,389,509,1554264000,1608699600,65
Grognard68,0,65,0,844,1552622400,1571976000,65
Dancedancerehab,7,58,858,662,1592020800,1608526800,65
ithinkthissucks,5,60,235,257,1597377600,1609390800,65
parksandwreck,1,64,227,343,1544677200,1573880400,65
screamifyouredriving,4,61,23,176,1563854400,1596254400,65
derpman86,0,65,0,708,1592366400,1608094800,65
BurnRubber567,0,64,0,320,1550811600,1564200000,64
textingperosn,0,64,0,373,1602907200,1609218000,64
DarkGamer,0,64,0,0,1578891600,1603512000,64
bertiebees,0,64,0,1436,1571630400,1606280400,64
tommy_turnip,0,64,0,1180,1571025600,1607749200,64
Aravisi,1,63,74,570,1573534800,1608958800,64
MPaulina,3,61,57,691,1577854800,1609304400,64
SphmrSlmp,5,59,9805,1051,1590638400,1608440400,64
LA-Matt,0,64,0,771,1577682000,1596772800,64
MetalNickA,1,63,1451,320,1557201600,1578459600,64
Whitedragon6702,0,64,0,63,1585454400,1585540800,64
Casual-Human,3,61,3284,2080,1575522000,1608526800,64
BronzeddAdonis,0,64,0,164,1576213200,1601179200,64
FuManBoobs,3,61,18,550,1551848400,1574053200,64
smellyscrotes27,0,64,0,1014,1598241600,1611810000,64
biggestbaddestnerd,0,64,0,1036,1575435600,1605330000,64
MainAdvisor,1,63,6,499,1572148800,1587355200,64
markodochartaigh1,0,64,0,859,1569470400,1607835600,64
THICC_DICC_PRICC,0,64,0,-211,1558065600,1599105600,64
AnonymousTowel,2,62,222,426,1576040400,1605070800,64
PaintingYourMom,1,63,13,547,1587528000,1612155600,64
tannerpending2113,0,64,0,662,1565496000,1611982800,64
NorthernAvo,2,62,37,580,1601524800,1611982800,64
visorian,0,64,0,659,1576126800,1609390800,64
twin_bed,0,64,0,262,1601956800,1609304400,64
fuckoff_21,8,55,492,450,1566878400,1608786000,63
DragonDai,0,63,0,907,1592971200,1612155600,63
realSatanAMA,0,63,0,978,1573880400,1608786000,63
sapphires_and_snark,0,63,0,1005,1546664400,1608786000,63
Darius510,0,63,0,-123,1590811200,1593748800,63
SeasonalDreams,0,63,0,1280,1569902400,1609477200,63
raziel_the_mystery,0,63,0,814,1572843600,1584590400,63
Kythirius,31,32,72363,1242,1572235200,1609304400,63
MichelangeloDude,6,57,190,305,1545195600,1569902400,63
RockinOneThreeTwo,1,62,12,567,1572843600,1609045200,63
HamtaroTradeFR,1,62,383,441,1521777600,1581656400,63
PhatPlonker,2,61,9765,704,1608613200,1609390800,63
Clicking_Around,1,62,24,292,1589688000,1609390800,63
lowercase_crazy,0,63,0,733,1560312000,1611896400,63
minisculemango,0,62,0,1026,1574658000,1612155600,62
colcrnch,0,62,0,-595,1577854800,1588996800,62
ManthBleue,1,61,77,402,1560830400,1593921600,62
macrosofslime,0,62,0,145,1585022400,1608786000,62
vapr-trp-n,0,62,0,389,1581224400,1600488000,62
anarchocynicalist1,2,60,21,349,1552968000,1581138000,62
zone-zone,0,62,0,1450,1594353600,1611982800,62
Pie-romancy,11,51,959,423,1567483200,1608699600,62
LeopoldParrot,3,59,251,1593,1548565200,1593662400,62
RabbitsAteMySnowpeas,0,62,0,296,1600574400,1609390800,62
ImmediateDrawing9612,0,62,0,14,1608267600,1609650000,62
PockingPread,6,55,3118,1036,1563336000,1606021200,61
TheIenzo,5,56,425,293,1538452800,1589947200,61
dumb_intj,7,54,77,199,1517634000,1557201600,61
Banana8686,2,59,1433,263,1598241600,1613451600,61
yell0wbirddd,10,51,686,1021,1586404800,1609218000,61
XyzzyxXorbax,0,61,0,621,1577336400,1598932800,61
poofyogpoof,3,58,75,505,1553140800,1609390800,61
fiskiligr,2,59,10,694,1556251200,1589515200,61
samothrace22,0,61,0,95,1556164800,1576645200,61
JediKnightKeylo,12,49,897,675,1554091200,1608440400,61
ChuzzoChumz,0,61,0,147,1571976000,1609304400,61
yetibarry,0,61,0,535,1587182400,1599710400,61
putnamto,3,58,43,339,1583125200,1608786000,61
ongestoordegek,0,60,0,1118,1604116800,1612069200,60
bullshitonmargin,0,60,0,727,1572321600,1608958800,60
EmpathyInTheory,2,58,141,1013,1567742400,1605848400,60
WJ_Amber,4,56,629,422,1555732800,1583470800,60
ttystikk,0,60,0,568,1603598400,1612155600,60
Fenrir_dwell,1,59,14,593,1576126800,1606453200,60
blue_dream_stream,1,59,35,389,1582088400,1607490000,60
Gamedoom,0,60,0,579,1569384000,1612155600,60
ScottsdaleDreaming,2,58,190,894,1598587200,1616558400,60
freutmich1,0,60,0,335,1595995200,1596254400,60
stubborn_introvert,0,60,0,1045,1561348800,1599969600,60
sevbenup,0,60,0,749,1580533200,1609218000,60
BeefPieSoup,0,60,0,925,1559361600,1606798800,60
Iniquiline,0,60,0,-61,1582347600,1592712000,60
DJschmumu,2,58,839,298,1592971200,1606280400,60
TheGentleDominant,0,60,0,451,1547182800,1607490000,60
sickoftheirship,2,57,1320,1062,1605416400,1605416400,59
Algoresball,9,50,702,336,1572580800,1601956800,59
Max_Thunder,0,59,0,922,1595131200,1602043200,59
SSquarepantsii,1,58,19,644,1599883200,1605243600,59
digdog303,1,58,10,736,1557547200,1607058000,59
x-meh,0,59,0,265,1595304000,1609390800,59
Smoldero,0,59,0,907,1548565200,1608699600,59
Azulmono55,1,58,29,501,1578546000,1599537600,59
Cheechmo884,4,55,616,223,1597377600,1612069200,59
celestial-bell,4,55,323,2177,1585972800,1604379600,59
DrJawn,1,58,190,731,1571112000,1611810000,59
Stratahoo,1,58,6,1123,1566360000,1607058000,59
iwannalearnitall,0,59,0,325,1594094400,1599364800,59
TyraelsBigWang,2,57,247,563,1566360000,1591588800,59
THEchancellorMDS,0,59,0,363,1598673600,1606971600,59
DopeDetective,2,57,1610,83,1587096000,1612155600,59
Gr1pp717,1,58,207,811,1546405200,1611896400,59
WaterStoryMark,0,58,0,450,1573102800,1609131600,58
Lemmiwinks99,0,58,0,-284,1579669200,1612069200,58
pm_me_fibonaccis,0,58,0,1309,1541912400,1585627200,58
hollow_bastien,4,54,261,368,1579410000,1608526800,58
Iasalvador,2,56,509,850,1575608400,1608094800,58
Mjollner06,5,53,10154,828,1594699200,1612155600,58
mariocova3,1,57,6355,369,1564545600,1610686800,58
Tarquin_Underspoon,0,58,0,1156,1551675600,1559880000,58
ProphecyRat2,0,58,0,648,1580533200,1608526800,58
Galaxycircling,0,58,0,593,1598068800,1606366800,58
OriginalityIsDead,0,58,0,919,1555819200,1579842000,58
LegendaryLonk,5,53,174,331,1592107200,1606453200,58
1982aw,1,57,1,398,1607662800,1608699600,58
EverForthright,3,55,45,569,1557115200,1594353600,58
Cmyers1980,1,57,6,1601,1560139200,1612069200,58
Time_Mage_Prime,1,57,12,501,1589083200,1608872400,58
great_dame,5,53,70,89,1574139600,1585713600,58
BackToTheNineties,3,55,573,2318,1569470400,1573102800,58
jollyroger1720,0,58,0,546,1571716800,1607922000,58
unitedshoes,1,57,453,1665,1556683200,1607749200,58
Deboche,1,56,21,594,1565236800,1596945600,57
ATeenWithNoSoul,0,57,0,131,1565496000,1603944000,57
MarshallDillion,0,57,0,285,1593230400,1607230800,57
Lambdal7,0,57,0,-259,1540612800,1606539600,57
GETZ411,2,55,266,805,1585627200,1609304400,57
Acidic_Junk,0,57,0,385,1554955200,1609477200,57
mattbag1,0,57,0,123,1573448400,1574571600,57
warsie,0,57,0,120,1562990400,1591156800,57
asdf785,0,57,0,-233,1577509200,1580965200,57
nightmuzak,0,57,0,843,1590120000,1609304400,57
ManWithDominantClaw,1,56,29,550,1582866000,1612155600,57
AyasakiHayate,3,54,71,382,1568692800,1608958800,57
windowtosh,0,57,0,1835,1561348800,1606885200,57
DeviousDefense,0,56,0,883,1558756800,1607662800,56
uw888,13,43,2308,317,1562472000,1612069200,56
LynchianNightmare,9,47,1407,426,1598241600,1608872400,56
EatThe0nePercent,1,55,5,597,1578891600,1594872000,56
squashieeater,0,56,0,1223,1558152000,1605157200,56
landback2,0,56,0,821,1567569600,1609390800,56
jgrovaswitness,2,54,10,649,1589083200,1605416400,56
asmodeuskraemer,0,56,0,297,1573448400,1607317200,56
secretsafeaccount123,5,51,177,258,1601352000,1608786000,56
da_Sp00kz,3,53,2773,591,1588132800,1599364800,56
olbaidiablo,0,56,0,921,1576990800,1608958800,56
commitme,1,55,124,1094,1555992000,1612069200,56
complain_about_work,22,34,1239,209,1581310800,1612069200,56
BigAlTrading,0,56,0,417,1591243200,1591848000,56
HertzDonut1001,1,55,52,922,1575262800,1612155600,56
progressiveoverload,0,56,0,552,1569816000,1608008400,56
Rilley_Grate,0,56,0,1131,1578373200,1611896400,56
gvsrgsdfgvxcf,0,56,0,205,1593662400,1609390800,56
Suedeltica,2,54,31,444,1591848000,1608181200,56
NotWorkingRedditing,2,54,140,390,1596081600,1611896400,56
MarieVerusan,0,56,0,1122,1565150400,1607576400,56
UnbeknownstWeirdo,2,54,4222,155,1577941200,1578286800,56
Tvmouth,1,55,7,420,1602648000,1609390800,56
2020vw69,0,56,0,1839,1572235200,1604030400,56
DivorceAfterDisabled,2,54,2373,206,1594958400,1609304400,56
Sad_Diamond1284,2,53,11,100,1593576000,1598328000,55
blckmeta,3,52,369,253,1547010000,1582779600,55
Dianazene,0,55,0,381,1580706000,1606971600,55
Michael_Trismegistus,2,53,32,864,1583298000,1606453200,55
Precaseptica,0,55,0,627,1425272400,1607662800,55
SDL_assert_paranoid,3,52,604,505,1567137600,1573102800,55
zerohours000,0,55,0,397,1545541200,1563249600,55
LightingTechAlex,0,55,0,644,1589428800,1612155600,55
rothmal,12,43,922,242,1589515200,1612155600,55
AgnieszkaMarszalek1,0,55,0,811,1591329600,1594612800,55
InternationalLoan,0,55,0,0,1558152000,1570075200,55
kezza747,0,55,0,1364,1577509200,1611810000,55
Overarching_Chaos,5,50,204,975,1555387200,1600574400,55
isananimal,5,50,79,137,1600228800,1608699600,55
Katzepede,16,39,18774,765,1574571600,1595304000,55
somethingclassy,0,55,0,-32,1525579200,1558497600,55
ChasingGoodandEvil,1,54,4,157,1561521600,1607835600,55
Getapizza3,2,53,169,989,1565496000,1592280000,55
3rdeyesurgeon,1,54,6565,429,1566446400,1608699600,55
damnedpessimist,2,53,40,499,1546491600,1588651200,55
Carrie518,1,54,688,379,1587355200,1612069200,55
nuublarg,0,55,0,660,1584763200,1609131600,55
Bookbringer,5,49,251,1214,1555300800,1585713600,54
Grognak_the_Orc,1,53,23,919,1585800000,1608267600,54
BillyCostiganBoston,4,50,97,16,1553745600,1557288000,54
Hagrid222,0,54,0,986,1547528400,1608008400,54
Oulr,3,51,351,242,1550034000,1582866000,54
gramsci101,0,54,0,1062,1576904400,1591934400,54
parens-p,1,53,13,555,1565582400,1608958800,54
TheBlingKing,6,48,74,278,1571803200,1579150800,54
PharmsAndPhilosophy,0,54,0,151,1588305600,1612155600,54
m1kethebeast,0,54,0,1182,1562904000,1584590400,54
kenpo22,0,54,0,20,1579928400,1583812800,54
wass41,0,54,0,135,1575867600,1590552000,54
IsntListening,2,52,18,383,1601697600,1608786000,54
Legalise_Gay_Weed,0,54,0,478,1543813200,1609390800,54
p00pey,1,52,11,427,1573016400,1574830800,53
dgaruti,1,52,7,501,1580446800,1611810000,53
latteisnotcoffee,1,52,48,306,1594699200,1609304400,53
Clichead,1,52,29,873,1578805200,1606798800,53
jamalw10,0,53,0,930,1568260800,1621742400,53
from_dust,3,50,473,756,1551589200,1608526800,53
smileystar,0,53,0,10,1598328000,1612069200,53
Grendel0075,0,53,0,222,1587182400,1611982800,53
cameronlcowan,0,53,0,961,1554004800,1599624000,53
amandax144,3,50,1105,353,1590033600,1609563600,53
ImapiratekingAMA,0,53,0,1734,1534219200,1608613200,53
OldSpiceSmellsNice,0,53,0,516,1545541200,1584936000,53
ninjapanda112,3,50,85,229,1540612800,1555992000,53
ItsBetterToHaveBeen,0,53,0,-190,1600660800,1601352000,53
Sister-Rhubarb,0,53,0,636,1568952000,1606885200,53
RaynotRoy,0,53,0,-94,1565496000,1607403600,53
-paranomad-,1,52,1,579,1543726800,1602648000,53
vapsorate,3,50,54,177,1588651200,1597118400,53
BladeJim,1,52,22,675,1564113600,1572408000,53
robotmanmeepmoopzorp,4,49,201,474,1581397200,1608958800,53
rokudaimehokage,0,53,0,471,1580446800,1609390800,53
The_Blithering_One,1,52,30,98,1569124800,1580014800,53
Mackan22,0,52,0,153,1580878800,1612069200,52
code_ghostwriter,1,51,5,717,1588564800,1605675600,52
Malurth,0,52,0,938,1554955200,1588910400,52
npjuggles,0,52,0,382,1582520400,1601611200,52
AndreyNazarov,2,50,98,410,1595217600,1609304400,52
founddumbded,2,50,227,855,1557547200,1563681600,52
MerryChristmasTed,0,52,0,274,1562644800,1612155600,52
phoenixrising11_8,0,52,0,364,1578891600,1597032000,52
vectorgirl,0,52,0,498,1585972800,1605675600,52
takenisthis,0,52,0,855,1594872000,1608699600,52
goosegrl21412,0,52,0,237,1585022400,1611982800,52
UpvoteOnlyPls,0,52,0,879,1582693200,1598846400,52
knightsofmars,0,52,0,471,1559102400,1603339200,52
SuicidalWageSlave,2,50,44,289,1582866000,1586923200,52
paximperius,2,50,23,507,1539316800,1608354000,52
InVirtuteElectionis,0,52,0,502,1582347600,1607662800,52
cactusdan94,6,46,2393,359,1578200400,1609045200,52
crapsh0ot,1,51,18,118,1607058000,1610254800,52
PancakeParthenon,3,49,228,690,1548133200,1605070800,52
hidrargir,2,50,22,-90,1553918400,1583298000,52
TheDungus,0,52,0,639,1552194000,1611810000,52
sheepofwallstreet86,1,51,239,265,1538193600,1581915600,52
redditrock56,0,51,0,530,1577768400,1606453200,51
mattum01,1,50,35,205,1606971600,1611896400,51
BearCavalryCorpral,0,51,0,364,1576904400,1607144400,51
floppydo,1,50,59,381,1536292800,1611810000,51
LastDanz,2,49,81,122,1540958400,1591070400,51
JimboSliceX86,4,47,887,606,1602993600,1612069200,51
grimoirehandler,0,51,0,151,1589860800,1609390800,51
getOperation,0,51,0,1693,1584504000,1612069200,51
jackalooz,16,35,110923,482,1538798400,1598068800,51
JustThinkAboutThings,5,46,513,629,1597809600,1611982800,51
Snakerspug,0,51,0,-299,1565582400,1593662400,51
W1nd0wPane,0,51,0,609,1594094400,1605157200,51
Shadowbound199,1,50,26,87,1573362000,1612242000,51
dharmabird67,0,51,0,171,1550466000,1604293200,51
Kivijakotakou,7,44,301,529,1557633600,1602993600,51
social_meteor_2020,0,51,0,292,1605157200,1612069200,51
mum_guy18,1,50,0,-274,1565841600,1602388800,51
vampyreking666,2,49,90,609,1558411200,1587960000,51
cheerfulKing,1,50,119,456,1587009600,1611896400,51
derivative_of_life,1,50,18,1510,1566446400,1609304400,51
Boycottprofit,0,51,0,1291,1579150800,1611896400,51
murksy13,2,49,92,284,1559880000,1580446800,51
Spicy_Alien_Cocaine_,0,51,0,201,1583298000,1595563200,51
Vfsdvbjgd,0,51,0,322,1598760000,1607403600,51
puppycat69,0,51,0,978,1594267200,1609218000,51
gholemu,47,4,6107,16,1545282000,1611896400,51
catrinadaimonlee,6,45,410,278,1593316800,1612155600,51
HeighInDenver,0,51,0,937,1582779600,1602820800,51
FuckDataCaps,0,51,0,433,1556251200,1609477200,51
comyuse,0,50,0,191,1544245200,1612069200,50
Reasonable_Housing,0,50,0,350,1579496400,1606885200,50
HoneyBunnyBabyBear,0,50,0,711,1588564800,1607835600,50
froggiechick,0,50,0,667,1569124800,1608094800,50
NormalAndy,1,49,0,286,1583470800,1606453200,50
SockGnome,0,50,0,510,1563336000,1605848400,50
FATEdPondera,0,50,0,173,1589515200,1599624000,50
zzzcrumbsclub,0,50,0,1860,1578286800,1609304400,50
KLWiz1987,0,50,0,-60,1562558400,1587441600,50
IGOMHN,0,50,0,428,1553918400,1609390800,50
410757864531DEADCOPS,1,49,11,247,1594008000,1611637200,50
CapableCarpet,0,50,0,305,1587355200,1599883200,50
capstan_hook,1,49,567,362,1588824000,1599796800,50
the_umbrellaest_red,1,49,38,337,1580274000,1607317200,50
blkhrthrk,1,49,3189,870,1579410000,1609390800,50
SilvioSantos2018,8,42,859,756,1545800400,1562817600,50
MutedPressure,3,47,76,227,1564632000,1606712400,50
moreat10,0,50,0,378,1604811600,1612069200,50
saltywings,0,50,0,691,1581310800,1609218000,50
GuianaSurvivor,1,49,81,1153,1588132800,1611810000,50
axion_edge,7,42,103,119,1564113600,1635307200,49
Bzzzzzzz4791,0,49,0,272,1591329600,1606626000,49
superout,2,47,115,716,1559188800,1597636800,49
Salabasama,0,49,0,426,1568520000,1609477200,49
ttomgirl,0,49,0,1086,1592971200,1607835600,49
SnooSquirrels6758,0,49,0,557,1607922000,1609390800,49
TypecastedLeftist,0,49,0,494,1593748800,1601524800,49
silky101010,0,49,0,-90,1569038400,1569816000,49
LittleVelvetBat,0,49,0,984,1552107600,1606280400,49
theguywhodunit,0,49,0,3432,1600574400,1611982800,49
scvalt,0,49,0,276,1584504000,1606539600,49
DoutefulOwl,0,49,0,258,1591588800,1608613200,49
celestial_view,0,49,0,925,1593835200,1608958800,49
EmilyU1F984,0,49,0,618,1549515600,1607230800,49
Sauron_78,1,48,7,299,1565755200,1594699200,49
Dragon3105,7,42,200,194,1577768400,1602734400,49
littlemissmoxie,8,41,3102,942,1579237200,1609304400,49
dfrancisco2,4,45,254,791,1553659200,1598241600,49
SigmaStrayDog,1,48,273,1329,1547787600,1584331200,49
Maker1357,0,49,0,261,1562558400,1595563200,49
Dennis9939,1,47,0,425,1562817600,1593662400,48
ActuallyCalindra,0,48,0,1429,1598932800,1609390800,48
lovelyllamas,2,46,218,227,1571889600,1606626000,48
B0nus_P4t3r_F4m1l1as,0,48,0,-26,1601179200,1603684800,48
BonelessSkinless,0,48,0,259,1607317200,1611982800,48
CycloneArchitect,3,45,370,654,1555473600,1584331200,48
VoidInvasion,1,47,121,1072,1585454400,1609131600,48
omega12596,0,48,0,728,1589428800,1609131600,48
spez_is_a_terrorist,2,46,49,515,1554868800,1596859200,48
willwork4oreos,4,44,280,199,1600660800,1608613200,48
roadrunnerII,4,44,103,535,1593576000,1609131600,48
Lainey1978,0,48,0,443,1576299600,1605416400,48
_mr_man,1,47,80,3033,1566532800,1609045200,48
night_owl,0,48,0,744,1534910400,1605243600,48
20191124anon,2,46,73,161,1574571600,1612155600,48
ALTSuzzxingcoh,0,48,0,105,1556251200,1612069200,48
Anargnome-Communist,0,48,0,722,1540094400,1609390800,48
Lonely-LND,11,37,570,229,1548824400,1602820800,48
sorin255,1,47,81,488,1583125200,1609131600,48
anjndgion,0,48,0,559,1604030400,1609477200,48
ohwowohkay,0,48,0,842,1589860800,1612069200,48
SSJGodFloridaMan,3,45,80,835,1563249600,1577336400,48
SunshineCat,0,48,0,269,1582693200,1604116800,48
manifesuto,2,46,438,537,1515560400,1595736000,48
bstix,0,48,0,694,1560484800,1609131600,48
TjTwinkle,0,48,0,488,1579064400,1605502800,48
squishpitcher,0,48,0,336,1584676800,1611810000,48
WartPig,0,48,0,505,1573534800,1611896400,48
MelancholyWookie,1,47,145,324,1574312400,1609045200,48
Kenny1239,0,48,0,185,1570420800,1595476800,48
TheCayciest,1,47,48,507,1578459600,1607144400,48
4BigData,0,48,0,63,1591243200,1611896400,48
Ausernamenamename,0,48,0,335,1559275200,1587009600,48
fcknwayshegoes,1,47,20,403,1555473600,1578286800,48
beautifulfuck,1,47,5,351,1585454400,1596686400,48
InsertEdgyUsername8,0,48,0,842,1576731600,1604379600,48
KahiaNyaaa,6,41,1521,366,1559016000,1601438400,47
DestruXion1,2,45,77,1038,1554350400,1611810000,47
Bag_Full_Of_Snakes,0,47,0,801,1575262800,1601611200,47
PoorDadSon,0,47,0,1112,1598846400,1611982800,47
LicksMackenzie,0,47,0,93,1591588800,1609045200,47
aNinjaWithAIDS,0,47,0,1010,1592366400,1607922000,47
anaesthaesia,0,47,0,539,1564459200,1608699600,47
no-militarism,44,3,911,4,1564200000,1592280000,47
MidTownMotel,0,47,0,913,1557633600,1611982800,47
mindyabusinesspoepoe,0,47,0,5,1606107600,1609218000,47
wvwvwvww,2,45,554,582,1558152000,1608181200,47
bucolucas,3,44,45,316,1588737600,1607922000,47
Yarrrrr,0,47,0,161,1586404800,1612242000,47
ChocolateBurger9963,1,46,23,334,1598500800,1608872400,47
wysteriafox,3,44,583,472,1565496000,1588564800,47
FromHToA92,2,45,193,426,1557288000,1565150400,47
4daughters,0,47,0,484,1567483200,1607922000,47
skyfullofstars89,0,47,0,540,1582866000,1611118800,47
StrangeShaman,1,46,99,583,1556856000,1600574400,47
DJayBirdSong,1,46,5,940,1559707200,1608613200,47
acfox13,4,43,118,481,1599537600,1609477200,47
ancientgardener,0,47,0,338,1596168000,1600660800,47
boggbutter,0,47,0,493,1598068800,1608699600,47
thepolishpen,4,43,127,154,1554177600,1572753600,47
airplane001,0,47,0,716,1582002000,1609304400,47
DudeWithAMood12,2,45,0,4,1607403600,1607576400,47
Zhenyia,0,47,0,973,1596254400,1602388800,47
anarcatgirl,0,47,0,909,1570334400,1607662800,47
Marie-Antoinette123,3,44,23,274,1571457600,1609218000,47
Environmental_Ad4721,0,47,0,710,1606539600,1608872400,47
SemiBird,5,42,346,396,1579582800,1588219200,47
Hambamwam,1,46,71,352,1568520000,1587009600,47
hughsocash45,2,45,83,427,1537243200,1612414800,47
MoralDiabetes,0,47,0,325,1572321600,1591588800,47
Captain_Stairs,2,45,100,336,1599019200,1612155600,47
lungsofdoom,7,40,362,203,1549170000,1606107600,47
igobyironman,0,47,0,351,1570766400,1600488000,47
NarutoDnDSoundNinja,0,46,0,130,1585540800,1612069200,46
Bgal31089,0,46,0,438,1599451200,1608786000,46
Not_Selling_Eth,0,46,0,-13,1573794000,1608267600,46
JeremyMo88,2,44,55,348,1593057600,1608181200,46
rillip,0,46,0,642,1546405200,1607317200,46
PizzaBeersTelly,0,46,0,456,1549170000,1606453200,46
Frandom314,0,46,0,934,1524628800,1612069200,46
BootStampingOnAHuman,0,46,0,625,1572667200,1601611200,46
KCJones91,0,46,0,108,1592280000,1600142400,46
raisedbydogsnhippies,0,46,0,1630,1611982800,1614747600,46
ryan57902273,0,46,0,-205,1580101200,1619668800,46
Buenizoo,2,44,3,-125,1594872000,1597982400,46
coke_and_coffee,0,46,0,-8,1583643600,1608354000,46
kasinasa,0,46,0,703,1575522000,1605675600,46
TypeVirus,2,44,225,534,1564891200,1593057600,46
Sophilosophical,1,45,10,1439,1589860800,1608008400,46
Sad_Cap,0,46,0,216,1577336400,1582693200,46
cadehalada,12,34,1352,196,1554350400,1579410000,46
Monk_Philosophy,1,45,18,473,1553227200,1609131600,46
retiredpartyplanner,3,43,404,320,1581656400,1608440400,46
PolaDora,1,45,18,946,1592884800,1607835600,46
SnowQuixote,0,45,0,458,1585540800,1612155600,45
DarkSoulsMatter,0,45,0,573,1549602000,1605330000,45
NukesAreFake,0,45,0,242,1574139600,1604725200,45
jdlech,0,45,0,634,1585972800,1602993600,45
ayyyyyyy8,0,45,0,-183,1602475200,1604466000,45
Qwel_,0,45,0,302,1576645200,1601006400,45
foxeyedman23698,1,44,0,123,1609218000,1609563600,45
Sharqi23,0,45,0,461,1576386000,1589428800,45
wutheringdelights,0,45,0,1423,1602820800,1603166400,45
dragonsfire14,2,43,74,422,1581138000,1608786000,45
redgr812,0,45,0,900,1597896000,1608267600,45
Islasuncle,3,42,216,290,1587614400,1606885200,45
silverwalker1,0,45,0,258,1597636800,1606366800,45
Cre8or_1,0,45,0,142,1596859200,1609045200,45
MalevolentlyInformed,3,42,2872,515,1585368000,1611896400,45
Eternity_Mask,5,40,1225,463,1589428800,1608958800,45
RollinThundaga,2,43,217,515,1582952400,1608267600,45
SniffSnatch,4,41,206,286,1605330000,1606798800,45
4RC4NG3L0,6,39,272,1294,1587355200,1612155600,45
ZakkaChan,1,44,66,512,1573534800,1607662800,45
ShoozCrew,1,44,19,228,1595995200,1612155600,45
wisconsinbrowntoen,0,45,0,300,1566360000,1589860800,45
TangerineBand,0,45,0,235,1579064400,1609045200,45
xSKOOBSx,1,44,1018,1939,1550293200,1598587200,45
Rick_from_C137,2,43,65,1185,1603684800,1608008400,45
LeChatParle,0,45,0,1068,1548133200,1604379600,45
thatHecklerOverThere,0,45,0,567,1558238400,1611637200,45
tednsfwonly,4,41,273,221,1572930000,1605675600,45
Asusofevil,0,45,0,196,1569038400,1594785600,45
Wolfeh2012,0,45,0,580,1567224000,1602648000,45
pastdivision,3,42,89,325,1571803200,1612069200,45
xena_lawless,19,26,1357,652,1581483600,1611810000,45
Danny-Devtio,0,45,0,949,1597464000,1611810000,45
AltRussian,0,44,0,-489,1570939200,1574053200,44
Dspsblyuth,0,44,0,669,1573534800,1609304400,44
redneck_ancap,4,40,72,108,1557979200,1582693200,44
Mr-Mediocre,2,42,347,217,1594699200,1603080000,44
griffaliff,1,43,9,369,1542862800,1608094800,44
Arkneryyn,1,43,43,205,1575522000,1608181200,44
derryroadfenian,2,42,85,306,1581138000,1609390800,44
LetsEatCongress,0,44,0,287,1546405200,1564459200,44
TheJayQuest,0,44,0,-89,1602302400,1611810000,44
malar1a,0,44,0,1180,1595736000,1612069200,44
erleichda29,0,44,0,516,1560225600,1605848400,44
LicenceNo42069,1,43,37,743,1549688400,1602648000,44
floatingspacerocks,0,44,0,610,1559966400,1606107600,44
Ice_Crash,0,44,0,330,1599451200,1606712400,44
pessimist_kitty,0,44,0,1175,1574917200,1611896400,44
SouthernOhioRedsFan,0,44,0,-175,1562040000,1600142400,44
KierkegaardsAngst,0,44,0,570,1563076800,1608526800,44
Groove-Theory,1,43,93,258,1575176400,1606971600,44
bibijoe,5,39,2741,190,1592280000,1595304000,44
MaterialHighlight7,0,44,0,550,1578027600,1592452800,44
seinman,0,44,0,611,1573448400,1609045200,44
cassious64,6,38,911,292,1546923600,1581570000,44
z_derApfel,0,44,0,274,1592193600,1610082000,44
rhyth7,0,44,0,295,1591416000,1608181200,44
testicularfluids,0,44,0,472,1560139200,1605934800,44
gentlesnob,0,44,0,454,1579410000,1608440400,44
Cherlokoms,0,44,0,1119,1572148800,1609218000,44
pdoherty972,0,44,0,293,1602302400,1612242000,44
AllMyBeets,0,44,0,863,1577422800,1609477200,44
ASDirect,0,44,0,199,1572753600,1609304400,44
Clutchcitybabay,0,44,0,269,1592280000,1612069200,44
sad-mustache,4,40,167,986,1595736000,1608872400,44
fooormaaaanmills,2,42,79,323,1573534800,1580274000,44
Dr_Identity,0,44,0,1129,1574744400,1602648000,44
stellarsellar,2,41,17,573,1593230400,1612069200,43
coolrandomafname,1,42,2634,1136,1567483200,1589860800,43
TrueBornTyrant,1,42,9,1378,1585540800,1590206400,43
nothing_in_my_mind,1,42,84,528,1553832000,1599105600,43
gingergirl181,0,43,0,828,1555992000,1605762000,43
Dick_Joustingly,0,43,0,565,1567224000,1612155600,43
neversaynever2,0,43,0,330,1546578000,1548997200,43
millennium-popsicle,2,41,770,612,1583726400,1611982800,43
raindampened,0,43,0,380,1566705600,1571889600,43
its-a-boring-name,0,43,0,837,1603771200,1607230800,43
Lunatcharsky,2,41,77,166,1578373200,1604030400,43
SS2907,0,43,0,153,1572235200,1583298000,43
sensualsanta,4,39,53,428,1534564800,1608440400,43
Letscommenttogether,0,43,0,229,1591934400,1608613200,43
zoeofdoom,0,43,0,137,1606280400,1611982800,43
hankbaumbach,0,43,0,602,1591502400,1612155600,43
LadyTime11,2,41,175,219,1565496000,1579842000,43
jszly,5,38,10264,567,1596340800,1608786000,43
trainedghost2,1,42,0,-4,1609477200,1609477200,43
yayfall,8,35,113,140,1423976400,1441512000,43
VaultSafe,0,43,0,818,1549342800,1612155600,43
canadian_air,2,41,8200,1213,1588910400,1611982800,43
JoePortagee,2,41,203,650,1569556800,1607835600,43
bababooeyqwer,3,40,86,802,1582174800,1607403600,43
kpoosh123,4,39,110,586,1573016400,1608613200,43
j2ck10465,5,38,1995,378,1591329600,1604466000,43
Jawatrader2000,6,37,330,315,1550811600,1561780800,43
pleasekillmerightnow,0,43,0,164,1589515200,1612069200,43
pukakattack,4,39,1038,403,1554696000,1599278400,43
csp256,0,43,0,299,1537070400,1594785600,43
gorram85,18,25,27175,299,1573016400,1608786000,43
sillyarse06,2,41,107,1432,1587096000,1611896400,43
segson9,1,42,20,441,1573362000,1584504000,43
QuintenBoosje,1,42,600,760,1592366400,1608094800,43
YoItsMCat,1,42,21,318,1578200400,1609218000,43
Crayzarz,3,40,33,184,1559707200,1563336000,43
IosefkatheClinician,0,43,0,328,1584244800,1609477200,43
HyperlinkToThePast,0,43,0,826,1566878400,1579410000,43
ultraleft68,0,43,0,113,1545627600,1608267600,43
krougle23,2,41,59,624,1571371200,1599019200,43
bcyost89,1,42,41,178,1571198400,1600574400,43
thescopeoflife,4,39,2371,412,1567224000,1607576400,43
bakura693,21,22,906,101,1597204800,1608699600,43
EducationalMoney7,2,41,15,245,1603857600,1609736400,43
fantasyLizeta,0,43,0,492,1548651600,1600228800,43
SummitCollie,0,43,0,396,1591416000,1611896400,43
No_Thot_Control,0,43,0,63,1560744000,1579410000,43
rea1l1,0,43,0,365,1540526400,1607317200,43
Attention-Scum,0,43,0,246,1548306000,1606885200,43
davidj1987,3,40,81,120,1605675600,1609477200,43
IsThereAnyWorth,3,39,171,259,1581397200,1600056000,42
cowboyboombap,0,42,0,421,1605243600,1609563600,42
_PaamayimNekudotayim,0,42,0,665,1564632000,1608181200,42
HeisenbergSaysBoo,2,40,0,13,1578546000,1579323600,42
CyberDumb,2,40,32,165,1555041600,1608786000,42
uhworksucks,0,42,0,139,1597464000,1609390800,42
Sigma_J,0,42,0,394,1557720000,1604898000,42
DaM3T,1,41,3,487,1589860800,1600660800,42
ight_here_we_go,0,42,0,159,1553832000,1606971600,42
Planetsonfireman,3,39,215,207,1601784000,1608526800,42
TheLivesOfFlies,1,41,55,105,1556164800,1565409600,42
neworderminusaword,1,41,6,227,1572321600,1587009600,42
davidj90999,2,40,1298,733,1591329600,1603598400,42
luxembird,2,40,620,1107,1572580800,1599883200,42
getval,3,39,71,537,1573362000,1596340800,42
lifesapreez,39,3,12875,35,1558497600,1607230800,42
Thymeisdone,1,41,14,746,1591156800,1609390800,42
Star_interloper,1,41,17,316,1585540800,1603080000,42
drunksinglemom,0,42,0,967,1576472400,1591848000,42
v0xx0m,0,42,0,1047,1578632400,1608613200,42
throwthisawaynow617,0,42,0,206,1568001600,1574830800,42
SkiIIs_,2,40,288,1720,1566014400,1578978000,42
ShotOwnFoot,3,39,121,212,1575954000,1607144400,42
CodeClanSucks,0,42,0,902,1592625600,1604898000,42
Ed_Trucks_Head,5,37,498,293,1583211600,1608008400,42
LGCJairen,0,42,0,800,1595131200,1609131600,42
alwaysmilesdeep,0,42,0,1125,1573534800,1611723600,42
jakethemate,0,42,0,18,1579323600,1595390400,42
tiredofstandinidlyby,4,38,116,359,1578286800,1609390800,42
Angry_Retail_Banker,1,41,33,445,1598328000,1612069200,42
MartialImmortal,0,42,0,-210,1582347600,1609477200,42
southernslanderer,0,41,0,151,1578373200,1588824000,41
Lyndis_Caelin,0,41,0,200,1555473600,1601179200,41
FatKnob,1,40,38,381,1529726400,1573794000,41
Wiwwil,0,41,0,1459,1566705600,1592625600,41
13BadKitty13,0,41,0,667,1568260800,1607058000,41
hmgEqualWeather,1,40,9,156,1556510400,1600833600,41
kai_okami,0,41,0,308,1577077200,1588996800,41
ricky28992722,0,41,0,1794,1578286800,1611723600,41
OstentaciousOstrich,6,35,554,833,1573621200,1584331200,41
KalphiteQueen,0,41,0,338,1543122000,1604725200,41
Niruzi,0,41,0,561,1578286800,1583470800,41
Mr_Makak,0,41,0,653,1590638400,1609218000,41
snikitysnackitysnake,0,41,0,360,1571630400,1583125200,41
S1n3-N0m1n3,1,40,23,296,1585627200,1606194000,41
Kinky-Iconoclast,3,38,129,658,1602648000,1609390800,41
optimisticgay80,4,37,81,50,1587873600,1609131600,41
AnarchicDeviance,0,41,0,818,1582866000,1608526800,41
Karui023,1,40,36,236,1592539200,1608786000,41
CallCenterDweller,4,37,299,308,1599796800,1606885200,41
isyankar1979,0,41,0,369,1577336400,1611810000,41
DvSzil,0,41,0,353,1548565200,1603684800,41
apndi,0,41,0,174,1596427200,1612069200,41
Lubomir1994,3,38,153,106,1552276800,1557288000,41
TheRussiansrComing,0,41,0,851,1554955200,1609218000,41
Katelyn89,1,40,506,693,1548046800,1609045200,41
moomooyumyum,2,39,34,249,1578027600,1596945600,41
baktisid12,4,37,84,552,1604203200,1609218000,41
Zombiecidialfreak,2,39,24,502,1605934800,1612242000,41
zepperoni-pepperoni,0,41,0,652,1583038800,1608267600,41
JohnJointAlias,0,41,0,236,1597032000,1601179200,41
izanami94,0,41,0,99,1577336400,1580014800,41
GainssniaG,0,41,0,364,1574485200,1607835600,41
tgw1986,1,40,3076,364,1567483200,1600401600,41
thefirstlunatic,1,40,71,1266,1603339200,1612155600,41
sisterofaugustine,0,41,0,296,1600315200,1611896400,41
immunologycls,0,41,0,141,1558843200,1605502800,41
SnoopLyger,5,36,113,142,1561953600,1581570000,41
Neato,0,41,0,538,1592107200,1607317200,41
cmdrkuntarsi,2,39,29,287,1586836800,1612069200,41
zestychilli,3,38,279,227,1568692800,1602561600,41
jason2306,0,41,0,681,1545109200,1609390800,41
StillNotDoneWithYou,0,40,0,-146,1593144000,1594440000,40
Kira-belmont,0,40,0,431,1592107200,1606107600,40
MillenialInDenial,0,40,0,715,1582434000,1608267600,40
idkwhattoput2019,5,35,288,175,1577768400,1609218000,40
Neehigh,0,40,0,268,1570161600,1611896400,40
Fickle_Midnight5907,0,40,0,154,1603771200,1608958800,40
Brocolli123,0,40,0,749,1566964800,1608008400,40
Rota_u,1,39,247,439,1561953600,1590206400,40
selfsoothingreddit,0,40,0,314,1560312000,1605157200,40
fatzgerald,2,38,1591,1945,1581051600,1593662400,40
Vrntgng,0,40,0,552,1567569600,1611896400,40
22012020,0,40,0,410,1585800000,1609304400,40
IspeakalittleSpanish,0,40,0,906,1574398800,1589428800,40
pmooreh,0,40,0,126,1559102400,1561176000,40
AynRawls,0,40,0,-235,1599883200,1607058000,40
868-hack,0,40,0,200,1596513600,1612155600,40
Atryan420,2,38,54,371,1582347600,1608008400,40
kjodle,12,28,27909,197,1598155200,1609390800,40
icumwhenracistsdie,1,39,194,1151,1598155200,1608872400,40
frank105311499,1,39,33,220,1582693200,1605070800,40
Practice-Pad,0,40,0,200,1595044800,1608181200,40
Yuria-,0,40,0,385,1579755600,1601006400,40
SelenaPacker,9,31,840,156,1565323200,1602129600,40
d3gree,0,40,0,1111,1562644800,1592107200,40
OTGb0805,0,40,0,-117,1581138000,1581224400,40
TortoiseQueen,1,39,68,859,1564804800,1574658000,40
Alexasissy,12,28,577,288,1569124800,1589169600,40
Aberrant_Introvert,0,40,0,247,1600488000,1612155600,40
TheRealLazloFalconi,0,40,0,456,1583038800,1609218000,40
McBreezy1286,2,38,2013,291,1585195200,1603598400,40
Comrade_Soomie,0,40,0,197,1566360000,1600228800,40
mattducz,0,40,0,267,1589342400,1608699600,40
StridentNegativity,0,40,0,395,1575954000,1589688000,40
NotYouAgainJeez,2,38,53,448,1559880000,1567569600,40
dldewolf,0,40,0,29,1606366800,1606626000,40
GorillaS0up,4,36,162,266,1572494400,1607835600,40
ResourceOgre,0,40,0,258,1554004800,1590897600,40
Bro_ops,7,33,628,644,1597550400,1608267600,40
ZadarskiDrake,12,28,13690,435,1569297600,1578286800,40
Omniseed,0,40,0,322,1556337600,1578373200,40
generatedusername456,0,40,0,643,1602388800,1608094800,40
thebigtripper,0,40,0,290,1570939200,1609218000,40
Iacu_Ane,0,40,0,131,1604811600,1608526800,40
ExtremelyPoopyBHole,0,40,0,87,1577077200,1597982400,40
pirate_fj,0,40,0,745,1561435200,1604293200,40
stonerplumber,8,31,36969,1128,1600488000,1611723600,39
knightfluttershy,7,32,331,1298,1595390400,1608958800,39
Afrobean,0,39,0,615,1585627200,1608958800,39
meesigma,1,38,28,407,1597032000,1606539600,39
ls952,0,39,0,346,1574744400,1612069200,39
Mernerner,1,38,23,458,1567483200,1602820800,39
OrangeHatsnFeralCats,1,38,42,731,1592625600,1607403600,39
Giovannilevel,1,38,103,352,1589947200,1596340800,39
Biobot775,0,39,0,370,1565150400,1610514000,39
halexfossil,0,39,0,324,1556856000,1579669200,39
dishsoap1197,1,38,62,525,1585886400,1608354000,39
askmenisashitsub,1,38,0,24,1567656000,1567828800,39
user1022020X8,0,39,0,598,1537243200,1584072000,39
someguy1847382,0,39,0,231,1582088400,1601352000,39
Magda_Gessler,1,38,19859,374,1591416000,1602648000,39
standragula-,8,31,198,101,1606107600,1609563600,39
cornglutenmeal,6,33,418,210,1547010000,1552881600,39
pedrots1987,1,38,12,-56,1555300800,1600660800,39
TotalPandemonium,1,38,69,246,1599883200,1608354000,39
Fredmcnich,1,38,49,239,1568865600,1605848400,39
biotheshaman,0,39,0,-137,1603944000,1612069200,39
My_Leftist_Guy,0,39,0,758,1597809600,1606366800,39
kybe333,17,22,409,67,1562212800,1606885200,39
RMan2018,7,32,816,487,1577682000,1611810000,39
suicidebystar123,5,34,837,105,1541217600,1589688000,39
Artislife_Lifeisart,0,39,0,420,1606107600,1609304400,39
tjacob638245,6,33,1362,257,1580187600,1604203200,39
RedGoldSickle,3,36,389,208,1606539600,1612155600,39
Retardedgoblin,0,39,0,869,1567396800,1603166400,39
letsrollwithit,0,39,0,539,1590552000,1607749200,39
hitmewithmuzak,0,39,0,317,1598846400,1612242000,39
Cliff55,0,39,0,918,1556424000,1569038400,39
Silver4R4449,2,37,43,326,1585195200,1608958800,39
antihostile,1,38,2858,1118,1564113600,1608526800,39
lstyls,0,39,0,443,1567656000,1595908800,39
thenderson13,0,39,0,335,1566532800,1577422800,39
StarshipSentinel,1,38,19,429,1593835200,1601611200,39
illinoishorrorman,13,26,84,46,1570420800,1603598400,39
WhompWump,0,39,0,855,1567137600,1611896400,39
pizzaheadbryan,0,39,0,1507,1560398400,1582866000,39
nada8,0,39,0,116,1568779200,1604030400,39
babymaker666,0,39,0,544,1595476800,1612155600,39
misty_gish,1,38,23,533,1559966400,1608699600,39
rh832,0,39,0,733,1585195200,1592539200,39
glitchedgamer,0,39,0,1434,1599451200,1603598400,39
Piccoro,2,36,51,462,1548133200,1594699200,38
tribefan_12,0,38,0,-23,1571976000,1612069200,38
Meganelizabethhhhhhh,2,36,791,338,1555387200,1575954000,38
Stephen_Honking,0,38,0,240,1598155200,1606021200,38
brain_fog_expert,0,38,0,252,1590811200,1601611200,38
Bears_Beets_Battles_,0,38,0,147,1574398800,1578373200,38
VastScene,0,38,0,431,1568347200,1612155600,38
ImmortalPharaoh,0,38,0,205,1590120000,1609477200,38
PeachyKeenest,0,38,0,412,1597464000,1607490000,38
Kaabiiisabeast,1,37,30,1015,1564027200,1606021200,38
ChairmanBen,6,32,985,621,1545195600,1564372800,38
SonOfLava,0,38,0,426,1572753600,1593921600,38
VancouverRedoubt,0,38,0,303,1562817600,1570507200,38
DirtyArchaeologist,0,38,0,329,1566964800,1592280000,38
alyssa_h,0,38,0,334,1525924800,1611810000,38
ShadowUmbreon20,0,38,0,249,1567137600,1608094800,38
funkymonkeybunker,0,38,0,19,1605934800,1611810000,38
holacomoestas1991,0,38,0,281,1572235200,1594008000,38
MaximumScrawn,1,37,312,202,1567483200,1598760000,38
darkerthandarko,0,38,0,705,1547442000,1605157200,38
MADNESS0918,4,34,186,495,1575781200,1607576400,38
n_pinkerton,0,38,0,-4,1592193600,1608181200,38
Gousset-,2,36,47,436,1550293200,1575694800,38
RoyalWeirdo,1,37,279,643,1569643200,1605589200,38
TWBO,0,38,0,522,1581915600,1612155600,38
DarkHumorDark,3,35,143,146,1568865600,1576731600,38
Shake_dem_asspergers,6,32,222,212,1582520400,1608613200,38
plantbasedbee,0,38,0,942,1545195600,1607749200,38
freshstrawberrie,0,38,0,284,1565928000,1589860800,38
SimilarSomewhere_,1,37,45,134,1576299600,1580360400,38
Naos210,0,38,0,895,1576040400,1608958800,38
AppleBerryPoo,1,37,18,279,1558584000,1584763200,38
Empirismus,4,34,28,56,1565236800,1570420800,38
ArachisDiogoi,0,38,0,1555,1591934400,1608008400,38
egrith,3,35,121,346,1570075200,1607662800,38
AggresivePickle,2,36,43,1888,1576213200,1609218000,38
bmonkey1313,6,32,343,195,1597291200,1608008400,38
techtowers10oo,0,38,0,-102,1571544000,1606885200,38
Illustriousworry,3,35,53,153,1568260800,1602993600,38
Gooch_Rogers,0,38,0,281,1588478400,1604293200,38
massiveboner911,0,38,0,130,1595822400,1607403600,38
Volfgang91,2,35,109,1178,1579496400,1607403600,37
1312_143,1,36,60,326,1573794000,1580792400,37
noot-noot-boot,0,37,0,547,1578373200,1604984400,37
CytheYounger,17,20,445,195,1513746000,1608008400,37
ThereWillBeSpuds,4,33,387,407,1551416400,1603425600,37
wakeruneatstudysleep,0,37,0,533,1563249600,1608526800,37
Unknownentity7,0,37,0,623,1557633600,1592107200,37
The-Turd-Herder,0,37,0,132,1596427200,1608699600,37
MonsterinNL1986,6,31,591,122,1548651600,1612155600,37
red_topgames,3,34,117,-101,1592539200,1593403200,37
Wammakko,0,37,0,371,1587960000,1609304400,37
Gazalar85,1,36,10,144,1591502400,1609131600,37
divertss,2,35,22,87,1588305600,1593316800,37
MajoraLuna,0,37,0,488,1594267200,1602648000,37
dildogerbil,0,37,0,488,1593057600,1607576400,37
Scandallicks,2,35,52,136,1559880000,1599969600,37
Daflique,0,37,0,297,1552276800,1587355200,37
I_am_catcus,3,34,44,184,1569211200,1600142400,37
tanhan27,3,34,29,211,1480482000,1607662800,37
fatjoe97,1,36,334,247,1592452800,1605502800,37
NotTheOnlyGamer,0,37,0,87,1559620800,1605330000,37
Modernglib,4,33,51,420,1573189200,1606798800,37
Jawahhh,4,33,197,287,1565582400,1603771200,37
420rolex,0,37,0,-48,1556251200,1563940800,37
gfrscvnohrb,0,37,0,-106,1577422800,1606626000,37
Dissentient,0,37,0,90,1558584000,1603684800,37
SevenSoIaris,0,37,0,465,1574571600,1607662800,37
radome9,1,36,19,407,1593576000,1608699600,37
ellasgb,0,37,0,118,1571976000,1588651200,37
Aikidi,0,37,0,507,1573534800,1609390800,37
bubblegummustard,2,35,322,1710,1555992000,1606280400,37
nightshadow995,0,37,0,646,1600574400,1608181200,37
Bas1cVVitch,0,37,0,399,1599192000,1605934800,37
Sketchtown666,0,37,0,504,1547874000,1612155600,37
thesaurusrext,1,36,9,335,1573362000,1612155600,37
Exystredofar,0,37,0,210,1588737600,1601956800,37
Ratio_Administrative,0,37,0,1514,1602648000,1604203200,37
Gynura,0,37,0,919,1506398400,1585454400,37
11ro25,1,36,4,-13,1600401600,1600488000,37
mg18_2020,6,31,55,-10,1581051600,1583985600,37
armouredsnuggles,11,26,942,126,1589256000,1608094800,37
rose_writer,9,28,2261,200,1540785600,1607576400,37
A-B-Cat,0,37,0,2242,1575608400,1608267600,37
__kamikaze__,0,37,0,418,1575435600,1608699600,37
jephwithaph,4,33,736,403,1552449600,1607230800,37
GalacticSenateLaw,0,37,0,-30,1599969600,1600056000,37
KhalidPhoenix,25,12,2153,132,1541653200,1604984400,37
I_am_jacks_reddit,0,37,0,430,1556078400,1598241600,37
Serena_XO_XO,3,34,65,170,1593576000,1604725200,37
bghjvddghjnn,0,37,0,538,1594440000,1608613200,37
GigiReddit,1,36,6,234,1468814400,1608440400,37
echoGroot,0,37,0,761,1559102400,1596859200,37
rightful_hello,0,37,0,6,1601092800,1601179200,37
SkraticusMaximus,0,37,0,423,1591329600,1608267600,37
micmacimus,1,35,29,195,1550293200,1599364800,36
CleatusVandamn,0,36,0,851,1599192000,1609390800,36
syw6282gw82b,1,35,440,1055,1597896000,1611723600,36
workplace_democracy,25,11,1010,4,1555473600,1608958800,36
5crystalraf,0,36,0,183,1603080000,1609304400,36
Anarchist23,19,17,40144,708,1580533200,1603339200,36
spiritualien,0,36,0,455,1570852800,1611810000,36
haseo8998,4,32,102,150,1543122000,1612242000,36
UnicornPewks,0,36,0,404,1587096000,1609390800,36
goingtothecircus,3,33,148,318,1582002000,1606712400,36
PoorHighClass,1,35,5,296,1569384000,1602388800,36
npsimons,0,36,0,496,1593748800,1606366800,36
-Totally_Not_FBI-,0,36,0,840,1552536000,1606021200,36
datavirtue2,0,36,0,59,1601265600,1612155600,36
selecadm,1,35,36,313,1538798400,1607749200,36
maintain_improvement,0,36,0,52,1591243200,1608613200,36
earthscribe,0,36,0,184,1582434000,1608613200,36
bam_shackle,0,36,0,956,1565496000,1601524800,36
DrinkyDrank,3,33,116,290,1553659200,1561867200,36
ddiggety69,0,36,0,-270,1580533200,1609390800,36
FriendlyRadish3,1,35,9,234,1579669200,1593835200,36
HashFap,3,33,514,492,1573621200,1639371600,36
JustAMelon433,0,36,0,-13,1590552000,1597204800,36
krurran,5,31,581,322,1546750800,1609045200,36
Dense_Engineering,0,36,0,268,1589342400,1611896400,36
Ratsincorduroy,2,34,163,232,1605157200,1607490000,36
d0ctorsmileaway,4,32,479,180,1582952400,1596513600,36
millbastard,0,36,0,420,1572408000,1597809600,36
ThaManThaLegend69,1,35,17,386,1580792400,1608699600,36
HawlSera,0,36,0,531,1580878800,1597204800,36
Caitjennersusedthong,6,30,341,188,1559793600,1594267200,36
Chumbolex,0,36,0,1136,1551848400,1605934800,36
mightycranberry,1,35,68,1073,1593835200,1606885200,36
TomBakerFTW,0,36,0,138,1559102400,1590120000,36
punsmasterflex,3,33,112,667,1565668800,1608699600,36
Waltzforzizi00,2,34,5207,211,1590724800,1603944000,36
shamisen-says-meow,0,36,0,316,1592280000,1606626000,36
detectiveDollar,0,36,0,135,1579842000,1604552400,36
Brother_Anarchy,0,36,0,840,1565582400,1611810000,36
Fifteen_inches,0,36,0,952,1577336400,1607749200,36
destenlee,0,36,0,331,1557806400,1606885200,36
TLMozart,3,33,124,300,1560657600,1581742800,36
SentinelZylon,0,36,0,151,1578286800,1582952400,36
mt200s,0,36,0,172,1576558800,1607749200,36
FatCapsAndBackpacks,0,36,0,394,1568606400,1600833600,36
Copasetic64,15,21,7844,448,1559880000,1605848400,36
human942,0,36,0,131,1531886400,1562904000,36
Mo_Salad,3,33,92,580,1579842000,1601006400,36
Soberskate9696,0,36,0,486,1590552000,1608958800,36
GoldieWyvern,1,35,20,223,1603080000,1611896400,36
mcphearsom1,0,36,0,537,1606194000,1608872400,36
left_hand_stranger,5,31,126,297,1580274000,1601092800,36
_xDEADBEEF,0,35,0,409,1553227200,1607317200,35
HOT__BOT,0,35,0,420,1566360000,1609304400,35
digiorno,0,35,0,451,1570075200,1608613200,35
Gothboi777,2,33,18,735,1555905600,1589688000,35
deadlifts_and_doggos,0,35,0,1978,1591588800,1609477200,35
Tabbarn,1,34,37,159,1597636800,1609218000,35
originalgrapeninja,0,35,0,88,1583812800,1608354000,35
time_fo_that,1,34,940,305,1551762000,1608267600,35
VoteAndrewYang2024,0,35,0,315,1584158400,1611810000,35
AntiAoA,0,35,0,390,1575435600,1603425600,35
ArrogantWorlock,0,35,0,459,1575176400,1611982800,35
gformatxvx,0,35,0,501,1552363200,1577250000,35
i-give-upvotes,0,35,0,7,1572667200,1607490000,35
kyabupaks,2,33,1525,277,1561780800,1607403600,35
vonbalt,0,35,0,382,1598932800,1608958800,35
JayGeezey,0,35,0,1340,1599796800,1611723600,35
Viking893,0,35,0,158,1597464000,1606453200,35
coraline_cross,1,34,21,130,1576558800,1606885200,35
brokendefeated,0,35,0,701,1555300800,1567656000,35
lealicai,0,35,0,1009,1599364800,1609304400,35
throwawayyyss4days,0,35,0,386,1593144000,1597723200,35
BlackPillMerchant,1,34,75,24,1569988800,1576040400,35
GameOverBros,2,33,362,169,1552881600,1597118400,35
Xaynr,0,35,0,776,1555646400,1608786000,35
ChickenOfDoom,1,34,16,302,1559448000,1583470800,35
The-Art-of-Reign,0,35,0,2242,1571371200,1606798800,35
Supernintendolover,1,34,15,160,1573189200,1608440400,35
FilthyThanksgiving,0,35,0,305,1591588800,1595044800,35
BizzleIsBack,2,33,56,101,1591761600,1596772800,35
visionbreaksbricks,0,35,0,921,1569729600,1611810000,35
kiros_winstone,1,34,24,199,1588478400,1604725200,35
Zirbs,0,35,0,-20,1592107200,1601611200,35
Satyromaniac,0,35,0,153,1547182800,1603771200,35
fsocietymrrobot,9,26,6392,118,1566619200,1598673600,35
FreightCrater,3,32,336,251,1563076800,1599624000,35
yummycorpse,0,35,0,587,1575694800,1600056000,35
13chaggit,0,35,0,388,1588305600,1608094800,35
millennialchaos,0,35,0,300,1572667200,1609131600,35
timetickingrose,3,32,530,178,1570593600,1608526800,35
vape1997,11,24,470,86,1591588800,1601438400,35
nannerpopppps,0,35,0,216,1581310800,1583125200,35
lillycrack,0,35,0,443,1570248000,1587355200,35
the_cnara,0,35,0,247,1593921600,1609045200,35
IAmGerino,0,35,0,505,1567742400,1608786000,35
sysifuscorp,0,35,0,145,1602734400,1608526800,35
hodeq,1,34,50,337,1577941200,1597291200,35
ThumpItInTheEd,6,29,412,63,1572321600,1605502800,35
felinafelis,0,35,0,243,1540180800,1608267600,35
sarenka-w-lesie,0,35,0,277,1606021200,1612155600,35
CiDevant,0,35,0,782,1599105600,1608008400,35
EveryoneExplodeNow,3,32,1897,589,1569211200,1574226000,35
jbuchana,0,35,0,195,1600142400,1611982800,35
The-Longtime-Lurker,0,34,0,207,1575176400,1605157200,34
SEOGamemaster,0,34,0,270,1559275200,1598760000,34
zensama,13,21,550,68,1549602000,1599019200,34
18CEO,0,34,0,27,1605934800,1606885200,34
SicItur_AdAstra,3,31,381,108,1599192000,1608526800,34
505ithy,4,30,89,270,1574398800,1605934800,34
tacotruckrevolution,0,34,0,336,1581310800,1607749200,34
JimAtEOI,4,30,21,-23,1571544000,1601092800,34
sealnegative,0,34,0,901,1599537600,1611982800,34
Electronic_Bunny,1,33,66,661,1575608400,1608526800,34
confusingpatterns,0,34,0,239,1587096000,1608267600,34
TheVoteMote,0,34,0,83,1571630400,1604552400,34
Brokenladder65,19,15,2072,93,1583038800,1603857600,34
sweetdeetwo,2,32,602,507,1580360400,1594958400,34
WHALE_PHYSICIST,1,33,63,552,1600833600,1608526800,34
DerekVanGorder,0,34,0,310,1584331200,1605675600,34
eviltwink,2,32,78,629,1555473600,1596772800,34
Anthony_Kate,0,34,0,89,1550898000,1555473600,34
Iamthespiderbro,0,34,0,-338,1554523200,1605330000,34
btcprox,0,34,0,137,1583643600,1608526800,34
2punornot2pun,0,34,0,470,1584504000,1595995200,34
diversity_is_racism,34,0,307,0,1457928000,1477022400,34
draconis4756,8,26,1447,888,1578286800,1611896400,34
cranberrydrink,1,33,29,389,1600142400,1607317200,34
lookatthetinydog,0,34,0,743,1572494400,1584936000,34
Sceptyczka,9,25,1687,93,1548651600,1567569600,34
BNVLNTWRLDXPLDR,0,34,0,68,1608958800,1609131600,34
TheCookieButter,0,34,0,203,1575694800,1611982800,34
thepanichand,2,32,2633,233,1594094400,1625284800,34
darwinianfacepalm,0,34,0,198,1550552400,1603425600,34
oldhazelburke,0,34,0,260,1582952400,1593662400,34
glowmilk,2,32,30,312,1543554000,1608354000,34
the_enfant_terrible,7,27,87,63,1437105600,1611637200,34
1ksassa,1,33,16,288,1599537600,1609477200,34
DigitalDynamo,3,31,1338,428,1571889600,1594267200,34
poetryinthewater,3,31,77,147,1567742400,1598673600,34
rick_principle,0,34,0,222,1570852800,1597204800,34
ItsJohn5542,1,33,0,31,1534824000,1534910400,34
Dxactivatxd,3,31,216,200,1592798400,1602907200,34
Area_X_333,1,33,22,111,1601784000,1608613200,34
chgxvjh,0,34,0,262,1608526800,1612155600,34
SIG-ILL,1,33,17,341,1564372800,1596945600,34
J-dub-suede,0,34,0,37,1599451200,1609477200,34
freetirement,0,34,0,165,1534824000,1557115200,34
Nickalapolis,2,32,212,296,1572494400,1588219200,34
No-Shopping7726,0,34,0,117,1604030400,1608786000,34
murderoustoast,3,31,82,131,1580446800,1594440000,34
FlyingSwords,2,32,30,368,1537156800,1584676800,34
voidcactus234,1,33,332,353,1604984400,1605589200,34
Portlandx2,0,34,0,676,1599278400,1609304400,34
Pbake,0,34,0,-10,1554955200,1601524800,34
Atsur,12,21,2608,451,1561694400,1582866000,33
charandom,1,32,18,141,1569729600,1578546000,33
GloomyTadpole4,6,27,23,227,1594612800,1612069200,33
Vanthernauc,0,33,0,2713,1597032000,1609218000,33
NoFascistsAllowed,1,32,122,452,1577163600,1605157200,33
Used_Dentist_8885,0,33,0,541,1594526400,1608872400,33
BEATUWITHASTICK,0,33,0,139,1602820800,1609045200,33
le_sossurotta,4,29,11697,278,1562558400,1611637200,33
Drago-Morph,0,33,0,393,1572843600,1608872400,33
cressida25,1,32,23,26,1599969600,1601784000,33
SwordtoFlamethrower,0,33,0,314,1573016400,1607835600,33
CrunchyOldCrone,0,33,0,215,1583557200,1606712400,33
BenRayfield,6,27,315,60,1539144000,1588996800,33
hunterofmochi,0,33,0,267,1588737600,1608699600,33
TotalAwareness53,1,32,13,168,1593835200,1603771200,33
EvieKnevie,2,31,102,311,1591675200,1609390800,33
ItJustMe1,3,30,56832,376,1562558400,1612069200,33
Barrytheyeti,0,33,0,151,1568520000,1575867600,33
JawsOfTheMachine,0,33,0,229,1539230400,1585540800,33
pblokhout,0,33,0,275,1575435600,1608786000,33
ianlittle2000,0,33,0,-64,1585972800,1612069200,33
RevolverHotTubRevive,2,31,35,149,1572235200,1584072000,33
GulchDale,0,33,0,736,1605762000,1609390800,33
RS_1800,0,33,0,55,1545109200,1579669200,33
mrbabZ,0,33,0,130,1606107600,1612155600,33
Eugene_Debmeister,1,32,8,873,1567569600,1601179200,33
WeAreMoreThanUs,0,33,0,227,1578200400,1609045200,33
Hob-Nob,1,32,1,-124,1582088400,1600833600,33
Quipelotious,5,28,865,409,1580792400,1605589200,33
mcflaggarty,2,31,253,179,1559102400,1574053200,33
Glttrnthclb,1,32,278,143,1548565200,1600833600,33
figferret,0,33,0,545,1570507200,1593316800,33
dak4f2,1,32,9,127,1507867200,1561953600,33
ShortestTallGuy,1,32,304,531,1574744400,1599796800,33
mwhit85,2,31,64,103,1572321600,1605416400,33
vladimir_Pooontang,0,33,0,286,1566878400,1580101200,33
Malarkay79,0,33,0,330,1593230400,1609045200,33
Gwenny99,3,30,71,128,1580965200,1609304400,33
RMS-099RickDias,0,33,0,343,1575608400,1603771200,33
NomadBotanist,0,33,0,238,1605934800,1608267600,33
WhenTimeFalls,1,32,13,100,1609045200,1609304400,33
GuyWhoGivesAwayMoney,2,31,20,39,1603425600,1604638800,33
FloppyDickFingers,0,33,0,184,1581483600,1607403600,33
Astecheee,0,33,0,334,1590379200,1608699600,33
paralleltimelines,1,32,486,353,1588392000,1605416400,33
Lights241,1,32,58,56,1606366800,1612069200,33
SuiteSwede,0,33,0,574,1582002000,1606366800,33
AlterCherry,4,29,123,206,1591416000,1607490000,33
bmoral91,4,29,136,106,1590379200,1611896400,33
Brace_For_Impact,0,33,0,305,1573534800,1594526400,33
Bonnwe23,18,15,4040,116,1576386000,1607835600,33
AintNobodyGotTime89,0,33,0,227,1550552400,1603339200,33
3multi,0,33,0,261,1591243200,1609131600,33
People1stFuckProfit,1,32,105,191,1583557200,1583985600,33
Benjam438,2,31,10236,722,1591156800,1599537600,33
Sockfucker9000,0,32,0,505,1569297600,1600574400,32
golden-trickery,0,32,0,1170,1583470800,1607576400,32
Beemerado,0,32,0,532,1603339200,1611896400,32
scupdoodleydoo,0,32,0,79,1592625600,1604293200,32
walterstewart2018,0,32,0,26,1605589200,1610600400,32
wasa333,0,32,0,40,1579323600,1594872000,32
load231,0,32,0,1552,1540180800,1602907200,32
woolyearth,6,26,1075,609,1568347200,1611982800,32
DisastrousSundae,0,32,0,270,1600833600,1608613200,32
Twitxx,8,24,25039,532,1574485200,1598760000,32
Sovtek95,0,32,0,-157,1599451200,1599537600,32
Lockdom,0,32,0,243,1589601600,1606194000,32
Bazinga_Bourgeoisie,4,28,154,81,1596859200,1606626000,32
BioStu,0,32,0,233,1581310800,1611982800,32
Spartacus90,0,32,0,278,1552968000,1607317200,32
firefly6345,7,25,1640,50,1560052800,1574485200,32
asdjk482,0,32,0,181,1549256400,1552536000,32
Psylocke01,0,32,0,355,1559620800,1606021200,32
_Victory_Gin_,0,32,0,509,1561176000,1589947200,32
Crusty_Magic,1,31,31,226,1590465600,1608786000,32
General_GTFO,0,32,0,316,1589601600,1607835600,32
Nocampzone,3,29,141,183,1595822400,1607922000,32
wowimvegan,1,31,46,154,1592107200,1606885200,32
TheBowlofBeans,0,32,0,120,1602216000,1608267600,32
BlackAshTree,0,32,0,719,1591588800,1600747200,32
ShellInTheGhost,1,31,0,-121,1557633600,1577163600,32
New-Success-5758,4,28,251,728,1601870400,1609304400,32
CVSfarmstheME,1,31,270,505,1596686400,1606885200,32
Habanero_Eyeball,0,32,0,352,1585195200,1607403600,32
starfyredragon,1,31,13,385,1585540800,1608094800,32
OpaqueShadow,0,32,0,787,1592539200,1608526800,32
arnoldez,0,32,0,420,1595822400,1609650000,32
treesalt617,6,26,457,182,1546491600,1579669200,32
LoneCookie,0,32,0,339,1551070800,1574744400,32
themodalsoul,1,31,106,412,1577854800,1609477200,32
mattwaver,1,31,28,557,1549515600,1608094800,32
OurTragicUniverse,0,32,0,202,1597896000,1604203200,32
AndrogynousRain,0,32,0,480,1580965200,1609390800,32
novacham,0,32,0,120,1574398800,1611810000,32
CXR1037,0,32,0,305,1546578000,1578286800,32
TapiocaTuesday,5,27,1991,234,1549429200,1599796800,32
Realistic_illusions,0,32,0,357,1605502800,1609304400,32
alphabetsong,0,32,0,113,1601006400,1601956800,32
OHNOitsNICHOLAS,0,32,0,79,1440388800,1609477200,32
NewfieAsianKid,8,24,136,60,1575349200,1600920000,32
Hoontah050601,0,32,0,133,1576126800,1593835200,32
Ohio4455,0,32,0,-244,1576126800,1580101200,32
ThatHeriNegro,5,27,147,220,1542344400,1599364800,32
thebeastwithin379,0,32,0,261,1579323600,1603944000,32
kodiakus,0,32,0,448,1583726400,1611896400,32
Choomee1,0,32,0,207,1580878800,1605934800,32
Intfamous,0,32,0,127,1568174400,1597464000,32
_per_aspera_ad_astra,0,32,0,304,1566792000,1586145600,32
bionicragdoll,1,31,4,217,1570161600,1597118400,32
SuicideBomberEyelash,3,29,134,109,1566273600,1568088000,32
The_Kratos,0,32,0,438,1558497600,1608699600,32
captainspacetraveler,0,32,0,1464,1592712000,1606712400,32
No-Structure-7244,6,26,995,260,1604116800,1607749200,32
DifferentJaguar,0,32,0,154,1585454400,1600315200,32
wavesofconfusion,1,31,30,367,1595476800,1605848400,32
HellzHoundz2018,0,32,0,239,1608181200,1609477200,32
MinimallyUseful,6,26,74,364,1565323200,1601956800,32
red-brick-dream,0,32,0,692,1568260800,1585022400,32
itsFlycatcher,4,28,252,638,1575954000,1608699600,32
empathyemerald,1,31,0,-45,1594785600,1594958400,32
Subpar_diabetic,8,24,1909,204,1569470400,1612242000,32
slip-7,0,32,0,111,1592280000,1605330000,32
Waveyone,2,30,78,191,1600574400,1612069200,32
Trashblog,0,32,0,737,1585368000,1607144400,32
RedquatersGreenWine,0,32,0,408,1569729600,1598328000,32
Fobilas,0,32,0,165,1565150400,1585195200,32
The-Song,2,30,16,117,1588824000,1597291200,32
tothet92,7,24,241,121,1563336000,1608958800,31
pollodustino,0,31,0,285,1461643200,1608958800,31
Apostle_B,0,31,0,113,1597896000,1612069200,31
g4nd41ph,1,30,217,143,1569556800,1607144400,31
doowgad1,3,28,66,209,1538366400,1559448000,31
cookiemonstahhhhh,3,28,220,156,1580014800,1600315200,31
TheKemistKills,0,31,0,461,1536120000,1563681600,31
Kaoshosh,0,31,0,220,1579669200,1603598400,31
hook-line-n-anarchy,0,31,0,244,1551330000,1600228800,31
chunes,0,31,0,681,1540699200,1605762000,31
bright-nukeflash,4,27,230,53,1548133200,1611723600,31
SpicyChocolate77,3,28,327,225,1600833600,1611982800,31
ShitStainedLegoBrick,0,31,0,280,1569038400,1609131600,31
moon_librarian,0,31,0,204,1547528400,1639803600,31
Persona5fan430,0,31,0,207,1576299600,1604030400,31
In_Relictoriam,0,31,0,55,1585886400,1585886400,31
BumayeComrades,0,31,0,142,1548824400,1597809600,31
BoringHollandaise,0,31,0,-39,1575608400,1589860800,31
eluna303,1,30,33,572,1561348800,1604984400,31
SergeantStoned,3,28,125,204,1569643200,1605416400,31
leafycandles,0,31,0,124,1546232400,1589169600,31
jameslilly02,5,26,825,101,1555992000,1607490000,31
Morphologism,0,31,0,435,1589774400,1600056000,31
KING_DEZ,1,30,10,777,1551675600,1600228800,31
plasticvalue,0,31,0,219,1596600000,1611810000,31
SomethingElse521,0,31,0,319,1573189200,1607403600,31
neptultra,1,30,62,621,1575003600,1580360400,31
CorpseJuiceSlurpee,0,31,0,285,1592020800,1608526800,31
Jim_E_Hat,0,31,0,355,1540958400,1591243200,31
Floor_Professional,0,31,0,317,1594872000,1609304400,31
GL_LA,0,31,0,1002,1571025600,1605762000,31
Mantis_Toboggan_76,0,31,0,182,1597291200,1608613200,31
Coyosao,3,28,42,84,1578373200,1594699200,31
walter10h,2,29,81,130,1547614800,1580101200,31
thunderfuck89,7,24,212,241,1578373200,1586750400,31
Chancery0,0,31,0,110,1606798800,1609477200,31
Garowen,1,30,19,638,1560830400,1575176400,31
SyrusDrake,0,31,0,299,1602388800,1611896400,31
marvelousdurk,2,29,34,584,1554782400,1602302400,31
persononfire,0,31,0,268,1574571600,1597550400,31
TheNecrocommiecon81,0,31,0,238,1547787600,1586404800,31
NothingToSeeHereMan,0,31,0,509,1581310800,1609477200,31
S1ayer,0,31,0,742,1567742400,1608872400,31
Deus0123,0,31,0,534,1601092800,1609304400,31
holyshithead,0,31,0,-118,1603080000,1603339200,31
HomemadeBananas,0,31,0,670,1588392000,1611637200,31
millenia3d,0,31,0,400,1571457600,1598760000,31
Lateralus936,4,27,149,340,1574053200,1609390800,31
NecroSocial,1,30,7,272,1554868800,1595476800,31
PariahSoul,0,31,0,124,1571025600,1593057600,31
SirCranburry,4,27,1303,283,1590379200,1604811600,31
fiftynineminutes,0,31,0,-25,1587441600,1598068800,31
Reiker0,0,31,0,497,1591761600,1595649600,31
CreativeThought88,6,25,311,104,1554868800,1572930000,31
bayfarm,20,11,1135,19,1572321600,1602648000,31
unsetname,0,31,0,48,1608526800,1608613200,31
yolodd,4,27,90,179,1570161600,1608872400,31
theconsummatedragon,0,31,0,455,1594699200,1607922000,31
RichardInaTreeFort,0,31,0,404,1566532800,1583211600,31
Kremyy,0,31,0,554,1596254400,1601524800,31
djb1983CanBoy,0,31,0,197,1605675600,1608181200,31
Slapinsack,0,31,0,487,1609131600,1609390800,31
succubitchin,0,31,0,704,1598846400,1609218000,31
extracaramelfrap,6,25,208,247,1606021200,1609304400,31
ImStrongICanDoThis,2,29,71,327,1545627600,1593662400,31
fenderiobassio,0,31,0,258,1583643600,1607576400,31
ummyaaaa,8,23,144,56,1419742800,1577768400,31
Talkahuano,4,27,298,196,1568606400,1571630400,31
RSGK,1,30,290,304,1571457600,1595304000,31
coffeeblossom,7,24,2218,152,1574485200,1606194000,31
kkpp99,2,28,67,109,1565582400,1566187200,30
Rev2016,4,26,5550,319,1591848000,1608872400,30
Nacholindo,2,28,43,425,1579496400,1609131600,30
Zondatastic,1,29,145,500,1522900800,1608958800,30
Ryland_Zakkull,0,30,0,992,1604466000,1608181200,30
No_Recognition,6,24,475,211,1592107200,1611982800,30
Mustaeklok,1,29,43,203,1605070800,1607835600,30
roodammy44,0,30,0,440,1570939200,1606021200,30
mon0theist,1,29,45,-35,1575003600,1596686400,30
mad_prol,0,30,0,252,1587528000,1608181200,30
RogueArtemis,5,25,10170,557,1578459600,1594872000,30
modsrworthless,0,30,0,33,1563422400,1612069200,30
blueridgechic,0,30,0,366,1599796800,1609390800,30
avengaar,0,30,0,334,1547096400,1560484800,30
Trynit,0,30,0,89,1597636800,1605070800,30
Jokkitch,0,30,0,415,1557806400,1609218000,30
nmkd,0,30,0,199,1539921600,1608267600,30
iFunnyExam,2,28,45,-142,1579582800,1600747200,30
Violetta311,0,30,0,47,1568433600,1589256000,30
Dlaxation,1,29,20,389,1583384400,1608267600,30
Singularity2025,2,28,1,23,1581656400,1608699600,30
GetCoinWood,3,27,94,154,1593144000,1606626000,30
gnat7890,0,30,0,48,1567483200,1573707600,30
jazmaj,0,30,0,1228,1577250000,1609131600,30
boo_ella,2,28,12,36,1541998800,1602475200,30
BapAndBoujee,4,26,2038,408,1591156800,1603598400,30
bermobaron,1,29,75,115,1582779600,1607922000,30
bthug27,1,29,74,65,1597204800,1602216000,30
neighborhooddan,0,30,0,166,1591416000,1604203200,30
regrets11729027,0,30,0,74,1588564800,1590379200,30
blues0,0,30,0,281,1586059200,1609218000,30
lordcirth,0,30,0,306,1576213200,1612242000,30
jaguarundi_,0,30,0,267,1597464000,1607749200,30
dascatmeow,1,29,52,347,1598673600,1608526800,30
B1ind_Spot,0,30,0,-66,1612155600,1612328400,30
altmarie,0,30,0,372,1579150800,1605502800,30
Futa_Princess_Athena,0,30,0,420,1576558800,1585972800,30
DepressedRobot909,0,30,0,5,1588046400,1588132800,30
justanotherwave00,0,30,0,778,1543381200,1572148800,30
coolsoop,6,24,549,128,1594094400,1606107600,30
RealNaked64,0,30,0,694,1575435600,1602734400,30
tree_cakes,4,26,2640,252,1568260800,1606021200,30
Freshtoast15,0,30,0,103,1575262800,1608613200,30
Hanjuuryoku,0,30,0,274,1589428800,1605675600,30
sushidecarne,3,27,1893,380,1571889600,1608354000,30
freshprinz1,0,30,0,-366,1575781200,1605589200,30
apsconditus_,2,28,60,544,1563595200,1600660800,30
ShabbyPath,3,27,161,177,1581224400,1604030400,30
new2bay,0,30,0,415,1568088000,1607749200,30
KlutzyNinja0319,2,28,25,362,1574398800,1600574400,30
WashedSylvi,1,29,61,155,1570680000,1643086800,30
voncloft22,0,30,0,430,1566273600,1582606800,30
Sad_Tired_Potato,1,29,3,229,1598328000,1612155600,30
GCD1995,0,30,0,305,1564545600,1591416000,30
Hoorizontal,0,30,0,820,1600833600,1611723600,30
ayden3a,1,29,18,100,1565582400,1598760000,30
DJ2688,0,30,0,225,1593662400,1608699600,30
trashtrottingtrout,1,29,63,779,1578805200,1603512000,30
AspiringBiotech,9,21,1247,259,1604116800,1611810000,30
SasquatchButterpants,3,27,460,293,1560744000,1582174800,30
sizm0,3,27,68,390,1538971200,1607230800,30
superweaner,0,29,0,356,1568692800,1596772800,29
DumpsterCyclist,0,29,0,109,1554523200,1603080000,29
Furore13,2,27,47,319,1592366400,1606539600,29
FaceFartFrank,0,29,0,168,1566360000,1602475200,29
SeabrookMiglla,0,29,0,612,1571976000,1601524800,29
Enzemo,0,29,0,75,1568260800,1608613200,29
Xx420noscopeXx98,3,26,308,1583,1560398400,1581483600,29
neo_neo_neo_96,6,23,615,102,1566705600,1588046400,29
NotMyHersheyBar,0,29,0,103,1562817600,1598932800,29
ScribblesandPuke,0,29,0,168,1597723200,1602043200,29
surethatsfinehi,1,28,14,740,1559016000,1600833600,29
Billygoatluvin,0,29,0,129,1591675200,1609477200,29
CrashKeyss,0,29,0,420,1598932800,1605157200,29
improbablynotyou,0,29,0,592,1602561600,1612069200,29
H-12apts,0,29,0,199,1440302400,1608699600,29
OraDr8,0,29,0,519,1574571600,1607490000,29
Userhasbeennamed,0,29,0,300,1572667200,1607403600,29
ilovejuices4,0,29,0,205,1579064400,1581829200,29
Oliweira_4,2,27,8221,675,1564027200,1585454400,29
kartana,0,29,0,431,1557201600,1605330000,29
shadycharacter2,1,28,28,141,1554436800,1575349200,29
Tyranith,0,29,0,147,1559188800,1577854800,29
MisterOneY,0,29,0,116,1573794000,1582866000,29
existentialnotions,1,28,12,979,1569038400,1584590400,29
The_Decoy,1,28,40,615,1575262800,1611810000,29
Kalel2319,0,29,0,429,1573621200,1602388800,29
horrificmedium,3,26,8588,803,1604725200,1611896400,29
aleksusy,0,29,0,226,1584244800,1606453200,29
MissRainbow77,0,29,0,99,1591329600,1607230800,29
orbsocialism,0,29,0,432,1566705600,1573534800,29
Veskerth,0,29,0,238,1563940800,1605157200,29
Boner_Implosion,1,28,143,442,1597377600,1611896400,29
Zhewhoneedsanalt,3,26,11236,4387,1573448400,1583298000,29
ComradeSchnitzel,2,27,29,917,1565496000,1604725200,29
Mordeline,0,29,0,142,1560398400,1561867200,29
Eblanc88,1,28,38,174,1593403200,1608872400,29
krutchreefer,0,29,0,112,1557288000,1608008400,29
nattie3789,0,29,0,143,1598587200,1606885200,29
A_Fabulous_Gay_Deer,0,29,0,354,1548738000,1609045200,29
787787787,0,29,0,-56,1574917200,1593835200,29
asswhooper007,8,21,4113,143,1579669200,1583812800,29
Pensive_Pauper,1,28,44,449,1566360000,1608094800,29
PrayandThrowaway,1,28,139,226,1568865600,1593144000,29
Korivak,1,28,17,351,1571025600,1606107600,29
FatPam007,0,29,0,344,1582434000,1606626000,29
TheDevilLLC,0,29,0,306,1572494400,1596340800,29
fullycycledfishtank,0,29,0,715,1565928000,1601265600,29
CaptainXplosionz,0,29,0,94,1593230400,1608354000,29
Natsu_T,1,28,6,165,1563940800,1600056000,29
idontknow2345432,0,29,0,41,1585800000,1586059200,29
KarmaBot1000000,1,28,17,210,1548046800,1561176000,29
onizuka11,0,29,0,110,1575522000,1591243200,29
NagevegaN,0,29,0,614,1568952000,1594267200,29
Hauptmann_Mech,2,27,54,140,1549256400,1593748800,29
Dustin_Bromain,0,29,0,285,1555473600,1609045200,29
Rustey_Shackleford,5,24,488,251,1577336400,1597032000,29
dsmaxwell,0,29,0,443,1556510400,1609131600,29
punkboy198,0,29,0,54,1603166400,1611810000,29
rootbeerking,0,29,0,199,1551330000,1609218000,29
Crispy_Fish_Fingers,1,28,15,367,1545368400,1611810000,29
slightlyhomoerotic,4,25,289,123,1588132800,1596340800,29
BipolarSyndicalist,0,29,0,258,1580446800,1608699600,29
dalex89,2,27,102,2180,1607835600,1609390800,29
VigilantMike,1,28,31,781,1593576000,1605502800,29
Plaidbeard89,0,29,0,218,1605070800,1607230800,29
funkinthetrunk,0,29,0,205,1585022400,1611896400,29
TouchyUnclePhil,4,25,14,127,1572235200,1607576400,29
Telaneo,0,29,0,524,1543294800,1608613200,29
Tuffrumblr,0,29,0,269,1595563200,1612155600,29
TheShingle,1,28,15,-59,1577595600,1609045200,29
VojvodaSrpski,0,28,0,-17,1599364800,1609218000,28
ImSuperCereus,0,28,0,171,1598068800,1611982800,28
TommyWilson43,0,28,0,288,1585454400,1585972800,28
insofarincogneato,0,28,0,100,1579323600,1608872400,28
qdolobp,0,28,0,86,1611982800,1612328400,28
PropaneLozz,1,27,15,149,1595649600,1612069200,28
NeonDepression,0,28,0,192,1569297600,1609131600,28
herodothyote,0,28,0,-52,1598846400,1609390800,28
Xavier-Willow,5,23,6457,302,1595995200,1597550400,28
eckrueger,0,28,0,775,1568692800,1606280400,28
Alltherays,5,23,90,52,1604898000,1608699600,28
ingachan,0,28,0,370,1576818000,1605330000,28
timeisart,1,27,6,384,1429848000,1582002000,28
ZGAEveryday,0,28,0,235,1555905600,1580706000,28
NeeaLM,0,28,0,247,1563249600,1596513600,28
aninvisiblemonster,0,28,0,41,1607490000,1607576400,28
moonheron,0,28,0,1100,1570593600,1608267600,28
AloyIon,0,28,0,250,1593144000,1604984400,28
beanmachine89,0,28,0,1025,1594353600,1612069200,28
AnastasiaMoon,0,28,0,118,1565236800,1607749200,28
rantboi,4,24,268,329,1570593600,1581224400,28
uxithoney,0,28,0,143,1599537600,1611896400,28
HorriblePhD21,0,28,0,1564,1592712000,1609304400,28
ganjabutweed,0,28,0,163,1608786000,1611982800,28
mostisnotalmost,0,28,0,6,1578805200,1602734400,28
WorldController,2,26,3842,366,1550898000,1606280400,28
shitposterkatakuri,1,27,0,-42,1551070800,1553400000,28
AHigherBeing,1,27,28,106,1572235200,1642309200,28
Nolanb22,4,24,288,350,1575090000,1608094800,28
bloodyfloss,1,27,404,197,1595649600,1607490000,28
rest_me123,0,28,0,65,1552449600,1600747200,28
redbrickchimney,1,27,1,27,1577422800,1582866000,28
theminister911,0,28,0,327,1604466000,1611982800,28
teejaytrue,3,25,102,93,1570507200,1579669200,28
NightMareSR71,1,27,9,160,1587441600,1607317200,28
kbr8510,0,28,0,101,1597809600,1603684800,28
DabbleDAM,0,28,0,739,1596427200,1606280400,28
imaginarytacos,0,28,0,91,1572580800,1580965200,28
BoopYourDogForMe,3,25,76,165,1571284800,1579755600,28
Roman_Nose_Job,2,26,127,276,1596427200,1609218000,28
Sayodot,0,28,0,-24,1579842000,1597204800,28
Thiswokesheep,0,28,0,864,1606712400,1609477200,28
jseego,0,28,0,366,1579323600,1611982800,28
toxicbroforce,0,28,0,-241,1597982400,1605416400,28
Will_Trent,0,28,0,158,1580706000,1611982800,28
WizardyoureaHarry,0,28,0,284,1561262400,1608526800,28
DeseretRain,0,28,0,260,1551589200,1576818000,28
PicnicLife,2,26,1313,423,1562817600,1605070800,28
a90sbaby,1,27,1961,276,1581051600,1600833600,28
zombie_katzu,3,25,396,541,1543554000,1608181200,28
S1r0n,4,24,29917,342,1604379600,1612069200,28
neitherherenothere,1,27,95,17,1577422800,1582606800,28
DuanePickens,1,27,160,207,1552795200,1561694400,28
valkon_gr,0,28,0,258,1567137600,1611637200,28
calm_chowder,0,28,0,768,1587441600,1609218000,28
JassassiN7,0,28,0,200,1571889600,1576558800,28
goldencrow68,1,27,17,385,1575349200,1606626000,28
littlefunman,1,27,8,397,1567742400,1611723600,28
pockpicketG,0,28,0,222,1573016400,1590465600,28
GoldenHairedBoy,0,28,0,452,1568606400,1608786000,28
axilmar,0,28,0,63,1599105600,1608526800,28
TechnicalFrustration,2,26,74,444,1597896000,1607490000,28
witchsbrew,20,8,289,43,1432612800,1464667200,28
peanutbutterjams,0,28,0,275,1583726400,1607749200,28
Sharpie61115,13,15,1607,53,1558411200,1606280400,28
yarkost,3,25,979,294,1575349200,1597032000,28
WeAreLostSoAreYou,0,28,0,210,1558497600,1605934800,28
BiShyAndReadytoDie,2,26,700,704,1557720000,1601265600,28
Sbreddragon,0,28,0,740,1593316800,1609304400,28
majortom106,3,25,96,219,1579582800,1608354000,28
totential_rigger,0,28,0,317,1564891200,1609218000,28
gnd318,0,28,0,281,1548997200,1602820800,28
Endoomdedist,0,28,0,297,1566964800,1596772800,28
1anarchy1,0,28,0,128,1597636800,1604379600,28
Jemtao,1,27,13,256,1608267600,1612069200,28
Digganoob,1,27,0,7,1599969600,1600056000,28
advicedog123,0,28,0,373,1582779600,1595476800,28
Hannibal5545,4,23,201,94,1590897600,1605070800,27
maru_tyo,0,27,0,332,1605589200,1611810000,27
Synthee,3,24,60,161,1597550400,1603771200,27
slipknotsita13,2,25,63,181,1584590400,1607749200,27
DontShootShotgun,0,27,0,425,1548565200,1551070800,27
ThidrikTokisson,0,27,0,185,1607144400,1608872400,27
AnalLeakSpringer,0,27,0,114,1601524800,1608440400,27
postedsomethingawful,4,23,8350,539,1608786000,1609304400,27
Bedlam10,5,22,616,455,1551070800,1602734400,27
abetterme1992,2,25,82,183,1599364800,1612414800,27
igetnauseousalot,0,27,0,160,1592798400,1609045200,27
dslave,0,27,0,133,1567656000,1571803200,27
FNKTN,0,27,0,133,1539921600,1608699600,27
fecalfrenzie,1,26,39,662,1594267200,1612155600,27
our-year-every-year,0,27,0,940,1579755600,1608872400,27
-Whispering_Genesis-,0,27,0,66,1589601600,1592971200,27
bigyip,0,27,0,563,1579496400,1602475200,27
Tableau,0,27,0,227,1566792000,1584331200,27
summer907gwen,0,27,0,283,1597291200,1607922000,27
mneff5514,0,27,0,208,1560744000,1609390800,27
fieldsofanfieldroad,0,27,0,227,1589860800,1601179200,27
974747484848483,6,21,237,95,1568520000,1576472400,27
notclever_name,3,24,130,419,1587787200,1606107600,27
ThorDansLaCroix,4,23,40,132,1574658000,1608786000,27
Various-Bid809,0,27,0,544,1602302400,1604203200,27
DPJesus69,5,22,22059,1247,1588564800,1605416400,27
todayimmainly,0,27,0,107,1603425600,1606194000,27
throwaway12448es-j,1,26,26,72,1563681600,1582434000,27
vcwarrior55,0,27,0,-73,1568433600,1612155600,27
kogsworth,1,26,6,167,1573794000,1609218000,27
metallicdrama,0,27,0,107,1576472400,1579669200,27
A-Disgruntled-Snail,0,27,0,1568,1595217600,1611723600,27
Allistairt290,2,25,26,51,1608699600,1612069200,27
conjecturer_,4,23,40,136,1605589200,1610773200,27
theinfamousroo,0,27,0,461,1570766400,1592280000,27
chairs_in_the_air,0,27,0,182,1584158400,1601524800,27
LiverwortSurprise,2,25,66,176,1536811200,1600315200,27
humanitysucks999,2,25,183,258,1561262400,1609477200,27
landlockedcorsair,1,26,4159,356,1596254400,1596340800,27
l80,1,26,17,414,1558670400,1580446800,27
petitbateau12,0,27,0,269,1603080000,1611982800,27
asininequestion,2,25,97,161,1558411200,1578459600,27
Unrealistic_actress,1,26,5,169,1567051200,1607403600,27
Ladyleto,0,27,0,179,1581138000,1607835600,27
Solo17,1,26,115,139,1564632000,1593403200,27
-Orotoro-,8,19,2431,254,1599364800,1611982800,27
eercelik21,3,24,18890,235,1597636800,1609131600,27
pc43893,0,27,0,175,1576645200,1579496400,27
Dominatto,0,27,0,143,1561435200,1597118400,27
mtombihodari,0,27,0,141,1583384400,1609218000,27
sophgallina,1,26,11,279,1599710400,1605157200,27
Koolest_Kat,0,27,0,100,1601611200,1612069200,27
tappinthekeys,0,27,0,-46,1591243200,1608267600,27
SaltFinderGeneral,1,26,6,708,1583211600,1606539600,27
Prof_Insultant,2,25,52,150,1544245200,1599969600,27
FearlessFlounder,0,27,0,232,1572408000,1593403200,27
maddminotaur,0,27,0,582,1580274000,1598500800,27
Mrw2904,0,27,0,212,1583726400,1596081600,27
UnlimitedApathy,0,27,0,359,1606626000,1609304400,27
masterbatin_animals,0,27,0,391,1577422800,1606712400,27
Mynewadventures,0,27,0,59,1606280400,1609304400,27
IndicationOver,1,26,32,116,1598328000,1606712400,27
null000,0,27,0,484,1573534800,1599537600,27
albinokitkat,0,27,0,116,1570852800,1603684800,27
ifeelsick98765,2,25,37,86,1607317200,1608699600,27
Ho_KoganV1,1,26,0,140,1569124800,1608872400,27
snarkyxanf,0,27,0,571,1563768000,1608699600,27
viper8472,0,27,0,196,1567656000,1606885200,27
dmanb,0,27,0,-56,1571371200,1571803200,27
XFinalPhantom,0,27,0,179,1562817600,1582434000,27
iwaspromisingonce,0,27,0,484,1588737600,1611810000,27
GuyBlushThreepwood,0,27,0,363,1571976000,1593921600,27
richter3456,3,24,96,250,1553918400,1600660800,27
passionflower666,3,24,280,153,1572408000,1608267600,27
THE_ABSURD_TURT,3,24,44,85,1541998800,1589601600,27
Weltschmerz5,1,25,17,49,1606107600,1606194000,26
eklp22,0,26,0,105,1605848400,1609390800,26
DontBanMeForAsking,8,18,160,125,1473393600,1606107600,26
azemda,1,25,3,119,1571889600,1611896400,26
Alkiaris,0,26,0,173,1560052800,1607576400,26
ForceFedPorkPies,0,26,0,248,1580792400,1609390800,26
singdadover,0,26,0,248,1582606800,1602302400,26
soad19152003,0,26,0,249,1543381200,1617940800,26
toomuchgammon,25,1,13569,28,1596513600,1611723600,26
_pope_francis,3,23,223,108,1438747200,1554004800,26
blueberrypancake33,10,16,2751,29,1555819200,1573966800,26
universl,0,26,0,217,1598500800,1602993600,26
wandrin_star,1,25,318,331,1582347600,1598760000,26
zeca1486,0,26,0,484,1569297600,1608699600,26
Nightstroll,0,26,0,174,1557028800,1576645200,26
Austenma,0,26,0,132,1597118400,1608181200,26
tyler_kreis,4,22,2552,234,1555473600,1585627200,26
JustMadeThisNameUp,0,26,0,1,1559102400,1587528000,26
Rude-Development-377,4,22,466,145,1596600000,1601092800,26
Roadhog_Rides,1,25,18,746,1561521600,1582606800,26
ccnnvaweueurf,0,26,0,118,1594353600,1602043200,26
DizzyInkpen,0,26,0,181,1601956800,1609045200,26
badbakedpotato,0,26,0,120,1553400000,1584763200,26
FreshPrinceOfRivia,0,26,0,814,1603684800,1611982800,26
ledfox,1,25,48,874,1561521600,1609304400,26
Pie4Brains,1,25,77,67,1595304000,1612155600,26
sweetpotatonugget,1,25,13,242,1584072000,1608008400,26
mogirl2000,3,23,1092,190,1595131200,1597723200,26
upstatestruggler,1,25,6,758,1599105600,1607576400,26
smuckola,0,26,0,156,1566705600,1607835600,26
Rohan768,1,25,8,44,1603252800,1609477200,26
reereejugs,0,26,0,92,1568865600,1585454400,26
Ultracelse,0,26,0,264,1594094400,1598587200,26
vocalfreesia,0,26,0,473,1579064400,1608786000,26
PopcornAndPornLuver,0,26,0,641,1577682000,1582693200,26
jtdcjtdc,9,17,1720,62,1586404800,1608008400,26
Frunobulaxian,0,26,0,503,1563249600,1601611200,26
aphextwin87,1,25,10,188,1607144400,1612242000,26
ChuftyMcGrufty,0,26,0,-34,1592452800,1597204800,26
Zman8969,0,26,0,384,1596254400,1609390800,26
PureAntimatter,0,26,0,5,1608526800,1611982800,26
MrGoldfish8,0,26,0,73,1578459600,1605416400,26
patchelder,2,24,28,61,1553832000,1605416400,26
Bobobib,0,26,0,149,1551848400,1572494400,26
Ettieas,0,26,0,324,1594094400,1606971600,26
philter451,2,24,239,69,1611810000,1613019600,26
Fjellbjorn,0,26,0,155,1605589200,1606712400,26
kbougy,0,26,0,69,1580878800,1609131600,26
8eMH83,0,26,0,262,1509508800,1588305600,26
Laz-Long,0,26,0,308,1540526400,1566964800,26
kurisu7885,0,26,0,199,1579064400,1607662800,26
MykhailoSobieski,1,25,195,68,1599364800,1611810000,26
ceruleannymph,0,26,0,269,1577422800,1589947200,26
westbroa,2,24,32,141,1552449600,1568347200,26
ThatRandomGuy1S,3,23,5455,1759,1595390400,1607749200,26
ButterfingersBiden,2,24,14,223,1555300800,1558929600,26
puzzles_irl,0,26,0,335,1589428800,1607144400,26
CitizenPremier,0,26,0,255,1547701200,1597464000,26
Ma1ad3pt,0,26,0,295,1595995200,1608267600,26
Antihuman101,5,21,96,104,1578459600,1608526800,26
Triene86,1,25,766,255,1548738000,1597464000,26
LIKELYtoRAPhorrible,1,25,122,258,1574744400,1608354000,26
ICFAOUNSFI,1,25,25,425,1555819200,1608526800,26
Joroda,0,26,0,418,1557720000,1607749200,26
Redelscum,1,25,0,-9,1601179200,1601179200,26
nejcr26,0,26,0,-205,1570507200,1599105600,26
nunodonato,7,19,53,119,1390366800,1608440400,26
SoundandFurySNothing,0,26,0,1001,1603512000,1609218000,26
ThrowAFlyingFox20,0,26,0,176,1597723200,1608354000,26
RecklessRuin,1,25,6,207,1599883200,1606453200,26
Danger_Dancer,0,26,0,299,1555387200,1599192000,26
Decimus_of_the_VIII,0,26,0,326,1602907200,1609045200,26
skilled_nihilist,1,25,3,169,1604293200,1608440400,26
Knob_Gobbler,1,25,4,551,1596168000,1611810000,26
ornerchy,0,26,0,103,1577422800,1585540800,26
Tar_alcaran,0,26,0,355,1576818000,1606107600,26
_z3r0__,0,26,0,719,1570507200,1608786000,26
IsignedUP2Saythis,2,24,216,33,1607576400,1608440400,26
OhGodPleaseJustNo,0,26,0,208,1574312400,1601524800,26
Gagulta,0,26,0,923,1583726400,1608872400,26
rumhamlover,0,26,0,168,1558497600,1565150400,26
Taxouck,0,26,0,286,1561176000,1600401600,26
gpointer13,24,2,14355,48,1574053200,1582952400,26
ihateradishes,0,26,0,-66,1606798800,1609477200,26
starm4nn,0,26,0,240,1565755200,1604379600,26
mister-ann-thrope,1,25,31,1395,1599883200,1605934800,26
RowlinVader,11,15,2692,92,1550552400,1611637200,26
Unhappy-Celery-3543,2,24,19,58,1605243600,1607922000,26
MehBlargh,0,26,0,311,1602043200,1609218000,26
beardsofmight,0,26,0,780,1569211200,1611810000,26
Serious_Feedback,0,26,0,193,1598155200,1609045200,26
throwawayexplain08,3,23,65,120,1574917200,1587614400,26
helpmeplease12235787,5,21,169,92,1582779600,1601524800,26
prozacrefugee,0,26,0,280,1569988800,1582434000,26
rushur,0,26,0,666,1573102800,1606194000,26
bluepillergonerogue,7,19,110,78,1556510400,1560398400,26
nowhereian,1,25,86,103,1549774800,1600228800,26
numbers863495,1,25,63,303,1575954000,1605416400,26
neo-dan,8,18,3003,344,1556510400,1565668800,26
Ibespwn,0,26,0,595,1583812800,1609218000,26
biwinning_tigaa,1,25,13,100,1539921600,1599105600,26
AssumingHyperbolist,4,22,69,221,1607749200,1609736400,26
barrythecook,0,26,0,163,1601956800,1609390800,26
thegreatself,12,14,569,51,1591848000,1611982800,26
RockyDify,0,25,0,491,1570593600,1607317200,25
xianwolf,2,23,40,593,1570852800,1582866000,25
random9a,7,18,536,87,1554696000,1608872400,25
jkxn_,0,25,0,133,1590033600,1606366800,25
Voxenna,1,24,41,150,1562299200,1578978000,25
theboxislost,0,25,0,549,1593921600,1597550400,25
NonProductiveApe,0,25,0,190,1567051200,1574053200,25
SinCorpus,0,25,0,161,1554177600,1611810000,25
Mindless-Lavishness,0,25,0,406,1597464000,1601524800,25
Fancykiddens,0,25,0,481,1592798400,1594612800,25
PM_me_salmon_pics,2,23,47,172,1562126400,1570939200,25
noyart,0,25,0,149,1579064400,1608699600,25
RayneCloud21,0,25,0,300,1569124800,1602907200,25
cardboard451,1,24,21,59,1603166400,1611723600,25
Anton_Pannekoek,1,24,3,338,1583384400,1609045200,25
CidCrisis,0,25,0,209,1569470400,1600747200,25
Gooner141,0,25,0,215,1601265600,1608008400,25
Killa_Nilla,1,24,52,158,1577768400,1592625600,25
prof0ak,0,25,0,159,1580101200,1605762000,25
icoinedthistermbish,5,20,381,242,1570766400,1611637200,25
alrightfrankie,8,17,18381,556,1568952000,1579064400,25
Sporkachew,4,21,395,197,1580619600,1597550400,25
janedoeincog,0,25,0,199,1567396800,1569124800,25
DickBiggum,0,25,0,77,1582174800,1584158400,25
carlospangea,3,22,370,306,1599710400,1609477200,25
Vosuleth,0,25,0,259,1559707200,1599537600,25
t-a_3r0a,0,25,0,105,1607317200,1609304400,25
Rafe,0,25,0,235,1543726800,1579410000,25
warmbloodedcreatures,0,25,0,227,1601265600,1608094800,25
lowkeygodofmischief,1,24,20,1502,1564027200,1583038800,25
existentialgoof,0,25,0,118,1561780800,1607490000,25
insideiggy,0,25,0,477,1548565200,1611810000,25
slowerisbetter527,0,25,0,511,1550811600,1560139200,25
CanIBreakIt,1,24,22,843,1596772800,1606366800,25
RedditCucksPlzDie,0,25,0,151,1603080000,1612155600,25
chrisfarleyraejepsen,0,25,0,489,1575349200,1606626000,25
dont_ban_me_please,4,21,520,285,1553918400,1606798800,25
tyrghast,0,25,0,473,1594267200,1606194000,25
yeasty_code,0,25,0,283,1549602000,1608958800,25
katespide,0,25,0,370,1594699200,1607662800,25
BillysGotAGun,0,25,0,1338,1603771200,1607576400,25
sandypockets_,2,23,248,128,1584590400,1605675600,25
Peepshow741,1,24,120,432,1591761600,1595476800,25
fffffffffffffuuu,1,24,125,257,1563768000,1601179200,25
FBML,1,24,17,198,1599105600,1608267600,25
TokusatauGunMan,0,25,0,130,1587182400,1589688000,25
LiquidHelium42,5,20,309,78,1584676800,1606021200,25
mistressbitcoin,0,25,0,18,1598068800,1609304400,25
KinkyBoots161,0,25,0,150,1572753600,1601956800,25
MorgulValar,1,24,38,80,1600660800,1606626000,25
Questionizer1,0,25,0,-109,1582088400,1583038800,25
x25e0,0,25,0,285,1590120000,1606626000,25
LivyKitty2332,0,25,0,486,1602216000,1609218000,25
elnet1,0,25,0,303,1594785600,1609218000,25
jayjaysortagay,0,25,0,122,1562040000,1578891600,25
Zomgzilla,0,25,0,1255,1591588800,1606798800,25
ghostx78x,0,25,0,321,1574312400,1603166400,25
YeezyOverJumpmanWoo,0,25,0,169,1583470800,1589860800,25
loco500,0,25,0,170,1586404800,1601611200,25
hellsbellltrudy,1,24,794,150,1550034000,1593662400,25
LordUmber93,0,25,0,-98,1593662400,1593835200,25
Little_Peon,0,25,0,122,1585540800,1602993600,25
wetblanketdreams,4,21,775,176,1588132800,1611982800,25
Onironius,0,25,0,115,1601179200,1611896400,25
ClaudeJRdL,0,25,0,-23,1598328000,1599710400,25
Zombiewski,0,25,0,454,1549515600,1606712400,25
Tomahawk757,0,25,0,255,1576299600,1597118400,25
SomeDudeWithAnIdea,0,25,0,387,1570507200,1612069200,25
classe_tmb,3,22,606,110,1511845200,1561435200,25
imsuperior2u,0,25,0,-42,1597550400,1605157200,25
Jujulicious69,0,25,0,102,1586750400,1602993600,25
colako,5,20,227,339,1573534800,1606971600,25
ToddTheDrunkPaladin,0,25,0,184,1570939200,1605416400,25
thatoldhorse,0,25,0,722,1552536000,1604116800,25
Piemandinoman,0,25,0,12,1607403600,1607662800,25
TheRynoceros,0,25,0,529,1597377600,1608267600,25
Trivi4,2,23,76,111,1576818000,1602734400,25
ILoveitNot,0,25,0,269,1596772800,1604116800,25
thrashing_throwaway,5,20,752,206,1576558800,1603252800,25
daldalbutt,0,25,0,-2,1607662800,1608613200,25
Autodidact420,0,25,0,26,1539835200,1541217600,25
messiiiah_,0,25,0,315,1550898000,1573621200,25
Anemoneao,0,25,0,47,1571112000,1574571600,25
wickerwitch4,1,24,13,488,1570593600,1603252800,25
youneverknow114,0,25,0,43,1593230400,1601438400,25
I-prefer-brown-sugar,1,24,11,64,1558065600,1559188800,25
BigDaddySwagLord,1,24,156,122,1605589200,1609477200,25
The3Percenterz,1,24,8,87,1594180800,1607403600,25
-goodguygeorge,0,25,0,229,1546405200,1596254400,25
steushinc,3,22,65,312,1589688000,1609304400,25
Unlearned_One,0,25,0,139,1559793600,1599192000,25
prplehailstorm,0,25,0,794,1583812800,1611205200,25
Euphorbium,0,25,0,268,1559707200,1591934400,25
zepol_2,1,24,962,154,1571371200,1609045200,25
abandepart,0,25,0,-68,1554523200,1554696000,25
Inquisitor1,0,25,0,35,1576386000,1607835600,25
TheManTheLegend69,0,25,0,1298,1604466000,1611896400,25
Canttakethewhyfromme,0,25,0,874,1564804800,1608008400,25
cool_pant_cate,4,21,6992,175,1572321600,1612155600,25
thetimescalekeeper,0,25,0,-121,1599969600,1600833600,25
Ironicbanana14,0,25,0,357,1537070400,1609218000,25
VinesNFluff,0,25,0,442,1573016400,1604030400,25
EventuallyScratch54,5,20,246,65,1561521600,1585108800,25
silverstonery,1,24,9,81,1585281600,1597723200,25
diquee,0,25,0,643,1560916800,1607749200,25
Thatmucildrop,0,25,0,121,1598673600,1600833600,25
itskelvinn,1,24,0,67,1579582800,1608267600,25
cantorofleng,0,25,0,170,1583125200,1608699600,25
deltasly,0,25,0,275,1544245200,1599883200,25
tlalexander,0,25,0,251,1565582400,1590984000,25
Ruxify,1,23,80,148,1572148800,1608440400,24
Logiman43,6,18,116,21,1569211200,1609218000,24
EvermoreWithYou,0,24,0,122,1595217600,1607662800,24
okaybutwhy69,0,24,0,72,1601784000,1606194000,24
Fbstrbr,0,24,0,133,1597377600,1601524800,24
SFWTVFAN,1,23,14,46,1570852800,1589342400,24
raretrophysix,1,23,24,208,1580187600,1598500800,24
Shynagua,0,24,0,138,1593403200,1608958800,24
Exbozz,0,24,0,-16,1590120000,1612155600,24
greenw40,0,24,0,-33,1584763200,1609390800,24
locust_breeder,0,24,0,57,1584763200,1609045200,24
ThoughtCrimeOffender,0,24,0,301,1570766400,1588651200,24
rippedApe,0,24,0,129,1600142400,1607058000,24
BaronVA,1,23,11,34,1599710400,1608613200,24
ShirtStainedBird,0,24,0,528,1573448400,1585108800,24
farrukhsshah,17,7,19455,406,1600747200,1609304400,24
scientific_thinker,0,24,0,124,1551762000,1608786000,24
Fuckyoudumbfucktwat,0,24,0,288,1546578000,1560744000,24
Shadowgirl7,2,22,40,57,1579842000,1605589200,24
kitbitlovesyou,1,23,68,207,1575262800,1585886400,24
MutMan56,0,24,0,217,1563249600,1576990800,24
cc_searching,0,24,0,54,1550466000,1550725200,24
ErmesAugustus,0,24,0,220,1586923200,1604116800,24
hateallhumans,2,22,236,188,1553486400,1589860800,24
sjacc,0,24,0,92,1576558800,1578632400,24
uber_neutrino,0,24,0,-85,1550293200,1550811600,24
ThatIntention1,1,23,29,807,1595995200,1609218000,24
bottleglitch,4,20,168,355,1578978000,1609045200,24
pj566,5,19,34,382,1580792400,1607403600,24
HardLithobrake,0,24,0,470,1554436800,1609045200,24
MaladaptiveCunt,0,24,0,3,1574571600,1583899200,24
PanzerkampfwagenIII,0,24,0,109,1556251200,1588046400,24
dontlikemath,0,24,0,209,1560052800,1608958800,24
detective_wes,1,23,11,93,1585195200,1588910400,24
madergency,1,23,2106,234,1575867600,1576386000,24
Jonathanplanet,2,22,15,58,1571371200,1580446800,24
Podsit,2,22,1050,479,1575176400,1578718800,24
doktorjackofthemoon,1,23,51,206,1544245200,1584676800,24
Yasae,0,24,0,113,1544504400,1574485200,24
EmmaGoldmansDancer,0,24,0,250,1575608400,1611896400,24
AKnightAlone,0,24,0,349,1582434000,1609045200,24
RodneyRabbit,0,24,0,215,1567051200,1602043200,24
eduthrowww,0,24,0,568,1595044800,1598414400,24
bored_and_scrolling,0,24,0,430,1571371200,1609045200,24
Regicollis,2,22,637,330,1566187200,1597464000,24
moshedman85,5,19,2668,55,1571976000,1608440400,24
Baby_venomm,0,24,0,160,1594526400,1598932800,24
AN_HONEST_COMMENT,1,23,26,37,1536292800,1580706000,24
SaintAlphonse,0,24,0,114,1600488000,1604725200,24
senseiberia,0,24,0,138,1593057600,1606798800,24
AlgerianThunder,0,24,0,315,1574226000,1584590400,24
Aqua_lung,1,23,9,151,1565150400,1608181200,24
SuddenWriting,0,24,0,109,1573880400,1582952400,24
MyUserSucks,0,24,0,123,1579150800,1608786000,24
okami11235,1,23,25,132,1590465600,1596772800,24
Krak2511,0,24,0,476,1559534400,1606885200,24
PM_ME_YOUR_TUTURUS,6,18,2174,130,1577163600,1609477200,24
NinjaLanternShark,0,24,0,118,1602475200,1604293200,24
B0B_Spldbckwrds,1,23,20,217,1567569600,1608181200,24
Fagerman10,0,24,0,22,1553227200,1557201600,24
LaFantasmita,0,24,0,286,1598241600,1611982800,24
Kim_catiko,0,24,0,253,1602561600,1612069200,24
newinvestors,0,24,0,389,1603598400,1609390800,24
MyLastSummerDev,0,24,0,445,1567396800,1606798800,24
businesslawpole,2,22,10,117,1577509200,1583038800,24
so_crat_ic,0,24,0,188,1568088000,1600833600,24
Lucilol,0,24,0,57,1593057600,1607490000,24
Lolocaust1,0,24,0,754,1575349200,1608526800,24
nek0kitty,0,24,0,69,1563422400,1587614400,24
Kalimu1590,1,23,107,190,1573621200,1605675600,24
thecarrot95,1,23,7,-65,1552276800,1588737600,24
throw_a_balll,6,18,361,104,1564545600,1607576400,24
hnnsSI,1,23,161,179,1574139600,1587441600,24
feetonthegrounddd,0,24,0,152,1546664400,1548738000,24
Yevad,0,24,0,150,1538452800,1607662800,24
RAPTOR115X,1,23,14,118,1551243600,1602216000,24
WanderingTrees,0,24,0,214,1577422800,1609390800,24
CheekiBleeki,0,24,0,48,1590120000,1602302400,24
Optimistprime777,0,24,0,108,1605243600,1608526800,24
m4dw0r1d,5,19,571,84,1594094400,1604725200,24
cinicacid,0,24,0,203,1571803200,1591502400,24
Raging_AricShin,0,24,0,12,1557633600,1569124800,24
Bug1031,0,24,0,210,1552363200,1605762000,24
macktheknive,0,24,0,-21,1569384000,1574312400,24
gakkless,0,24,0,299,1581051600,1606885200,24
RighteousAwakening,3,21,197,310,1548565200,1602648000,24
LeuconoeWhoWonders,0,24,0,174,1601784000,1607490000,24
thebeengrim,0,24,0,462,1587700800,1606107600,24
codeine_sandwich,0,24,0,72,1595476800,1602993600,24
CordaneFOG,1,23,3,757,1576213200,1590206400,24
EarnestQuestion,0,24,0,374,1581483600,1609390800,24
i_snarf_butts,0,24,0,389,1605589200,1609131600,24
S_Belmont,0,24,0,308,1595390400,1609390800,24
TheEndTrend,0,24,0,-22,1571025600,1571630400,24
Thyperson08,1,23,255,123,1560484800,1608613200,24
Joann713,0,24,0,56,1564459200,1587268800,24
terdude99,1,23,2135,252,1572930000,1608613200,24
nezumysh,0,24,0,216,1572062400,1599969600,24
dkglitch82,0,24,0,-76,1578027600,1580101200,24
CreateDontConsume,0,24,0,194,1557115200,1582779600,24
surfingjesus,0,24,0,-113,1600315200,1608354000,24
redditrabbit999,1,23,11,59,1551330000,1598760000,24
FloridAussie,0,24,0,375,1580619600,1589083200,24
surger1,0,24,0,647,1575608400,1611810000,24
Agnia_Barto,1,23,0,31,1549688400,1595649600,24
ProdigiousPlays,0,24,0,241,1570420800,1597377600,24
_sauceallthewaydown,0,23,0,143,1598846400,1599796800,23
jimofwales,0,23,0,263,1470628800,1608267600,23
m999_9,0,23,0,29,1599710400,1599710400,23
onelesslife,0,23,0,565,1559880000,1579582800,23
oganhc,0,23,0,97,1573016400,1608354000,23
bgaimur,0,23,0,129,1606539600,1606626000,23
CriticalTransit,1,22,67,371,1538452800,1571630400,23
ImLordNextDoor,0,23,0,30,1598500800,1598500800,23
DreamlandCitizen,0,23,0,131,1586232000,1598932800,23
ElonMuskIsMyWaifu,0,23,0,80,1593230400,1608094800,23
Flowersinherhair79,0,23,0,350,1573534800,1600747200,23
TheyCallMeAdonis,0,23,0,356,1594353600,1611896400,23
targ_,2,21,176,432,1592193600,1609045200,23
SlicerX321,1,22,59,201,1572494400,1583298000,23
punkthesystem,23,0,423,0,1457586000,1606021200,23
str8baller,9,14,598,205,1544504400,1602216000,23
SN-double-OP,0,23,0,212,1599451200,1603425600,23
BisexualCaveman,0,23,0,229,1589083200,1607403600,23
Dumbface2,0,23,0,446,1550638800,1609390800,23
69SadBoi69,0,23,0,271,1576126800,1608181200,23
garaile64,0,23,0,80,1584331200,1603166400,23
WasButNotLost,0,23,0,22,1597636800,1601352000,23
hizeto,2,21,105,79,1556596800,1576126800,23
SuperDuperChuck,0,23,0,888,1569643200,1579323600,23
starmartyr11,0,23,0,171,1601352000,1609390800,23
mixingmemory,0,23,0,79,1597377600,1611810000,23
InfamousMachine33,1,22,118,303,1569643200,1608613200,23
MustardIsFood,0,23,0,173,1600747200,1600833600,23
HoursOfCuddles,1,22,167,79,1573621200,1606626000,23
Hedhunta,0,23,0,287,1597723200,1605675600,23
woke_avocado,0,23,0,248,1549602000,1598673600,23
lefthook_hospital,0,23,0,349,1598328000,1607835600,23
--Anarchaeopteryx--,4,19,378,164,1584936000,1611810000,23
vomit-gold,6,17,13689,979,1582606800,1606971600,23
EidolonMan,0,23,0,24,1597723200,1609131600,23
tryitout91,0,23,0,-204,1606626000,1607749200,23
Gidalla,0,23,0,11,1581915600,1582088400,23
Century_Toad,0,23,0,182,1599451200,1608526800,23
lebeer13,0,23,0,771,1578373200,1600228800,23
mesopotamius,0,23,0,127,1574398800,1601179200,23
VeeamFTW,0,23,0,-8,1603339200,1604116800,23
Covalent08,2,21,23,193,1582261200,1609390800,23
200201552,1,22,0,107,1579410000,1579755600,23
WeAreLegion1863,0,23,0,234,1581742800,1587614400,23
Heterophylla,0,23,0,49,1606021200,1615438800,23
februaryerin,0,23,0,797,1603512000,1609304400,23
Mycateatsmoney,4,19,603,246,1595390400,1606712400,23
DualtheArtist,0,23,0,204,1592625600,1602820800,23
im-bad-at-names64,1,22,0,-12,1600747200,1600747200,23
jamzthrowaway,0,23,0,118,1572408000,1608267600,23
Mr_Quackums,0,23,0,634,1603339200,1609390800,23
ProblemPenis,2,21,21,178,1577250000,1609477200,23
FlowerShine2U,0,23,0,112,1569643200,1598155200,23
Times_New_Roman_1983,0,23,0,177,1611810000,1611982800,23
various336,5,18,984,335,1567915200,1581656400,23
god_peepee,0,23,0,89,1598587200,1611637200,23
BobbyTheWallflower,9,14,129,83,1602302400,1605502800,23
stormyllewellynn,1,22,85,82,1611810000,1612242000,23
abcq02,1,22,86,166,1580360400,1608267600,23
kungfucuck,0,23,0,75,1572235200,1584072000,23
51837,0,23,0,273,1566964800,1606366800,23
LostInTheWorld28,2,21,469,181,1563249600,1579410000,23
cheaplogic,2,21,25,176,1593230400,1611896400,23
ThinWildMercury1,7,16,130,48,1409889600,1568347200,23
ViviCetus,2,21,14,303,1575608400,1606280400,23
AntithesisVI,0,23,0,138,1583384400,1589169600,23
jelenko1999,0,23,0,11,1604984400,1608094800,23
Staatsmann,0,23,0,194,1579064400,1601352000,23
dunkinninja,0,23,0,414,1585022400,1590724800,23
MisanthropicFriend,1,22,56,165,1585627200,1588132800,23
mojrim67,0,23,0,57,1577077200,1578373200,23
PJvG,0,23,0,253,1560484800,1585972800,23
Double_Cake,0,23,0,346,1568088000,1601179200,23
Nyanu,0,23,0,494,1552021200,1609304400,23
cjv1_,3,20,336,526,1580619600,1588910400,23
Disc077,0,23,0,466,1579755600,1604293200,23
Tomek_Hermsgavorden,0,23,0,303,1575522000,1611810000,23
Horinde,1,22,32,86,1585713600,1608613200,23
ToolboxTinker,0,23,0,249,1544590800,1593057600,23
Bill-The-Autismal,1,22,29,332,1571630400,1609390800,23
Chj_8,2,21,27,655,1585281600,1606712400,23
glassneighborhood22,7,16,22692,197,1598760000,1603598400,23
Tszayrav,1,22,96,197,1529208000,1554523200,23
Sedition1917,0,23,0,202,1557288000,1609304400,23
Nthrwaway,7,16,196,74,1549342800,1587441600,23
killthenerds,0,23,0,137,1561780800,1603598400,23
TrumpCardStrategy,0,23,0,5,1598932800,1608181200,23
Rude_aBapening,0,23,0,181,1572235200,1604116800,23
Artear,0,23,0,244,1541217600,1609131600,23
electricblues42,0,23,0,207,1559880000,1569902400,23
wondererSkull,11,12,593,134,1605243600,1612069200,23
Nonsenseinabag,0,23,0,299,1590120000,1603684800,23
TravelbugRunner,1,22,28,611,1602561600,1608699600,23
impressedham,0,23,0,109,1567051200,1609131600,23
RamiiNoodles,0,23,0,125,1597636800,1609304400,23
apocalypseconfetti,0,23,0,427,1557547200,1589860800,23
littletealbug,0,23,0,1158,1577336400,1607317200,23
Pcakes844,1,22,17,136,1581397200,1594958400,23
Bitemebitch00,2,21,24,111,1567569600,1577595600,23
Shamazij,0,23,0,312,1556251200,1609304400,23
SKY-911-,0,23,0,33,1595822400,1598328000,23
BrownPaperHeart,0,23,0,89,1587182400,1590120000,23
AwaitingDaphne,3,20,54,115,1564632000,1565064000,23
RootMason,0,23,0,315,1590120000,1600488000,23
ElanaIdk,0,23,0,408,1600142400,1608354000,23
dave_hedgehog88,0,23,0,91,1584244800,1584936000,23
Bidets4Americans,3,20,195,205,1549429200,1571976000,23
Melodic_Programmer,0,23,0,316,1585627200,1609390800,23
mark_hadfield,1,22,19,35,1608958800,1609045200,23
Freddie_fode_cu,2,21,50,108,1565409600,1600488000,23
Wadez1000,0,23,0,263,1565582400,1608958800,23
Be-Jammin,2,21,2455,374,1559534400,1594958400,23
liberulo,0,23,0,189,1581570000,1602734400,23
worthcrisis,0,23,0,519,1559188800,1609045200,23
RowAwayJim91,0,23,0,390,1593576000,1611982800,23
100100110l,0,23,0,218,1557979200,1585281600,23
Huzakkah,0,23,0,202,1550293200,1603857600,23
Akuuntus,0,23,0,173,1557806400,1609131600,23
shuryamba,2,21,52,64,1539921600,1574917200,23
checkoutthisbreach,0,23,0,101,1560744000,1608958800,23
CovidGR,0,23,0,152,1594872000,1603684800,23
IDontWantToArgueOK,0,23,0,249,1540785600,1594353600,23
hankypankchinaski,0,23,0,130,1571371200,1593921600,23
NectarDeCeapa,3,20,25,14,1596600000,1597636800,23
m3ltph4ce,0,23,0,184,1557288000,1609304400,23
SporkydaDork,1,22,12,66,1603080000,1609390800,23
Diggy696,0,23,0,268,1582002000,1588824000,23
KastorNevierre2,0,23,0,-10,1611982800,1612328400,23
EchoingSharts,0,23,0,171,1580706000,1605502800,23
Lunessence,0,23,0,80,1583470800,1589947200,23
daavq,0,23,0,88,1579755600,1612155600,23
ergotofrhyme,0,23,0,-90,1584590400,1604984400,23
this-un-is-mine,0,23,0,121,1587528000,1604984400,23
x-files-theme-song,3,20,37,132,1570334400,1608354000,23
Nit3fury,0,23,0,562,1567137600,1606885200,23
chickenery,0,23,0,515,1564200000,1607835600,23
alwaysrightusually,0,23,0,68,1576558800,1590206400,23
TheInfamousBlack,1,22,905,406,1586404800,1608699600,23
Frylite1441,0,23,0,39,1572580800,1606539600,23
Copse_Of_Trees,1,22,18,142,1570248000,1588392000,23
corona-4-president,0,23,0,113,1591934400,1608786000,23
DonkeySchlongCountry,0,23,0,347,1585713600,1586923200,23
ogipogo,0,23,0,216,1541131200,1589774400,23
talaxia,0,23,0,412,1577336400,1609218000,23
ladycarpenter,0,23,0,77,1597550400,1608181200,23
bobotechnique,0,23,0,53,1552968000,1582002000,23
Aspel,1,22,50,199,1606280400,1612069200,23
bethos30,0,23,0,296,1591243200,1611896400,23
observingjackal,0,23,0,289,1596945600,1611896400,23
LazyWorldliness420,0,23,0,-269,1608354000,1609131600,23
WannaMove2Alaska,3,20,109,118,1597896000,1601956800,23
Ruby_Shades,0,22,0,317,1605934800,1608440400,22
Sevv2102,0,22,0,258,1594699200,1602388800,22
Inebriator,1,21,704,339,1429156800,1596686400,22
ChomskyHonk,0,22,0,216,1541044800,1609045200,22
PyroSpark,2,20,160,106,1575781200,1606712400,22
NotsoGrump23,0,22,0,-147,1580706000,1585627200,22
net_traveller,1,21,19,109,1570939200,1607490000,22
CAHTA92,0,22,0,373,1586750400,1602043200,22
WeirdNoise98,0,22,0,50,1563854400,1594872000,22
GothWitchOfBrooklyn,0,22,0,732,1555819200,1601524800,22
Throwawayacct1015,15,7,1274,100,1582779600,1606798800,22
thanks1hate1t,1,21,6244,209,1592539200,1603944000,22
Doomer_Patrol,3,19,1760,555,1604898000,1609563600,22
Middy635,0,22,0,169,1584417600,1601870400,22
Davidk9292,3,19,23,123,1597809600,1599451200,22
Der_Absender,0,22,0,338,1571112000,1611982800,22
emskiez,0,22,0,235,1588046400,1609477200,22
pinkytoze,0,22,0,192,1560916800,1609218000,22
RainbowAfterRainstom,0,22,0,263,1584676800,1608181200,22
bexyrex,1,21,20,182,1556078400,1602734400,22
ExcitementNegative,0,22,0,449,1599019200,1609477200,22
d3rp7d3rp,0,22,0,99,1589169600,1591070400,22
ijustneedthisaccount,0,22,0,232,1563163200,1566187200,22
substance_d,4,18,313,62,1580792400,1608008400,22
stop1117,0,22,0,96,1601179200,1608958800,22
ElfMage83,2,20,27,131,1581310800,1612846800,22
oh_nooooooooooooo,0,22,0,175,1583211600,1585454400,22
bassicallyalcoholic,1,21,30,204,1593230400,1606107600,22
lossescollector,3,19,96,105,1567137600,1598587200,22
4garbage2day0,0,22,0,111,1599105600,1602820800,22
SHCR,0,22,0,855,1545022800,1584676800,22
Guitar_Commie,0,22,0,972,1600228800,1608181200,22
ZaphodBBlebrok,0,22,0,355,1592280000,1609131600,22
Slipsonic,0,22,0,160,1534910400,1605070800,22
Vetinery,0,22,0,-47,1577336400,1609218000,22
minimotres,1,21,310,165,1567656000,1585454400,22
Andre__Kim,0,22,0,-31,1602388800,1608786000,22
Shuiner,0,22,0,427,1606539600,1609390800,22
Imperator_Knoedel,0,22,0,160,1582174800,1597118400,22
jesusboat,10,12,81,39,1606453200,1608699600,22
Not-c831,0,22,0,16,1576818000,1577336400,22
AquaEnglehart,0,22,0,114,1602475200,1606712400,22
ThatBankTeller,1,21,0,0,1552449600,1589860800,22
Brndrll,1,21,8,131,1581310800,1603512000,22
boycottSummer,0,22,0,286,1550034000,1585627200,22
EmperorRosa,0,22,0,209,1599019200,1608699600,22
gibmelson,1,21,254,112,1588392000,1598500800,22
minoltagirl,2,20,109,340,1577768400,1607144400,22
Outrage-Is-Immature,0,22,0,-37,1608440400,1612155600,22
spitfire104,2,20,79,94,1589256000,1604811600,22
KeeanuMusk,1,21,17,327,1568952000,1573794000,22
ClF3ismyspiritanimal,0,22,0,272,1542258000,1603339200,22
SetoXlll,1,21,28,182,1566964800,1599192000,22
Offtangent,0,22,0,91,1559620800,1609304400,22
Rookwood,1,21,22,448,1598673600,1611896400,22
chargingrhino,0,22,0,318,1552107600,1611810000,22
bl3nd0r,0,22,0,136,1575435600,1608613200,22
sarcasmbecomesme,0,22,0,327,1551243600,1603684800,22
ge0n1,0,22,0,145,1555473600,1571803200,22
Pfacejones,0,22,0,205,1595131200,1600315200,22
deathofroland,0,22,0,186,1565755200,1583812800,22
prowlinghazard,0,22,0,649,1572930000,1605157200,22
Pickyour_vices,0,22,0,126,1576558800,1602388800,22
metafizzishin7,1,21,6,88,1548910800,1569643200,22
TomMilner19,0,22,0,24,1578632400,1599537600,22
Tomoromo9,0,22,0,84,1584763200,1600920000,22
PinkCaffeine14,0,22,0,184,1566100800,1597809600,22
ConfidentOrdinary,7,15,431,239,1582693200,1594785600,22
Lard_of_Dorkness,0,22,0,380,1576386000,1612069200,22
SingularityRS,0,22,0,197,1550552400,1603512000,22
pabotaralabasura,2,20,22,45,1606712400,1610341200,22
computer121,3,19,128,430,1595304000,1597896000,22
overbeast,0,22,0,104,1575435600,1605070800,22
Makerobxa,0,22,0,76,1550984400,1581483600,22
BureaucratDog,0,22,0,222,1604379600,1608872400,22
fajardo99,0,22,0,71,1602129600,1612242000,22
Legit_a_Mint,0,22,0,16,1580792400,1585454400,22
stonehallow,0,22,0,157,1596600000,1603425600,22
noworn,3,19,208,119,1581570000,1608699600,22
fleduvius,1,21,17,224,1554436800,1604898000,22
hbgbees,0,22,0,322,1586491200,1607058000,22
coredweller1785,0,22,0,152,1583298000,1606626000,22
Cosmic-Cardinal,0,22,0,130,1588219200,1608181200,22
anxiousjeff,1,21,66,177,1607835600,1608872400,22
mypipboyisbroken,2,20,337,212,1571544000,1587355200,22
MorddSith187,0,22,0,154,1589169600,1598587200,22
NeoNazisHafTinyDongs,0,22,0,135,1572148800,1608786000,22
prstaley,0,22,0,128,1578114000,1581051600,22
Gethighwithcoffee,4,18,3185,155,1533700800,1597982400,22
guutarajouzu,1,21,10,255,1587355200,1608958800,22
BIGFAAT,0,22,0,401,1576645200,1607749200,22
Wytch78,0,22,0,351,1581138000,1609131600,22
TA_mentalhealth,0,22,0,39,1597291200,1603857600,22
depthandbloom,1,21,190,494,1565150400,1602993600,22
FlippingSinceBirth,5,17,603,241,1599969600,1602129600,22
rehoboam,0,22,0,27,1589601600,1612069200,22
folcrumb1111,0,22,0,67,1590724800,1608008400,22
BlitheCynic,1,21,90,92,1568779200,1577768400,22
fenbekus,0,22,0,97,1553486400,1589169600,22
RogueVert,0,22,0,353,1546405200,1609218000,22
BWWFC,0,22,0,318,1561953600,1606971600,22
PoeT8r,0,22,0,498,1581051600,1607922000,22
transtonowhere,0,22,0,119,1594872000,1596686400,22
brettisinthebathtub,0,22,0,600,1572930000,1586577600,22
RecollectingWanderer,1,21,25,54,1591416000,1604293200,22
Bionicler,5,17,217,89,1580706000,1602475200,22
Nuwave042,0,22,0,168,1578978000,1608613200,22
thugstin,0,22,0,52,1592452800,1608008400,22
Thatoneguy15678,1,21,18,1281,1605330000,1612069200,22
Christ_was_a_Liberal,0,21,0,92,1612069200,1612155600,21
panrestrial,0,21,0,72,1582866000,1603339200,21
Symb0lic_Acts,2,19,112,120,1559534400,1602907200,21
tomahawkzz,4,17,30,49,1553227200,1572494400,21
Orpheeus,0,21,0,383,1572667200,1607144400,21
testzxcvb,0,21,0,210,1557806400,1572580800,21
checkthf,2,19,39,261,1575003600,1576386000,21
Autumnwood,0,21,0,83,1602648000,1608267600,21
MDCCCLV,0,21,0,8,1605243600,1609304400,21
Rain__Lover,0,21,0,223,1540526400,1604725200,21
TrappedWithTheKey,4,17,1307,144,1597204800,1608613200,21
Atiberious,1,20,342,545,1587268800,1607662800,21
littlenid,0,21,0,823,1571025600,1601524800,21
shellstains,2,19,74,380,1580274000,1603857600,21
lovesprite,4,17,93,76,1579669200,1582261200,21
consios88,0,21,0,226,1553140800,1607490000,21
justausername69,0,21,0,394,1552021200,1578978000,21
RATHOLY,0,21,0,133,1593662400,1603598400,21
Kurr123,0,21,0,219,1580101200,1592539200,21
Hulemanden90,0,21,0,464,1595908800,1600833600,21
whomstreallycares,0,21,0,187,1591761600,1594180800,21
devandroid99,1,20,68,174,1582520400,1608786000,21
Mr_Dnxsty,0,21,0,490,1593748800,1594267200,21
ThyrsusSmoke,1,20,85,477,1567396800,1604203200,21
MegD99,2,19,51,39,1566964800,1569470400,21
beetard,1,20,55,229,1559620800,1591156800,21
TigreDeLosLlanos,0,21,0,268,1569902400,1611982800,21
BigHairyNipples,0,21,0,467,1549861200,1581742800,21
stadchic,0,21,0,108,1579496400,1609304400,21
AlextheAnalyst,0,21,0,92,1564459200,1580792400,21
Legitimate_Teddy,0,21,0,397,1588564800,1605934800,21
Gordiflu,0,21,0,128,1582347600,1611896400,21
RoryButler,0,21,0,150,1592712000,1607576400,21
desolatecontrol,0,21,0,481,1564545600,1611810000,21
RiverorRiver,0,21,0,220,1591675200,1609304400,21
QCA_Tommy,0,21,0,163,1585454400,1608872400,21
BeatnikFink,0,21,0,110,1573621200,1608613200,21
Depression-Boy,0,21,0,116,1590033600,1607317200,21
Maximellow,0,21,0,585,1606971600,1609390800,21
azulhombre,3,18,2073,497,1551934800,1609390800,21
Victor_Saltzpyre,0,21,0,233,1556078400,1582088400,21
Kutekitty234,6,15,140,199,1564200000,1606798800,21
Plays-0-Cost-Cards,0,21,0,142,1573621200,1599192000,21
kaynkaynkayn,0,21,0,-78,1606626000,1606798800,21
MisterFor,0,21,0,439,1605502800,1609304400,21
RamshackleDayParade,3,18,1865,792,1564632000,1592625600,21
HellooooooSamarjeet,1,20,397,459,1560571200,1605070800,21
GuDMarty,1,20,0,0,1558584000,1579323600,21
greasykhakeesi,0,21,0,380,1582002000,1596600000,21
tubbis9001,0,21,0,98,1567742400,1607662800,21
onewhoisnthere,0,21,0,313,1549342800,1568952000,21
zombiecatwoman,11,10,6297,84,1583812800,1608267600,21
Annange-love-aagide,1,20,7,136,1604203200,1607230800,21
tramselbiso,3,18,298,75,1548478800,1586491200,21
sunnynihilist,0,21,0,293,1600833600,1601179200,21
PBYACE,0,21,0,177,1579410000,1612069200,21
ArcaneErudition,0,21,0,142,1484024400,1589860800,21
goodbyequiche,0,21,0,148,1608613200,1612069200,21
BuildAutonomy,1,20,218,220,1528862400,1569211200,21
spirit_thinker,2,19,134,105,1576299600,1580187600,21
ImYourBesty69,0,21,0,122,1595563200,1607230800,21
amber-ri,1,20,30,124,1573534800,1605502800,21
isthefridge,0,21,0,378,1573362000,1574312400,21
anonymousmusician93,0,21,0,281,1566964800,1582779600,21
yoyoadrienne,1,20,51,175,1578718800,1598932800,21
ChamsRock,0,21,0,341,1550379600,1595304000,21
nakedtruuth,5,16,43,54,1592625600,1606107600,21
theresnothingthereso,1,20,45,280,1572408000,1574226000,21
CubistHamster,1,20,15,122,1593144000,1609218000,21
Thecrow1981,0,21,0,64,1568692800,1570161600,21
paprikasegg,0,21,0,68,1597118400,1609477200,21
TreiAniSiSaseLuni,0,21,0,107,1560830400,1607058000,21
Xale1990,1,20,96,1142,1560484800,1603598400,21
analogsimulacrum,2,19,2362,441,1569124800,1592971200,21
psychoalchemist,2,19,24,134,1527652800,1609390800,21
Administrative-Curry,1,20,9,169,1580965200,1592884800,21
1982000,0,21,0,261,1586404800,1608872400,21
bornstellar_eternaI,0,21,0,122,1571544000,1608699600,21
Lonchenzo,0,21,0,143,1569816000,1604203200,21
Necronomicommunist,0,21,0,319,1548219600,1607576400,21
ricarleite1,1,20,2,-20,1608958800,1608958800,21
crow-of-darkness,4,17,6,33,1595649600,1598414400,21
shadowvendetta,4,17,815,36,1568260800,1579496400,21
2_Fingers_of_Whiskey,0,21,0,331,1598500800,1605243600,21
Timeworm,0,21,0,262,1580706000,1603598400,21
unxile_phantom,0,21,0,283,1598414400,1605502800,21
Naolone,2,19,9,-44,1600228800,1606366800,21
Ijustwantedtosay666,0,21,0,263,1575435600,1580878800,21
carverofcanyons,2,19,2200,222,1572148800,1608267600,21
middlesidetopwise,0,21,0,500,1575262800,1599796800,21
panconquesofrito,0,21,0,101,1569211200,1606626000,21
Locusthorde300,0,21,0,47,1556683200,1607490000,21
ZeroNullAnon,1,20,26,118,1609477200,1612155600,21
evhan55,0,21,0,82,1580533200,1607403600,21
Nirvash_117,5,16,27318,9,1600747200,1607922000,21
SupremelyUneducated,0,21,0,131,1589342400,1595217600,21
SiddharthaSuburbia,0,21,0,217,1559880000,1592020800,21
ayampedas,0,21,0,104,1593489600,1607058000,21
scmflower,0,21,0,119,1602734400,1611810000,21
soundpa,0,21,0,132,1602129600,1602993600,21
ruane777,1,20,13,190,1593662400,1595217600,21
KillTheElite,0,21,0,101,1599796800,1600488000,21
garbagecanaccount123,2,19,44,104,1600228800,1608786000,21
ScamWatchReporter,0,21,0,23,1594267200,1603944000,21
WhistleStop999,0,21,0,131,1580878800,1597809600,21
dhalgrendhalgren,0,21,0,493,1560657600,1599451200,21
LaughingOnTheSun,0,21,0,54,1546837200,1548910800,21
Diver_Nick,1,20,13,58,1558152000,1567915200,21
Cuddly_Wumpums,1,20,4,155,1458964800,1514005200,21
_Pretzel,0,21,0,98,1590033600,1605157200,21
UltraEngine60,1,20,35,77,1599278400,1609045200,21
Toe_of_Patriarchy,0,21,0,-70,1586923200,1588824000,21
GoodBoyNumberOne,0,21,0,-109,1575262800,1608267600,21
Fast-Koala,0,21,0,82,1596772800,1598846400,21
IronDBZ,0,21,0,188,1576472400,1593230400,21
TaylorSeriesExpansio,0,21,0,353,1538798400,1577336400,21
Red_bearrr,0,21,0,274,1567483200,1594353600,21
annaleast,0,21,0,112,1607058000,1609390800,21
lefukcos,0,21,0,-8,1592539200,1592625600,21
nailgunnotebook,2,19,22,33,1599451200,1606366800,21
Mashawn2000,0,21,0,165,1598673600,1601611200,21
SkrullandCrossbones,0,21,0,173,1570161600,1608526800,21
Tristaine1,2,19,52,162,1568779200,1570075200,21
EndlessEggplant,0,21,0,256,1605416400,1609390800,21
shaingel_sle,6,15,701,562,1601438400,1609218000,21
unholy_abomination,0,21,0,385,1550293200,1584504000,21
stitch_and_witch,0,21,0,156,1573275600,1583812800,21
UnderlordZ,3,18,160,446,1579410000,1609477200,21
spiritwarfare,0,21,0,95,1583557200,1596254400,21
Million_Dollar_Dream,0,21,0,381,1562904000,1602475200,21
Sokrates7777,1,20,10,217,1568952000,1585195200,21
Dadlayz,0,21,0,251,1567483200,1591416000,21
Sp99nHead,0,21,0,808,1596168000,1607490000,21
RSpectre,0,21,0,852,1549861200,1572494400,21
nofap_actually_works,0,20,0,164,1578632400,1586836800,20
ZeroBarkThirty,0,20,0,546,1572235200,1609131600,20
Rujevit,1,19,67,-24,1593057600,1599278400,20
Do0ozy,1,19,1,11,1587355200,1591243200,20
Spamwarrior,0,20,0,1176,1578373200,1588651200,20
Alpha100f,0,20,0,40,1569297600,1572843600,20
wapey,1,19,7,229,1582174800,1607230800,20
Ella_Spella,0,20,0,59,1591675200,1608699600,20
shabbysneakers,4,16,321,419,1548219600,1608872400,20
nihozumi,1,19,7,213,1562126400,1572667200,20
RusticTroglodyte,0,20,0,183,1603684800,1609563600,20
Green-64-Lantern,1,19,38,303,1583125200,1592193600,20
rexthewrx,3,17,1146,155,1597809600,1608267600,20
itsmassive,0,20,0,82,1551070800,1587355200,20
AHamburgerGuy,0,20,0,301,1570507200,1578027600,20
MaybeMaeMaybeNot,0,20,0,114,1567569600,1586923200,20
lolicutiedx,0,20,0,36,1596254400,1598241600,20
PublicEvent,1,19,8,30,1595476800,1604984400,20
fartliberator,1,19,60,56,1537416000,1557979200,20
_zenith,0,20,0,106,1589169600,1607317200,20
chpbnvic,2,18,139,463,1599710400,1608786000,20
bro0t,0,20,0,110,1575262800,1610859600,20
Gloire91,2,18,96,313,1596772800,1602388800,20
SYNTHES1SE,0,20,0,199,1440388800,1608786000,20
angelbitme,0,20,0,156,1588824000,1601611200,20
Nnsoki,1,19,64,100,1598414400,1602129600,20
ChemicalGovernment,0,20,0,187,1598760000,1609477200,20
Colin-IRL,0,20,0,21,1568520000,1579410000,20
robo_number_5,3,17,18,16,1572321600,1606539600,20
litheEpiphany,0,20,0,129,1598760000,1602043200,20
mlucaswalker,0,20,0,175,1601697600,1606885200,20
aesthethique,3,17,4549,320,1594353600,1608094800,20
scaredfail,0,20,0,465,1554523200,1608613200,20
SpraynardKrueg,0,20,0,198,1600833600,1608181200,20
Jamesx6,0,20,0,205,1564545600,1607576400,20
mybadalternate,0,20,0,152,1597982400,1609304400,20
saddestofboys,0,20,0,106,1562731200,1609650000,20
legsintheair,0,20,0,357,1600660800,1607490000,20
PomyPie,2,18,178,177,1607144400,1611982800,20
Andrusela,0,20,0,75,1596513600,1608872400,20
Supple_Meme,0,20,0,321,1585022400,1608699600,20
chickenthinkseggwas,0,20,0,122,1569729600,1574571600,20
NuScorpi,3,17,87,122,1570852800,1576472400,20
Stew_Long,0,20,0,315,1554436800,1608786000,20
mode7scaling,0,20,0,613,1482037200,1608008400,20
lolistrashh,6,14,516,1349,1597291200,1609131600,20
breadhead84,0,20,0,22,1571198400,1572321600,20
parma_saturn,0,20,0,94,1594612800,1599624000,20
yiyo999,1,19,11,127,1568520000,1606280400,20
umehara_ga,0,20,0,243,1580965200,1611896400,20
L0raxx,0,20,0,-125,1577941200,1607576400,20
GenericFatGuy,0,20,0,130,1580878800,1609131600,20
01cecold,0,20,0,123,1599364800,1607922000,20
crabbyvista,0,20,0,92,1538452800,1564372800,20
whit4504,1,19,5,700,1601352000,1606194000,20
SlowJoeCrow44,0,20,0,-237,1599883200,1601265600,20
vastopenguin,1,19,4128,117,1595736000,1608872400,20
Xylitolisbadforyou,0,20,0,1048,1583812800,1599364800,20
ThatWasCool,1,19,768,179,1570075200,1608613200,20
folstar,0,20,0,431,1602907200,1607662800,20
oldmanhiggons,0,20,0,695,1575176400,1576040400,20
ch3dd4r99,0,20,0,-64,1602129600,1609218000,20
MakeupD0ll2029,1,19,20,103,1594267200,1602302400,20
h3xag0nSun,1,19,34,202,1549515600,1605416400,20
Mrs-Peacock,0,20,0,476,1548651600,1574226000,20
nixthar,0,20,0,204,1575522000,1581915600,20
Taterchip871,0,20,0,154,1582693200,1594094400,20
AaronfromKY,0,20,0,472,1599364800,1606626000,20
TheSidheWolf,2,18,127,142,1596427200,1607576400,20
qwertymasshole,0,20,0,159,1600142400,1607576400,20
ostrieto17,5,15,4338,133,1587009600,1609218000,20
intensitei,0,20,0,41,1553659200,1556942400,20
Knife_The_Watermelon,0,20,0,96,1580446800,1602993600,20
Indieisdead95,5,15,75,42,1582693200,1607317200,20
maxvalley,0,20,0,112,1561176000,1606539600,20
daveinsurgent,0,20,0,388,1604638800,1607576400,20
pepperonion,2,18,268,288,1563163200,1582520400,20
Flyingwheelbarrow,0,20,0,426,1608699600,1611810000,20
Surbiglost,0,20,0,177,1577509200,1609218000,20
IoSonCalaf,0,20,0,705,1607317200,1612155600,20
eiggaMAD,1,19,228,231,1601956800,1608613200,20
confusedWageSlave,2,18,16,159,1606366800,1606885200,20
EAO48,1,19,28,537,1564200000,1569816000,20
blackcatcaptions,0,20,0,249,1579150800,1602475200,20
TheDeadEpsteins,0,20,0,139,1574312400,1601697600,20
u1v1w1,0,20,0,51,1575954000,1608440400,20
Meshami,1,19,47,141,1569643200,1597809600,20
HydraGene,0,20,0,1,1605934800,1608872400,20
DapperDanManCan,0,20,0,516,1562126400,1584331200,20
heloisebsb,3,17,720,118,1550984400,1588046400,20
mckenny37,0,20,0,143,1545022800,1559793600,20
CrazyJMiles,0,20,0,140,1595044800,1595563200,20
Pyrazoid,0,20,0,51,1581656400,1589428800,20
Runningoutofideas_81,1,19,6,130,1559275200,1589860800,20
TenNinetythree,0,20,0,174,1574139600,1606971600,20
aykay427,2,18,96,152,1605934800,1608008400,20
il_the_dinosaur,0,20,0,243,1565064000,1607922000,20
Ajitprop,0,20,0,289,1545022800,1586318400,20
Bostonah,4,16,6080,24,1578891600,1608094800,20
Tomishko,0,20,0,79,1563508800,1577854800,20
magentablue,0,20,0,239,1583384400,1607144400,20
Fizzy_Fresh,0,20,0,45,1571284800,1571544000,20
jordankomemer,2,18,10,18,1566360000,1572667200,20
GentleZacharias,0,20,0,171,1582347600,1585627200,20
CalixRenata,0,20,0,239,1589342400,1605330000,20
HBKF,1,19,177,248,1563249600,1597982400,20
blingwat,0,20,0,674,1548306000,1587528000,20
Peter_Parkingmeter,4,16,94,132,1568865600,1586145600,20
throwmeaway03827,4,16,178,100,1570420800,1595304000,20
Scott4370,0,20,0,471,1584763200,1608181200,20
RazorBlade233,8,12,230,80,1579410000,1603598400,20
damondan,3,17,59,72,1571371200,1574139600,20
ValueForm,0,20,0,77,1602302400,1608526800,20
sweetsoftheart,1,19,6207,352,1586404800,1586577600,20
musickismagick,1,19,0,157,1551934800,1608008400,20
old_el_paso,1,19,46,181,1601524800,1609304400,20
mayonaenae,0,20,0,314,1562731200,1569556800,20
drick2,0,20,0,175,1607317200,1609304400,20
alanpugh,0,20,0,58,1418101200,1544763600,20
Cthulhu_Leviathan,0,20,0,408,1603512000,1608181200,20
morbidlyatease,1,19,25,20,1554350400,1604898000,20
ThoseCloudsArentReal,2,18,54,129,1574658000,1579928400,20
JamesDevitt,0,20,0,142,1576472400,1606626000,20
lochnessthemonster,0,20,0,223,1609045200,1612155600,20
wake4coffee,1,19,154,210,1606626000,1611723600,20
Winterixes,0,20,0,165,1556078400,1571803200,20
neuten,0,20,0,66,1603857600,1611896400,20
lagatoazul,0,20,0,272,1574658000,1611810000,20
fullmega,0,20,0,405,1572753600,1603339200,20
Samjokazoo,0,20,0,39,1570852800,1598068800,20
dirtypenpal29,1,19,18,85,1602820800,1605762000,20
LisaDeadFace,2,18,22,86,1547960400,1591848000,20
IlIDust,0,20,0,125,1572753600,1604116800,20
uraniumrooster,0,20,0,542,1575349200,1611810000,20
gamer98x,0,20,0,105,1601697600,1606021200,20
Claud6568,1,19,160,225,1536379200,1582779600,20
reelect_rob4d,0,20,0,368,1576558800,1592366400,20
Jaksuhn,0,20,0,238,1574139600,1611810000,20
sm11_TX,8,12,444,53,1592280000,1609650000,20
Thepearlrabbit,3,17,101,243,1555473600,1606366800,20
alastairgrim,0,20,0,130,1580187600,1593748800,20
GrimmTrixX,0,20,0,397,1565755200,1608699600,20
IRIS-1151,5,15,131,49,1583384400,1604552400,20
Two_Percenter,0,20,0,19,1601092800,1609477200,20
Orjustthinkofkittens,1,19,11,318,1591416000,1596168000,20
WildThunders,0,20,0,172,1571112000,1608094800,20
SassiesSoiledPanties,0,20,0,236,1547701200,1606798800,20
whyamIstillhere1313,0,20,0,328,1596254400,1608872400,20
ArcNetS,2,18,546,104,1567137600,1607317200,20
yelothrowaway,0,20,0,141,1582866000,1586145600,20
DismalBore,0,20,0,73,1565236800,1573448400,20
harryflashman2,0,20,0,22,1583038800,1588478400,20
KabuGenoa,2,18,158,165,1599537600,1600574400,20
preshiepresh,0,20,0,167,1591934400,1608958800,20
stinkydooky,0,20,0,496,1578459600,1611896400,20
tjmaxal,6,14,389,101,1576558800,1599192000,20
recalcitrantJester,0,20,0,237,1571803200,1608872400,20
cigarrafina,0,20,0,163,1548392400,1603684800,20
counternarratives,1,19,9,153,1607576400,1611896400,20
xneyznek,0,20,0,387,1578632400,1602129600,20
CapitalismSucks666,0,20,0,243,1569988800,1570075200,20
Semi-Hemi-Demigod,1,19,2,377,1597377600,1609304400,20
serenityfive,0,20,0,212,1602302400,1612069200,20
BrokenHarmonica,0,19,0,151,1601524800,1607576400,19
K1LLTH3F4SH,0,19,0,206,1597291200,1600056000,19
nomadProgrammer,0,19,0,105,1556078400,1612069200,19
AnomandertheGod,0,19,0,16,1594008000,1594008000,19
TunaFishIsBestFish,0,19,0,-26,1585540800,1585627200,19
vanessahill23,2,17,135,72,1592280000,1600660800,19
duff-tron,0,19,0,514,1598673600,1608440400,19
MispricedGamble,0,19,0,74,1593403200,1605502800,19
dariuccio,6,13,243,21,1592280000,1611896400,19
garysgotaboner82,0,19,0,182,1582779600,1609390800,19
Key_Culture2919,0,19,0,69,1600401600,1602648000,19
Esperaux,17,2,1857,9,1598241600,1609131600,19
Detriumph,0,19,0,66,1599969600,1600401600,19
HearshotAtomDisaster,0,19,0,99,1572930000,1594872000,19
HenryK81,8,11,90,38,1587700800,1608786000,19
allie280,3,16,1629,323,1584331200,1605502800,19
bagman_,2,17,3413,368,1581570000,1612155600,19
Straight_Depth,0,19,0,317,1594958400,1609477200,19
DrSomniferum,0,19,0,124,1557547200,1583812800,19
message_bot,2,17,1358,326,1599192000,1608094800,19
poopbutt734,0,19,0,65,1575349200,1590379200,19
Adeviation,0,19,0,103,1598846400,1609304400,19
FeynmanBabe,0,19,0,99,1596945600,1599969600,19
nitonitonii,1,18,50,267,1591329600,1607922000,19
avengerofhusayn,1,18,0,66,1569297600,1573189200,19
LaDewsWin,1,18,33,50,1592539200,1602648000,19
rallyechallenger,0,19,0,257,1584504000,1586145600,19
sharperindaylight,0,19,0,174,1599019200,1603771200,19
katiedelonge,5,14,267,109,1583384400,1607403600,19
megameganium1,2,17,413,381,1602648000,1608786000,19
ChequeBook,0,19,0,371,1550552400,1605762000,19
Diabeerus,7,12,155,49,1566360000,1608354000,19
MozerfuckerJones,0,19,0,109,1581051600,1595131200,19
MagicCandy,0,19,0,156,1555387200,1600747200,19
SocFlava,0,19,0,319,1594872000,1609390800,19
TravelingThroughTime,0,19,0,-49,1582088400,1589169600,19
DeathsarmEV,0,19,0,650,1560052800,1572580800,19
8th_House_Stellium,2,17,174,116,1597809600,1611810000,19
Master_Ryan_Rahl,0,19,0,101,1590465600,1598673600,19
VIK_96,0,19,0,183,1596859200,1604811600,19
Alecarte,1,18,0,247,1577250000,1593748800,19
Zo50,0,19,0,190,1570420800,1609045200,19
bigjim1993,0,19,0,100,1567569600,1608699600,19
sparc64_,0,19,0,202,1565323200,1611810000,19
be_less_shitty,0,19,0,130,1588305600,1601524800,19
aquariusangst,0,19,0,1245,1599710400,1606971600,19
Commercial_Log,0,19,0,74,1548133200,1552449600,19
worldwontlisten,2,17,18,31,1534651200,1550984400,19
stoic_leftist,3,16,390,142,1603252800,1608872400,19
ilovewhitetea,0,19,0,162,1573102800,1606885200,19
buddhadarko,1,18,47,726,1589083200,1602734400,19
Daredevilpwn,0,19,0,116,1538625600,1578546000,19
Shotdown210,0,19,0,339,1559793600,1565582400,19
dragonphlegm,0,19,0,547,1573275600,1605243600,19
iAn1sha,2,17,19,30,1608267600,1608958800,19
9daydream,1,18,22,166,1587441600,1608786000,19
hopefulgardener,0,19,0,236,1571025600,1590033600,19
tangled_night_sleep,0,19,0,55,1586577600,1602302400,19
Queerdee23,3,16,157,79,1596859200,1611810000,19
Samtastic33,0,19,0,282,1577422800,1593748800,19
pooptypeuptypantss,2,17,22,1262,1587355200,1640322000,19
Isk4ral_Pust,0,19,0,271,1601870400,1603857600,19
prometheussf,9,10,171,-29,1568174400,1600056000,19
Xotta,0,19,0,380,1563854400,1578027600,19
Paddington-and-Geary,0,19,0,1148,1536379200,1606971600,19
LMessi101,0,19,0,169,1596859200,1604379600,19
Jaegernaut-,0,19,0,482,1591243200,1608613200,19
LouieCapone,0,19,0,75,1577854800,1584936000,19
bprice57,0,19,0,72,1572930000,1609390800,19
chickenonastic,0,19,0,181,1598932800,1605243600,19
YuenHsiaoTieng,0,19,0,60,1589342400,1609045200,19
young_broccoli,0,19,0,111,1575003600,1605589200,19
elidawood,0,19,0,141,1581310800,1608613200,19
LaddiusMaximus,1,18,32,85,1571457600,1608613200,19
12sushi,3,16,51,57,1588392000,1593835200,19
idontreddit10,0,19,0,780,1571716800,1580533200,19
SoraM4,0,19,0,177,1591416000,1600228800,19
Junebprice,0,19,0,358,1594440000,1602475200,19
turd-ucken,0,19,0,31,1606885200,1606971600,19
Barnyard_Pussy,0,19,0,64,1599883200,1606021200,19
DavidFrumTheBlock,0,19,0,322,1566878400,1568952000,19
lostpanda85,1,18,76,76,1608267600,1608354000,19
NASA_Lies,1,18,52,162,1583985600,1608354000,19
Elizibithica,0,19,0,77,1599883200,1604898000,19
mayorOfIToldUTown,1,18,14,139,1568260800,1609304400,19
TheL0nePonderer,1,18,196,170,1534478400,1581397200,19
Myerrobi,0,19,0,109,1604379600,1604466000,19
CamTheDM,0,19,0,252,1580792400,1592539200,19
Ramsden_12,0,19,0,428,1557374400,1568779200,19
bitlingr,0,19,0,66,1563076800,1577077200,19
nytropy,0,19,0,640,1577595600,1601092800,19
bowtochris,0,19,0,556,1540699200,1604030400,19
escravo365,0,19,0,52,1581656400,1595304000,19
__1312__,0,19,0,131,1592798400,1600315200,19
sunny1cat,0,19,0,70,1589860800,1608094800,19
loveisideology,2,17,1089,82,1560657600,1593403200,19
ItzKillaCroc,0,19,0,352,1593921600,1609131600,19
Square-Custard,0,19,0,71,1583211600,1609045200,19
joshdts,0,19,0,323,1579064400,1606971600,19
craigsl2378,0,19,0,38,1582088400,1597550400,19
CrumpetDestroyer,0,19,0,134,1588737600,1607230800,19
f_o_t_a_,1,18,68,64,1606971600,1609390800,19
whateversomethnghere,1,18,68,292,1560744000,1609304400,19
Kinium,0,19,0,336,1582174800,1608440400,19
smoke_clearer,2,17,158,216,1567569600,1611810000,19
MountTuchanka,0,19,0,927,1553745600,1560225600,19
Cosmic_Traveler,1,18,18,44,1527566400,1600142400,19
Scioto_,1,18,175,325,1589515200,1594699200,19
estoy_apprendiendo,1,18,18,-56,1578805200,1580274000,19
AndracoDragon,3,16,7614,162,1599537600,1605416400,19
hans1193,0,19,0,59,1572148800,1605330000,19
pbr_is_life,2,17,995,278,1591934400,1603512000,19
garrettmickley,0,19,0,239,1551330000,1602388800,19
bakedsunflowers,1,18,211,135,1583298000,1607403600,19
fakeknees,0,19,0,141,1583812800,1592193600,19
judeau7,8,11,695,1033,1596686400,1608267600,19
Kinglens311,19,0,19,0,1554436800,1609477200,19
bartonar,0,19,0,259,1574053200,1607230800,19
ivaerak,0,19,0,-14,1541217600,1558584000,19
korvre,1,18,19,75,1565409600,1589515200,19
ifeedthem,2,17,20,19,1565841600,1582779600,19
hhhnnnnnggggggg,0,19,0,79,1561953600,1611982800,19
InMooseWeTrust,1,18,5,45,1602302400,1609045200,19
Needsabreakrightnow,2,17,130,68,1555732800,1586145600,19
LadyNyghtTyger,0,19,0,358,1603598400,1605934800,19
Beatrix437,0,19,0,75,1590379200,1597723200,19
writhinginnoodles,0,19,0,260,1465358400,1567915200,19
a-1yogi,1,18,2,58,1540699200,1590638400,19
Sailor_Pluto_,0,19,0,479,1592971200,1606626000,19
blarnbatt,0,19,0,227,1573621200,1606626000,19
Blarty97,1,18,167,149,1548478800,1607749200,19
AGermaneRiposte,0,19,0,10,1605589200,1607749200,19
Shyflyer13,0,19,0,218,1581570000,1605762000,19
MarkoLUFC,0,19,0,69,1608872400,1609304400,19
nighthawk_eternal,0,19,0,437,1589860800,1603598400,19
Lazy_Devil,0,19,0,243,1578027600,1611982800,19
SavageDownSouth,0,19,0,194,1586059200,1608699600,19
catmasterfunk,3,16,1284,130,1581051600,1608181200,19
ilyassouu,1,18,5,81,1592884800,1607835600,19
FeathercockMelee,3,16,1458,646,1604638800,1608872400,19
ChesterRico,0,19,0,400,1578632400,1605070800,19
LonoRising,0,19,0,377,1595822400,1608526800,19
depressedSapien,1,18,10,83,1582002000,1605675600,19
itsthe5thhm,0,19,0,346,1568606400,1605070800,19
drzmv,0,19,0,167,1592107200,1600228800,19
niccotinepatch,0,19,0,41,1588651200,1601438400,19
veryohkay,1,18,1,131,1563163200,1597291200,19
ectobiologist7,0,19,0,211,1594440000,1611896400,19
Chemistry-Leather,3,16,102,91,1594008000,1596772800,19
passablehole,0,19,0,64,1554868800,1572408000,19
inishmannin,7,12,90,40,1575349200,1599192000,19
morerokk,0,19,0,43,1558152000,1591243200,19
laborconquersall,0,19,0,121,1582693200,1584676800,19
SunnyVilla_,0,19,0,80,1591416000,1605502800,19
Mr_Alexanderp,0,19,0,554,1608354000,1612155600,19
TeddehBear,0,19,0,267,1572494400,1607403600,19
6seanryan15,0,19,0,178,1591675200,1598241600,19
RadicalBlackCentrist,0,19,0,-161,1596686400,1602216000,19
ineffedp,0,19,0,219,1574485200,1596254400,19
-NoOneYouKnow-,1,18,13,291,1580274000,1589169600,19
Thomas-Emilio,2,17,8004,646,1576472400,1608699600,19
oxyoxyboi,0,19,0,80,1583812800,1607403600,19
Dalebssr,1,18,311,329,1603684800,1609045200,19
parodg15,1,18,24,147,1563076800,1600228800,19
late_thoughts,1,18,38,41,1594353600,1594526400,19
samep04,0,19,0,146,1566014400,1606539600,19
DredGodTheClout,0,19,0,96,1546405200,1547701200,19
icyhotonmynuts,0,19,0,343,1600574400,1606712400,19
MrDurden93,0,19,0,41,1561348800,1592798400,19
boolean_array,2,17,362,252,1569902400,1600747200,19
ilikepieman,2,17,44,202,1576386000,1586664000,19
E-308,2,17,4561,81,1598068800,1608181200,19
coolsheep769,1,18,29,178,1579237200,1597032000,19
shiputukya,1,18,2,100,1598846400,1611896400,19
Random_182f2565,0,19,0,145,1581915600,1611896400,19
felixkatz,0,19,0,353,1565496000,1600056000,19
mikneleh,0,19,0,676,1599278400,1600142400,19
czartreck,2,17,66,97,1542776400,1561953600,19
Stormophile,0,19,0,1429,1551934800,1602561600,19
NoCoffeeForThee,0,19,0,697,1592280000,1592712000,19
UnableEngineering,0,19,0,54,1539921600,1551762000,19
SuborbitalQuail,2,17,85,176,1595822400,1603771200,19
Live4NVR,3,16,104,519,1548565200,1575003600,19
zeusfist,0,19,0,122,1603512000,1607922000,19
Llaine,0,18,0,108,1548824400,1592107200,18
CaptainBeefFart98,1,17,45,113,1550293200,1552536000,18
acroporaguardian,0,18,0,191,1579150800,1582088400,18
tawlon,3,15,56,28,1604030400,1609131600,18
Edmond-the-Great,0,18,0,-94,1578373200,1604203200,18
TsundereGiraffe,0,18,0,166,1575694800,1609131600,18
Keywhole,1,17,3,259,1551762000,1602734400,18
Aibhne_Dubhghaill,0,18,0,662,1605762000,1611810000,18
DoctorProfessorConor,4,14,182,92,1596859200,1608613200,18
A_Becker,0,18,0,315,1578546000,1608958800,18
cgello,0,18,0,128,1534219200,1568520000,18
blazetrain520,0,18,0,101,1577336400,1578978000,18
blaisreddit,0,18,0,87,1602129600,1607317200,18
RoleplayPete,0,18,0,0,1605157200,1607922000,18
FinalEgg9,0,18,0,321,1574312400,1606626000,18
ladybrevity,4,14,196,92,1574226000,1583038800,18
WrassleBabe,3,15,344,482,1606885200,1607662800,18
jaylong76,0,18,0,364,1606539600,1609390800,18
BigMagicTulip,1,17,4,103,1578027600,1606712400,18
Thanatopsis_,1,17,16,269,1533528000,1541394000,18
SureYeahOkCool,0,18,0,170,1593230400,1597204800,18
Throoooowawayyyyy55,0,18,0,287,1577163600,1595822400,18
WiggleBooks,0,18,0,113,1541131200,1577509200,18
SlimCagey,3,15,56,57,1595563200,1612328400,18
chill-e-cheese,0,18,0,2,1571630400,1588996800,18
JonnyAU,0,18,0,152,1548824400,1609304400,18
stevekornackismaps,2,16,45,92,1586059200,1592193600,18
paris_rogue,0,18,0,362,1601352000,1606194000,18
Hoelscher,0,18,0,783,1558584000,1583557200,18
forgotmyabcs,4,14,145,64,1565841600,1585540800,18
Lonely_Cartographer,0,18,0,63,1580706000,1605934800,18
Newthinker,0,18,0,434,1600228800,1608181200,18
Sneaky-Alpaca,0,18,0,-4,1601092800,1609218000,18
Finvic,1,17,12,121,1591675200,1608613200,18
Karasumor1,0,18,0,233,1577941200,1611810000,18
RoutineIsland,0,18,0,440,1566705600,1606280400,18
unspacedem,0,18,0,138,1556596800,1594612800,18
LionBirb,0,18,0,79,1576904400,1581829200,18
DSibling,2,16,164,67,1569816000,1606626000,18
log1992,0,18,0,65,1562472000,1592539200,18
gettingthewordnonce,0,18,0,180,1568001600,1588996800,18
IncindiaryImmersion,0,18,0,37,1575176400,1592539200,18
underground_crane,0,18,0,53,1596772800,1604379600,18
ShibbyHaze1,8,10,976,50,1557374400,1573275600,18
OllieOul,0,18,0,231,1600660800,1607230800,18
BABOU_theOCelott,0,18,0,51,1575349200,1598932800,18
StellaBaines,0,18,0,248,1569124800,1609131600,18
Geleemann,0,18,0,68,1583985600,1594353600,18
sh0t,0,18,0,131,1578632400,1602648000,18
rvbjohn,0,18,0,181,1555905600,1579755600,18
keeleon,0,18,0,-72,1555387200,1591502400,18
FrankMarkovic,18,0,159,0,1596600000,1603252800,18
vw46u,0,18,0,11,1551070800,1568174400,18
CanAlwaysBeBetter,0,18,0,136,1598760000,1606626000,18
DecafLatte,0,18,0,197,1573621200,1607662800,18
MadMadMesa,0,18,0,-54,1581742800,1581829200,18
xorandor,6,12,138,64,1562558400,1606885200,18
actuallyitsmadelyn,0,18,0,354,1579323600,1595217600,18
MagnaCumLoudly,1,17,10,140,1546405200,1608699600,18
mms13,0,18,0,137,1589947200,1611810000,18
CrimsonOblivion,0,18,0,129,1576386000,1607749200,18
thelongestusernameee,0,18,0,492,1570593600,1599192000,18
Musklim,0,18,0,224,1592107200,1592366400,18
Cap_whitepatch,0,18,0,-6,1597550400,1611896400,18
livintheshleem,0,18,0,43,1564459200,1571716800,18
MattThePaladin,1,17,17,149,1601956800,1608613200,18
alex11947657,2,16,48,207,1575608400,1608267600,18
dustybizzle,0,18,0,256,1569124800,1590206400,18
Feisty-Confidence,0,18,0,77,1607749200,1608786000,18
_orion_1897,0,18,0,2,1605848400,1608267600,18
muni0,0,18,0,117,1567310400,1577595600,18
2rfv,0,18,0,106,1602388800,1607922000,18
RagingBullUK,0,18,0,131,1588651200,1607144400,18
falconview,0,18,0,266,1539748800,1609304400,18
NHecrotic,0,18,0,182,1572408000,1573362000,18
bairdydev,1,17,10,145,1551589200,1565668800,18
TargetMajora,0,18,0,202,1598500800,1612155600,18
Setari,0,18,0,83,1574312400,1592798400,18
suzisatsuma,0,18,0,30,1590379200,1599624000,18
SharkEel,0,18,0,252,1566792000,1612069200,18
throwaway_f74w12289,0,18,0,216,1606280400,1608786000,18
digitalEarthling,2,16,172,185,1534219200,1608786000,18
peterslabbit,0,18,0,101,1585540800,1606798800,18
XBreaksYFocusGroup,1,17,7,194,1598846400,1609304400,18
KingOmega9,7,11,220,64,1541217600,1549170000,18
liirko,0,18,0,222,1572321600,1608699600,18
mywakinghours,1,17,62,82,1595908800,1600833600,18
dragon1412,0,18,0,119,1599451200,1609390800,18
Bravelady16,1,17,91,97,1559275200,1563595200,18
hello_der_fam,0,18,0,0,1595390400,1604466000,18
Konradleijon,4,14,298,88,1573275600,1611810000,18
homestar440,1,17,32,277,1537848000,1581915600,18
MDavis8387,2,16,877,89,1565496000,1608699600,18
methuselah01,1,17,22,70,1596772800,1605070800,18
boob_wizard,0,18,0,14,1594699200,1598587200,18
OutOfTheVault,0,18,0,-22,1567828800,1571889600,18
throckmeisterz,1,17,13,233,1603166400,1611896400,18
brodeo69,0,18,0,158,1602216000,1609563600,18
BreadXCircus,3,15,1065,460,1599969600,1611723600,18
Slummish,0,18,0,692,1568001600,1587528000,18
bicoril,0,18,0,235,1569729600,1582952400,18
Teddy_Eddy84,1,17,220,998,1597204800,1608267600,18
RafeHaab,0,18,0,15,1606971600,1607230800,18
SalvageProbe,0,18,0,128,1554523200,1578891600,18
evilerutis,0,18,0,148,1582606800,1607144400,18
Zoncord,0,18,0,-46,1566964800,1567310400,18
seraph9888,1,17,1,407,1540008000,1608008400,18
pinkliquor,1,17,78,204,1571457600,1605330000,18
GLADisme,0,18,0,267,1562817600,1612155600,18
moonbyjonghyun,0,18,0,512,1553659200,1574485200,18
Rage-Xion,9,9,96,49,1582606800,1605848400,18
Ocasio_Cortez_2024,1,17,153,124,1601524800,1609390800,18
NotEnriqueIglesias,2,16,98,101,1567915200,1597291200,18
nowherelefttolook,1,17,169,102,1566446400,1566532800,18
DeleteBowserHistory,0,18,0,458,1559102400,1589860800,18
slidingmodirop,0,18,0,454,1587873600,1597032000,18
woodscommaelle_,3,15,117,124,1594267200,1598155200,18
Literally_A_Vampire,3,15,36,42,1580360400,1582520400,18
BoughtMyNameOnFiverr,0,18,0,74,1582088400,1584504000,18
arniegrape,0,18,0,1364,1577163600,1609304400,18
Trileon,0,18,0,89,1589860800,1604030400,18
River_tamm,4,14,169,140,1555992000,1589601600,18
UnpaidOvereducated,1,17,42,69,1565928000,1574398800,18
mighty_alicorn,7,11,230,39,1590379200,1601265600,18
ExistentDavid1138,0,18,0,160,1575522000,1608008400,18
thatguykeith,4,14,5568,119,1604466000,1611810000,18
MusicNerd4,0,18,0,114,1605848400,1609218000,18
ZGMF-X10-Strike,0,18,0,316,1546837200,1606712400,18
VanMisanthrope,0,18,0,177,1537243200,1592971200,18
Affectionate_Okra_68,5,13,80,54,1597204800,1598587200,18
WasteAway81883,0,18,0,136,1595995200,1603771200,18
Westdrache,0,18,0,249,1571716800,1597896000,18
lilith_linda,0,18,0,89,1592020800,1611810000,18
martya7x,0,18,0,267,1421038800,1606626000,18
Chert_Blubberton,0,18,0,218,1608699600,1609304400,18
jswensenmusic,5,13,1441,143,1561348800,1607403600,18
1SecretUpvote,0,18,0,99,1549342800,1578286800,18
Ethiconjnj,0,18,0,-1,1586664000,1608440400,18
fguhfdty13,0,18,0,-39,1590465600,1606366800,18
beaglefoo,1,17,886,158,1547010000,1598760000,18
Thoughtitwouldlast,0,18,0,-17,1599710400,1603771200,18
madman8000,3,15,126,120,1561176000,1569211200,18
knowspickers,0,18,0,700,1562126400,1590897600,18
_lmnoponml_,0,18,0,244,1600660800,1604552400,18
Snozzler,0,18,0,27,1581310800,1608958800,18
Kakofoni,1,17,121,65,1535083200,1586318400,18
SaintYanno,1,17,15,58,1587441600,1609477200,18
GGWolfSif,0,18,0,57,1595563200,1607403600,18
NathanielR505,2,16,214,768,1593057600,1593403200,18
progman8,0,18,0,199,1596254400,1609218000,18
Fishychicken,2,16,38,137,1598328000,1606194000,18
xnx2018,1,17,5,173,1546923600,1550206800,18
plipyplop,0,18,0,244,1561348800,1608440400,18
avacado_of_the_devil,0,18,0,240,1597896000,1606885200,18
Almighty_Bidoof424,0,18,0,1048,1611723600,1612155600,18
kelminak,0,18,0,-25,1578805200,1589860800,18
SharpieScentedSoap,0,18,0,1072,1580360400,1603252800,18
454444933,2,16,17,32,1586577600,1592539200,18
Sakops,1,17,571,412,1583211600,1606885200,18
rivigurl,0,18,0,252,1578286800,1604203200,18
aven_colonist,0,18,0,32,1580446800,1601179200,18
nearsingularity,0,18,0,281,1602993600,1611982800,18
MXSCHISMA,0,18,0,137,1592539200,1595995200,18
idcandnooneelse,0,18,0,-66,1579410000,1579669200,18
thesetheredoctobers,0,18,0,815,1603425600,1607317200,18
Divine2012,0,18,0,215,1554523200,1574744400,18
BillyW1994,0,18,0,215,1563336000,1608958800,18
Sombrere,0,18,0,124,1581051600,1591588800,18
JoeySadass,0,18,0,151,1597896000,1606107600,18
mark1822,2,16,1492,650,1554955200,1608440400,18
AdmiralFoxx,0,18,0,26,1576731600,1608872400,18
Filly_Fill,0,18,0,101,1576818000,1583470800,18
LordOfPieces,0,18,0,158,1581829200,1606626000,18
portodhamma,0,18,0,80,1556424000,1606885200,18
rowdy-riker,0,18,0,275,1565496000,1611982800,18
from_east_to_west,1,17,80,61,1569297600,1572235200,18
Nurum,0,18,0,24,1593489600,1593835200,18
thatdudethatyeah,1,17,72,175,1594353600,1598155200,18
Snaggled-Sabre-Tooth,0,18,0,828,1601265600,1605070800,18
merunas,2,16,2693,216,1591675200,1597636800,18
Rising_Falling,1,17,3,142,1561521600,1589860800,18
sbwv09,2,16,108,292,1563595200,1597377600,18
hondelonk,0,18,0,448,1572930000,1596254400,18
illbefinehonest,0,18,0,44,1608699600,1609477200,18
lala9605,0,18,0,287,1594353600,1612069200,18
SalvaStalker,0,18,0,99,1576731600,1582347600,18
BarryBondsBalls,0,18,0,102,1584590400,1609045200,18
D10S_,0,18,0,176,1599537600,1607230800,18
lordofthepumpkin,0,18,0,126,1593316800,1602993600,18
imaginearagog,0,18,0,64,1571284800,1584936000,18
MissMagdalenaBlue,0,17,0,58,1596081600,1605675600,17
choose-a-pseudonym,0,17,0,118,1607317200,1608094800,17
Bladex20,0,17,0,94,1605070800,1605330000,17
Desproges,1,16,102,230,1587960000,1608699600,17
WalnutScorpion,0,17,0,297,1607230800,1609390800,17
allTradesbyName_,1,16,19,412,1581915600,1609304400,17
This_Mud8879,0,17,0,45,1606366800,1612069200,17
chocologicality,2,15,17,114,1599019200,1607922000,17
thehonorablechairman,0,17,0,156,1593662400,1607230800,17
FishLauncher,1,16,11,129,1581310800,1584763200,17
anothershrubbery_,0,17,0,33,1587268800,1602129600,17
MaximPetrikov,0,17,0,-33,1602043200,1603771200,17
banalityoflegal,0,17,0,104,1536638400,1540008000,17
Aradia_Wolf,2,15,57,59,1566446400,1592280000,17
sameshitdifferentpoo,0,17,0,320,1586750400,1612069200,17
ColonelBernie2020,1,16,8,316,1588478400,1603252800,17
KuroArk088,0,17,0,162,1583125200,1587873600,17
Abutrug,0,17,0,-57,1573966800,1592193600,17
BurbeeTurbs,0,17,0,-60,1579755600,1580274000,17
bxxgeyman,1,16,38,175,1554955200,1582952400,17
TanithRosenbaum,0,17,0,331,1540785600,1608008400,17
PurpleMuskogee,0,17,0,365,1577422800,1603771200,17
bannanaduck,1,16,147,41,1576558800,1606366800,17
galleria_suit,0,17,0,73,1568260800,1605589200,17
audigex,0,17,0,96,1598068800,1608699600,17
qsc123951,1,16,13,73,1596859200,1597896000,17
Convicted__Vapist,0,17,0,170,1590811200,1604379600,17
earthlingshe,0,17,0,1046,1566964800,1581310800,17
guante-izquierdo,1,16,11,34,1593403200,1594699200,17
JustWantsHappiness,1,16,60,37,1550638800,1582693200,17
butt_mucher,0,17,0,56,1556596800,1607835600,17
Usermemealreadytaken,0,17,0,-24,1571976000,1595649600,17
saint_abyssal,0,17,0,139,1548306000,1609045200,17
SuitsAndStripes,0,17,0,91,1596168000,1599796800,17
leafsruleh,1,16,82,472,1599537600,1608094800,17
CountessRostov,3,14,75,111,1567051200,1588478400,17
crepper4454,0,17,0,289,1575608400,1595476800,17
Neocentennial,5,12,246,70,1546405200,1605675600,17
plaiboi,1,16,18,150,1564027200,1603944000,17
wolviepayne,0,17,0,95,1573707600,1578373200,17
agua70,0,17,0,249,1598846400,1605243600,17
JODYHIGHROLLER1,0,17,0,122,1551330000,1557460800,17
lordbobofthebobs,0,17,0,84,1592193600,1605675600,17
anonima_,0,17,0,364,1563854400,1608354000,17
mendedroad,2,15,132,54,1597809600,1601784000,17
mypostingname13,0,17,0,178,1592193600,1607922000,17
mimajo,0,17,0,324,1573016400,1585195200,17
eetuua,1,16,8,196,1573534800,1608526800,17
mjobby,3,14,19,244,1565582400,1597377600,17
GenesisMonster,0,17,0,245,1595649600,1601179200,17
mzesk17,1,16,267,-12,1569816000,1600747200,17
Sophorien,0,17,0,94,1540872000,1573102800,17
kistusen,1,16,1,184,1605934800,1612155600,17
DooWeeWoo,0,17,0,315,1591675200,1608094800,17
intrepid-teacher,2,15,39,41,1575867600,1601870400,17
dumbuglyloser,0,17,0,663,1547701200,1566360000,17
Prime_Director,0,17,0,317,1573016400,1611896400,17
HoppyBadger,0,17,0,119,1554955200,1582779600,17
palmerio80222_,2,15,516,90,1592280000,1599105600,17
a_friendly_miasma,0,17,0,300,1548133200,1589860800,17
voluotuousaardvark,0,17,0,112,1601524800,1607403600,17
Mr_Shroom_King,5,12,168,269,1572148800,1590465600,17
Bonfires_Down,0,17,0,77,1559016000,1596600000,17
Commodity_,2,15,268,340,1574312400,1590897600,17
bipolarvortex70,0,17,0,50,1593057600,1600747200,17
LunaticOstrich,0,17,0,247,1576299600,1602302400,17
GenePuzzleheaded,0,17,0,128,1597723200,1603857600,17
OMPOmega,0,17,0,78,1594785600,1608699600,17
Another_leaf,0,17,0,120,1582002000,1582174800,17
secularDruid,0,17,0,116,1573448400,1587182400,17
OmniLiquid,0,17,0,116,1591848000,1593921600,17
44ster,0,17,0,192,1589169600,1609045200,17
daftmunk,4,13,229,55,1547010000,1578632400,17
cbr777,0,17,0,-4,1589169600,1589342400,17
mike_lotz,1,16,27,-128,1596513600,1608267600,17
winstanleywasright,0,17,0,187,1567483200,1578373200,17
LettieAC,0,17,0,101,1581742800,1586232000,17
PublicDomainMPC,2,15,149,169,1563854400,1585022400,17
Smedleys_Butler_1933,0,17,0,24,1583643600,1613451600,17
jamesh922,1,16,376,398,1577768400,1607835600,17
Arch_Enemy_616,0,17,0,47,1606021200,1609131600,17
KaskyNightblade,0,17,0,101,1569297600,1587700800,17
nutscyclist,0,17,0,-32,1561262400,1599451200,17
alwaystimeforpizza77,3,14,428,261,1594872000,1611896400,17
Cleopara,0,17,0,143,1602907200,1607835600,17
McLeavey,0,17,0,230,1580619600,1592107200,17
RogueKatt,2,15,67,112,1596427200,1608094800,17
zetterburger,0,17,0,304,1587787200,1608354000,17
GerinX,0,17,0,105,1572843600,1604466000,17
Are_My_Oxys_Ready,1,16,43,85,1559275200,1588824000,17
film_composer,1,16,230,806,1576558800,1607403600,17
Kanon-Umi,0,17,0,237,1582088400,1600315200,17
ffucckfaccee,0,17,0,419,1579842000,1605675600,17
throwmetotheas,1,16,52,86,1599192000,1609304400,17
sjayb217,2,15,80,60,1576904400,1577250000,17
RoamingKid,4,13,202,205,1583211600,1593230400,17
FountainFull,0,17,0,705,1597464000,1609390800,17
dryblueink,0,17,0,63,1589256000,1595131200,17
landoonter,0,17,0,54,1598328000,1611896400,17
NEETsLastResort,0,17,0,170,1572321600,1607749200,17
PupidStunk,0,17,0,291,1589601600,1607922000,17
NiceGuyGreg77,0,17,0,64,1598932800,1603684800,17
house-hermit,0,17,0,144,1595822400,1608872400,17
charxc2222,2,15,23059,99,1604552400,1607662800,17
RahgronKodaav,1,16,3,111,1601006400,1608354000,17
Owl_Of_Orthoganality,0,17,0,92,1584936000,1607749200,17
Ajaatshatru34,3,14,341,139,1535688000,1542171600,17
theaurorabeam,0,17,0,287,1576299600,1604379600,17
engxcommish,1,16,28,237,1566446400,1607058000,17
Ormond-Is-Here,0,17,0,183,1574312400,1576558800,17
rgc202,0,17,0,47,1593748800,1609045200,17
ginzing,0,17,0,22,1598155200,1608181200,17
nervyliras,0,17,0,348,1578286800,1607490000,17
Fragrance-World,0,17,0,-8,1602820800,1603598400,17
ZizDidNothingWrong,0,17,0,374,1556078400,1574658000,17
HustleInMuhBlood,2,15,79,439,1607490000,1607922000,17
BLoDo7,0,17,0,173,1583470800,1612242000,17
rrrrrryyy124,0,17,0,56,1601006400,1602129600,17
DevChatt,0,17,0,291,1560484800,1587268800,17
MadzDragonz,1,16,104,160,1540008000,1590033600,17
ExistentialAmbiguity,3,14,243,106,1555300800,1572062400,17
grendhalgrendhalgren,0,17,0,342,1547787600,1599537600,17
TheScreamingHorse,0,17,0,-40,1569988800,1570334400,17
barkley87,1,16,20,142,1572580800,1583985600,17
AnaiekOne,0,17,0,166,1541653200,1603512000,17
jojomcflowjo,0,17,0,90,1554350400,1579496400,17
Solarat1701,0,17,0,131,1571889600,1599019200,17
ephekt,0,17,0,-1,1586404800,1586664000,17
RabiesPositive,0,17,0,180,1599019200,1603771200,17
Hightowerin,16,1,12014,1,1564632000,1574917200,17
ShyShimmer,1,16,45,200,1565150400,1584072000,17
Constantly_Panicking,0,17,0,130,1573966800,1608440400,17
BiBiBicycle,1,16,71,162,1541044800,1573534800,17
BlueShield,0,17,0,313,1588046400,1591761600,17
Some-Pomegranate4904,0,17,0,95,1605070800,1612242000,17
irreductio,0,17,0,1181,1594353600,1607490000,17
phthaloverde,0,17,0,157,1578459600,1607490000,17
pepper0510,0,17,0,66,1603252800,1607230800,17
IamGodHimself2,5,12,1188,73,1571112000,1608354000,17
Zolan0501,8,9,115,24,1585195200,1607144400,17
nanitheshit,0,17,0,-22,1599883200,1599883200,17
A000000StoleMyBike,1,16,0,-20,1601265600,1605762000,17
SpicyHashbrowns,2,15,61,274,1569384000,1608786000,17
mallokrano,0,17,0,206,1560052800,1589860800,17
rawfulness,0,17,0,170,1606280400,1608267600,17
waldyrious,7,10,221,72,1429848000,1608354000,17
projing,2,15,104,273,1592452800,1605243600,17
noavocadoshere,0,17,0,103,1559188800,1582693200,17
Zlint,1,16,22,223,1577077200,1609131600,17
iluvchicken01,1,16,20,125,1603684800,1607317200,17
aceymichaelis,1,16,12,39,1599537600,1607058000,17
wiql,0,17,0,161,1595304000,1601956800,17
MyUsrNameWasTaken,0,17,0,150,1591156800,1608526800,17
Delphizer,0,17,0,23,1605589200,1609045200,17
WharDoesThisButtonDo,1,16,170,234,1588219200,1609218000,17
Naive_Drive,0,17,0,462,1578805200,1587096000,17
bbqpauk,2,15,4778,416,1585886400,1591934400,17
juoeys,0,17,0,90,1595476800,1598760000,17
EatWithConscience,0,17,0,47,1599883200,1606798800,17
Lilshadow48,0,17,0,122,1570420800,1602734400,17
comedgygenius,0,17,0,151,1549515600,1560744000,17
Kagomeatheart,2,15,14,132,1560225600,1561521600,17
lordofbud,0,17,0,296,1591502400,1608699600,17
CaLotDESS,0,17,0,-175,1571630400,1571630400,17
Everything4Everyone,13,4,1831,17,1507867200,1609131600,17
Throw_Away_License,0,17,0,1230,1581570000,1590033600,17
_wjp_,1,16,375,472,1571630400,1598500800,17
unite-thegig-economy,0,17,0,767,1572235200,1583298000,17
DrBinkleton,0,17,0,522,1604030400,1609304400,17
Outlandish_0,0,17,0,-124,1561867200,1562472000,17
LynchMob1009,0,17,0,30,1596600000,1601956800,17
Bearimbolo420,0,17,0,215,1598932800,1611637200,17
OT-Knights,0,17,0,254,1569038400,1603598400,17
WageSlave39,0,17,0,101,1605502800,1606712400,17
iWantPankcakes,0,17,0,37,1575090000,1579237200,17
elperroborrachotoo,0,17,0,122,1586318400,1609477200,17
aMuslimPerson,3,14,38,55,1557633600,1602734400,17
Derrickmb,0,17,0,-272,1606712400,1608526800,17
JackEpidemia,0,17,0,133,1570161600,1606712400,17
itchyhorse,0,17,0,99,1596427200,1608440400,17
neon-neko,0,17,0,395,1604379600,1608872400,17
so_fucken_sowsy,0,17,0,129,1575349200,1575608400,17
Mylaur,0,17,0,47,1559361600,1602129600,17
BostonDrinks,0,17,0,109,1556164800,1577682000,17
itsaravemayve,0,17,0,288,1575608400,1608181200,17
pbj10101,1,16,6,252,1600488000,1611810000,17
FaintDamnPraise,0,17,0,296,1556683200,1602907200,17
perceptor77,0,17,0,274,1575003600,1595995200,17
funyunsgood,0,17,0,43,1592539200,1608267600,17
Neiladaymo,0,17,0,144,1573275600,1590206400,17
skewsh,1,16,67,112,1581656400,1602820800,17
idonteatchips,0,17,0,341,1593921600,1611896400,17
asian_tryhard,0,17,0,39,1608699600,1608699600,17
Crosstitution,0,17,0,290,1451883600,1589515200,17
marques33,0,17,0,74,1607490000,1611810000,17
iota0atg,3,14,86,60,1608526800,1612414800,17
writingthefuture,0,17,0,80,1573534800,1608267600,17
Astropecorella,1,16,9,227,1568088000,1573362000,17
Corusmaximus,0,17,0,0,1553140800,1562558400,17
winters_red,0,17,0,34,1593921600,1605675600,17
certified_rat,1,16,22,464,1581051600,1609390800,17
Mew_T,1,16,459,327,1594699200,1604116800,17
seriouslydavid,1,16,20,69,1547528400,1574658000,17
PopTartAfficionado,1,16,58,47,1607317200,1609390800,17
HawkEy3,0,17,0,80,1452315600,1576040400,17
thisisme5555555,2,15,11,46,1601870400,1602561600,17
mindaslab,12,5,5168,27,1570420800,1607230800,17
Sometimes_Airborne,0,17,0,170,1588478400,1603080000,17
safemate98,9,8,1482,56,1581915600,1598846400,17
TheDean84,6,11,3604,150,1573016400,1599105600,17
alhamjaradeeksa,0,17,0,186,1546491600,1588651200,17
PM-tits_or_lenin_pic,0,17,0,323,1582088400,1600574400,17
VerneAsimov,4,13,142,52,1601352000,1611723600,17
nose_shit,0,17,0,811,1603252800,1607922000,17
TemperedTorture,0,17,0,359,1594008000,1608267600,17
ghostbubby420,0,17,0,102,1593835200,1611982800,17
VJett101,11,6,133,26,1573621200,1582002000,17
plinkoplonka,0,17,0,97,1592798400,1607835600,17
brokendrive,1,16,0,-14,1576731600,1594440000,17
itshudsonsir,1,16,11,81,1602648000,1611982800,17
Warmduscher1876,1,16,9,70,1576213200,1606021200,17
scorchdearth,0,17,0,969,1582261200,1607144400,17
vye_curious,0,17,0,174,1571284800,1608008400,17
redpanther36,0,17,0,87,1597809600,1609131600,17
Bourbon-Mason,1,16,65,110,1579669200,1594267200,17
nb4hnp,0,17,0,86,1427428800,1471579200,17
eazolan,0,17,0,26,1588392000,1604293200,17
CivilEngineerThrow,0,17,0,151,1574139600,1608354000,17
thrway1209983,2,15,148,152,1568779200,1608958800,17
Iwilleatyourpie,0,17,0,33,1599105600,1599710400,17
ShitPostingNerds,0,17,0,250,1560571200,1603598400,17
futurepaster,0,17,0,17,1608008400,1609045200,17
InvestigatorJosephus,0,17,0,44,1553227200,1553313600,17
ichiban_01,0,17,0,268,1583211600,1605675600,17
PHIMBY,0,17,0,91,1588478400,1593489600,17
ImPretendingToCare,1,16,52,75,1578718800,1609218000,17
drauch52,6,11,1861,40,1553918400,1604811600,17
AngelOfDerp,0,16,0,72,1595908800,1601438400,16
BorealBard,1,15,6,203,1597377600,1598587200,16
Notyourhero3,0,16,0,118,1572235200,1583899200,16
safetyindarkness,1,15,38,57,1579064400,1602734400,16
Dat_Harass,0,16,0,325,1577422800,1586923200,16
Elaphoil,0,16,0,251,1561262400,1605589200,16
PaddyPervert,1,15,59,56,1557374400,1570248000,16
Darkmage752,0,16,0,219,1568952000,1600142400,16
ThymeHamster,0,16,0,33,1602043200,1605070800,16
Lacriphage,0,16,0,87,1548046800,1607835600,16
squidward4comminism,0,16,0,122,1562126400,1571544000,16
communized,0,16,0,75,1576731600,1588305600,16
robo_jojo_77,0,16,0,52,1589515200,1592625600,16
TrueProfessor,1,15,233,215,1571544000,1608699600,16
captainwoozy,0,16,0,220,1593057600,1609390800,16
tobbitt,4,12,380,44,1572667200,1605157200,16
AssMaster6000,0,16,0,168,1579582800,1605502800,16
cryptorchild7,0,16,0,23,1573102800,1592798400,16
aventadorlp,1,15,26,53,1601870400,1608699600,16
ZarathoustraIsLaifu,1,15,16,34,1576731600,1576904400,16
koschei124c,0,16,0,171,1601956800,1608613200,16
conman526,0,16,0,488,1597291200,1606280400,16
AbraspamLinkler,1,15,564,103,1601265600,1608354000,16
Philly_South_Paw,1,15,315,238,1592798400,1601179200,16
bluesun100,3,13,1,19,1590292800,1603425600,16
sybar142857,3,13,1073,58,1556942400,1562299200,16
ErnestGoesToSaturn,0,16,0,38,1605330000,1606280400,16
Hrrrrnnngggg,0,16,0,627,1552276800,1609390800,16
DroWillis,0,16,0,409,1571112000,1609131600,16
PottsV1,0,16,0,232,1592366400,1605157200,16
thatninjathere,0,16,0,-89,1612069200,1612155600,16
Heybigheadbranded,2,14,32,1001,1600315200,1600833600,16
SightmarkSimon,0,16,0,10,1608181200,1608267600,16
FaithOfOurFathers,0,16,0,44,1599969600,1609477200,16
99zakya,8,8,1062,24,1600747200,1611810000,16
la_zarzamora,0,16,0,252,1557201600,1583384400,16
naruka777,0,16,0,18,1606539600,1606626000,16
landothedead,3,13,143,210,1542862800,1608786000,16
ChevyT1996,0,16,0,-54,1594699200,1608267600,16
trafalux,0,16,0,187,1585368000,1598846400,16
MeatFloggerActual,0,16,0,132,1527652800,1547701200,16
Capable-Wasabi,0,16,0,267,1597377600,1608958800,16
billythygoat,0,16,0,121,1572321600,1608699600,16
TheNerdJournals,0,16,0,418,1565236800,1604984400,16
Puzzleheaded_Raise43,0,16,0,27,1602475200,1607144400,16
errlfreewilly,0,16,0,35,1606626000,1606712400,16
sonictails2049,0,16,0,149,1586664000,1604898000,16
fecuff,6,10,151,26,1546923600,1592539200,16
Helpful_Temporary_96,3,13,43,48,1605502800,1611810000,16
Spliteer,0,16,0,102,1582088400,1594008000,16
RoseRedRhapsody,0,16,0,88,1565582400,1600574400,16
labalabah,0,16,0,14,1580965200,1584331200,16
Derriaoe,1,15,29,171,1544245200,1564113600,16
whatisanorange,0,16,0,83,1569211200,1603771200,16
desertsprinkle,0,16,0,71,1602043200,1605675600,16
bored_toronto,2,14,66,49,1560484800,1603598400,16
DANKKrish,4,12,392,59,1566878400,1581915600,16
Lest4r,0,16,0,47,1580360400,1585627200,16
boofthatcraphomie,0,16,0,132,1584763200,1608008400,16
centaur_unicorn23,0,16,0,332,1603684800,1608354000,16
jurvekthebosmer,1,15,175,45,1579150800,1589860800,16
PointSaintGeorge,0,16,0,74,1586750400,1605070800,16
Honestopinions5,3,13,21,0,1567828800,1580014800,16
TrickyBoss4,0,16,0,-7,1584590400,1594699200,16
slejla,0,16,0,127,1601697600,1608699600,16
RenegadeJoeson,0,16,0,-519,1578114000,1580014800,16
CVNC-Coils,0,16,0,108,1577336400,1606626000,16
deus_mortuus_est,2,14,460,190,1565496000,1580706000,16
Daniel0739,1,15,20,4,1605675600,1608613200,16
Big-Judgment,0,16,0,26,1583038800,1583038800,16
DocMoochal,0,16,0,133,1607144400,1611982800,16
Emzaar,1,15,1007,339,1583298000,1590552000,16
jpfowler40,0,16,0,84,1605416400,1607576400,16
CastePaste,2,14,3255,135,1597118400,1600833600,16
MayflyEng,0,16,0,287,1572235200,1609477200,16
benabducted,0,16,0,205,1540958400,1599364800,16
yoloimgay,0,16,0,249,1556856000,1595476800,16
DCfueledwithpopeyes_,1,15,12,32,1598328000,1608613200,16
last_hairbender_jsy,4,12,319,110,1596600000,1605848400,16
zztop5533,0,16,0,170,1599883200,1609304400,16
emlgs,5,11,7648,-819,1606712400,1611982800,16
PMMeMeiRule34,2,14,161,188,1552795200,1567483200,16
BillyBerigman,1,15,24,-62,1605848400,1606453200,16
wangsneeze,0,16,0,536,1568692800,1601611200,16
accidentalsurvivor,0,16,0,184,1599624000,1602907200,16
Combefere,0,16,0,61,1576558800,1611896400,16
Binnacle_Balls_jr,0,16,0,121,1577682000,1607403600,16
Crabnab,0,16,0,191,1598500800,1609477200,16
courtneat,3,13,57,96,1579842000,1603425600,16
EkskiuTwentyTwo,0,16,0,210,1560571200,1589515200,16
Rumaizio,0,16,0,537,1599796800,1607144400,16
Takoyaki_is_MURDER,1,15,7,116,1592971200,1596340800,16
stressed2damax,3,13,96,148,1551589200,1597982400,16
twobit211,0,16,0,320,1571976000,1608181200,16
EngiPotato,1,15,71,49,1547182800,1565150400,16
mr_bigmouth_502,2,14,78,36,1546578000,1595044800,16
NOS326,2,14,43,58,1580792400,1606798800,16
chillbro113,0,16,0,108,1600488000,1606194000,16
Casperredemption,1,15,85,257,1591416000,1609477200,16
MrBeanFlicker,0,16,0,-13,1585713600,1598414400,16
SecondBestToaster,0,16,0,-83,1593230400,1602129600,16
scythianlibrarian,0,16,0,137,1573275600,1595217600,16
Truffles326,0,16,0,251,1554177600,1612069200,16
minecraft1984,0,16,0,134,1569470400,1604116800,16
d710905,0,16,0,91,1605157200,1609131600,16
Diskographi,0,16,0,474,1558929600,1596945600,16
Spirit_of_No_Face,0,16,0,23,1597896000,1598500800,16
jagrflow,1,15,459,22,1591329600,1591675200,16
exogenote,1,15,21,91,1558065600,1585972800,16
treefoxx,0,16,0,392,1574658000,1592539200,16
ryderlefeg,1,15,22,60,1568779200,1569816000,16
Beforeidie-,0,16,0,493,1606885200,1608613200,16
ComprehensiveAddict,0,16,0,254,1604293200,1609390800,16
Wheresmycloud,0,16,0,221,1547787600,1609304400,16
escailer,0,16,0,106,1582606800,1595217600,16
Dsnake1,0,16,0,49,1601265600,1603252800,16
ThatCraftyDragon,3,13,219,189,1602734400,1608872400,16
DSteep,0,16,0,118,1578286800,1608786000,16
Memeinator123,0,16,0,228,1582261200,1592107200,16
chillwifi,0,16,0,129,1547182800,1579496400,16
ers123_asfd3f213,0,16,0,-13,1593144000,1594612800,16
LinuxPhreak,1,15,298,190,1588564800,1612069200,16
sp4cel0ver,0,16,0,229,1598932800,1607490000,16
divvyagent,2,14,33,810,1584331200,1584763200,16
psychedelic_lab_rat,4,12,1473,47,1572753600,1577163600,16
TheRealActiveLearner,0,16,0,39,1592884800,1593316800,16
Sailor_Solaris,0,16,0,290,1594612800,1608786000,16
Big-Hard-Chungus,0,16,0,484,1564977600,1609477200,16
HaElfParagon,0,16,0,96,1598068800,1598155200,16
spetrillob,0,16,0,117,1580014800,1595304000,16
blackmarker77,0,16,0,21,1591588800,1591588800,16
Prism_Red,0,16,0,116,1572753600,1602475200,16
K1ngOfEthanopia,0,16,0,169,1560744000,1585540800,16
Scadeau101,1,15,134,56,1578373200,1597204800,16
albatrossG8,1,15,13,78,1591761600,1611982800,16
PsychedelicsConfuse,0,16,0,105,1576731600,1608181200,16
69BadAss420,0,16,0,-46,1583038800,1596513600,16
FaustTheBird,0,16,0,60,1584849600,1590552000,16
heresyforfunnprofit,0,16,0,92,1571976000,1609304400,16
ChristosArcher,0,16,0,598,1601697600,1608267600,16
mercutios_girl,0,16,0,230,1568692800,1579928400,16
weekendsarelame,0,16,0,40,1608267600,1608526800,16
pm_me_ur_happy_traiI,0,16,0,151,1553313600,1592884800,16
aregularpoompoom,0,16,0,199,1549515600,1590379200,16
greendayshoes,0,16,0,360,1576472400,1606539600,16
istandostoievsky,2,14,2150,80,1554523200,1602129600,16
JasonDragonbourne,0,16,0,209,1605070800,1607749200,16
MyStolenCow,0,16,0,144,1589947200,1608699600,16
Viksinn,0,16,0,87,1560139200,1580014800,16
sk8pickel,0,16,0,24,1574830800,1592020800,16
DemoseDT,0,16,0,71,1571716800,1604203200,16
antiWorkHomeless,3,13,95,44,1571544000,1596340800,16
CaptainNimta,0,16,0,163,1552622400,1579582800,16
dayavera,1,15,2245,142,1577163600,1584763200,16
the_exminster,3,13,23,-162,1576386000,1578718800,16
LusciousWildFlower,0,16,0,288,1574744400,1600056000,16
DefectiveAndDumb,0,16,0,335,1579928400,1589947200,16
minikins44,0,16,0,68,1581051600,1611982800,16
MRNOFUCKSTOGIVE,5,11,3270,76,1605157200,1607058000,16
ATworkATM,2,14,30,94,1570161600,1601524800,16
virtualkitteh,0,16,0,231,1589169600,1612069200,16
Raschwolf,0,16,0,165,1567569600,1574571600,16
Sasquatchamunk,0,16,0,154,1570075200,1601524800,16
RyanX1231,0,16,0,166,1568692800,1604030400,16
Myreddditusername,0,16,0,-42,1577336400,1606626000,16
Itsmay1987,7,9,98,47,1604725200,1611982800,16
KimmiG1,0,16,0,127,1474084800,1608008400,16
PlaneCrashNap,0,16,0,120,1590897600,1606712400,16
FoiDeCeapa,0,16,0,265,1594440000,1596513600,16
herald_yfandes,0,16,0,142,1564459200,1612069200,16
sporadicallydrifting,0,16,0,52,1544245200,1547269200,16
ColgateToothpaste,0,16,0,37,1578805200,1582520400,16
BraSS72097,0,16,0,415,1566878400,1592712000,16
cidroja1312,0,16,0,348,1582002000,1591588800,16
MufasaLocks,1,15,30,197,1546664400,1567137600,16
PreventCivilWar,0,16,0,274,1569729600,1606885200,16
VulpixEevee,1,15,32,82,1559793600,1606453200,16
GuineaPigBikini,0,16,0,193,1570075200,1609390800,16
Choice_Garbage,0,16,0,115,1563768000,1588564800,16
DrowningEmbers,1,15,10,88,1579150800,1590552000,16
200lbRockLobster,0,16,0,251,1562472000,1567569600,16
Original_You_2154,5,11,168,82,1597464000,1601352000,16
joshthecynic,1,15,1,348,1455685200,1611637200,16
AlextheLyonnn,1,15,73,201,1596859200,1604984400,16
LieutenantEvident,0,16,0,331,1599537600,1612155600,16
Ghostlyhero7,0,16,0,154,1575435600,1602648000,16
Princess___Aurora,0,16,0,99,1592712000,1608440400,16
VincentVanGrow,0,16,0,179,1565496000,1575694800,16
chehsu,0,16,0,163,1599969600,1609218000,16
hereforthemadness,3,13,452,81,1568779200,1576126800,16
ballzwette,0,16,0,43,1605589200,1609477200,16
20Comer100SaberesXD,3,13,0,55,1570939200,1599883200,16
zappadattic,0,16,0,265,1558497600,1603857600,16
NoiseBoxes,0,16,0,53,1601092800,1603166400,16
elfdruidbard,0,16,0,17,1552449600,1560052800,16
Kaiserraiser21,0,16,0,38,1597982400,1603598400,16
Iwantallof-it,0,16,0,133,1598500800,1600574400,16
GuitarGodsDestiny420,0,16,0,28,1606971600,1609304400,16
m_d_f_l_c,0,16,0,76,1587009600,1587009600,16
ShrewOfDoom,0,16,0,56,1596772800,1606453200,16
tehbored,0,16,0,-98,1577854800,1605502800,16
ctsgreg,0,16,0,-9,1571976000,1573794000,16
EJR77,0,16,0,-64,1579064400,1595217600,16
TheLoneWolfA82,0,16,0,423,1551934800,1602388800,16
47sams,1,15,2,9,1559016000,1600228800,16
wasupwasup05,0,16,0,685,1593662400,1608008400,16
OneTaoThree,1,15,2429,87,1560744000,1579669200,16
PossessedToSkate,1,15,61,217,1578373200,1600833600,16
MadDingersYo,0,16,0,230,1602302400,1609218000,16
SkyPuppy561,0,16,0,112,1558497600,1571284800,16
AGoodWordForOldGil,0,16,0,288,1440388800,1603771200,16
Xello_99,1,15,16,393,1593057600,1594440000,16
NotesOff,2,14,423,23,1578632400,1588392000,16
MeisterDejv,0,16,0,364,1580533200,1583557200,16
sardonic_chronic,3,13,436,625,1581051600,1584763200,16
paigeawebb,0,16,0,245,1561694400,1606712400,16
Pollo_Pollo_Pollo,0,16,0,335,1590465600,1606971600,16
tiredkj,0,16,0,60,1597118400,1597377600,16
AriAncom,0,16,0,395,1576386000,1598414400,16
Cultural_Glass,0,16,0,21,1608267600,1612328400,16
manawydan-fab-llyr,0,16,0,94,1578027600,1606021200,16
bankseu,0,16,0,271,1569816000,1582952400,16
ActiveShipyard,0,16,0,4,1424149200,1552107600,16
PhoebeMcGreedy,1,14,1844,175,1571198400,1571284800,15
HockeyIsMyWife,1,14,239,423,1566100800,1605934800,15
That_red_guy,0,15,0,-65,1603166400,1608267600,15
eliseereclusvivre,14,1,165,1,1559880000,1606712400,15
zippybit,1,14,47,136,1571198400,1591588800,15
KarmaPharmacy,0,15,0,546,1601006400,1612069200,15
Waters_of_Caladan,0,15,0,48,1569470400,1571025600,15
coppermouthed,0,15,0,119,1593403200,1595908800,15
QueenE_din,1,14,33,30,1560312000,1560571200,15
Tyme_2_Go,0,15,0,60,1587355200,1604898000,15
maeschder,0,15,0,53,1557633600,1598414400,15
RageWolf1222,0,15,0,59,1603684800,1608786000,15
shablyas,1,14,23,-29,1567569600,1607922000,15
always_tired_hsp,2,13,15,120,1576990800,1601524800,15
GoodAndBluts,0,15,0,88,1590379200,1608786000,15
ausomemama666,0,15,0,191,1585540800,1608786000,15
BrotherDBAD,1,14,5,54,1581829200,1611810000,15
Fil_the_Dude,3,12,440,136,1588478400,1605416400,15
DrVet,0,15,0,123,1585713600,1608958800,15
shaving99,0,15,0,120,1598673600,1608699600,15
Meanttobepracticing,0,15,0,239,1569211200,1602907200,15
Kaymish_,0,15,0,128,1595649600,1609218000,15
fleshworks,0,15,0,56,1595908800,1608094800,15
420cherubi,0,15,0,151,1553918400,1597377600,15
slippy204,4,11,1334,943,1578632400,1590724800,15
sugabelly,0,15,0,-69,1584504000,1600660800,15
CrimsonBolt33,0,15,0,0,1594699200,1602561600,15
CanadianWorker99,0,15,0,32,1585540800,1603857600,15
tes_kitty,0,15,0,531,1575262800,1608699600,15
happy-idiot,0,15,0,1094,1573102800,1605157200,15
Antihippyaktion,0,15,0,994,1596513600,1597809600,15
OkonkwoYamCO,0,15,0,140,1587182400,1608354000,15
Anonymous-420smoker,0,15,0,2,1609650000,1609736400,15
hawkshaw1024,1,14,556,295,1597982400,1608958800,15
iguessthisis,0,15,0,43,1580014800,1608440400,15
a_Walgreens_employee,0,15,0,99,1569988800,1598500800,15
venus-lvr,1,14,57,191,1592625600,1608613200,15
just0a0person,1,14,75,91,1575867600,1576040400,15
jojo_reference,0,15,0,115,1555387200,1587009600,15
mohd16,7,8,731,195,1603857600,1609045200,15
siddhi5699,3,12,8301,25,1597896000,1603080000,15
rufflayer,0,15,0,199,1587441600,1600315200,15
fedditredditfood,0,15,0,-22,1598068800,1607144400,15
TheSystemZombie,0,15,0,-10,1575954000,1578718800,15
oscarfacegamble,0,15,0,87,1569211200,1588046400,15
fluffypinkblonde,0,15,0,46,1589428800,1606539600,15
MrSatanicTrial,0,15,0,63,1582174800,1598846400,15
jasztech,0,15,0,446,1593748800,1606971600,15
oSHTsasQuatch,0,15,0,-88,1565323200,1565409600,15
Limeila,1,14,749,329,1600056000,1604984400,15
plaze6288,0,15,0,70,1582520400,1606280400,15
deez_fluffernutters,0,15,0,33,1575867600,1575954000,15
Bleu_Cheese_Pursuits,0,15,0,116,1541912400,1583211600,15
UnbiasedPartisan,0,15,0,-82,1601524800,1603512000,15
GuerrillerodeFark,0,15,0,-1,1547010000,1556251200,15
Argent_Hythe,0,15,0,215,1598414400,1609045200,15
drippingyellomadness,0,15,0,165,1573448400,1573448400,15
Motherof42069,0,15,0,45,1603598400,1603684800,15
mochicekream,0,15,0,62,1601870400,1607749200,15
KlargDeThaym,1,14,95,129,1539835200,1567137600,15
Nuclear_rabbit,0,15,0,209,1595563200,1609131600,15
allymadoxreads,0,15,0,34,1605157200,1605416400,15
Girthybrooks420,6,9,16913,91,1608872400,1609477200,15
louhepburn1219,0,15,0,81,1601092800,1605762000,15
Bananas_in_my_jammas,0,15,0,122,1578718800,1582952400,15
Snowman33001,0,15,0,83,1550293200,1584504000,15
budshitman,0,15,0,51,1573534800,1604984400,15
Mockpit,0,15,0,157,1585454400,1594440000,15
DeweyCheatamAndHowe,0,15,0,135,1553486400,1576731600,15
LordBrettus,0,15,0,24,1589428800,1609131600,15
myownzen,0,15,0,18,1579064400,1600228800,15
Meeghan__,1,14,23,285,1573275600,1587873600,15
FoolishLyingHumans,0,15,0,66,1571889600,1601611200,15
AntibioticOintment,1,14,71,93,1552107600,1567310400,15
Ghostcarapace3,3,12,6,27,1595390400,1604811600,15
xxXKingPinXxx,0,15,0,101,1595736000,1607749200,15
Bigfrostynugs,0,15,0,59,1550552400,1576818000,15
Calibanize,2,13,55,79,1596513600,1596772800,15
paulie07,0,15,0,104,1551502800,1605502800,15
Frostysuede,0,15,0,684,1572321600,1578114000,15
buzzkillington86,0,15,0,23,1578546000,1579842000,15
LabTech41,0,15,0,-83,1543122000,1543122000,15
Wyzegy,0,15,0,-19,1608440400,1608526800,15
sl0wrx,0,15,0,140,1567137600,1607230800,15
yaboyexa,1,14,2,197,1595649600,1599105600,15
OhioJeeper,0,15,0,-2,1580274000,1608181200,15
RunnyTinkles,1,14,82,60,1565150400,1607490000,15
Xaviarsly,0,15,0,938,1562990400,1607835600,15
soparaestecomentario,0,15,0,146,1604203200,1605330000,15
sanorace,3,12,99,48,1585972800,1596254400,15
mouthybeardy,1,14,28,384,1572753600,1586145600,15
Stockyarp,0,15,0,148,1572930000,1599883200,15
Deathduck,0,15,0,457,1556596800,1602820800,15
tsuo_nami,1,14,14,152,1597464000,1607403600,15
Siowyn,0,15,0,61,1603684800,1611810000,15
grittzcz,1,14,0,-20,1593662400,1594526400,15
latower,1,14,19,26,1424062800,1431662400,15
BURMoneyBUR,0,15,0,48,1602820800,1606971600,15
guy7C1,0,15,0,91,1602043200,1606107600,15
Jezon,1,14,59,154,1595131200,1603339200,15
StoryOfLaverna,0,15,0,234,1553140800,1596945600,15
ConceitedBuddha,0,15,0,198,1508990400,1598155200,15
PsychoShampoo,0,15,0,43,1584244800,1602820800,15
Cute_Spide,5,10,173,58,1576731600,1604898000,15
Kingu_Enjin,0,15,0,42,1569211200,1569297600,15
i_like_frootloops,0,15,0,174,1541044800,1549342800,15
Kaldenar,0,15,0,268,1593748800,1607922000,15
ezranilla,1,14,24038,121,1611982800,1627358400,15
RarePepePNG,0,15,0,247,1550206800,1593316800,15
Arondeus,4,11,2152,148,1577422800,1593057600,15
vercetti87,0,15,0,42,1597291200,1597982400,15
GrumpyBaristaBastard,1,14,21,58,1597204800,1597291200,15
spacejenkins,0,15,0,167,1572321600,1575349200,15
OriginalZinn,0,15,0,83,1584244800,1584504000,15
afrocreative,0,15,0,66,1572408000,1612069200,15
incrediblystalkerish,0,15,0,67,1577595600,1611982800,15
velohell,0,15,0,415,1561348800,1587009600,15
4gpw,0,15,0,-8,1590379200,1598673600,15
akaBrotherNature,0,15,0,730,1551243600,1585454400,15
ttc153,0,15,0,81,1606021200,1606194000,15
TheGreaterOutdoors,0,15,0,1,1549602000,1556510400,15
usnea90,0,15,0,123,1571025600,1580792400,15
CeruleaAzura,1,14,23,116,1578805200,1592366400,15
Just-Drew-It,0,15,0,-31,1607749200,1607749200,15
ted5011c,0,15,0,265,1573534800,1603771200,15
Kcthonian,0,15,0,138,1597032000,1606885200,15
censorinus,0,15,0,328,1597118400,1607922000,15
rowechelon01,1,14,19,142,1574053200,1577682000,15
Orphan-Slayer,3,12,1412,211,1580274000,1596600000,15
Philly-South-Paw,5,10,3557,83,1604030400,1609045200,15
PersonVA,0,15,0,88,1598155200,1611982800,15
hawa11styl3,1,14,2215,107,1596686400,1608699600,15
absurdchrono,0,15,0,91,1600747200,1608699600,15
mok2k11,1,14,7,10,1598760000,1605934800,15
redpandarox,5,10,425,119,1588219200,1611810000,15
omgwtfscreenname,1,14,6,76,1582261200,1608786000,15
Rudybus,0,15,0,216,1581138000,1604116800,15
ineedincome,1,14,12,117,1557115200,1561608000,15
ifeellikemoses,1,14,818,274,1552363200,1582434000,15
NatashaSpeaks,1,14,14,54,1607922000,1608181200,15
singhdilavr,1,14,3,43,1569124800,1588651200,15
NarcanMeFam,0,15,0,205,1602648000,1605157200,15
whowasonCRACK,0,15,0,181,1586923200,1600488000,15
CandyAltruism,0,15,0,-17,1591502400,1607576400,15
gigachadd,0,15,0,-165,1558065600,1582779600,15
Conniverse,0,15,0,48,1608699600,1608699600,15
filipomar,1,14,18,437,1575608400,1601956800,15
TheTooz,0,15,0,102,1570334400,1593576000,15
Aixemple,0,15,0,-7,1595131200,1607749200,15
dkrzf,0,15,0,167,1588996800,1600747200,15
maselphie,0,15,0,170,1558324800,1595390400,15
Kolios14,0,15,0,-38,1571198400,1579237200,15
WhitheredOldTree,0,15,0,123,1585108800,1609045200,15
Gujirus,1,14,53,104,1578027600,1599019200,15
-petroleum-,0,15,0,12,1587873600,1588737600,15
runs_in_the_jeans,0,15,0,20,1554955200,1588910400,15
sandshrew69,3,12,56,49,1594872000,1611982800,15
Error8,0,15,0,533,1588392000,1608872400,15
lbnovisad,1,14,673,194,1575522000,1606712400,15
AndyValentine,1,14,367,53,1611637200,1611637200,15
madonice,0,15,0,671,1592366400,1611810000,15
sonicb00m42,0,15,0,1,1595649600,1597118400,15
RhombusAcheron,0,15,0,134,1563422400,1586664000,15
alicejane1010,1,14,6,143,1590379200,1608526800,15
Giopetre,3,12,238,59,1558670400,1640667600,15
sarkicism101,0,15,0,115,1576126800,1583643600,15
ITriedLightningTendr,0,15,0,48,1573275600,1608267600,15
stillplayingpkmn,0,15,0,107,1596686400,1600833600,15
Onlythevoicesinside,1,14,637,135,1601784000,1603339200,15
USAisDyingLULZ,0,15,0,115,1592971200,1602907200,15
on_the_mike,5,10,102,33,1543381200,1590724800,15
R3K3M,1,14,0,0,1590897600,1594008000,15
FiscalDoughnut,0,15,0,100,1577509200,1608872400,15
bolasthegodpharoh,0,15,0,1,1609390800,1609563600,15
Masark,0,15,0,312,1576040400,1608872400,15
CulturedHollow,2,13,205,420,1591416000,1609304400,15
MrVierPner,0,15,0,159,1540008000,1596600000,15
Ouroboros616,2,13,27,-29,1543381200,1544590800,15
semi_colon,0,15,0,219,1567137600,1575176400,15
waffleking_,0,15,0,1287,1569988800,1607144400,15
Vexeris,0,15,0,239,1566532800,1572580800,15
snortzilla,2,13,30,167,1578027600,1609304400,15
zacheryed,0,15,0,208,1581051600,1607490000,15
LegendarySpark,0,15,0,355,1573621200,1605157200,15
helpmelearn12,0,15,0,106,1566446400,1608786000,15
evolutions123,0,15,0,37,1603512000,1605675600,15
SoldierofNod,0,15,0,62,1556510400,1560830400,15
heckyescheeseandpie,0,15,0,189,1564977600,1585627200,15
toodleoop,0,15,0,199,1605848400,1607835600,15
pavlovianscreens,0,15,0,204,1593230400,1598155200,15
SomeRandomGuy33,0,15,0,-20,1559793600,1560744000,15
kazeshinikira,0,15,0,47,1606626000,1606971600,15
PurpleKneesocks,2,13,199,291,1573016400,1598241600,15
LuvOneAnother,0,15,0,215,1576645200,1576904400,15
OlDerpy,1,14,126,156,1578546000,1585886400,15
EgoanCap,1,14,379,307,1579755600,1600920000,15
Lady_Valentyna,0,15,0,163,1566100800,1594872000,15
jesuswipesagain,0,15,0,428,1598068800,1611896400,15
commandolandorooster,9,6,3111,25,1567051200,1582434000,15
Knighthood666999,0,15,0,76,1597723200,1605070800,15
energizedmortal,0,15,0,324,1555041600,1575435600,15
connorsk,0,15,0,32,1559707200,1564632000,15
MikeTheBard,0,15,0,289,1603598400,1611982800,15
anyklosaruas,0,15,0,127,1570766400,1582779600,15
rooterRoter,0,15,0,124,1571630400,1583125200,15
super_zodiac,0,15,0,190,1603339200,1611982800,15
UncomfortableFarmer,0,15,0,49,1587009600,1608526800,15
brispybreme,0,15,0,106,1583038800,1608526800,15
MargarineIsEvil,0,15,0,403,1558324800,1581829200,15
Nerdthrasher,0,15,0,218,1594008000,1605934800,15
Turtlepower7777777,5,10,1081,86,1594008000,1608958800,15
Cigarello123,0,15,0,15,1599883200,1600056000,15
LadyQuatherine,1,14,21,121,1600056000,1603944000,15
BlazingSpaceGhost,0,15,0,72,1583812800,1611810000,15
Throwaway08952,1,14,149,101,1602475200,1608440400,15
Heiditha,3,12,47,152,1530590400,1592020800,15
farklenator,0,15,0,186,1585108800,1608267600,15
nyeemavery141,0,15,0,72,1599364800,1609390800,15
Aoede,0,15,0,155,1547182800,1569297600,15
MrBohemian,0,15,0,333,1555992000,1576731600,15
MaczenDev,0,15,0,-128,1588737600,1588737600,15
LL112,0,15,0,426,1577854800,1611896400,15
SirBeaverton,0,15,0,-33,1588910400,1603339200,15
siewcazametu,0,15,0,128,1598068800,1598846400,15
Irkutsk2745,2,13,70,132,1547528400,1601092800,15
ReptarTheBrave,0,15,0,259,1576731600,1596168000,15
WarmOutOfTheDryer,0,15,0,67,1581051600,1607403600,15
Gast8,0,15,0,449,1597118400,1609304400,15
joahnames,0,15,0,-13,1611982800,1612069200,15
83cats,1,14,16,128,1547269200,1604203200,15
dread_pirate_humdaak,5,10,55,220,1599105600,1609390800,15
NadiaMPereira,1,14,5,43,1602993600,1607144400,15
Kdog909,0,15,0,165,1578891600,1595131200,15
secter,0,15,0,82,1571025600,1571716800,15
Popoff_the_cap_onH2O,0,15,0,43,1595390400,1598500800,15
83jdbsna,0,15,0,-70,1572148800,1576386000,15
Seriack,0,15,0,136,1570939200,1580706000,15
FiftyOne151,11,4,8143,9,1571544000,1606885200,15
ExcellentNatural,0,15,0,171,1607230800,1611896400,15
ChateauTermite,0,15,0,195,1561435200,1585108800,15
Wormhole-Eyes,0,15,0,360,1565582400,1603512000,15
SailorENC,0,15,0,-57,1582779600,1585800000,15
woggin,6,9,4877,179,1564977600,1606280400,15
justsomeyeti,1,14,93,182,1598760000,1608872400,15
doublowsven,0,15,0,-165,1604898000,1608699600,15
manofathousandnames,0,15,0,95,1572667200,1584504000,15
thrwaymylif,1,14,6,31,1570161600,1570161600,15
Born-2-Troll,0,15,0,180,1575781200,1576386000,15
smokeout3000,0,15,0,396,1560398400,1587960000,15
Paintingsosmooth,0,15,0,107,1572408000,1608526800,15
Bit-Bi-Bit,0,15,0,199,1545022800,1589860800,15
PandaLLC,0,15,0,39,1577941200,1607144400,15
Sanjuko_Mamajuloko,0,15,0,-65,1554436800,1554523200,15
lahire87,0,15,0,358,1559793600,1597377600,15
9thgrave,1,14,19,361,1604293200,1611896400,15
farmkidLP,1,14,76,170,1569384000,1591502400,15
Shintacos,2,13,173,57,1594699200,1594785600,15
PersonOfInternets,0,15,0,44,1575608400,1605589200,15
helloelan,2,13,113,664,1537761600,1589169600,15
VeritasValues,3,12,81,268,1581915600,1594872000,15
H0bg0blin0verl0rd,0,15,0,60,1578891600,1591416000,15
HPGal3,0,15,0,212,1554264000,1587268800,15
Explolguy,1,14,117,71,1571630400,1584676800,15
paiselyy,0,15,0,111,1550206800,1563336000,15
SociopathicPeanut,0,15,0,42,1531195200,1563768000,15
From_My_Brain,2,13,91,43,1578286800,1604379600,15
DefenseofLostCauses,1,14,0,-19,1580187600,1580878800,15
zenshatta,0,15,0,111,1551762000,1559707200,15
Secondsemblance,0,15,0,250,1430884800,1569988800,15
MikeCharlieUniform,0,15,0,99,1514178000,1594526400,15
Kaliworship,1,14,31716,107,1578286800,1606107600,15
fitkistobiwan,0,15,0,216,1591934400,1596254400,15
Tuck_Vison,0,15,0,55,1547528400,1566532800,15
ZakAdoke,0,15,0,88,1585972800,1607662800,15
BeVegan-StopBreeding,0,15,0,46,1596427200,1610427600,15
FistFullofGil,1,14,40,136,1559361600,1591588800,15
film-freak,0,15,0,158,1574571600,1582866000,15
Murkspectre,0,15,0,26,1594440000,1596340800,15
human8ure,0,15,0,-32,1604898000,1611982800,15
MulchyYT,4,11,104,34,1572148800,1611810000,15
Kangarookas,0,15,0,97,1560484800,1564632000,15
SquakSquakBird,0,15,0,119,1588478400,1609131600,15
e-cola,0,15,0,543,1589083200,1606885200,15
Freddie_T_Roxby,0,15,0,21,1597723200,1607662800,15
Innocentrage1,0,15,0,98,1608267600,1608786000,15
jobquestionsss27,1,13,62,123,1551330000,1552795200,14
theBinSUBTLEisSUBTLE,7,7,728,62,1540699200,1553572800,14
ThespianBarrage,0,14,0,60,1593144000,1603425600,14
Zomaarwat,5,9,256,30,1562990400,1608699600,14
Sirota_Kazanskaya,0,14,0,8,1600228800,1606885200,14
Hanz616,1,13,7,139,1587528000,1603684800,14
maybeillbetracer,0,14,0,413,1562472000,1593921600,14
saveyourtissues,1,13,9,446,1571457600,1601784000,14
Robin420,0,14,0,725,1585195200,1600142400,14
Worried111,0,14,0,127,1571889600,1596513600,14
writinglucy,0,14,0,85,1545022800,1558584000,14
bawbag-t,0,14,0,303,1569124800,1594958400,14
CAC-Sama,0,14,0,40,1579410000,1607835600,14
be5ui,0,14,0,52,1541217600,1546750800,14
Yokokaijin,0,14,0,165,1600142400,1604638800,14
madrix999,0,14,0,259,1571284800,1576731600,14
El_McKell,0,14,0,94,1563940800,1585022400,14
lewis492,0,14,0,5,1595649600,1598846400,14
AlchemicalEnthusiast,2,12,110,60,1578805200,1600660800,14
Cake890,1,13,81,357,1592798400,1612069200,14
vatomalo,0,14,0,80,1579237200,1612155600,14
havokinthesnow,0,14,0,57,1566446400,1609218000,14
Z-W-A-N-D,0,14,0,88,1560139200,1579928400,14
Onslow85,0,14,0,67,1571371200,1581224400,14
scarlettskadi,0,14,0,77,1558411200,1592366400,14
iamthewhite,0,14,0,718,1584849600,1608958800,14
SeveralOven,0,14,0,108,1577077200,1583557200,14
1000ancestors,0,14,0,52,1552107600,1573534800,14
TheFatMouse,0,14,0,64,1567742400,1582088400,14
DoctorSamuelHayden,0,14,0,286,1591329600,1599192000,14
bepis_69,0,14,0,-8,1589601600,1605416400,14
wingzero6,0,14,0,75,1584417600,1607403600,14
Noodler_Canoodler,1,13,51,70,1602302400,1608267600,14
ihateaspergers,5,9,159,36,1593230400,1606971600,14
kishbish,1,13,220,356,1534737600,1567656000,14
DickedGayson,0,14,0,491,1576472400,1593835200,14
DevoRevo56,0,14,0,-204,1597550400,1597636800,14
isnt_existence_crazy,5,9,1146,78,1556596800,1579410000,14
PandemicPower,2,12,222,57,1589947200,1599796800,14
catgirlsandmolotovs,0,14,0,84,1577163600,1597636800,14
WiseChoices,0,14,0,589,1569643200,1611982800,14
ExtroHermit,0,14,0,114,1587960000,1608872400,14
Buddhas_Palm,0,14,0,87,1566532800,1596772800,14
dooby1,3,11,827,58,1581051600,1587009600,14
csmith2077,0,14,0,48,1584244800,1597291200,14
swadawa2,5,9,434,78,1574917200,1598932800,14
victoriasponge87,3,11,57,64,1570766400,1572580800,14
suscribednowhere,0,14,0,21,1599624000,1606798800,14
midnightstitcher,0,14,0,73,1595908800,1605762000,14
ZestycloseBrother0,0,14,0,-100,1587873600,1587960000,14
Plus3d6,0,14,0,359,1594094400,1603339200,14
Afraid-Pace,0,14,0,84,1603339200,1605502800,14
I_DONT_NEED_HELP,0,14,0,421,1600574400,1608699600,14
-DoublePlusGood-,2,12,25,148,1596686400,1608786000,14
fuckyourfascism,1,13,143,44,1545022800,1566187200,14
icandoMATHs,0,14,0,26,1582779600,1583643600,14
Anarchit,1,13,371,76,1583557200,1583726400,14
Cado7,0,14,0,134,1554436800,1607144400,14
Tom_The_Human,0,14,0,238,1545627600,1595390400,14
25point8069758011279,3,11,192,71,1547701200,1554868800,14
Sure-Temperature,0,14,0,111,1581742800,1602993600,14
PastaOfMuppets,3,11,389,44,1532059200,1576472400,14
Troll4ever31,0,14,0,174,1581570000,1609390800,14
superkickerjess,4,10,308,42,1563336000,1585281600,14
mercurymarinated,0,14,0,31,1590120000,1590379200,14
playfordays1,0,14,0,50,1563595200,1588132800,14
GrannyLow,0,14,0,-251,1583125200,1585281600,14
MrDToTheIzzle,2,12,506,265,1573534800,1603512000,14
ballettapandjazz,0,14,0,41,1604030400,1608267600,14
theoriginalmathteeth,2,12,19,36,1577941200,1606539600,14
Beverlydriveghosts,0,14,0,164,1571371200,1598241600,14
KetwarooDYaasir,1,13,23,80,1577941200,1584763200,14
ghostsandvodka_,1,13,24,37,1586577600,1587960000,14
Flopolopagus,2,12,24,423,1557720000,1608267600,14
GeneralFeet,1,13,6,27,1605070800,1610686800,14
doubtfulwager,0,14,0,28,1569556800,1573362000,14
Spaced_Raider,0,14,0,197,1552968000,1592366400,14
juttep1,0,14,0,69,1582174800,1611896400,14
dlc741,0,14,0,198,1594872000,1620446400,14
UntamedMongrel,0,14,0,648,1592366400,1602043200,14
cereixa,0,14,0,377,1572667200,1596945600,14
AlexUstimenko,0,14,0,6,1611896400,1612242000,14
ActualAccountss,0,14,0,96,1574139600,1577595600,14
propqueen420,0,14,0,324,1591761600,1605330000,14
JJEng1989,0,14,0,61,1539489600,1541739600,14
BethofDeath,0,14,0,105,1572667200,1606885200,14
wish_to_conquer_pain,0,14,0,67,1555819200,1607576400,14
Careful_Description,0,14,0,45,1604984400,1608526800,14
FluorineWizard,0,14,0,67,1581656400,1591156800,14
Kins97,0,14,0,610,1563163200,1608354000,14
WilliamMButtlickerJr,0,14,0,163,1586232000,1607490000,14
hibiscus38,3,11,206,148,1567483200,1574312400,14
never_safe_for_life,0,14,0,106,1578632400,1609390800,14
nertynertt,0,14,0,165,1573621200,1607922000,14
sleeptonic,0,14,0,255,1589342400,1595217600,14
_decrypt--,0,14,0,148,1557460800,1573189200,14
RJohn12,0,14,0,267,1571889600,1605157200,14
conmattang,0,14,0,9,1608267600,1608267600,14
PixelBlock,0,14,0,-11,1589083200,1601870400,14
sanfoale,3,11,8,35,1599710400,1608094800,14
BuddyTheBunny,0,14,0,37,1600833600,1608094800,14
1timmy0911,0,14,0,-70,1551762000,1571371200,14
thomas533,0,14,0,123,1481432400,1611982800,14
Feminist_Username,0,14,0,-14,1591156800,1605070800,14
cerberus698,0,14,0,174,1573275600,1607490000,14
Halldon,0,14,0,81,1584676800,1589601600,14
johnnysivilian,0,14,0,123,1569902400,1592798400,14
ae2014,1,13,0,115,1560398400,1584158400,14
ThreeLeggedTranny,0,14,0,-26,1574917200,1605330000,14
AddieWeasley,2,12,271,103,1548738000,1608008400,14
starterflipper,6,8,6385,48,1599624000,1611896400,14
Husonaut90,6,8,13247,233,1559793600,1583812800,14
kynovardy,0,14,0,1264,1570420800,1578978000,14
Laphroach,0,14,0,-30,1591675200,1608526800,14
Excrubulent,0,14,0,263,1576731600,1607490000,14
GoChaca,0,14,0,116,1605502800,1605589200,14
Sm0llguy,1,13,3,219,1553227200,1608181200,14
SpaceBoggled,0,14,0,50,1548651600,1602820800,14
t1lewis,1,13,4,164,1563940800,1590379200,14
greensilos,0,14,0,421,1574917200,1577854800,14
pewpsispewps,0,14,0,214,1559188800,1586145600,14
KANGAROO_ASS_BLASTER,0,14,0,104,1575262800,1593144000,14
Nikhilvoid,4,10,96,89,1578459600,1596772800,14
ElliottNessie,2,12,861,183,1550725200,1604984400,14
Darth_Debate,1,13,13,51,1522900800,1523073600,14
lout_zoo,0,14,0,51,1499832000,1575176400,14
transgirl16,1,13,0,-18,1604116800,1604203200,14
coyowile,0,14,0,509,1580274000,1608526800,14
Lost_vob,1,13,231,275,1589947200,1612069200,14
ka0tika,0,14,0,38,1594008000,1597291200,14
lisalisagoike,0,14,0,344,1575781200,1582606800,14
PapaSlurms,0,14,0,1,1585454400,1606626000,14
Hoppmjac000,0,14,0,63,1574571600,1604116800,14
Canvaverbalist,2,12,119,253,1545714000,1562212800,14
americanwolf999,0,14,0,-135,1575781200,1575867600,14
DemoniteBL,0,14,0,394,1583125200,1608181200,14
Username62415,0,14,0,263,1586750400,1600401600,14
carlsonhfj,3,11,4096,22,1596081600,1606280400,14
One_Shot_Finch,0,14,0,53,1557979200,1605330000,14
abandonedapparition8,1,13,56,55,1563768000,1581397200,14
LoveToSeeMeLonely,0,14,0,756,1581483600,1597032000,14
RunawayHobbit,0,14,0,218,1594785600,1608699600,14
SalamanderSampson,0,14,0,8,1585454400,1593144000,14
Spezzit,1,13,0,-16,1561089600,1582779600,14
generic2050,0,14,0,63,1543813200,1553659200,14
antinatalistria,0,14,0,53,1562299200,1612069200,14
Ethchappy,2,12,293,35,1572235200,1612069200,14
LiquidDreamtime,0,14,0,443,1576818000,1600056000,14
iamthemizzbridget,0,14,0,166,1605848400,1608267600,14
rockandroll666,0,14,0,143,1574053200,1600056000,14
stormyguyniels,0,14,0,28,1547182800,1554955200,14
Antifa_Meeseeks,0,14,0,285,1597204800,1608008400,14
ddplz,0,14,0,-17,1582520400,1608958800,14
beenalegend,0,14,0,157,1567483200,1604898000,14
mihai2me,0,14,0,204,1551070800,1603684800,14
nestledin,0,14,0,136,1557979200,1595217600,14
RaccoonWound,0,14,0,264,1559707200,1600142400,14
sw33tleaves,0,14,0,178,1573016400,1605330000,14
HowieFeltersnitz,0,14,0,19,1561262400,1562385600,14
pumpkinpatch6,0,14,0,37,1558497600,1598414400,14
Lilium79,0,14,0,248,1605848400,1611896400,14
hastethedayway,1,13,6,23,1564891200,1565064000,14
RandomCookie1234,0,14,0,-59,1568952000,1576213200,14
shlushfundbaby,0,14,0,62,1587096000,1589342400,14
nosleepforthedreamer,1,13,13,-11,1560052800,1560225600,14
tell_me_a-bot_it,0,14,0,67,1611723600,1612155600,14
SwordOfKas,0,14,0,76,1577422800,1580014800,14
Skateflip36011,0,14,0,118,1579496400,1608181200,14
SprinkledDonut88,3,11,151,77,1575435600,1598068800,14
MILFs_PM_Me_Selfies,0,14,0,118,1585886400,1592107200,14
Eevee36,8,6,727,51,1575867600,1605675600,14
Kaarsty,0,14,0,94,1559102400,1611982800,14
xartalien,9,5,21873,8,1595995200,1608786000,14
pathfinder_101,0,14,0,213,1598587200,1605070800,14
Ithekkinme,3,11,1543,45,1603252800,1606712400,14
CrackedSpruce,0,14,0,-14,1600056000,1602043200,14
quarry00900,0,14,0,141,1597550400,1601956800,14
m3t3orVII,0,14,0,210,1599624000,1608354000,14
AchillesFirstStand,0,14,0,0,1612069200,1612069200,14
collectorofsouls5a7d,2,12,28,26,1602648000,1609045200,14
radiax10,0,14,0,-88,1598760000,1602388800,14
Miranda8142,2,12,128,74,1595217600,1599192000,14
dashtBerkeley,2,12,58,50,1572843600,1588219200,14
hiccupq,1,13,80,33,1606194000,1606280400,14
weebmaster32,1,13,112,-133,1574830800,1579842000,14
Atsena,1,13,341,95,1562904000,1614402000,14
IKeepForgetting,2,12,46,160,1534219200,1564286400,14
xyon1282,0,14,0,-20,1577509200,1589342400,14
randomphoneuser2019,2,12,37,215,1596081600,1607662800,14
DatParadox,0,14,0,225,1521604800,1607576400,14
kd_socialist,1,13,11,88,1580533200,1607662800,14
nickydlax,0,14,0,18,1597204800,1608267600,14
LordAurum007,0,14,0,457,1557460800,1586750400,14
andyW9,0,14,0,225,1549342800,1573189200,14
Cute-ologist,0,14,0,81,1598846400,1611982800,14
Mikedermott,0,14,0,239,1584244800,1584331200,14
papertowelz4life,0,14,0,7,1585627200,1585627200,14
Free__NYC,0,14,0,45,1559880000,1581310800,14
DeslerZero,0,14,0,0,1597896000,1605157200,14
pidoran,1,13,6,143,1581915600,1608958800,14
EmberSeven,0,14,0,58,1579410000,1603944000,14
1u___u1zZz,0,14,0,1073,1579582800,1608354000,14
Mostface,1,13,97,47,1561176000,1580101200,14
DrDougExeter,0,14,0,225,1572321600,1583470800,14
alienrabbithunter,0,14,0,131,1578027600,1585886400,14
karmayz,0,14,0,184,1576299600,1605934800,14
Papyrus_Sans,3,11,73,46,1575522000,1608786000,14
cemego,2,12,123,35,1600142400,1608440400,14
mindkingdom,2,12,83,150,1589169600,1603771200,14
Fen94,0,14,0,180,1594094400,1608872400,14
AnotherGoodUser,0,14,0,46,1591243200,1604898000,14
bald_butte,1,13,10,59,1590897600,1600228800,14
CringeLover69420,1,13,0,185,1591675200,1605157200,14
wanderingbubble,2,12,440,100,1558756800,1571457600,14
tonyespera,1,13,49,26,1582866000,1583125200,14
AngerMAkesmeHAppyHA,5,9,158,216,1567915200,1578805200,14
GleefulAccreditation,0,14,0,44,1575694800,1576126800,14
deep_in_smoke,0,14,0,169,1587960000,1604379600,14
Dariex777,0,14,0,205,1574830800,1607490000,14
PikpikTurnip,0,14,0,79,1546923600,1612155600,14
Gordchell,0,14,0,202,1570507200,1593230400,14
flatline4life,0,14,0,222,1598241600,1605675600,14
Lojak_Yrqbam,0,14,0,156,1561780800,1573016400,14
apocalypse314,2,12,907,121,1578632400,1596427200,14
beartankguy,0,14,0,123,1537588800,1575781200,14
nocatsnomasters,1,13,58,68,1608786000,1610946000,14
TheGamingDividend,1,13,43,194,1594699200,1608440400,14
Marishii,0,14,0,194,1603684800,1612069200,14
practicallyblue,0,14,0,76,1560657600,1562731200,14
Corm,0,14,0,85,1598068800,1611896400,14
Bell-01,0,14,0,151,1600315200,1606885200,14
GrouchyIncident1,0,14,0,7,1587355200,1587441600,14
cosmogli,0,14,0,168,1584417600,1603252800,14
3l_Chup4c4br4,0,14,0,235,1568088000,1607403600,14
The_SHUN,0,14,0,31,1597204800,1606194000,14
xyzxyz8888,0,14,0,52,1569211200,1572321600,14
DiMadHatter,4,10,2379,489,1572062400,1581397200,14
SirEarlBigtitsXXVII,0,14,0,48,1559275200,1562299200,14
Caspersouleater,0,14,0,103,1581051600,1590206400,14
Elvinmay,1,13,128,219,1570248000,1597377600,14
ep1cnom1cs,0,14,0,-79,1552708800,1552881600,14
insensitiveTwot,0,14,0,42,1576040400,1605762000,14
validestusername,3,11,207,43,1567742400,1592107200,14
festeringswine,0,14,0,162,1605934800,1606885200,14
BackendofForever,1,13,144,119,1547528400,1608267600,14
fofonai,1,13,56,106,1554523200,1561694400,14
Felineghostsex,0,14,0,134,1600142400,1607922000,14
healthyconscience,0,14,0,97,1579582800,1580187600,14
mighty-chor,0,14,0,-37,1606280400,1608526800,14
ixikei,1,13,239,166,1597291200,1607662800,14
DTFChiChis,4,10,1645,78,1593144000,1608872400,14
ghytghytghytiinbv,0,14,0,77,1564027200,1609390800,14
savageblunder,0,14,0,13,1607490000,1607576400,14
ovelhaloira,2,12,68,88,1571457600,1593921600,14
GMN123,0,14,0,78,1576558800,1578978000,14
just_here_4_dogelore,1,13,171,29,1605762000,1607576400,14
shakethenuttree_2,0,14,0,-29,1605589200,1605675600,14
NamelesShadow,0,14,0,31,1577941200,1584849600,14
DepersonalizingCow,3,11,329,75,1576731600,1583211600,14
PimemtoCheese,0,14,0,241,1579928400,1609304400,14
pak-da-kid,1,13,0,29,1573189200,1588132800,14
QWieke,0,14,0,284,1560052800,1584590400,14
itsalwaysrainingx,0,14,0,74,1566705600,1579323600,14
TheBoredDeviant,0,14,0,1,1550638800,1550725200,14
liberatecville,0,14,0,-42,1579150800,1579496400,14
RTNoftheMackell,0,14,0,14,1567742400,1584763200,14
BarBarBar22,0,14,0,91,1609218000,1612069200,14
ISNT_A_ROBOT,0,14,0,141,1584590400,1599969600,14
4GN05705,0,14,0,38,1573275600,1597982400,14
WhyMe8675309,0,14,0,57,1595131200,1600574400,14
SingingWhileCrying,1,13,10,24,1585972800,1588046400,14
gnarology,0,14,0,42,1572667200,1595908800,14
Yebi,0,14,0,10,1590984000,1608699600,14
Takinobu,0,14,0,88,1570075200,1571803200,14
CatBitchFatBitch,0,14,0,361,1602734400,1604379600,14
Boiled_Cabbage_babie,2,12,93,32,1592107200,1606885200,14
painted-comrade,3,11,119,233,1581570000,1606626000,14
appandemonium,0,14,0,333,1600228800,1608094800,14
o00gourou00o,0,14,0,93,1575435600,1612155600,14
balr,0,14,0,-79,1552536000,1589256000,14
The3rdGodKing,0,14,0,15,1580360400,1580965200,14
Whatfoord,7,7,155,35,1608872400,1609304400,14
toastofxmaspast,0,14,0,109,1603339200,1604811600,14
PupperLoverDude,0,14,0,18,1570852800,1607144400,14
fishdonthavefeeling,0,14,0,120,1574744400,1606626000,14
Miss_pechorat,0,14,0,81,1601956800,1611982800,14
SuperGlideViking,0,14,0,40,1578459600,1590984000,14
boliby94,0,14,0,107,1539835200,1541394000,14
Iorith,0,14,0,-10,1561176000,1569211200,14
poskantorg,0,14,0,17,1593057600,1606021200,14
koki_li,0,14,0,143,1590724800,1605589200,14
Cookieflavwaffle,2,12,139,96,1569470400,1601092800,14
MichaelPeters4321,1,13,25,209,1594785600,1602302400,14
babarlab21,0,14,0,14,1596859200,1598500800,14
VioletChachkiAsshole,1,13,24,151,1549602000,1563163200,14
Lola_Miiiko,0,14,0,167,1563854400,1572148800,14
nexusoflife,1,13,42,43,1558584000,1599105600,14
LeakyPeenus,1,13,0,-6,1608699600,1608699600,14
Evil_Bananas,0,14,0,5,1589083200,1598414400,14
RubyFan727,2,12,24,197,1573707600,1606107600,14
Madisenpai-522,0,14,0,129,1576126800,1590552000,14
bakertaylor88,4,10,383,84,1552622400,1602043200,14
Junk_Goat,0,14,0,-61,1559793600,1559880000,14
Justkiddingimnotkid,0,14,0,101,1538712000,1608958800,14
TheMightyKamina5,0,14,0,126,1543208400,1560484800,14
CzarChasm23,0,14,0,209,1554523200,1565668800,14
JonaSaxify,0,14,0,86,1605243600,1608440400,14
El_Buga,1,13,30,50,1560312000,1560657600,14
lingeringwill2,0,14,0,60,1599105600,1611896400,14
literallyhatereddit,1,13,13,50,1590379200,1594612800,14
BrashMonkey8,2,12,32,19,1592539200,1593230400,14
MENoir,0,14,0,-15,1588910400,1588996800,14
PhilsMeatHammer,0,14,0,377,1559275200,1583298000,14
unclejakery,0,14,0,187,1575867600,1601870400,14
taklamaknX,3,11,489,434,1601870400,1608699600,14
runnerkenny,0,14,0,297,1565668800,1605416400,14
Hinastorm,0,14,0,31,1580101200,1604379600,14
SF1NX_CZ,0,14,0,208,1591588800,1609045200,14
alysurr,0,14,0,115,1569211200,1594353600,14
BrightestofLights,0,14,0,203,1582606800,1602388800,14
jonsnow312,1,13,6,60,1540353600,1608354000,14
anon0110110101,0,14,0,-50,1583470800,1601265600,14
Epsilon_Meletis,0,14,0,126,1581483600,1611896400,14
wearingsox,5,9,182,142,1549083600,1581915600,14
kamarkamakerworks,2,12,214,38,1595995200,1612155600,14
40ozSmasher,0,14,0,354,1594785600,1604030400,14
jhertz14,0,14,0,103,1543208400,1606971600,14
OgunX,0,14,0,81,1598068800,1608181200,14
FFFUARK,0,13,0,11,1580274000,1580274000,13
-abigail,1,12,389,354,1560398400,1608699600,13
Dreadweave,0,13,0,148,1563854400,1569124800,13
crispknight1,0,13,0,238,1592798400,1609304400,13
narcolonarcolo,0,13,0,135,1573621200,1609045200,13
klynnf86,0,13,0,147,1581310800,1596340800,13
bobandack,0,13,0,75,1569297600,1605934800,13
Balls-over-dick-man-,0,13,0,539,1588996800,1609390800,13
Eugregoria,0,13,0,39,1582002000,1588910400,13
Pizza_Party13,0,13,0,212,1604293200,1611896400,13
mlc4202,1,12,66,205,1599796800,1607922000,13
Gotham-City,0,13,0,365,1563336000,1599192000,13
Mircone,0,13,0,157,1589515200,1608526800,13
KaiserWilhelmDaThird,0,13,0,274,1538452800,1601006400,13
Ahefp,0,13,0,47,1577422800,1608872400,13
SerenelyKo,1,12,57,56,1592625600,1606453200,13
Wiggy_Bop,0,13,0,138,1568001600,1569729600,13
Beefurz,0,13,0,42,1607922000,1608526800,13
MoviesInFrench,0,13,0,93,1569038400,1592712000,13
Thinkingofm,0,13,0,133,1574744400,1604293200,13
EvolutionaryChurch,0,13,0,172,1560139200,1600488000,13
spiker311,0,13,0,195,1605762000,1609131600,13
Vollnoppe,0,13,0,142,1577941200,1590724800,13
Calibear056,1,12,30,256,1570593600,1578373200,13
Forbidden_Froot,0,13,0,182,1605934800,1609304400,13
Last_Snowbender,0,13,0,50,1605934800,1607230800,13
deadlydimples25,0,13,0,54,1608699600,1608786000,13
harrysplinkett,0,13,0,348,1583125200,1606712400,13
inndbeastftw,1,12,20,-11,1605675600,1606798800,13
ArdyAy_DC,0,13,0,-17,1559102400,1560225600,13
throwawayto1992,1,12,114,168,1608872400,1609390800,13
PussyTermin4tor1337,0,13,0,95,1573621200,1577682000,13
Maxfjord,0,13,0,23,1579237200,1601611200,13
ananaSUPREME,0,13,0,108,1604725200,1608440400,13
24isthehighestnumba,0,13,0,-53,1605934800,1606885200,13
Un_Pta,0,13,0,-12,1605070800,1606626000,13
DDS_Deadlift,0,13,0,12,1593403200,1594699200,13
Doyle524,0,13,0,120,1596340800,1606280400,13
master2080,0,13,0,133,1549170000,1595390400,13
Steele-Spartan32,2,11,193,49,1570420800,1579755600,13
Caped_Crusader89,0,13,0,-109,1577422800,1579410000,13
phr3k,0,13,0,75,1567569600,1587268800,13
Wise-Site7994,0,13,0,166,1602820800,1603080000,13
radaghasp,2,11,142,29,1555214400,1570939200,13
99CentOrchid,0,13,0,199,1566532800,1583298000,13
Xx420noskwopexX,2,11,217,75,1564459200,1592366400,13
9BigDicks,0,13,0,135,1603425600,1611810000,13
princesspeachpallet,1,12,260,46,1584331200,1608267600,13
khandnalie,0,13,0,135,1550638800,1596859200,13
Y0ungOne,1,12,10,66,1580101200,1607662800,13
Serious_Fly,2,11,1,-29,1586750400,1587096000,13
ItThatisnt,0,13,0,80,1585886400,1607576400,13
_ShrekOurLord_,0,13,0,29,1607662800,1608786000,13
Glokmar,0,13,0,57,1585454400,1606885200,13
OhNoImOnline,1,12,276,113,1573880400,1608613200,13
imaginexcellence,0,13,0,531,1593662400,1606194000,13
Snow0v0,3,10,91,40,1548738000,1553918400,13
deltamike556,0,13,0,58,1599537600,1609390800,13
RainOfPain125,11,2,3825,5,1555992000,1576126800,13
da_original_dankster,0,13,0,-4,1572062400,1572580800,13
WalfAkaiTsuki,0,13,0,245,1600574400,1605675600,13
Matty_Poppinz,0,13,0,44,1593057600,1608440400,13
prequel_tothe_sequel,0,13,0,350,1587787200,1603425600,13
anonyminator,5,8,71,11,1583298000,1604030400,13
ButAFlower,0,13,0,210,1595044800,1607662800,13
Nafemp,0,13,0,15,1607662800,1607662800,13
Phototoxin,0,13,0,140,1543467600,1606539600,13
NewUserF0kU2,0,13,0,111,1587009600,1606280400,13
vgkosmoes,3,10,11478,79,1578373200,1608267600,13
qwertyhuio,0,13,0,-31,1597723200,1611896400,13
caramelcooler,0,13,0,120,1576386000,1603598400,13
AnimeFanOnPromNight,3,10,143,126,1575262800,1611896400,13
Bad_MoonRising,0,13,0,441,1525233600,1556424000,13
nihilishim,0,13,0,47,1551330000,1603857600,13
MennMonster,3,10,122,21,1575694800,1582520400,13
LittleBigMidget,2,11,4,2,1561521600,1561694400,13
AcryllicSkin,0,13,0,19,1569124800,1569470400,13
Jicle123,3,10,145,50,1573707600,1577854800,13
McFinder,1,12,71,100,1570334400,1593921600,13
astroroy,0,13,0,269,1606626000,1608958800,13
LucienDark,2,11,272,55,1573966800,1578546000,13
TrueGrey,0,13,0,24,1578200400,1592798400,13
tankyboi447,0,13,0,22,1602302400,1606194000,13
Koala_eiO,0,13,0,61,1569643200,1611637200,13
fartingwiffvengeance,0,13,0,153,1575176400,1605675600,13
RiskAdversity,0,13,0,-20,1594526400,1594785600,13
TheCiervo,0,13,0,350,1574312400,1591502400,13
Neebay,0,13,0,250,1561089600,1605675600,13
ShivasKratom3,0,13,0,85,1587182400,1600574400,13
stellte,0,13,0,49,1574053200,1607317200,13
UnusualIntroduction0,0,13,0,122,1586836800,1612069200,13
switchlessdynamo,0,13,0,36,1588564800,1602648000,13
Not_A_Wendigo,0,13,0,172,1570939200,1608526800,13
Shark_Girl_Jazzy,0,13,0,233,1579150800,1608872400,13
Nowthatisfresh,0,13,0,346,1568520000,1611810000,13
just_reading_1,1,12,1182,161,1588132800,1600142400,13
MysteriousFlowChart,0,13,0,223,1604898000,1612069200,13
SnakeMcbain,1,12,37,58,1570766400,1602129600,13
PeterGreen27,1,12,560,180,1582261200,1609390800,13
Phobia_Ahri,0,13,0,37,1607749200,1607835600,13
Splashlight2,2,11,2,16,1582088400,1597636800,13
SatokoHoujou,0,13,0,94,1558238400,1561694400,13
faireducash,0,13,0,98,1603339200,1607144400,13
iraqlobsta,1,12,78,112,1548392400,1583643600,13
Shifu_Chan_,2,11,65,51,1598155200,1598414400,13
evanatyourservice,0,13,0,171,1585368000,1604203200,13
mjp141r,0,13,0,106,1578286800,1581570000,13
banammockHana,0,13,0,186,1561176000,1597636800,13
waterdrop135,1,12,9,43,1562904000,1590552000,13
SnooLemons7885,1,12,17,73,1597032000,1600488000,13
dad_rug,2,11,74,96,1561435200,1564372800,13
GlaerOfHatred,0,13,0,53,1572843600,1598760000,13
MonsieurBonaparte,0,13,0,132,1570593600,1598155200,13
cough_e,0,13,0,-20,1592280000,1607576400,13
Masterweedo,0,13,0,123,1573621200,1607835600,13
HungryBleeno,0,13,0,370,1607922000,1609218000,13
The_Pimp_Arcana,4,9,323,40,1556510400,1569038400,13
ValtronW,0,13,0,118,1569384000,1601352000,13
bientaille,0,13,0,109,1592971200,1598068800,13
maudde00,2,11,171,105,1581570000,1607144400,13
el-cuko,0,13,0,211,1599969600,1612069200,13
MeIsJustAnApe,0,13,0,51,1582606800,1593316800,13
VegetableEar,1,12,20,106,1592280000,1597204800,13
FuckYourPoachedEggs,0,13,0,196,1574917200,1606539600,13
NeedYourTV,0,13,0,89,1551675600,1562299200,13
EatsWithoutTables,0,13,0,256,1581915600,1598414400,13
mo_weasel,2,11,66,53,1590552000,1605502800,13
Sawbones90,8,5,284,115,1529553600,1596859200,13
French_Fried_Taterz,0,13,0,-24,1567742400,1570075200,13
reagan2024,0,13,0,-18,1606626000,1606626000,13
imaginary_raccoon,0,13,0,143,1559275200,1607835600,13
Bunny_tornado,0,13,0,202,1608181200,1608786000,13
Sororita,0,13,0,128,1562126400,1593662400,13
tutelhoten,0,13,0,322,1575867600,1603684800,13
HitMeWithUrBestThot,0,13,0,-82,1589342400,1589428800,13
LapisRS,0,13,0,6,1606021200,1608786000,13
Cropitekus,12,1,658,1,1564891200,1608181200,13
DancingChromosome,0,13,0,134,1573448400,1576126800,13
fullyvictorious,2,11,100,86,1569124800,1573534800,13
sself161,0,13,0,-28,1563336000,1563508800,13
GiveMeINeed,0,13,0,80,1599192000,1612069200,13
Serkaugh,0,13,0,22,1600660800,1602820800,13
LegendaryPrimate,0,13,0,116,1572494400,1594699200,13
WaitingForWormwood,0,13,0,84,1576472400,1583557200,13
salemtheblackcat,0,13,0,223,1555905600,1605934800,13
clamandcat,0,13,0,36,1581915600,1582261200,13
anxietyhub,6,7,1931,26,1600920000,1605502800,13
lieutennant_chipmunk,0,13,0,251,1566964800,1600833600,13
farkner,2,11,360,61,1536379200,1593316800,13
N0thingtosee,2,11,90,31,1518066000,1603080000,13
_befree_,0,13,0,-22,1563076800,1587528000,13
sadtimes21,0,13,0,244,1606885200,1607490000,13
archfapper,0,13,0,133,1598414400,1608008400,13
Abra1878,0,13,0,79,1595390400,1601438400,13
ratjuice666,0,13,0,180,1601438400,1611896400,13
DazedDoom,1,12,58,122,1559793600,1588046400,13
kayb1987,0,13,0,105,1552021200,1601870400,13
mysticpolka,0,13,0,27,1600574400,1608699600,13
weirdobot,0,13,0,44,1575090000,1606280400,13
4x4play,0,13,0,174,1591243200,1607835600,13
season8branisusless,0,13,0,188,1566878400,1580965200,13
loklanc,0,13,0,117,1555041600,1603339200,13
introverted_cyclist,0,13,0,190,1607317200,1608526800,13
ru55ianb0t,0,13,0,-20,1556596800,1568692800,13
boohole,0,13,0,47,1555992000,1563768000,13
Dongalor,0,13,0,199,1575781200,1606021200,13
clcs295,0,13,0,819,1580533200,1607835600,13
Exotemporal,0,13,0,148,1549342800,1604293200,13
short-cosmonaut,0,13,0,161,1608440400,1612155600,13
volkvulture,0,13,0,13,1573794000,1574053200,13
l0net1c,0,13,0,28,1590724800,1599451200,13
2-year-old-edgelord,0,13,0,263,1594612800,1606539600,13
m_rockhurler,1,12,214,531,1564891200,1582261200,13
daddy1c3,1,12,24,303,1576990800,1597809600,13
Downiki,1,12,15,88,1595476800,1602648000,13
BeatsMonster23,0,13,0,76,1556769600,1605934800,13
cargobikes,0,13,0,92,1575176400,1578200400,13
QueBelleEpok,5,8,71,56,1558065600,1606453200,13
Herr_Zimmermann,1,12,96,80,1573621200,1577768400,13
meergranenminderpopo,1,12,737,168,1603425600,1609390800,13
Obviously_mysterious,1,12,19,65,1585195200,1587441600,13
Soerinth,0,13,0,59,1573102800,1605675600,13
Remaining-upbeat,0,13,0,47,1595908800,1609304400,13
ComradeZ42,0,13,0,92,1575694800,1588996800,13
tkneil131,1,12,5,54,1595995200,1610773200,13
jackatman,0,13,0,1581,1560571200,1607403600,13
vegancrossfiter,0,13,0,-20,1559793600,1562990400,13
officerbread,0,13,0,160,1595908800,1607144400,13
OpalEpal,0,13,0,47,1561262400,1604984400,13
Whisperingsoup,0,13,0,79,1589601600,1611982800,13
northboundcentreriot,0,13,0,577,1597118400,1608008400,13
pireninjacolass,1,12,38,103,1604203200,1607576400,13
zedislongdead,0,13,0,129,1597118400,1609390800,13
rjrgjj,1,12,81,52,1601870400,1604203200,13
BarneyBodie,2,11,128,56,1563854400,1587268800,13
mcndjxlefnd,0,13,0,52,1592020800,1595822400,13
Luigi-Vercotti,0,13,0,16,1588910400,1606626000,13
incorporatedFiefdom,1,12,14,68,1546491600,1598673600,13
FierceBun,1,12,103,70,1600056000,1601265600,13
EsotericAccents,0,13,0,64,1575435600,1589947200,13
-Hanazuki-,0,13,0,228,1566792000,1603598400,13
MarioVanPebbles,1,12,153,426,1573534800,1605070800,13
drteeth12,1,12,5,76,1567396800,1567742400,13
FilliamHMuffmanJr,0,13,0,-77,1589601600,1589601600,13
dystopianrealism,0,13,0,64,1585800000,1588132800,13
Soltang,0,13,0,71,1594094400,1600315200,13
kittykatinabag,1,12,88,64,1605157200,1608267600,13
Ok-Still-7834,0,13,0,-19,1606626000,1606798800,13
pandakoo,0,13,0,115,1547442000,1582088400,13
gzingher,0,13,0,73,1572843600,1575090000,13
26dlsinmyhand,1,12,28,126,1570248000,1589428800,13
greenflame239,0,13,0,23,1595649600,1601697600,13
secretbudgie,0,13,0,187,1562040000,1607317200,13
EccentricRants,3,10,71,230,1570334400,1612155600,13
InvisibleRegrets,0,13,0,37,1539921600,1540267200,13
namenotrick,0,13,0,36,1596859200,1606971600,13
yresimdemus,0,13,0,18,1604811600,1604984400,13
gmml4,0,13,0,105,1544763600,1584504000,13
CupcakePotato,0,13,0,19,1594440000,1599105600,13
kethera__,0,13,0,103,1587268800,1612069200,13
Monk_of_Tranquility,0,13,0,52,1579928400,1611896400,13
Zero1030,0,13,0,866,1592193600,1608354000,13
Metal_Charizard,0,13,0,-44,1550293200,1564632000,13
sacredblasphemies,0,13,0,153,1478754000,1558584000,13
duskcourt,0,13,0,31,1599883200,1608526800,13
megatog615,0,13,0,242,1546405200,1606798800,13
CI_dystopian,0,13,0,146,1561867200,1605157200,13
Anindefensiblefart,0,13,0,286,1558497600,1579928400,13
standard_vegetable,0,13,0,183,1556424000,1606798800,13
Revealingstorm,0,13,0,201,1548738000,1604379600,13
Tinidril,0,13,0,152,1576558800,1600228800,13
butchheart,2,11,29,85,1581656400,1602648000,13
BuyNanoYaDingus,0,13,0,43,1592539200,1595563200,13
anotherdamnloser,1,12,4231,67,1608267600,1609390800,13
trettles,1,12,32,207,1571284800,1586232000,13
nromanenko,0,13,0,65,1603598400,1609045200,13
Minimumtyp,0,13,0,71,1579150800,1595131200,13
DerpDogDevices,0,13,0,64,1603252800,1609390800,13
sami_shakur,0,13,0,102,1567569600,1605157200,13
ChromeQuixote,1,12,6,0,1582434000,1610082000,13
GavyGavs,0,13,0,125,1572753600,1572753600,13
SPAMRAAM_,0,13,0,29,1589601600,1600228800,13
Quirmer,0,13,0,61,1600747200,1603425600,13
Kwasan,0,13,0,131,1592625600,1611982800,13
Johnnyjazz92,1,12,87,22,1599105600,1599278400,13
Staktus23,0,13,0,355,1596427200,1606971600,13
Gnolldemort,0,13,0,374,1596600000,1598414400,13
obscurereference234,0,13,0,344,1587009600,1606453200,13
tsujxd,2,11,237,428,1590379200,1609390800,13
g_squidman,0,13,0,36,1576386000,1611982800,13
daddy_mark,0,13,0,214,1579323600,1607576400,13
HoldMyDeere,0,13,0,-15,1581570000,1581742800,13
Kipper246,0,13,0,372,1562990400,1601352000,13
Ericaohh,1,12,495,252,1580533200,1602043200,13
DaMan123456,1,12,6,18,1587614400,1609390800,13
MostBoringStan,0,13,0,108,1579755600,1598932800,13
jakalan7,1,12,79,93,1579755600,1591156800,13
Echospite,0,13,0,267,1599537600,1612069200,13
Mikerells,0,13,0,23,1608267600,1608267600,13
Tooplex,2,11,242,164,1581656400,1597896000,13
--llll-----llll--,0,13,0,147,1574744400,1597377600,13
stormacolyte,0,13,0,28,1596513600,1608181200,13
JucyLemon,0,13,0,161,1561435200,1574398800,13
Bacon_Kitteh9001,0,13,0,-31,1569816000,1572062400,13
greensweet,0,13,0,92,1549861200,1563940800,13
-cordyceps,1,12,14,429,1591848000,1605934800,13
Grandclosing,0,13,0,373,1601956800,1608267600,13
maafna,0,13,0,64,1572580800,1608354000,13
Trampboymichael,2,11,3131,105,1557374400,1609477200,13
berrycat14,0,13,0,249,1585886400,1607317200,13
prof_vannostrand,1,12,64,130,1602129600,1608699600,13
HouseHolder87,0,13,0,19,1596859200,1600747200,13
SecretSurvivalHank,1,12,24,198,1550984400,1571889600,13
Seemseasy,0,13,0,150,1555128000,1575262800,13
jacobmob,0,13,0,47,1589256000,1589256000,13
captainmo017,0,13,0,164,1555732800,1599969600,13
Spoderman4,0,13,0,5,1540094400,1541998800,13
ImDownWithJohnBrown,0,13,0,381,1570075200,1594008000,13
ladyyninjaa,4,9,82,51,1598328000,1611810000,13
LosVangelis,0,13,0,-54,1587960000,1589428800,13
AnyFox6,0,13,0,202,1592798400,1606626000,13
LimeWarrior,2,11,559,101,1583384400,1603512000,13
thro_a_wey,0,13,0,24,1595995200,1597550400,13
throwaway2073z,0,13,0,-30,1546405200,1550379600,13
GrUnReVel,0,13,0,134,1595908800,1596513600,13
BastetWilton,3,10,8,41,1571716800,1581224400,13
originalname104,0,13,0,311,1587096000,1606021200,13
wateryoudoinglmao,0,13,0,393,1560139200,1567656000,13
Zebezd,0,13,0,153,1580101200,1606971600,13
panic_bread,0,13,0,147,1557892800,1604203200,13
Formerevangelical,0,13,0,73,1607835600,1611810000,13
OverthrowDissent,0,13,0,9,1552363200,1576040400,13
cykosys,0,13,0,115,1549256400,1595563200,13
fitness_gerber,0,13,0,-206,1579410000,1580878800,13
ephemeral__forest,4,9,5434,75,1599710400,1601438400,13
dirty9white5boy,0,13,0,45,1601524800,1609477200,13
GrandWolf319,0,13,0,38,1596600000,1606971600,13
lettercarrier86,0,13,0,235,1599796800,1609390800,13
JohnTDouche,0,13,0,94,1558670400,1607576400,13
voteforcorruptobot,0,13,0,237,1600228800,1612069200,13
Neottika,0,13,0,196,1594785600,1612069200,13
Deweydog1234,0,13,0,330,1594785600,1609045200,13
anonymousthrowra,0,13,0,-187,1589342400,1589774400,13
Mrmistermeekz,0,13,0,13,1593230400,1593489600,13
CortezEspartaco2,0,13,0,161,1549342800,1583899200,13
rustoo,11,2,288,5,1597636800,1607835600,13
puterelle,0,13,0,165,1564459200,1600056000,13
lilac__dreams,0,13,0,66,1579410000,1583643600,13
EddoB93,0,13,0,19,1574139600,1585627200,13
proboardslolv5,1,12,44,-25,1589860800,1593403200,13
Snaykerino,0,13,0,-59,1579064400,1606539600,13
Maverick822,0,13,0,203,1560139200,1603425600,13
DontFuckWithThisSite,1,12,75,190,1603166400,1604293200,13
Wooden_Chef,0,13,0,81,1562731200,1598673600,13
GalacticENTpire,0,13,0,86,1565668800,1598155200,13
ecole84,1,12,27,43,1578114000,1595217600,13
BodkinVanHorne,0,13,0,58,1560312000,1595649600,13
DarkReign2011,0,13,0,116,1599537600,1608958800,13
lovelychef87,0,13,0,46,1568260800,1598068800,13
Informal_Drawing,0,13,0,598,1576731600,1608354000,13
OkinawaParty,1,12,153,-122,1577077200,1600488000,13
deck_hand,0,13,0,149,1557115200,1601092800,13
Sunshineflowerstrees,0,13,0,69,1596081600,1608786000,13
mothermedusa,0,13,0,73,1564372800,1585454400,13
BillyJoel9000,0,13,0,65,1557892800,1587009600,13
henry_david_throwed,1,12,104,92,1557201600,1603598400,13
beefstewforyou,0,13,0,409,1580014800,1608786000,13
Comicalacimoc,0,13,0,55,1574398800,1597464000,13
AbigailofDarkness,1,12,82,345,1581224400,1608181200,13
FieryPhoenix56,0,13,0,313,1573621200,1594958400,13
bellj1210,0,13,0,43,1597723200,1608699600,13
jj1917,1,12,81,58,1572235200,1587355200,13
greasefire,0,13,0,203,1556683200,1573621200,13
makeoneup176,1,12,271,130,1600056000,1602561600,13
Glowing_bubba,1,12,55,105,1593662400,1607058000,13
Gummie32,0,13,0,105,1584590400,1602129600,13
baconeater94,2,11,152,47,1579064400,1606626000,13
Jeffro14,0,13,0,168,1554955200,1598587200,13
M0dusPwnens,0,13,0,218,1560052800,1597896000,13
WunWegWunDarWun_,0,13,0,57,1579410000,1579496400,13
s0nicfreak,0,13,0,55,1586836800,1609131600,13
Zerp242,1,12,20,51,1597982400,1608699600,13
VultureCat337,0,13,0,178,1600660800,1608872400,13
jsawden,0,13,0,19,1548565200,1554696000,13
sharpiebrows,0,13,0,251,1573966800,1601697600,13
BladeDancer190,0,13,0,-137,1597636800,1597723200,13
writeronthemoon,0,13,0,66,1608267600,1609045200,13
QueenOfWands2,0,13,0,116,1594353600,1607576400,13
Seppdizzle,0,13,0,72,1593489600,1595649600,13
Shadefeaster,0,13,0,221,1586145600,1609131600,13
secretsafeaccount,2,11,59,67,1583812800,1591156800,13
HippieCorps,0,13,0,8,1597377600,1609304400,13
Agleimielga,0,13,0,127,1581138000,1585713600,13
Innomen,0,13,0,53,1571803200,1580101200,13
GrimProteusVerum,0,13,0,96,1582088400,1587268800,13
WilhelmWrobel,2,11,3449,88,1565323200,1593662400,13
snertwith2ls,0,13,0,159,1607230800,1608440400,13
Flatcapspaintandglue,0,13,0,193,1587528000,1607490000,13
AllThoseSadSongs,0,13,0,161,1571544000,1603598400,13
SpoliatorX,0,13,0,240,1557720000,1607835600,13
yp_interlocutor,0,13,0,45,1608008400,1609304400,13
NovelTAcct,0,12,0,80,1536897600,1596600000,12
Morro-valemdrs,0,12,0,101,1592452800,1608181200,12
spanishMcflys,2,10,15,22,1580014800,1590206400,12
0xMatt,0,12,0,-78,1598587200,1611637200,12
ThirdWorldIncel,2,10,0,-5,1594872000,1602043200,12
Psychic_Maelstrom,0,12,0,15,1578114000,1588564800,12
Konwayz,1,11,178,534,1591416000,1596600000,12
stanerd,3,9,102,146,1599019200,1607662800,12
midnightmontage,2,10,1011,166,1583470800,1608699600,12
GOP-TV,1,11,16,98,1601352000,1604984400,12
HueyLongdong027,0,12,0,-69,1601438400,1601524800,12
sprogger,1,11,78,221,1578027600,1608181200,12
Creeemi,2,10,97,251,1580446800,1601092800,12
Sasse4Grass,0,12,0,255,1560744000,1561694400,12
lava_lamp69,0,12,0,43,1598241600,1598500800,12
SubjectsNotObjects,0,12,0,527,1553054400,1592971200,12
CriticalEscapeBike,0,12,0,14,1591329600,1612069200,12
pineapplequeenzzzzz,0,12,0,98,1607230800,1609477200,12
Ephidiel,0,12,0,178,1593748800,1608613200,12
Alex_0606,0,12,0,92,1590811200,1607403600,12
DoctorWaluigiTime,0,12,0,17,1584244800,1598846400,12
Deastrumquodvicis,0,12,0,90,1573534800,1605934800,12
Buhdumtssss,2,10,125,59,1603944000,1607317200,12
Midwest_Deadbeat,0,12,0,168,1574312400,1579928400,12
ithinkicaretoo,0,12,0,41,1580446800,1608354000,12
MagicAte_8,0,12,0,139,1577163600,1587441600,12
thatsuzychick,1,11,16,100,1548046800,1575522000,12
brbkillingyou,1,11,64,220,1571803200,1583298000,12
chromosome21_,7,5,5155,91,1597377600,1602475200,12
PleasePleaseHer,1,11,25,59,1552795200,1590033600,12
eppydeservedbetter,1,11,23,195,1597809600,1609304400,12
SargentScrub,0,12,0,114,1569211200,1599192000,12
Jecktor,0,12,0,41,1599019200,1599019200,12
thebeardlywoodsman,0,12,0,292,1569988800,1606885200,12
DxrthRevxn,1,11,348,89,1587700800,1606798800,12
runnriver,0,12,0,39,1588737600,1593230400,12
AmericanMurderLog,0,12,0,-41,1597636800,1609218000,12
throawaydeathlol,2,10,106,57,1598155200,1598414400,12
benadrylpill,0,12,0,578,1600574400,1608267600,12
vedad_grozdanic,4,8,67,27,1568865600,1582088400,12
BoBab,0,12,0,39,1598414400,1605243600,12
StackingRealCheddar,1,11,22,71,1587614400,1588046400,12
Catjack,3,9,143,225,1552363200,1608526800,12
rambointhedark,11,1,21845,-6,1595563200,1609045200,12
StellarTabi,0,12,0,156,1564372800,1593057600,12
RoastedPony,0,12,0,-120,1571630400,1571630400,12
utbo1,0,12,0,-12,1596340800,1606366800,12
RedMiah,0,12,0,247,1576386000,1607662800,12
darkNergy,0,12,0,213,1570420800,1607922000,12
OSRS-Memes,0,12,0,108,1592625600,1594094400,12
ObjectiveDeal,0,12,0,37,1596081600,1611896400,12
slap_my_hand,0,12,0,57,1590724800,1607403600,12
LKanarienvogel,0,12,0,97,1548306000,1570334400,12
godhatesnormies,0,12,0,83,1569211200,1588132800,12
manoffewwords,0,12,0,122,1560657600,1579410000,12
gim145,0,12,0,191,1560398400,1606194000,12
1k6v9x5m,0,12,0,81,1573102800,1575522000,12
KenAdams1967,0,12,0,150,1573707600,1607749200,12
SocialistPug,0,12,0,288,1579755600,1592366400,12
TRealTStark,1,11,11,12,1603684800,1609477200,12
RealGangstaShit,2,10,0,-29,1585368000,1585368000,12
Dabigbluebass,2,10,10,19,1591416000,1606021200,12
Simplicity775,1,11,29,86,1601524800,1612155600,12
electric_nan,1,11,7,45,1569297600,1595304000,12
A_Hound,0,12,0,247,1573189200,1599796800,12
FellerINC,0,12,0,-33,1602734400,1608613200,12
thefakemexoxo,1,11,3,48,1595390400,1605157200,12
themeanferalsong,0,12,0,114,1555041600,1564632000,12
TheSweatyFlash,1,11,118,246,1593230400,1599364800,12
AlwaysAngron1,0,12,0,307,1584763200,1606539600,12
NordicUpholstery,0,12,0,-28,1575176400,1579755600,12
HonoraryMancunian,0,12,0,84,1593576000,1609131600,12
Nesrynn,0,12,0,37,1600574400,1606453200,12
alexdd88,3,9,61,15,1554955200,1570593600,12
menice4,0,12,0,336,1550293200,1608699600,12
storm_acolyte,2,10,348,79,1608613200,1609477200,12
everythingiswrong_,0,12,0,169,1578286800,1585886400,12
robertabramski,0,12,0,422,1567742400,1589860800,12
_slimpug_,1,11,192,197,1576904400,1576990800,12
turquoiseblues,0,12,0,171,1576299600,1576472400,12
Velcatt,0,12,0,71,1572321600,1577682000,12
becsandbobs,0,12,0,38,1575003600,1580965200,12
cutegoblin,0,12,0,49,1593921600,1602216000,12
slinkimalinki,0,12,0,8,1607403600,1608440400,12
ward2bel,1,11,117,162,1578891600,1578978000,12
Subject1928,0,12,0,614,1574830800,1596081600,12
PMURMEANSOFPRDUCTION,0,12,0,1601,1573707600,1609477200,12
TimX24968B,0,12,0,8,1589083200,1589083200,12
kriegercontainers,0,12,0,-27,1562817600,1607576400,12
bobofartt,0,12,0,205,1559275200,1575090000,12
AGoodDayInTheValley,0,12,0,164,1601006400,1606366800,12
Jojall,0,12,0,174,1579323600,1585540800,12
C477um04,0,12,0,144,1577422800,1612155600,12
elusivefractal,3,9,4453,29,1594612800,1606194000,12
WillIPostAgain,0,12,0,34,1585627200,1607403600,12
lastaaronman,1,11,19,36,1598760000,1599019200,12
Upio,0,12,0,220,1587873600,1596686400,12
DarKnightOfficial,3,9,166,37,1596340800,1598932800,12
SlaughtertheIRON,0,12,0,10,1608526800,1608786000,12
BetterCallSaulSilver,0,12,0,232,1567569600,1580014800,12
nandemonaidattebayo,0,12,0,127,1560312000,1589601600,12
noaydi,2,10,28,27,1512018000,1520658000,12
eggumlaut,0,12,0,64,1602388800,1605762000,12
NV2E582,0,12,0,243,1603339200,1611810000,12
Dubante_Viro,0,12,0,210,1598241600,1608699600,12
CamQTR,0,12,0,79,1508212800,1554609600,12
jonpaladin,2,10,15,84,1556424000,1606021200,12
phillip_wareham,0,12,0,42,1599364800,1600920000,12
FatherBrandex,0,12,0,100,1558670400,1565323200,12
klaustrophobie13,0,12,0,178,1556769600,1608786000,12
ImJewishWhatDo,0,12,0,133,1570507200,1581224400,12
messiestobject,1,11,29,145,1548392400,1580878800,12
big_hungry_joe,0,12,0,338,1580014800,1600574400,12
saphirawater,1,11,32,50,1607490000,1609131600,12
lavendercaina,2,10,36,36,1567569600,1571371200,12
Revolutionary9999,1,11,3,98,1593662400,1607403600,12
GenericlyDynamic,0,12,0,-17,1556424000,1556424000,12
Sensitive-You,0,12,0,2,1585454400,1612155600,12
neither_both,1,11,122,391,1582261200,1584676800,12
BambooSound,0,12,0,-124,1606712400,1606971600,12
Me--Not--I,0,12,0,-15,1580706000,1580792400,12
With_The_Ghosts,0,12,0,80,1594526400,1606280400,12
DoubleReputation2,0,12,0,174,1594872000,1605934800,12
PeachRing23,2,10,34,77,1577941200,1603339200,12
sndtrb89,0,12,0,311,1583470800,1602216000,12
melisaydin,0,12,0,88,1606971600,1607490000,12
Sioclya,0,12,0,46,1585281600,1609045200,12
milkyd4d,1,11,71,140,1596772800,1607576400,12
Ummah_Strong,0,12,0,47,1601956800,1607317200,12
bigbottle8,0,12,0,41,1586750400,1605848400,12
Cardeal,0,12,0,92,1551934800,1601352000,12
LuketheDiggerJr,0,12,0,119,1562040000,1604379600,12
ankensam,0,12,0,264,1577768400,1602820800,12
crazygurl3,1,11,8,76,1597118400,1603512000,12
Karma-On-My-Face,0,12,0,133,1580446800,1589083200,12
Ephemerror,0,12,0,61,1548392400,1558152000,12
Wompguinea,1,11,57,47,1572408000,1603944000,12
deadmangorind,2,10,29,98,1583125200,1612155600,12
GSM_Heathen,0,12,0,97,1577336400,1604984400,12
catmoochie,1,11,54,75,1577595600,1589688000,12
Mexx98,0,12,0,18,1608958800,1612328400,12
leamsi4ever,2,10,18,18,1568174400,1606712400,12
leftcornerofmychair,0,12,0,62,1582002000,1603857600,12
NaturalFuture,0,12,0,30,1544763600,1608267600,12
Randyboob,0,12,0,15,1611982800,1612328400,12
Awkward_Maths,0,12,0,84,1589083200,1594353600,12
nomos97,0,12,0,-2,1600574400,1608786000,12
_pjanic,0,12,0,71,1598414400,1599624000,12
margueritedeville,0,12,0,1215,1601265600,1601438400,12
SurprisinglyCoherent,1,11,614,158,1569816000,1569902400,12
solowolfwarrior,0,12,0,37,1606798800,1608008400,12
Infinite_Layer1386,1,11,7,1,1597118400,1597291200,12
stopbreedingworkers,1,11,4,-30,1560398400,1560657600,12
Love4Beauty,0,12,0,97,1611982800,1612155600,12
cuteshooter,3,9,20,14,1586577600,1597982400,12
dx1012,12,0,54,0,1497412800,1584763200,12
adamd22,0,12,0,92,1510808400,1572148800,12
anotherone65,0,12,0,31,1586318400,1587182400,12
bitchyrussianbot,0,12,0,43,1575954000,1592107200,12
hmmliquorice,0,12,0,340,1566964800,1601438400,12
Accidental_Edge,0,12,0,40,1578978000,1608440400,12
OneConfoundedBridge,0,12,0,42,1605243600,1606712400,12
will2089,0,12,0,393,1602475200,1608008400,12
Bockon,0,12,0,131,1573621200,1608526800,12
cadbojack,0,12,0,394,1571025600,1580101200,12
AntiWorkThrowaway917,4,8,351,67,1583812800,1600660800,12
applesaucehums,0,12,0,483,1583557200,1608872400,12
occupynewparadigm,0,12,0,147,1579064400,1599796800,12
SpookDaddy-,0,12,0,159,1578373200,1595822400,12
jludey,1,11,42,64,1573448400,1575262800,12
throwaway_j3780,0,12,0,729,1599451200,1609304400,12
badgerbob1,0,12,0,153,1558065600,1587355200,12
onlyamiga500,1,11,516,910,1548651600,1604898000,12
AdequateAmoeba,1,11,30,64,1598241600,1608958800,12
Lenins-Gh0st,0,12,0,195,1592712000,1600833600,12
starshappyhunting,0,12,0,159,1557892800,1607835600,12
-LadyMcLeod,1,11,202,90,1566360000,1569384000,12
Smrgling,0,12,0,54,1573362000,1583643600,12
michchar,0,12,0,160,1576386000,1589342400,12
LordHughRAdumbass,3,9,26,13,1581397200,1589774400,12
soy_boy_69,0,12,0,25,1589860800,1590033600,12
Roba1921,1,11,59,34,1605934800,1608354000,12
CrossCountryDreaming,0,12,0,667,1601870400,1620792000,12
Xercen,0,12,0,66,1594267200,1605070800,12
CharlieGoldy,0,12,0,258,1574398800,1602302400,12
Mr_Truttle,0,12,0,-28,1547010000,1547787600,12
fruitjerky,0,12,0,219,1563854400,1607490000,12
TheOnlyTori,1,11,184,65,1585195200,1605589200,12
UmmWaitWut,1,11,23,55,1579064400,1583038800,12
drakekengda,0,12,0,71,1583470800,1612155600,12
quokkafarts,2,10,132,362,1550206800,1592971200,12
Prof_Acorn,0,12,0,101,1586404800,1608181200,12
Ghirahim890,0,12,0,189,1552276800,1594008000,12
pmekonnen,0,12,0,39,1575176400,1588996800,12
AOCCANPEEONME,0,12,0,115,1592971200,1604116800,12
BenRegulus,1,11,39,90,1591502400,1597550400,12
Atomiclincoln,0,12,0,138,1570593600,1604466000,12
lookoutitsrascal,1,11,43,42,1582520400,1586491200,12
Rayne-Spyder,0,12,0,91,1576818000,1580965200,12
rarechievos,0,12,0,156,1561953600,1602734400,12
yummytoastnaruto,0,12,0,92,1579842000,1608440400,12
JDuCalisson,2,10,76,71,1597982400,1609304400,12
ThreadedPommel,0,12,0,215,1563940800,1604030400,12
notautisticjustanass,0,12,0,-278,1567137600,1574658000,12
Bo_Jangles_528,0,12,0,-10,1550293200,1550293200,12
DrakierX,0,12,0,11,1606626000,1606712400,12
Own_Bag,3,9,147,58,1573448400,1577595600,12
WanderingIllusions,3,9,4983,87,1602648000,1608699600,12
cold_moon,1,11,113,59,1589169600,1590033600,12
IAmFern,0,12,0,60,1542344400,1598846400,12
dzyrider,0,12,0,2,1559880000,1562040000,12
fuschiaoctopus,0,12,0,273,1599451200,1607403600,12
apost54,2,10,1079,36,1550293200,1593576000,12
prettyflyforafungi,1,11,344,252,1568174400,1590552000,12
S13Ni,0,12,0,127,1556251200,1639803600,12
castros_machetee,0,12,0,134,1582779600,1588996800,12
satans-sugarbaby,1,11,51,152,1595304000,1599019200,12
blacklightjesus_,0,12,0,87,1582261200,1606798800,12
ElunMoskNotElonMusk,0,12,0,108,1595390400,1605502800,12
rcraver8,0,12,0,130,1591675200,1607749200,12
moroccan_gigolo,0,12,0,502,1583557200,1585627200,12
ThermalFlask,1,11,1005,96,1555387200,1597204800,12
Gorby_Greebo,1,11,77,91,1573189200,1573448400,12
chapstickninja,0,12,0,140,1550466000,1589083200,12
doctajodave,0,12,0,101,1559880000,1581224400,12
bluegirl690,0,12,0,233,1603252800,1611896400,12
justyourbarber,0,12,0,127,1572930000,1609304400,12
OMGClayAikn,1,11,8630,164,1605330000,1607835600,12
super_fold,1,11,9,81,1539921600,1540785600,12
MMTardis,0,12,0,40,1547096400,1583125200,12
translukentt,2,10,36,41,1602043200,1602216000,12
updog6,0,12,0,154,1600056000,1611896400,12
4th_dimensi0n,0,12,0,441,1570075200,1611982800,12
onyxrecon008,0,12,0,119,1546837200,1567051200,12
booster_silver,1,11,101,117,1584849600,1611637200,12
anarhisticka-maca,0,12,0,87,1569988800,1603512000,12
DoctorPrisme,0,12,0,22,1550293200,1550293200,12
SlashStar,0,12,0,81,1587960000,1608094800,12
clocksailor,0,12,0,214,1591675200,1608786000,12
Classic_Extent_1077,1,11,82,67,1611982800,1612069200,12
Saintsman12,4,8,96,42,1594267200,1611982800,12
YMCApoolboy,1,11,12,754,1593662400,1607490000,12
armpitdungeon,0,12,0,48,1585022400,1605848400,12
_linusthecat_,0,12,0,-12,1561953600,1603512000,12
roadstojudah_,0,12,0,63,1558756800,1567569600,12
vilennon,2,10,103,51,1508126400,1557720000,12
The_KMAN,0,12,0,110,1591848000,1608094800,12
BurnKnowsBest,0,12,0,57,1563940800,1563940800,12
Tcryer,3,9,585,97,1580619600,1607662800,12
ExpendableToMe,2,10,762,187,1574485200,1607749200,12
rogercaplin,2,10,26,72,1588046400,1599796800,12
sclsmdsntwrk,0,12,0,0,1606626000,1606626000,12
Icecl,1,11,10,132,1575781200,1595563200,12
pissedanarchist69,0,12,0,326,1570507200,1584244800,12
heckler5000,0,12,0,402,1600401600,1604116800,12
Yungjaykicks,1,11,6,52,1601784000,1608699600,12
artificialnocturnes,0,12,0,22,1595736000,1608699600,12
RoyalB612,1,11,10,34,1548651600,1561867200,12
Eat-the-Poor,0,12,0,96,1585972800,1608958800,12
roperch,2,10,31,87,1600833600,1608094800,12
MaceShiz,0,12,0,474,1568606400,1577941200,12
Mustbhacks,0,12,0,94,1605934800,1611810000,12
rush4you,0,12,0,106,1571112000,1597809600,12
Xata27,1,11,29,461,1539921600,1605934800,12
scruffmgckdrgn,0,12,0,42,1598673600,1606366800,12
G3N5YM,0,12,0,117,1573189200,1600315200,12
deranged_rover,1,11,26,24,1565582400,1604116800,12
it_leaked_out,0,12,0,167,1589947200,1607230800,12
DoNotDominate,0,12,0,199,1578286800,1578459600,12
Tangy200,0,12,0,11,1603857600,1607403600,12
Viiibrations,2,10,11182,135,1597982400,1611810000,12
adfddadl1,0,12,0,141,1582606800,1607576400,12
BlueEyesWhiteShark,4,8,207,42,1550379600,1580014800,12
TAJoy,0,12,0,153,1598155200,1606885200,12
RandomOpponent4,0,12,0,-6,1602216000,1609218000,12
Tytoalba2,0,12,0,105,1595563200,1609218000,12
AdamskiiJ,1,11,11,17,1581656400,1601006400,12
Bleumoon_Selene,0,12,0,112,1579928400,1608181200,12
SebastianHowl,1,11,22,174,1601092800,1608613200,12
ActuallyAnOctopus,0,12,0,215,1568692800,1577941200,12
EssentialLady,0,12,0,107,1605070800,1608267600,12
SpecialCarbine,0,12,0,50,1607403600,1608699600,12
erronioussomething,0,12,0,34,1593835200,1600056000,12
hooleyheck17,2,10,1512,97,1606712400,1608699600,12
TheMellowLion,1,11,144,41,1604116800,1604116800,12
g7x8,1,11,25,152,1544245200,1581829200,12
Ahoyya,0,12,0,97,1567742400,1583038800,12
rezwell,0,12,0,94,1580533200,1604116800,12
Automate_Dogs,0,12,0,53,1548478800,1606453200,12
tdreager,0,12,0,24,1533873600,1586836800,12
GregKannabis,0,12,0,91,1581310800,1611982800,12
SentientPotato2020,0,12,0,90,1551675600,1587614400,12
Oh_Help_Me_Rhonda,1,11,16,49,1557374400,1598241600,12
IlllIlllIlllllI,0,12,0,86,1562990400,1568174400,12
colerobertx,0,12,0,897,1592625600,1593230400,12
Weaselur,0,12,0,12,1609563600,1609736400,12
Madbax22,0,12,0,-33,1587355200,1604725200,12
SourceDestroyer,1,11,46,167,1585368000,1597118400,12
jonathon-parker,0,12,0,32,1598068800,1599105600,12
MerelPerel,0,12,0,11,1598932800,1599105600,12
HD_Thoreau_aweigh,2,10,45,132,1557633600,1573880400,12
PM_ME_UR_PCMR,0,12,0,85,1540008000,1552536000,12
grumbleagrumble,0,12,0,81,1568952000,1607576400,12
trynaimprove8888,3,9,28,39,1584504000,1599192000,12
smithereens78,0,12,0,-7,1588564800,1588651200,12
12crowsinatrenchcoat,0,12,0,94,1570507200,1601956800,12
forgotten_sleeper,0,12,0,130,1589256000,1591502400,12
dahk16,0,12,0,106,1591329600,1594180800,12
baween,0,12,0,229,1584158400,1608181200,12
zipityquick,1,11,162,71,1585368000,1608181200,12
upper_,0,12,0,157,1601956800,1607835600,12
vaulttecboy54,2,10,1147,77,1603598400,1608008400,12
TattoosinTexas,0,12,0,104,1600747200,1609390800,12
weeewoopoo,7,5,187,11,1590206400,1591502400,12
marsrover001,0,12,0,188,1589169600,1609218000,12
Usual_Passion,3,9,101,93,1568174400,1569729600,12
thatdude473,0,12,0,283,1595995200,1608786000,12
Mommy_Lawbringer,0,12,0,366,1603684800,1612069200,12
SlyCoopersButt,1,11,37,51,1595908800,1606626000,12
sealteamricksss,0,12,0,163,1568865600,1609218000,12
loltyp3,1,11,184,119,1597636800,1609390800,12
AcrobaticStatic,0,12,0,82,1593662400,1594872000,12
neonreplica,0,12,0,21,1596945600,1604116800,12
jerdub1993,1,11,0,59,1599019200,1609477200,12
WildHoneyChild,1,11,23,31,1556251200,1564027200,12
detourne,0,12,0,2,1605848400,1611896400,12
Socile,0,12,0,22,1552107600,1554523200,12
CalmProfit,1,11,153,123,1551848400,1603512000,12
SoberCharlieSheen123,0,12,0,98,1589947200,1592107200,12
bondagewithjesus,1,11,47,69,1571544000,1608354000,12
clemkaddidlehopper,0,12,0,87,1576731600,1604116800,12
beckettinga,3,9,115,121,1575867600,1604811600,12
ElbowStrike,0,12,0,140,1591675200,1604811600,12
Vergil1997,8,4,5170,29,1601179200,1605157200,12
yazyazyazyaz,0,12,0,47,1562644800,1612587600,12
AngryBlindSilence,0,12,0,59,1602734400,1606971600,12
VRisNOTdead,0,12,0,45,1601524800,1609477200,12
Less-Winter,0,12,0,-116,1588737600,1598673600,12
Praline1322,0,12,0,-17,1576040400,1601611200,12
prallundfeucht,3,9,47,41,1582779600,1608613200,12
lestack,1,11,5,360,1574398800,1600574400,12
Stevereversed,0,12,0,158,1599105600,1611810000,12
Amandasch44,0,12,0,89,1579237200,1603684800,12
Jaway66,0,12,0,363,1598241600,1605934800,12
YourDailyGinAndTonic,2,10,89,51,1581570000,1612069200,12
Mentalmidgett,0,12,0,145,1602820800,1604725200,12
Some_Username_Here,0,12,0,59,1601265600,1605589200,12
Peenography,0,12,0,-73,1577509200,1580878800,12
OnceInABluMoon,0,12,0,124,1590465600,1599105600,12
AliceInTruth,0,12,0,66,1582520400,1608872400,12
Mr_Wassonwheeler,1,11,8,81,1580101200,1595304000,12
NateHevens,1,11,28,103,1584590400,1592798400,12
fatduck-,0,12,0,106,1572843600,1601438400,12
Midna0092,0,12,0,104,1575781200,1608699600,12
spiderman1216,1,11,25,88,1526356800,1565841600,12
Quajek,3,9,281,90,1575522000,1609218000,12
FaceTatsAreCool,2,10,164,130,1571889600,1608181200,12
27fingermagee,1,11,44,83,1549602000,1571803200,12
cutegraykitten,1,11,14,43,1571716800,1612069200,12
Catsaresuperawesome,0,12,0,70,1602216000,1609477200,12
JinxSphinx,3,9,547,34,1555214400,1602388800,12
svkadm253,0,12,0,112,1606626000,1609218000,12
Capt_Smashnballs,0,12,0,215,1559361600,1607490000,12
dahuoshan,0,12,0,145,1572494400,1589515200,12
SlothsAreCoolGuys,0,12,0,349,1509163200,1558065600,12
_Idmi_,0,12,0,162,1580533200,1601179200,12
MrMrFitzwilliamDarcy,1,11,147,167,1551416400,1578373200,12
Miss_Robot_,0,12,0,35,1572062400,1597636800,12
Sir_Player_One,0,12,0,113,1567137600,1606194000,12
fatty899,6,6,65,21,1596340800,1602993600,12
PM_Me_Garfield_Porn,0,12,0,134,1568606400,1608958800,12
metalocality,0,12,0,-50,1588392000,1598760000,12
KilgoreThunfisch,0,12,0,91,1572321600,1602648000,12
annecrankonright,0,12,0,160,1561780800,1569470400,12
UnhallowedOctober,0,12,0,188,1597550400,1605502800,12
mickymouse105,0,12,0,1,1577077200,1577163600,12
earthlybird,0,12,0,201,1561348800,1602129600,12
AgentArticuno,0,12,0,508,1592625600,1609390800,12
MilkshakeDeCeapa,0,12,0,-31,1597809600,1599105600,12
HanburryiTree,0,12,0,169,1577768400,1609390800,12
cojavim,0,12,0,54,1600056000,1600833600,12
whenhellfreezes,0,12,0,35,1540180800,1561435200,12
Omyfreak,0,12,0,20,1572321600,1607576400,12
8EyedOwl,0,12,0,163,1588478400,1596686400,12
max10201,0,12,0,73,1595131200,1611982800,12
Hu_Designs,0,12,0,47,1583470800,1587009600,12
girls_gone_wireless,2,10,242,680,1602734400,1609131600,12
BryanDuboisGilbert,0,12,0,164,1604293200,1608958800,12
OrneryAstronaut,0,12,0,113,1575349200,1577163600,12
RichieWolk,1,11,60,89,1557633600,1594008000,12
finallyprettyhappy,0,12,0,472,1580360400,1595304000,12
XpertRebel111,0,12,0,33,1573362000,1609390800,12
DiscRot,1,11,14,32,1581656400,1604725200,12
j0oboi,0,12,0,2,1555905600,1571544000,12
damngoodbeerchris,0,12,0,119,1545454800,1609131600,12
JohnnyPotseed,1,11,164,156,1578027600,1602129600,12
MGTOWManofMystery,0,12,0,5,1579237200,1600142400,12
thetimujin,0,12,0,607,1560830400,1596081600,12
Kstardawg,1,11,190,38,1602648000,1606280400,12
bumbletonne,3,9,47,151,1565755200,1594440000,12
montarion,0,12,0,13,1590120000,1606453200,12
leeloosmashlas,1,10,2,76,1596168000,1607144400,11
egamK7oCtR6nZFyZuHTP,0,11,0,50,1579064400,1608958800,11
merrickinradiator,0,11,0,82,1559016000,1568952000,11
Ascendant_Mind_01,0,11,0,33,1541217600,1606107600,11
corpsecabin,1,10,12,102,1571371200,1574053200,11
eyeandtail,0,11,0,51,1575867600,1608699600,11
danieltv11,0,11,0,79,1595217600,1608526800,11
TreeOfKnowledge,0,11,0,172,1569816000,1600574400,11
coffeeshopAU,0,11,0,70,1558843200,1598328000,11
tatiana_the_rose,0,11,0,63,1572580800,1607317200,11
EveryoneDoDaMAGA,0,11,0,-63,1540699200,1541217600,11
heycz,6,5,305,235,1583038800,1585886400,11
exona,0,11,0,57,1575522000,1611982800,11
throwawayaway630192,0,11,0,147,1585022400,1611896400,11
UltraBuffaloGod,0,11,0,-19,1582347600,1607922000,11
dellamatta,2,9,69,52,1574226000,1580014800,11
DalekForeal,0,11,0,36,1598760000,1598846400,11
pearthefruit168,0,11,0,-29,1590638400,1608699600,11
shivvy1234,1,10,56,40,1589083200,1591070400,11
unicorncoleslaw,0,11,0,288,1604984400,1607662800,11
RandomShmamdom,0,11,0,162,1594440000,1608354000,11
greysvnday,1,10,63,133,1574398800,1576386000,11
plesiadapiform,0,11,0,64,1560916800,1606021200,11
bobthefish505,0,11,0,34,1604725200,1611982800,11
Xstream3,0,11,0,522,1569988800,1578200400,11
Subject_Wrap,0,11,0,128,1577422800,1605502800,11
HankCrocodile,0,11,0,18,1581570000,1581570000,11
mrdennis3,0,11,0,90,1568779200,1582606800,11
Theemulators,0,11,0,132,1572667200,1600833600,11
abbajoy,0,11,0,37,1590811200,1592366400,11
Ford456fgfd,10,1,11,1,1585454400,1603598400,11
offib,1,10,19,45,1589515200,1611896400,11
cheesymouth,0,11,0,42,1598328000,1606971600,11
anonymousbunbun,0,11,0,15,1592452800,1592539200,11
zinkydoodle,0,11,0,179,1564113600,1608613200,11
Big808bass,0,11,0,30,1594094400,1600142400,11
NightmanisDeCorenai,0,11,0,154,1562385600,1599105600,11
bumblebe86,3,8,59,41,1591761600,1608354000,11
breadtube-accound,2,9,25,24,1579582800,1587096000,11
snorken123,1,10,31,47,1574571600,1576213200,11
Shizen__,0,11,0,-114,1606971600,1607230800,11
the-sugar-shack,0,11,0,60,1593230400,1604725200,11
SuckMyAssItSmellz,2,9,30,108,1593921600,1594958400,11
OOPGeiger,0,11,0,-125,1590379200,1599624000,11
Rebuta,0,11,0,5,1579496400,1606712400,11
honz_,0,11,0,5,1587873600,1587960000,11
f_alt04,0,11,0,18,1608440400,1609304400,11
P0tat0eater,0,11,0,375,1569729600,1611810000,11
rudedudemood,0,11,0,1,1593921600,1597118400,11
NachoMartin1985,0,11,0,91,1576040400,1608699600,11
Squelchy_The_Squid,0,11,0,68,1572843600,1580706000,11
HoneyBadgerninja,0,11,0,116,1607058000,1608786000,11
SleepworkDie94,0,11,0,83,1570680000,1570766400,11
flait7,0,11,0,111,1579410000,1612155600,11
Eager_Question,0,11,0,316,1570680000,1600056000,11
honeymustrd,0,11,0,81,1592625600,1607835600,11
hushi704,0,11,0,181,1579928400,1605157200,11
TheRealBaseborn,1,10,551,288,1571716800,1600401600,11
memoryserum,0,11,0,403,1559620800,1589342400,11
gucci_gear,0,11,0,72,1605675600,1608526800,11
lAljax,0,11,0,42,1551589200,1574744400,11
PleasantBad,1,10,5,27,1539921600,1561348800,11
cauthonredhand,0,11,0,10,1593748800,1593748800,11
redditor829,0,11,0,9,1597636800,1599278400,11
TheCastro,0,11,0,-7,1578459600,1612069200,11
Phaynel,0,11,0,111,1551934800,1609045200,11
Senior-Breadfruit333,0,11,0,93,1605848400,1606626000,11
VoidDreamer6,2,9,78,44,1584936000,1585800000,11
space_jam,0,11,0,28,1588564800,1593489600,11
Clollin,0,11,0,-44,1608267600,1608613200,11
vectorpower,0,11,0,139,1607403600,1609390800,11
TheManWithNoLegs,2,9,86,60,1573534800,1575435600,11
Howareyoui,0,11,0,6,1606885200,1607144400,11
DabIMON,0,11,0,270,1551848400,1607749200,11
Rtreesaccount420,0,11,0,23,1608786000,1609477200,11
juxtapositionlove,2,9,27,44,1581483600,1581915600,11
GiveMeClarkson,0,11,0,186,1606798800,1609304400,11
moviequote88,0,11,0,132,1581483600,1603512000,11
aliffattah,1,10,2,-23,1567483200,1577422800,11
KatnissXcis,0,11,0,26,1599796800,1610514000,11
Rizizdead,0,11,0,2,1576386000,1583643600,11
Tsobe_RK,0,11,0,21,1572843600,1602216000,11
adamanimates,0,11,0,199,1549602000,1606798800,11
afunkysongaday,0,11,0,138,1598846400,1612155600,11
NoRichard77,0,11,0,195,1597032000,1608699600,11
Scientific_Socialist,0,11,0,44,1586404800,1595649600,11
Odie_Dass,0,11,0,66,1606626000,1609650000,11
girlfriendflavored,0,11,0,116,1561435200,1572667200,11
RedBaron1902,0,11,0,87,1571025600,1588910400,11
korrakas,2,9,136,29,1541304000,1563854400,11
patrickmercierx,9,2,11,1,1590897600,1594353600,11
SmiralePas1907,0,11,0,50,1581051600,1607317200,11
burnthebanks,1,10,14,40,1562472000,1595736000,11
suburban_monk,1,10,10,29,1460433600,1485925200,11
leanfireboy,0,11,0,78,1566532800,1567310400,11
zoolilba,2,9,46,175,1581915600,1611810000,11
Autismo9001,0,11,0,65,1552107600,1562644800,11
Old_boy7,0,11,0,40,1592366400,1608008400,11
GreatScott191,1,10,38,59,1595563200,1611810000,11
FrogAndToadRGay4u,0,11,0,44,1600142400,1602993600,11
alex_supertramp_Oz,3,8,342,74,1597982400,1606021200,11
Can_of_Ubik,0,11,0,109,1543294800,1578805200,11
DowntownPomelo,0,11,0,247,1562299200,1573880400,11
musclemanjim,1,10,20,105,1576126800,1609477200,11
RapeMeToo,0,11,0,-71,1577422800,1592366400,11
mmmmrrrr6789,0,11,0,83,1581915600,1606626000,11
throwawaypassingby01,0,11,0,216,1593835200,1607749200,11
WizardSenpai,0,11,0,100,1540180800,1570334400,11
StoicRopesalesman,1,10,209,48,1598328000,1598587200,11
DolfK,0,11,0,95,1597982400,1608181200,11
kittybikes47,3,8,136,46,1572580800,1583557200,11
dawn913,0,11,0,125,1581570000,1611896400,11
loudhalgren,0,11,0,68,1579150800,1609304400,11
HistoricalAvocado201,1,10,7,31,1602388800,1605330000,11
AngusKirk,0,11,0,64,1571544000,1608526800,11
uhredditaccount,1,10,4,78,1601611200,1603857600,11
MonzellRS,0,11,0,61,1608613200,1612069200,11
cosmoO_O,0,11,0,15,1598673600,1598760000,11
WildCock30,0,11,0,93,1567656000,1574658000,11
refazenda,0,11,0,41,1540612800,1557028800,11
thrattatarsha,0,11,0,60,1571371200,1604984400,11
hamburger666666,0,11,0,317,1576645200,1606021200,11
KuiperBE,1,10,1,62,1560484800,1577595600,11
blankdolli,0,11,0,107,1591416000,1605070800,11
foxcoregrrrl,0,11,0,151,1582434000,1595649600,11
MoneroMoe,1,10,898,567,1575694800,1578978000,11
Chiaramell,1,10,2023,80,1593403200,1595649600,11
WOJ3_PL,0,11,0,-52,1600747200,1606712400,11
dl-lml-lb,0,11,0,223,1576818000,1583211600,11
SoftFarrah,0,11,0,106,1604116800,1605157200,11
ColwynBane,0,11,0,459,1599624000,1608786000,11
ppatches24,0,11,0,20,1578805200,1578805200,11
scrunch27,0,11,0,-104,1586318400,1608613200,11
HarshKLife,0,11,0,117,1564977600,1604116800,11
Jzadek,1,10,63,68,1549342800,1607576400,11
kita_takizawa99,1,10,45,63,1594612800,1607662800,11
BarrySquatter,0,11,0,29,1595736000,1605934800,11
ViolenceForBreakfast,0,11,0,51,1608699600,1609390800,11
mjkevin247,2,9,441,50,1549602000,1553400000,11
tempelton27,0,11,0,26,1602907200,1608699600,11
notyoursweetie,1,10,102,104,1594094400,1594267200,11
Its_OK_2_be_white,0,11,0,12,1603512000,1603598400,11
tobyburger,2,9,931,114,1580101200,1598500800,11
HELM108,1,10,43,23,1569643200,1584676800,11
acid_bear_boy,0,11,0,388,1597636800,1608267600,11
yamchan10,0,11,0,2,1612069200,1612069200,11
PoliticalBullshit,0,11,0,86,1568260800,1603512000,11
TJ_McWeaksauce,0,11,0,168,1583985600,1609045200,11
hotstepperog,0,11,0,79,1573966800,1606539600,11
throwaway420goodgirl,0,11,0,45,1603425600,1603684800,11
Xarathox,0,11,0,95,1579150800,1607144400,11
Lucko4Life,0,11,0,89,1585368000,1602993600,11
Maegaranthelas,0,11,0,191,1584590400,1593748800,11
Nocturne-Owl,0,11,0,51,1597464000,1597636800,11
BeYou422,0,11,0,56,1596254400,1608008400,11
traggot,0,11,0,38,1562040000,1588910400,11
inspiredfaith,2,9,22,2,1597982400,1601524800,11
udjejeksoshwhhsjsb,2,9,5,4,1582261200,1582261200,11
DeaditeMessiah,0,11,0,190,1604116800,1604379600,11
iloveredditing2112,2,9,57,40,1568606400,1612155600,11
Built2Smell,0,11,0,233,1588910400,1597982400,11
34Rovac12,0,11,0,153,1542776400,1608699600,11
MancAngeles69,1,10,138,124,1591416000,1607490000,11
MistressLiliana,0,11,0,202,1567569600,1606021200,11
ExMachina999,1,10,9,0,1596513600,1597377600,11
xknav3x,2,9,365,37,1599883200,1604116800,11
aShyVixen,1,10,157,130,1594612800,1594699200,11
devTripp,0,11,0,192,1551762000,1593057600,11
Lemak0,1,10,10,12,1578286800,1592366400,11
gimmeyourbones,0,11,0,101,1585800000,1607662800,11
treefitty350,0,11,0,49,1585454400,1585540800,11
HolleringCorgis,0,11,0,278,1606798800,1608958800,11
Dreadsin,0,11,0,189,1562472000,1594353600,11
Fletch55,0,11,0,128,1559966400,1589947200,11
insomniacsheep,0,11,0,137,1555905600,1581224400,11
jus_say_it,0,11,0,-18,1603512000,1603684800,11
RoondarFutaSlut,0,11,0,56,1579669200,1602820800,11
atrocity_exhlbition,1,10,1298,234,1564200000,1580274000,11
ilovecraftbeer05,0,11,0,208,1602302400,1609304400,11
jonasbc,0,11,0,119,1604293200,1605762000,11
crisspinne1,1,10,239,178,1604898000,1606107600,11
hotelstationery,1,10,4,35,1585886400,1608181200,11
Inertial_Mass,0,11,0,66,1605157200,1609390800,11
greenSixx,0,11,0,79,1578805200,1604379600,11
the8thbit,1,10,712,129,1549429200,1569038400,11
Darwin42SW,0,11,0,70,1578546000,1603598400,11
natooDidou,0,11,0,42,1581570000,1589860800,11
rickrossorganicpears,0,11,0,395,1565755200,1580965200,11
PaddyFlatz,1,10,0,-29,1585281600,1585368000,11
yey96,1,10,155,380,1600228800,1609131600,11
GreyJackalope,0,11,0,95,1582693200,1587960000,11
YeezyTakeTheWheel,0,11,0,17,1554264000,1561867200,11
CueDramaticMusic,0,11,0,108,1584590400,1599278400,11
radmemethrowaway,0,11,0,65,1560484800,1609131600,11
jcelflo,0,11,0,95,1606453200,1608958800,11
incognitojt00,0,11,0,24,1578373200,1601179200,11
leandersci,1,10,11027,259,1593662400,1609304400,11
Tay0405,0,11,0,-22,1567483200,1587355200,11
drfusterenstein,1,10,4,27,1579410000,1594008000,11
Chris_358,0,11,0,27,1582866000,1603166400,11
flakenomore,0,11,0,154,1603944000,1604984400,11
jessoweny,1,10,21,110,1583038800,1596081600,11
my_leftist_alt,0,11,0,81,1566964800,1585886400,11
Theunknown94,1,10,350,47,1572753600,1581742800,11
stevepwn3,0,11,0,18,1560657600,1603771200,11
Perigold,0,11,0,62,1580619600,1586404800,11
NickleNaks,2,9,276,21,1579496400,1581483600,11
jameswlf,0,11,0,1,1506571200,1593748800,11
passerbycmc,0,11,0,57,1567483200,1593576000,11
thehoodpsychologist,0,11,0,150,1559793600,1608526800,11
demonlemonade,0,11,0,113,1565668800,1579410000,11
glownyxo,1,10,60,67,1573621200,1574917200,11
Likeablekey,0,11,0,14,1554955200,1602993600,11
sliproach,0,11,0,44,1553918400,1594440000,11
cultish_alibi,0,11,0,57,1533614400,1543294800,11
doug_on_a_rug,0,11,0,-25,1596254400,1596340800,11
fuckyourraisins,0,11,0,527,1586318400,1602475200,11
dulcian_,0,11,0,161,1594872000,1608181200,11
doomsdayprophecy,1,10,27,23,1604725200,1609304400,11
wokeinthematrix,1,10,5,39,1608613200,1612242000,11
fallinmyhole,0,11,0,362,1564977600,1611896400,11
flaminhotcheetah,0,11,0,39,1607058000,1609477200,11
Pleasurist,0,11,0,32,1582866000,1584590400,11
GenerationXero,3,8,536,164,1547874000,1596686400,11
BigBillz128,0,11,0,60,1605070800,1608526800,11
The_Fad,0,11,0,125,1546405200,1549602000,11
PMmeyourdeadfascists,1,10,85,30,1598328000,1599537600,11
plentity,0,11,0,290,1580446800,1593662400,11
Kicooi,0,11,0,177,1545714000,1597550400,11
hyperactiveme1,2,9,51,-5,1606021200,1612069200,11
SamWize-Ganji,1,10,83,179,1575867600,1584936000,11
sheryldoh,1,10,59,48,1604811600,1605589200,11
marius1001,1,10,254,230,1574917200,1581051600,11
Got2InfoSec4MoneyLOL,0,11,0,17,1581656400,1599796800,11
greengreenrockyroads,0,11,0,178,1566792000,1588737600,11
surrealabstraction,1,10,44,68,1575090000,1576299600,11
poohbearlola,2,9,40,29,1572235200,1581051600,11
wowwee99,0,11,0,113,1609218000,1609390800,11
turtleonmonday,0,11,0,60,1551243600,1601352000,11
anarchistfajitas,0,11,0,98,1576213200,1604898000,11
Wandererofhell,0,11,0,40,1598760000,1609304400,11
DuderMcGroover,1,10,168,97,1581397200,1604552400,11
notviccyvictor,0,11,0,1,1582434000,1582606800,11
purpledollar,0,11,0,52,1539921600,1541998800,11
naiveescapist,2,9,11,123,1559880000,1561435200,11
michaelochurch,0,11,0,111,1567051200,1609304400,11
UncleRooku87,0,11,0,123,1580101200,1612069200,11
luigisphilbin,0,11,0,213,1584676800,1605502800,11
videogamingfires,0,11,0,77,1598760000,1607144400,11
TheBambooBoogaloo,0,11,0,-40,1575176400,1585454400,11
OSHAstandard,0,11,0,-41,1583812800,1583899200,11
nothingtolose878,2,9,159,69,1549602000,1566792000,11
wannabeskinnylegend,1,10,36,224,1581310800,1600488000,11
lmorsino,0,11,0,92,1550466000,1612155600,11
TheRockGame,1,10,343,29,1582779600,1594699200,11
itsneedtokno,0,11,0,20,1609218000,1609218000,11
ryguy92497,0,11,0,11,1606280400,1608354000,11
calilac,0,11,0,452,1578891600,1608872400,11
Lazienessx,0,11,0,158,1594267200,1606453200,11
amythevegan,3,8,92,46,1606194000,1608699600,11
jaibajpai7,0,11,0,278,1571803200,1605070800,11
Tinafu20,0,11,0,241,1600488000,1607490000,11
nothanks1997,0,11,0,-26,1607317200,1608181200,11
bulbasauuuur,0,11,0,87,1538625600,1599710400,11
Elektribe,0,11,0,23,1517288400,1562817600,11
genericusername4724,3,8,184,33,1605502800,1612155600,11
1-44,1,10,29,30,1558411200,1608699600,11
Effthegov,0,11,0,105,1607835600,1607922000,11
KGWA-hole,0,11,0,112,1560744000,1592625600,11
profoundmuffin,1,10,12,82,1580360400,1593403200,11
LeopardJockey,1,10,12,61,1567569600,1602043200,11
Blood_In_A_Bottle,0,11,0,41,1605330000,1607144400,11
oldsaltycrab1,0,11,0,-373,1597636800,1597636800,11
uuuuuggghhhhhg,0,11,0,43,1598500800,1609218000,11
before_i_die_alone,2,9,65,109,1546578000,1607835600,11
IamNotGonnaMakeIt,1,10,803,285,1587873600,1587960000,11
blahvigoblah,0,11,0,90,1577422800,1593057600,11
andsendunits,0,11,0,33,1587096000,1606626000,11
Vikngprncss,0,11,0,266,1597550400,1606021200,11
dgsticky,0,11,0,-26,1593576000,1593662400,11
quack-and-slash,2,9,42,20,1588824000,1592798400,11
popperinthere,0,11,0,147,1597204800,1603598400,11
ItWorkedLastTime,0,11,0,63,1591243200,1608699600,11
fiveminutedoctor,1,10,11,110,1579323600,1604898000,11
Vannfarge,0,11,0,47,1598155200,1598414400,11
MelkorBelegurth,0,11,0,124,1547787600,1607144400,11
hstarbird11,0,11,0,252,1567569600,1603512000,11
FuckHarambe2016,1,10,0,-3,1608613200,1608699600,11
jwrose,0,11,0,39,1577854800,1587873600,11
SalaciousStrudel,0,11,0,224,1583470800,1608699600,11
VisaEchoed,0,11,0,-22,1561348800,1561521600,11
nautical1776,0,11,0,135,1573621200,1585627200,11
throthrothroawayawa,3,8,386,63,1575867600,1578286800,11
chichilcitlalli,0,11,0,13,1609736400,1609822800,11
Merfond,0,11,0,134,1567915200,1586491200,11
upatanangle,0,11,0,105,1597291200,1598673600,11
PrinceNoMoreStars,0,11,0,219,1592798400,1606971600,11
PitchforkManufactory,0,11,0,77,1574312400,1602302400,11
quiette837,0,11,0,243,1602388800,1611982800,11
Aiyana_Jones_was_7,0,11,0,25,1571112000,1577941200,11
XXXSuperDupe,0,11,0,-48,1601697600,1604030400,11
SeaOfBullshit,0,11,0,89,1565496000,1575694800,11
drmozzarella,0,11,0,133,1580619600,1607317200,11
masternachos95,0,11,0,511,1573016400,1588478400,11
WEOUTHERE120,0,11,0,115,1597204800,1602820800,11
franco_thebonkophone,0,11,0,15,1583899200,1603252800,11
sharkshavemouths,0,11,0,14,1605157200,1606712400,11
PsySom,0,11,0,346,1576386000,1591243200,11
truerightiealt,0,11,0,-5,1576818000,1596600000,11
Catatonic27,0,11,0,41,1584676800,1608613200,11
drtobbogan0,0,11,0,28,1606712400,1606798800,11
athiefintamriel,0,11,0,396,1592625600,1598500800,11
Tarsonis181,1,10,23,22,1566878400,1567051200,11
noncommittal_sigh,0,11,0,72,1571976000,1605502800,11
ShadesPath,0,11,0,63,1548910800,1581051600,11
kellyanneconartist,4,7,936,93,1558584000,1596859200,11
xN00dzx,0,11,0,141,1559016000,1579150800,11
HodorIsLove,0,11,0,136,1541044800,1548910800,11
Coltrane45,0,11,0,309,1591675200,1600660800,11
JexCast,1,10,111,24,1546664400,1546750800,11
DiamondVibes,0,11,0,124,1568779200,1589947200,11
Omelette-doo-fromage,0,11,0,144,1594353600,1601697600,11
1369ic,0,11,0,26,1603684800,1611810000,11
theMEtheWORLDcantSEE,0,11,0,33,1568174400,1606626000,11
TheronEpic,0,11,0,103,1599278400,1609477200,11
dahliablaxkrose,0,11,0,61,1603684800,1606366800,11
hipsterhipst,0,11,0,327,1577163600,1600228800,11
Fluff_Me,0,11,0,184,1566705600,1607662800,11
mnhill2088,1,10,70,175,1597896000,1605762000,11
lefromageetlesvers,2,9,2696,161,1562817600,1572753600,11
Kvltist4Satan,0,11,0,119,1562472000,1583899200,11
tragedy_strikes,0,11,0,24,1602734400,1604984400,11
starberry_Sundae,0,11,0,103,1578632400,1599883200,11
sp00dynewt,0,11,0,122,1584763200,1608872400,11
DrunkInRlyeh,0,11,0,272,1576040400,1601438400,11
cryptoevergreen,1,10,100,59,1611810000,1611810000,11
TheCaptainShithouse,2,9,22,58,1563940800,1572408000,11
lvcv2020,5,6,65,94,1578373200,1582952400,11
HeroPiggy95,6,5,228,24,1589428800,1599105600,11
rukeen2,0,11,0,182,1580014800,1603252800,11
heuvos_grande69,0,11,0,24,1582866000,1583298000,11
powerhawk5000,7,4,485,130,1563249600,1595131200,11
Roshmos,0,11,0,22,1546059600,1553140800,11
GfFoundOtherAccount,0,11,0,17,1592884800,1606798800,11
rudolfs001,0,11,0,-75,1584763200,1585368000,11
throwawaythisdecade,9,2,6390,5,1597118400,1601784000,11
myaltfortransstuffs,0,11,0,122,1584331200,1609390800,11
creaturefeature2012,0,11,0,35,1571112000,1571112000,11
epicweaselftw,0,11,0,123,1588651200,1609304400,11
UnsolicitedFodder,4,7,776,41,1583557200,1586836800,11
-A-n-0-n-,1,10,39,50,1600660800,1602561600,11
Subplot-Thickens,0,11,0,169,1554955200,1602648000,11
Irbis_The_Moogle,0,11,0,87,1566446400,1582002000,11
UnhappyChemist,0,11,0,2,1562731200,1562817600,11
SirCatX,1,10,18,10,1596772800,1603512000,11
tylerden,0,11,0,125,1600574400,1608958800,11
Kirchetorte,1,10,14,48,1580101200,1601784000,11
moistwaffles420,1,10,48,52,1557720000,1587614400,11
don_rampanelli,0,11,0,147,1560744000,1581224400,11
JRexrode,6,5,544,32,1582088400,1599278400,11
restlesslegzz,1,10,11,371,1569384000,1607662800,11
papadanku42,1,10,9,90,1589083200,1602993600,11
merchantofdeaf88,0,11,0,77,1592280000,1598068800,11
the_tabasco_guy,0,11,0,448,1593921600,1600574400,11
BloodforKhorne,0,11,0,82,1580360400,1599796800,11
crystal_hd,0,11,0,11,1589083200,1589083200,11
Kbranstetter,0,11,0,95,1555128000,1572494400,11
SpiceCake68,5,6,1883,16,1559707200,1605157200,11
Alarming-Flan,0,11,0,162,1589601600,1589688000,11
Th3Catmoth3r,0,11,0,207,1569729600,1573966800,11
Price-x-Field,0,11,0,67,1583643600,1606107600,11
Mickosaurusrex,1,10,22,44,1602302400,1602388800,11
TheBigBallsOfFury,0,11,0,-61,1601179200,1601956800,11
BudgetTruth,1,10,84,26,1546750800,1585627200,11
ConstipatedUnicorn,0,11,0,820,1583470800,1604984400,11
CompleteIdeal,1,10,18,188,1593403200,1607662800,11
bigolnewsboi,0,11,0,70,1603425600,1606021200,11
jimichael,1,10,0,10,1606021200,1606107600,11
INTHEMIDSTOFLIONS,1,10,100,182,1575781200,1577768400,11
krokodilrott,2,9,30,111,1583812800,1605675600,11
arbiter_of_lucifer,0,11,0,90,1562472000,1575176400,11
mister_patience,1,10,30,40,1603425600,1605157200,11
without_nap,0,11,0,65,1599105600,1607835600,11
BunnyTheCow,0,11,0,227,1540180800,1587960000,11
Kiroen,0,11,0,226,1601179200,1609131600,11
asdfasd666,0,11,0,177,1547701200,1565323200,11
roawr123,0,11,0,36,1587096000,1639544400,11
venicerocco,0,11,0,139,1597896000,1611810000,11
noodlesbitches,1,10,21,44,1606107600,1608181200,11
Phazlerde,1,10,61,191,1574658000,1605934800,11
chicagodurga,0,11,0,172,1568779200,1608267600,11
mobydog,0,11,0,93,1595217600,1606194000,11
letsfly147,0,11,0,11,1596772800,1608008400,11
wittyschmitty119,0,11,0,41,1598932800,1612155600,11
pedantic-asshole-,0,11,0,-15,1585454400,1602820800,11
misterEpoop,0,11,0,138,1560312000,1562990400,11
CheeseburgerFan04,2,9,91,44,1596340800,1597550400,11
jenifr8218,2,9,121,58,1598241600,1601697600,11
breadlessMolotov,0,11,0,125,1576731600,1582693200,11
burntfortress,0,11,0,147,1562040000,1599969600,11
JimFromTheMoon,2,9,25,93,1581051600,1607490000,11
justgivemeafuckingna,1,10,9,1012,1591934400,1607317200,11
custhulard,0,11,0,74,1526529600,1612155600,11
thaktootsie,0,11,0,50,1573102800,1604203200,11
PM_ME_YOUR_BAN_NAME,2,9,6919,35,1560744000,1575176400,11
280zzzed,1,10,0,12,1605330000,1605502800,11
Same-LameName,0,11,0,71,1580446800,1601524800,11
kerubimm,0,11,0,204,1569729600,1579496400,11
maxigar,1,10,430,63,1552795200,1581915600,11
AlienCaterpillar,1,10,73,15,1594180800,1594267200,11
EatsShootsLeaves90,0,11,0,361,1594872000,1608267600,11
skylos,0,11,0,13,1605502800,1605589200,11
Senderender,2,9,111,56,1582520400,1587096000,11
elladexter,0,11,0,-27,1591934400,1591934400,11
Genericnameandnumber,2,9,61,73,1589601600,1590811200,11
calrebsofgix2,0,11,0,73,1606539600,1609045200,11
spenarak,4,7,389,250,1577768400,1591502400,11
Auspicios,0,11,0,220,1574053200,1609304400,11
Realistic_Honey7081,0,11,0,93,1608354000,1611896400,11
IIlIIlIIIIlllIlIlII,0,11,0,19,1611982800,1611982800,11
rivetcalamity,0,11,0,302,1595390400,1609218000,11
RearrangeYourLiver,0,11,0,162,1565755200,1601006400,11
ExtremelyBoringBetta,0,11,0,130,1568692800,1611982800,11
_SmokeDeGrasseTyson_,0,11,0,-58,1595044800,1595131200,11
The_baboons_ass,0,11,0,204,1598414400,1608699600,11
WandernWondern,0,11,0,34,1599969600,1602820800,11
Bureaucromancer,0,11,0,277,1576213200,1592539200,11
DevelopedDevelopment,0,11,0,61,1591329600,1612069200,11
Tennysonn,0,11,0,-51,1595649600,1611982800,11
SastrugiBun,0,11,0,390,1607835600,1608181200,11
thunderedclouds,0,11,0,28,1560571200,1593403200,11
shapeofthings,0,11,0,190,1586318400,1595908800,11
Griever114,0,11,0,85,1604379600,1608786000,11
Lakukaratscha,1,10,15,85,1578373200,1600574400,11
vgnbkr,0,11,0,47,1586318400,1605157200,11
SomethingClever1337,3,8,1434,125,1567137600,1608613200,11
xofeatherxo,1,10,11,96,1575262800,1606453200,11
slothygon,0,11,0,79,1583557200,1606971600,11
tooomuchpooop,0,11,0,127,1584331200,1584936000,11
Xanny,0,11,0,221,1572843600,1609131600,11
desbest,0,11,0,17,1596081600,1599451200,11
snackerjacker,2,9,466,-36,1599105600,1605502800,11
glad4j,1,10,13,133,1572148800,1609390800,11
OIl_Acrylic,0,11,0,32,1582779600,1608699600,11
Times_Hunger,2,9,34,63,1565841600,1597982400,11
TheBQT,0,11,0,148,1595476800,1607749200,11
amfoolishness,1,10,7,94,1579064400,1593921600,11
dillbreadsaladchair,1,10,171,119,1584331200,1609390800,11
cardvomit,0,11,0,55,1551243600,1558065600,11
jaidefoxpaintings,0,11,0,16,1584504000,1608526800,11
moistJesus666,0,11,0,73,1569902400,1604725200,11
tarsier_jungle1485,0,11,0,144,1598673600,1608008400,11
lydiardbell,0,11,0,92,1599969600,1608958800,11
UniqueFailure,0,11,0,484,1574658000,1605416400,11
fhgyrhk,0,11,0,19,1604379600,1604552400,11
AdmiralPlant,1,10,79,99,1596686400,1597550400,11
sindrogas,0,11,0,258,1588392000,1605157200,11
KatrinaVonDiesel,1,10,8,70,1606194000,1611982800,11
Johndough1066,0,11,0,38,1570507200,1607835600,11
rentisafuck,0,11,0,172,1566964800,1600747200,11
AnActualPairOfPants,3,8,181,26,1602907200,1608872400,11
ra940511,0,11,0,-51,1597550400,1605589200,11
cocaint,0,11,0,48,1588910400,1596859200,11
Michalusmichalus,0,11,0,212,1584936000,1607749200,11
Konradwolf,1,10,24,46,1513486800,1607749200,11
tayloline29,1,10,10981,87,1602129600,1611896400,11
gamehen21,1,10,14,27,1574139600,1575867600,11
CommanderMillie,0,11,0,136,1566446400,1599192000,11
Scytherax,1,10,2,4,1573966800,1573966800,11
DonovanWrites,0,11,0,497,1611810000,1612069200,11
VacTheDumbass,0,11,0,90,1569470400,1579928400,11
Realitytvtrashpanda,1,10,5,27,1599796800,1599883200,11
Asjkkqw,1,10,30,49,1568433600,1568520000,11
Exospheric-Pressure,1,10,66,38,1573966800,1574053200,11
Mecca1101,0,11,0,45,1567742400,1598846400,11
corpuscularcutter,4,7,123,23,1568606400,1582693200,11
StellarIntellect,0,11,0,18,1593576000,1593662400,11
Dirtface1,2,9,667,123,1587182400,1589256000,11
SkankHuntForty22,0,11,0,32,1602216000,1602216000,11
Diligent_Owl,0,11,0,71,1576299600,1597809600,11
DoktorG0nz0,0,11,0,29,1609218000,1612155600,11
Kewwike,0,11,0,46,1569902400,1575867600,11
ImWorthMore,6,5,729,36,1572408000,1609218000,11
ravenHR,0,11,0,23,1560484800,1588824000,11
gatoradewade,0,11,0,31,1600228800,1601092800,11
Mortimer_Snerd,0,11,0,26,1593057600,1601092800,11
simbalulu,1,10,40,22,1599451200,1599710400,11
tripsafe,0,11,0,2,1607490000,1608786000,11
gravyjives,1,10,40,211,1576904400,1595908800,11
audreydemartini,0,11,0,20,1574226000,1584590400,11
ivanbin,0,10,0,-13,1548392400,1591156800,10
MountandJew,0,10,0,52,1588910400,1589428800,10
Life_isbutadream,0,10,0,42,1568606400,1605589200,10
Lonelystarlight,2,8,117,49,1562817600,1584072000,10
VainTwit,0,10,0,145,1592798400,1608008400,10
charles_kuhl,0,10,0,119,1559707200,1581310800,10
duckofdeath87,0,10,0,58,1604030400,1612328400,10
asmartermartyr,0,10,0,71,1568347200,1605243600,10
minkeyaye,0,10,0,44,1577595600,1606021200,10
OozingPositron,0,10,0,223,1602820800,1611810000,10
TriForceShadow,2,8,96,46,1566705600,1568347200,10
Jiibaro,2,8,695,29,1560139200,1606971600,10
Sloppiestpusheen,0,10,0,27,1564459200,1596254400,10
coolturnipjuice,0,10,0,234,1561521600,1604203200,10
Grimalkin,0,10,0,188,1575694800,1578373200,10
feloncholy,0,10,0,36,1565755200,1608267600,10
gravgp2003,0,10,0,136,1573534800,1606539600,10
ThatZBear,0,10,0,73,1573102800,1606712400,10
ConfusedPalm95,0,10,0,114,1580446800,1601352000,10
ChewyHD,0,10,0,169,1590638400,1602993600,10
PyrateNemo,0,10,0,260,1596427200,1599451200,10
NothingHereAfterAll,5,5,146,75,1569038400,1609131600,10
The_Schwartz_Family,0,10,0,-24,1599796800,1599796800,10
njl4515,0,10,0,-4,1579755600,1580014800,10
Energylegs23,2,8,6934,85,1579237200,1600056000,10
nomadicwonder,0,10,0,21,1578373200,1597809600,10
MyNeighbourBurrito,0,10,0,276,1599969600,1605243600,10
IdealAudience,1,9,1,55,1570852800,1599105600,10
ComradeCatgirl,0,10,0,34,1584676800,1594526400,10
TunaCatz,0,10,0,-41,1570507200,1570593600,10
delukious,1,9,49,79,1588305600,1590379200,10
Jibjumper,0,10,0,249,1595563200,1607662800,10
CreamyToots,0,10,0,-12,1604030400,1608440400,10
alien665,0,10,0,140,1596600000,1606626000,10
Ann_Xiety,1,9,3,349,1576299600,1595044800,10
MrBanden,0,10,0,1104,1600228800,1606626000,10
Dupensik,2,8,307,92,1546578000,1574830800,10
Blastbeast,0,10,0,255,1534651200,1596859200,10
FatShamingWorks,0,10,0,31,1597723200,1600315200,10
joeamerican9,0,10,0,46,1583298000,1603771200,10
truth-reconciliation,0,10,0,99,1585022400,1598414400,10
TIFFSYNDICATE,0,10,0,76,1598328000,1598500800,10
i_love_humus,2,8,757,34,1607403600,1608613200,10
QuickToTheBatmobile,1,9,85,169,1608094800,1608440400,10
UnicornFukei42,0,10,0,25,1555905600,1605589200,10
425425throwaway,1,9,25,31,1602820800,1602820800,10
YoThisTK,0,10,0,98,1599624000,1602734400,10
hellothatismeimhere,1,9,18,28,1596427200,1596427200,10
m41triya,0,10,0,157,1569556800,1574658000,10
id_o,0,10,0,-31,1592712000,1592798400,10
TARDISinScarlet,0,10,0,31,1582261200,1605502800,10
Kooky_Independence,0,10,0,53,1589169600,1611982800,10
vitaderane,0,10,0,48,1582434000,1585540800,10
theGoodMouldMan,1,9,12,214,1565150400,1593835200,10
felixthecat066,0,10,0,102,1549515600,1601524800,10
JDBear52,7,3,1201,12,1584504000,1597896000,10
wiseaufanclub,3,7,1114,62,1589774400,1607058000,10
DaCoolX,1,9,109,736,1592020800,1608354000,10
skyrimshuffle17,1,9,12310,156,1608613200,1608699600,10
tri0lus,0,10,0,132,1595908800,1607403600,10
AerinQ,1,9,18,19,1572408000,1608181200,10
funwheeldrive,0,10,0,-135,1580274000,1606539600,10
Elmeregor44,0,10,0,5,1589169600,1591675200,10
isalod_2298,0,10,0,220,1555992000,1566273600,10
roboconcept,1,9,14,44,1572843600,1606626000,10
Vaelin_,0,10,0,97,1604898000,1608008400,10
AlwaysTheNextOne,0,10,0,-22,1607749200,1607835600,10
logsobolevinequality,0,10,0,61,1563336000,1595476800,10
giraffewoman,0,10,0,86,1599624000,1607835600,10
peaceloveandgames,0,10,0,98,1576386000,1611982800,10
gnashtyyy,4,6,5720,22,1573880400,1599796800,10
nichts_neues,0,10,0,149,1574658000,1608786000,10
elusivenoesis,0,10,0,169,1571630400,1608958800,10
Imprettystrong,0,10,0,38,1605589200,1606366800,10
lupercalpainting,0,10,0,29,1594094400,1606366800,10
notallthatrelevant,0,10,0,88,1598414400,1608613200,10
PaddyStars,1,9,28,315,1591848000,1605157200,10
schroeder742,0,10,0,357,1577422800,1577509200,10
goddog_,2,8,144,52,1559188800,1569384000,10
people_watcher,1,9,266,80,1535428800,1585454400,10
shitscuit69,0,10,0,9,1592798400,1592884800,10
Brewer_Lex,0,10,0,68,1572321600,1593489600,10
dascott,0,10,0,885,1583470800,1594353600,10
RagingCitrusTree,1,9,6,117,1576386000,1603512000,10
TheWalkingDead91,0,10,0,129,1602648000,1608181200,10
monos_muertos,0,10,0,207,1577941200,1585281600,10
HumanBehaviorByBjork,0,10,0,120,1551330000,1563768000,10
ohpfordays,1,9,113,151,1554004800,1583985600,10
SassyPerere,1,9,38,46,1595217600,1608354000,10
Freefalafelin,0,10,0,154,1582088400,1587873600,10
Coglioni,0,10,0,44,1578373200,1605589200,10
SexHaver2323,0,10,0,2615,1579150800,1606885200,10
_Those_Who_Fight_,0,10,0,43,1597809600,1608008400,10
Danykiri,0,10,0,224,1603339200,1605416400,10
Able2c,0,10,0,225,1583298000,1608613200,10
dumblederp,0,10,0,39,1575781200,1598673600,10
Emmanuel_Badboy,0,10,0,31,1605070800,1611982800,10
calebmke,0,10,0,465,1578373200,1608354000,10
brother_beer,0,10,0,142,1552194000,1606712400,10
HowRiskyIsDatClick,0,10,0,56,1609045200,1609390800,10
The_Hot_Stepper,0,10,0,302,1595390400,1606021200,10
DNGRDINGO,0,10,0,78,1594699200,1608872400,10
phatposer,0,10,0,14,1598932800,1598932800,10
BolaBrancaV7,0,10,0,60,1549515600,1550552400,10
slickztoyz,0,10,0,225,1580965200,1597982400,10
ProClumsy,0,10,0,4,1577336400,1589169600,10
AutumnRosettaCygni,1,9,2,38,1597118400,1597377600,10
Naturescoldcut,0,10,0,96,1571371200,1605848400,10
iwastetime4,1,9,6,42,1602648000,1604898000,10
JucheNecromancer,0,10,0,56,1605934800,1606885200,10
CurrentOccasion,1,9,524,129,1568260800,1595822400,10
x_alexithymia,0,10,0,84,1549342800,1570420800,10
TheRealStandard,0,10,0,45,1600228800,1606107600,10
Hockinator,0,10,0,-5,1585454400,1585540800,10
SisyphusHappy18,1,9,15,61,1584590400,1602734400,10
Skulvana,1,9,228,70,1583298000,1606712400,10
Unicornucopia23,1,9,70,168,1584072000,1592280000,10
blackupsilon,4,6,1667,163,1582088400,1604725200,10
Mollanlets,0,10,0,160,1605416400,1609304400,10
MaFataGer,1,9,15,42,1571716800,1595736000,10
myicedtea,1,9,989,99,1567051200,1584072000,10
for-the-memes,1,9,7,8,1547010000,1547010000,10
MaesterSchIeviathan,0,10,0,251,1577595600,1592366400,10
dat2ndRoundPickdoh,0,10,0,70,1601179200,1606712400,10
jeanroyall,0,10,0,4,1584936000,1589342400,10
Soren11112,0,10,0,32,1580792400,1593230400,10
treysonking147,2,8,29,187,1566100800,1581310800,10
Armalyte,0,10,0,65,1598328000,1611982800,10
ws_celly,0,10,0,67,1593748800,1603512000,10
amcken13,3,7,105,27,1594526400,1609304400,10
Sir-Belledontis,0,10,0,121,1607576400,1609218000,10
Goddesss2,0,10,0,38,1578027600,1593230400,10
allworkandnoYahtzee,0,10,0,182,1575176400,1587096000,10
Nerevars_Bobcat,1,9,18,70,1606107600,1606712400,10
Artesal,2,8,159,33,1594180800,1607144400,10
punkmetalbastard,0,10,0,282,1579928400,1612155600,10
Wobblewobblegobble,1,9,8,50,1571284800,1606885200,10
PSoponyai,0,10,0,72,1576731600,1608786000,10
Addicted2UrMom,0,10,0,81,1586836800,1592366400,10
xconomicron,0,10,0,220,1573275600,1590120000,10
mike4763,0,10,0,186,1577854800,1608354000,10
OkumurasHell,0,10,0,58,1580965200,1588305600,10
kitty-94,2,8,18,131,1600833600,1607749200,10
xmmr,1,9,0,-1,1567828800,1609477200,10
Mdnghtmnlght,0,10,0,47,1579928400,1584244800,10
hiddenfrommyboss,2,8,476,95,1593489600,1594958400,10
shruglifeOG,0,10,0,50,1597032000,1608872400,10
bobbi_jo182,1,9,261,72,1572930000,1573534800,10
Room_Temp_Coffee,0,10,0,127,1604811600,1608354000,10
TerriblyGentlemanly,0,10,0,5,1605848400,1606107600,10
AnalystOfData,0,10,0,26,1585454400,1585454400,10
souprize,0,10,0,45,1593662400,1609390800,10
hellokittyoh,1,9,828,69,1588910400,1609045200,10
StcStasi,3,7,90,-43,1591156800,1608699600,10
jenn12765,1,9,83,52,1600056000,1600315200,10
virgil_the_absurd,0,10,0,88,1598241600,1599192000,10
deathsdevice,0,10,0,2,1568001600,1568001600,10
Taldyr,0,10,0,13,1598587200,1607403600,10
RS702,0,10,0,-60,1572930000,1601870400,10
vansvch,0,10,0,160,1552276800,1553486400,10
man-this-sucks,0,10,0,78,1553400000,1554264000,10
Yodplods,0,10,0,79,1542690000,1606194000,10
grunt-sculpin,0,10,0,128,1585540800,1608872400,10
TheCreepyLady,3,7,112,761,1589515200,1608181200,10
DJDickJob,0,10,0,97,1540612800,1599710400,10
cat_fartzz,9,1,13118,1,1601697600,1606971600,10
dilxoxoxlib,1,9,13,65,1563508800,1603080000,10
canny_goer,0,10,0,209,1579150800,1579237200,10
owegner,1,9,14,350,1602129600,1609304400,10
holeMOLEhole,0,10,0,89,1604898000,1608354000,10
crimsonchin68,0,10,0,-146,1548392400,1571025600,10
dept_of_silly_walks,0,10,0,57,1588996800,1604379600,10
95girl,1,9,4,13,1590379200,1607403600,10
BROWN0133,0,10,0,86,1585627200,1607490000,10
redfec01,0,10,0,253,1582606800,1598155200,10
lgp88,0,10,0,57,1598155200,1602561600,10
Fuchsfaenger,0,10,0,101,1599537600,1607403600,10
Jehdrid,4,6,5523,90,1602129600,1602993600,10
3D_SHILL,0,10,0,31,1595995200,1609218000,10
fallen_soulblighter,0,10,0,241,1560571200,1596859200,10
PartyPoncho,0,10,0,15,1566446400,1601524800,10
Tongue_In_Butt_Yes,1,9,182,164,1575262800,1577595600,10
heartofabrokenstory,0,10,0,59,1596168000,1612155600,10
pinktiger1,3,7,196,19,1575522000,1588219200,10
getfuckedrogerstone,0,10,0,203,1593662400,1599451200,10
MariaDolorosa,0,10,0,33,1586664000,1607576400,10
guitarguy109,0,10,0,101,1558584000,1607662800,10
ijustneedanametouse,1,9,538,403,1594094400,1597291200,10
nihilist-trash,0,10,0,86,1563076800,1585108800,10
artgo,0,10,0,98,1598328000,1598414400,10
Different_State,0,10,0,89,1582866000,1611810000,10
bluehands,0,10,0,243,1549515600,1607749200,10
insane_gravy,0,10,0,29,1579928400,1607576400,10
0pipis,1,9,2,31,1566100800,1598155200,10
x0jDa,0,10,0,24,1590552000,1601265600,10
Digestivesrule,0,10,0,-10,1569988800,1570075200,10
greedo10,1,9,27,28,1608354000,1608786000,10
richyrich723,0,10,0,102,1552276800,1582520400,10
bluedrygrass,0,10,0,47,1550552400,1560830400,10
famo2020,1,9,64,43,1607058000,1609218000,10
Mcd4848,0,10,0,172,1570248000,1587096000,10
Vegetable-Chain,1,9,15,101,1595390400,1611896400,10
MemeLordMango,0,10,0,-48,1570420800,1593576000,10
addisonshinedown,0,10,0,86,1574398800,1606885200,10
engin__r,0,10,0,199,1570939200,1607922000,10
harfang88,0,10,0,125,1581656400,1607662800,10
Zworyking,0,10,0,5,1578373200,1578373200,10
Cimejies,0,10,0,24,1575954000,1598673600,10
Andynonomous,0,10,0,305,1471752000,1570161600,10
PenetrationT3ster,0,10,0,148,1593921600,1602129600,10
Wanderers_Schatten,0,10,0,55,1579669200,1589515200,10
EldraziKlap,0,10,0,-10,1570334400,1604898000,10
blesser-of-rains,0,10,0,579,1579755600,1608008400,10
Aquila-King,2,8,172,150,1580014800,1588478400,10
LumpyJones,0,10,0,58,1584590400,1600228800,10
xrobyn,3,7,701,17,1587614400,1603684800,10
WolfMan889,0,10,0,522,1603425600,1607576400,10
falseprofit-s,0,10,0,34,1570420800,1593662400,10
YawnieYohnson,0,10,0,-41,1608354000,1608872400,10
Quiet-Access,0,10,0,320,1603771200,1612155600,10
electricsheep95,1,9,31,44,1587182400,1587268800,10
hydrangeea,0,10,0,69,1567051200,1588824000,10
anna_id,0,10,0,57,1580274000,1600142400,10
usernameinprogress89,0,10,0,160,1561521600,1580274000,10
UnicornDust1860,1,9,10728,108,1589256000,1609390800,10
spaceman_spliffs,0,10,0,22,1561348800,1605934800,10
spookyfoxiemulder,0,10,0,83,1600142400,1602648000,10
Yorkpeepee,1,9,22,36,1589601600,1589774400,10
craziefuzi,1,9,22,22,1548651600,1608267600,10
NorkinMan7,5,5,664,55,1580187600,1592539200,10
idlepose,0,10,0,98,1553486400,1564027200,10
WiidStonks,0,10,0,12,1611982800,1612846800,10
IncognitoVoidBoi,0,10,0,23,1600833600,1603598400,10
neurasthene,1,9,197,88,1585108800,1585454400,10
lilyholicphilia,2,8,857,162,1577854800,1591243200,10
ThatOneGuy4321,0,10,0,65,1593144000,1609218000,10
joblo46,0,10,0,42,1590379200,1591502400,10
Theiim,2,8,840,98,1552276800,1565236800,10
Set_the_tone-,1,9,4,27,1570507200,1570939200,10
BoldBupropion,2,8,166,33,1580446800,1586318400,10
jockeyman,2,8,632,60,1599192000,1612155600,10
three18ti,0,10,0,0,1576990800,1582866000,10
NormieSpecialist,0,10,0,82,1583298000,1611896400,10
John238,4,6,2204,32,1574571600,1590984000,10
dashboardbythelight,2,8,61,137,1556942400,1603771200,10
FlatElk,2,8,34,20,1555732800,1577854800,10
AutoSpiral,1,9,28,48,1574830800,1581397200,10
ch1993,0,10,0,197,1578632400,1608613200,10
Bebop1819,0,10,0,41,1573448400,1607835600,10
Peudejou,0,10,0,52,1606539600,1608440400,10
lysergic_serpent,0,10,0,75,1556251200,1557460800,10
TomBoysHaveMoreFun,0,10,0,32,1549515600,1556251200,10
mic3dave,0,10,0,84,1584590400,1597032000,10
Wraith305,0,10,0,-8,1582606800,1602907200,10
niewadzi,0,10,0,26,1598587200,1607922000,10
plumbtree,0,10,0,-25,1577336400,1577422800,10
AnotherSchool,0,10,0,-76,1589342400,1589774400,10
ArboresMortis,0,10,0,74,1571544000,1592280000,10
Shramo,0,10,0,62,1589774400,1609477200,10
ArmyOfThe12Trumps,1,9,21,50,1584072000,1584158400,10
SkulduggeryIsAfoot,0,10,0,76,1593835200,1607662800,10
afternoonscribble,0,10,0,71,1575522000,1608181200,10
Fatman280,0,10,0,-17,1581483600,1600747200,10
LouiseGoesLane,0,10,0,71,1582174800,1584072000,10
Joobothy,0,10,0,63,1601006400,1607835600,10
tellme-how,0,10,0,53,1589083200,1607144400,10
jax_christian,0,10,0,16,1580187600,1612155600,10
Farren246,0,10,0,462,1589860800,1590033600,10
NewSysAdmin2,2,8,29,53,1586577600,1594267200,10
RedKingDre,0,10,0,13,1608440400,1609390800,10
QuarantineSucksALot,0,10,0,11,1602129600,1605589200,10
ccawcc,1,9,9,19,1562299200,1572062400,10
outed,0,10,0,299,1578632400,1589947200,10
Rocky_Bukkake,0,10,0,33,1571112000,1595822400,10
Martofunes,1,9,121,27,1573189200,1575694800,10
AthasDuneWalker,0,10,0,169,1576126800,1600660800,10
Duke_Nukem_1990,0,10,0,154,1578286800,1607576400,10
SpawnlingMan,0,10,0,-15,1585454400,1585454400,10
bsldurs_gate_2,0,10,0,90,1584590400,1602388800,10
BDouglas2013,2,8,15,14,1581656400,1589860800,10
skyisbluetoday,0,10,0,46,1555992000,1559102400,10
Gravity_flip,0,10,0,118,1585627200,1603512000,10
littleray35,2,8,74,147,1607835600,1609390800,10
sonofkratos,2,8,315,112,1556337600,1579755600,10
pabloescoballss,1,9,152,82,1593230400,1593662400,10
SilliVilliN,3,7,458,18,1603512000,1607662800,10
Hookahwave,1,9,0,31,1536379200,1541217600,10
mar-qs,2,8,44,16,1581829200,1584072000,10
ZzDe0,0,10,0,71,1536379200,1585713600,10
nathanielsnider,1,9,1,-38,1601352000,1601352000,10
arctxdan,0,10,0,48,1579150800,1608267600,10
lightinplainsight,1,9,9,38,1582606800,1600747200,10
creative_nothing_,1,9,10,46,1479877200,1482210000,10
Curt2000,2,8,862,801,1576040400,1601092800,10
zhephyx,0,10,0,99,1574917200,1582952400,10
MarkOfTheCage,0,10,0,207,1605675600,1609131600,10
iamnotamangosteen,0,10,0,148,1583643600,1596686400,10
JuiceNoodle,1,9,0,-33,1604030400,1604116800,10
brumguvnor,1,9,88,62,1562904000,1602388800,10
mahschmidt,1,9,4,13,1603598400,1609218000,10
B-Otter,0,10,0,131,1560398400,1584158400,10
unicornlocostacos,0,10,0,44,1592107200,1609045200,10
Craving4H,0,10,0,73,1578459600,1579842000,10
ShermanWert,0,10,0,74,1605675600,1607835600,10
Ze_insane_Medic,0,10,0,104,1573794000,1588478400,10
Cr3X1eUZ,0,10,0,106,1556424000,1608958800,10
Danizdaman0506,0,10,0,55,1562990400,1604116800,10
StuckWithThisOne,0,10,0,10,1603512000,1603598400,10
322955469,0,10,0,449,1575435600,1605243600,10
Daesii,1,9,2351,80,1594958400,1598241600,10
freeTheWorker,1,9,25,44,1602043200,1609218000,10
Vadise_TWD,0,10,0,34,1575349200,1607230800,10
Lobere,1,9,60,77,1590984000,1598155200,10
Fortunefavourthebold,0,10,0,-22,1574571600,1607576400,10
fnuduwuh,0,10,0,114,1605762000,1609390800,10
sxan,0,10,0,10,1577422800,1592193600,10
CoolestBoyCorin,0,10,0,19,1596168000,1609045200,10
Blackout62,0,10,0,36,1595649600,1596254400,10
___TrashPanda___,0,10,0,35,1583985600,1606194000,10
fugitiquit,0,10,0,162,1598328000,1609131600,10
Work_Work_III,2,8,23,58,1589428800,1602734400,10
AlongRiverEem,0,10,0,26,1608181200,1608267600,10
SoDeepInYouRightNow,0,10,0,-1,1546664400,1547874000,10
sas317,0,10,0,84,1578114000,1583899200,10
curveabrae,0,10,0,54,1601524800,1609131600,10
branewalker,0,10,0,235,1592798400,1607403600,10
MelodicMessage,0,10,0,16,1562990400,1605675600,10
TheDrakced,1,9,9,70,1587614400,1608786000,10
CookBladeBakeAndCode,0,10,0,43,1582693200,1596945600,10
velw,0,10,0,47,1606798800,1609218000,10
Brain-Fiddler,2,8,994,103,1571112000,1602129600,10
Rofel_Wodring,1,9,25,26,1602043200,1603080000,10
GoldDustMetal,0,10,0,196,1587182400,1609131600,10
nepomuk167,1,9,90,22,1549170000,1594872000,10
HanSolo1519,0,10,0,707,1583125200,1605675600,10
upboatsallaround,0,10,0,78,1584244800,1605243600,10
Akhi11eus,0,10,0,130,1576558800,1607662800,10
me-topia,0,10,0,444,1598068800,1608354000,10
Dont_touch_my_elbows,0,10,0,424,1562299200,1609304400,10
keithITNoob,2,8,381,140,1571198400,1597809600,10
nokia621,9,1,11649,6,1559361600,1573880400,10
Neat_Description,0,10,0,10,1559966400,1560052800,10
Benasen,0,10,0,-144,1570766400,1590033600,10
hempmylk420,0,10,0,60,1577595600,1606798800,10
pederbalke,0,10,0,25,1582779600,1582779600,10
worksucks91,1,9,44,44,1559275200,1565236800,10
NumberOneDingus,2,8,56,53,1606021200,1612069200,10
Devilishlypretty,0,10,0,20,1602648000,1602907200,10
toastygingersnap,0,10,0,44,1583298000,1583812800,10
TheFunkDragon,0,10,0,43,1594785600,1597809600,10
ezyt8,3,7,3059,25,1600488000,1601092800,10
sauchlapf,1,9,24,72,1560139200,1579323600,10
WannabeSpaceMan1301,0,10,0,-155,1547182800,1555300800,10
TheRiverStyx,0,10,0,55,1604984400,1612069200,10
LunarGiantNeil,2,8,21,141,1594094400,1601352000,10
astronautsamurai,0,10,0,52,1586059200,1605070800,10
JazzyPier,1,9,23,67,1578286800,1605070800,10
getaloadofthishoopla,0,10,0,30,1579669200,1593921600,10
xwing_n_it,0,10,0,176,1556337600,1607835600,10
cccccakes,0,10,0,20,1590120000,1590811200,10
mathemagical-girl,0,10,0,31,1601092800,1612069200,10
fairygodmotherfckr,0,10,0,68,1600142400,1603252800,10
LichenTruther,5,5,222,11,1591070400,1602907200,10
Epic_Gaymer_Jeff,0,10,0,89,1570334400,1575608400,10
Thanatar18,0,10,0,36,1563249600,1577768400,10
echoplus2020,0,10,0,152,1561348800,1595822400,10
bmarsh3932,0,10,0,70,1571544000,1574830800,10
enough_is_plenty,0,10,0,352,1578805200,1578978000,10
greystar05,1,9,125,34,1571803200,1575262800,10
smallangrything,0,10,0,196,1605934800,1609563600,10
taylorikari,2,8,98,64,1575349200,1580014800,10
turquoisehexagonsun_,0,10,0,37,1555387200,1581310800,10
SaffellBot,0,10,0,137,1604898000,1612069200,10
cheezy_cheddar,1,9,0,-14,1598673600,1598673600,10
iTohke,0,10,0,-22,1608526800,1608786000,10
ImThaired,0,10,0,139,1578978000,1597809600,10
Mr_McZongo,0,10,0,50,1582779600,1603684800,10
Damn_Taffer,0,10,0,27,1564372800,1606280400,10
sadchild5,0,10,0,58,1572148800,1579064400,10
BrFrancis,0,10,0,121,1561348800,1608181200,10
ShetlandJames,0,10,0,48,1575435600,1603512000,10
vick1voss2,1,9,7,21,1580187600,1585800000,10
Kudos1027,1,9,13,-43,1606021200,1607922000,10
CinnasterStix,0,10,0,113,1584417600,1588651200,10
crosey22,0,10,0,-63,1575262800,1575608400,10
WeranioRacker,0,10,0,53,1552708800,1604811600,10
MasterChris725,0,10,0,331,1578373200,1585454400,10
Underdriver,0,10,0,-8,1580706000,1581915600,10
DownOnTheUpside,0,10,0,141,1464840000,1581483600,10
fiercefurry,1,9,138,346,1570420800,1577509200,10
AverageDingbat,0,10,0,21,1570507200,1586404800,10
linezNsmoke,0,10,0,111,1599278400,1605243600,10
EarSuccessful1462,0,10,0,41,1608958800,1608958800,10
jablesmcgee,0,10,0,4,1588996800,1603771200,10
diamond_rake,1,9,2,11,1598414400,1598500800,10
GrandWizardBumtickle,1,9,629,76,1565841600,1594440000,10
KibacherKat,0,10,0,31,1555214400,1555300800,10
xanju,0,10,0,100,1555732800,1594612800,10
Penguin_lies,0,10,0,210,1599278400,1621915200,10
venusinfurstattoo,1,9,34,170,1570680000,1599105600,10
danllo2,0,10,0,-26,1602648000,1602648000,10
rmlrmlchess,0,10,0,18,1576558800,1592625600,10
Quest4Peace,3,7,49,24,1552449600,1580274000,10
Zhellblah,0,10,0,38,1603512000,1603598400,10
yuhkih,1,9,277,284,1547269200,1555300800,10
Imydie,0,10,0,62,1576990800,1589774400,10
Awarth_ACRNM,0,10,0,41,1571544000,1587182400,10
DiamondXr,5,5,1729,16,1572753600,1579496400,10
ferngully99,0,10,0,167,1582088400,1608872400,10
Dungerella,1,9,66,69,1604116800,1606366800,10
youloveme227,0,10,0,44,1592020800,1598241600,10
silbermannasher,0,10,0,0,1567051200,1567224000,10
Dexontronox,0,10,0,101,1595217600,1609218000,10
Ozlempje,1,9,17,-7,1563336000,1564113600,10
Vigil_the_Shaper,0,10,0,36,1567915200,1569211200,10
Glaciata,0,10,0,236,1571976000,1592884800,10
Nairbnotsew,1,9,91,478,1574744400,1604984400,10
TakeItEasyPolicy,0,10,0,-169,1576299600,1576472400,10
hey_eye_tried,0,10,0,26,1578373200,1578373200,10
IamBrazilian_AMA,2,8,178,153,1599710400,1600833600,10
workisaprison,1,9,24,184,1607230800,1608354000,10
Spectrachic311311,0,10,0,247,1586404800,1598155200,10
amethyst_asuna,0,10,0,260,1601265600,1602648000,10
DCMurphy,0,10,0,498,1605243600,1608786000,10
Jackle77,0,10,0,-5,1594353600,1609131600,10
Horse-Cock-Harry,1,9,356,144,1574053200,1579064400,10
cornrowed_honkey,1,9,118,124,1559534400,1564891200,10
weirdness_incarnate,1,9,8,121,1598328000,1611896400,10
ButtFleas,0,10,0,33,1551070800,1552363200,10
theGreatestFucktard,0,10,0,620,1574226000,1605157200,10
BobmaiKock,0,10,0,301,1594267200,1598414400,10
sleepsucks,2,8,70,49,1548651600,1559188800,10
im_the_scat_man,0,10,0,235,1551330000,1602648000,10
jonnyinternet,0,10,0,77,1583038800,1608958800,10
wookiepoop93,0,10,0,153,1578459600,1597809600,10
JustHere2RuinUrDay,0,10,0,15,1604811600,1609218000,10
sculltt,1,9,9,70,1572148800,1602820800,10
lightly_salted_fetus,0,10,0,56,1598760000,1602648000,10
DontBeAScumBag22,0,10,0,78,1596772800,1601870400,10
WonTonBurritoMeals,0,10,0,176,1578718800,1608094800,10
Candi88,0,10,0,133,1555992000,1573448400,10
socialismnotevenonce,0,10,0,-57,1554523200,1577422800,10
ShamelessCrimes,0,10,0,146,1596168000,1603425600,10
roosterkun,1,9,584,116,1587873600,1608181200,10
GiaredL,2,8,1843,171,1563940800,1587614400,10
smokeshack,1,9,515,180,1551330000,1551416400,10
BigManWalter,0,10,0,37,1539921600,1572235200,10
likeitironically,0,10,0,125,1577336400,1608699600,10
Mad_King,0,10,0,95,1583470800,1608008400,10
Uparupa212,0,10,0,20,1576645200,1599105600,10
I_need_power,0,10,0,1951,1602129600,1606626000,10
Kamikazekagesama,0,10,0,11,1562731200,1590033600,10
spacemaninbound,0,10,0,-29,1575954000,1576040400,10
Sephitard9001,0,10,0,20,1603857600,1606626000,10
bukkake_waterballoon,0,10,0,555,1605762000,1608094800,10
mongoljungle,1,9,3,14,1587441600,1587614400,10
Dire-Dog,0,10,0,-46,1571803200,1587787200,10
SnooStories3658,0,10,0,56,1607922000,1609304400,10
gazellefan,1,9,46,42,1552968000,1608786000,10
witty-pun-name,0,10,0,-9,1569816000,1569988800,10
jaykbb,2,8,278,69,1602302400,1605589200,10
DarthNihilus1,0,10,0,73,1606021200,1608354000,10
Pajeet_My_Son,0,10,0,-110,1563076800,1567569600,10
RagingBillionbear,0,10,0,88,1568865600,1602475200,10
honeybadger9,0,10,0,78,1587009600,1603598400,10
RegeneratingForeskin,0,10,0,79,1595995200,1611896400,10
guarilonio,5,5,3789,174,1557720000,1607922000,10
Naotagrey,1,9,60,55,1599796800,1607662800,10
failed_evolution,10,0,231,0,1588305600,1609218000,10
bootscats,2,8,144,160,1573966800,1608440400,10
TrueCrimeMoose,0,10,0,14,1611810000,1611810000,10
conrad_w,1,9,52,17,1594094400,1608872400,10
forkedstream,0,10,0,20,1559707200,1559793600,10
TheNeys,0,10,0,56,1577854800,1588392000,10
sluohg,0,10,0,78,1597982400,1601179200,10
GunMunky,0,10,0,19,1553918400,1592107200,10
veilwalker,0,10,0,58,1600574400,1609045200,10
flxwrx,0,10,0,587,1589428800,1598328000,10
GorgeousGregory,0,10,0,164,1585886400,1586577600,10
ComradeRosie69,1,9,15,53,1595131200,1608699600,10
clarkborup,0,10,0,141,1567224000,1580014800,10
RealHornblower,0,10,0,1220,1578718800,1608267600,10
Flick1981,0,10,0,180,1574744400,1579582800,10
colehoots,1,9,24,93,1559793600,1608786000,10
big-dik-energy,4,6,117,13,1575349200,1581570000,10
maskedpaki,0,10,0,26,1580446800,1602993600,10
irlgarbodor,1,9,104,63,1539921600,1556510400,10
KillerKombo,0,10,0,9,1589947200,1590033600,10
Titan_of_sindustry,0,10,0,413,1608526800,1608872400,10
jpastore,0,10,0,-10,1554955200,1559361600,10
blawlt,0,10,0,104,1576990800,1584590400,10
connecticut06611,0,10,0,125,1567742400,1578200400,10
Statutory_Tape,0,10,0,-363,1598068800,1605762000,10
dekrepit702,1,9,63,135,1557288000,1606021200,10
splunklebox,0,10,0,142,1593576000,1612069200,10
plncn,1,9,200,94,1563595200,1563595200,10
Xeritos,0,10,0,111,1548046800,1585800000,10
FullFatVeganCheese,0,10,0,76,1569297600,1573275600,10
kati3rose,0,10,0,93,1602388800,1607490000,10
CaptainAsshat,0,10,0,33,1576990800,1587614400,10
Jimmycjacobs,0,10,0,78,1606971600,1609477200,10
SnowStarMoon,0,10,0,92,1599883200,1607662800,10
luckecage,0,10,0,-19,1590292800,1594180800,10
spelunk_in_ya_badonk,0,10,0,423,1578632400,1606107600,10
boofthatchit,0,10,0,126,1572753600,1602388800,10
Owstream,1,9,28,54,1574658000,1594785600,10
Elyon113,1,9,498,95,1578805200,1587528000,10
TheAmazingRedditUser,1,9,0,6,1592712000,1592884800,10
larrybudmel,0,10,0,38,1552276800,1578459600,10
goodstuffsamantha,1,9,14,55,1599796800,1601352000,10
VergeIll,0,10,0,-25,1605934800,1608440400,10
TapesNStuff,0,10,0,54,1578459600,1607317200,10
Koyamano,0,10,0,173,1573534800,1599883200,10
yoorubyy18,0,10,0,55,1603684800,1609218000,10
SuperChadMonkey,0,10,0,234,1582002000,1582088400,10
shxrrrr,0,10,0,-15,1577422800,1579237200,10
FoxWyrd,0,10,0,134,1594699200,1608613200,10
BazaarMonk,1,9,134,26,1581310800,1581397200,10
bonechinadebt,0,10,0,106,1554004800,1580878800,10
coffeebeera,0,10,0,127,1593748800,1598414400,10
Bob1939USA,0,10,0,-485,1569988800,1570075200,10
OptimalExplanation,1,9,138,62,1604379600,1609390800,10
TenshiS,0,10,0,62,1559707200,1604811600,10
JoeBlow49032,0,10,0,88,1556510400,1602216000,10
roostershoes,0,10,0,73,1598328000,1608613200,10
Armoured_Kitten,0,10,0,142,1582606800,1602043200,10
FecalAlgebra,0,10,0,105,1580187600,1605589200,10
SALMON_OW,0,10,0,37,1607922000,1607922000,10
readit_later,0,10,0,-153,1566964800,1576472400,10
noirist88,1,9,13,50,1569816000,1571630400,10
william_tells,0,10,0,9,1550811600,1550811600,10
auximenies,0,10,0,247,1561694400,1577336400,10
OnceWasInfinite,0,10,0,69,1566187200,1567051200,10
TakeANotion,2,8,108,133,1608094800,1609477200,10
mylifeintopieces1,0,10,0,60,1598241600,1608699600,10
MuggD,0,10,0,54,1564891200,1573102800,10
G_O_O_G_A_S,0,10,0,16,1611982800,1611982800,10
Rakijosrkatelj,0,10,0,40,1562817600,1608958800,10
V01DIORE,0,10,0,20,1589688000,1603598400,10
aicheo,0,10,0,137,1549256400,1581310800,10
physlizze,0,10,0,74,1587268800,1608267600,10
The_Wolfpack,0,10,0,-31,1607576400,1608872400,10
Kaijudile,1,9,71,54,1605675600,1608958800,10
Plenty_Ad790,0,10,0,113,1604811600,1607576400,10
Technicka,0,10,0,137,1586836800,1606280400,10
David_The_Lion,0,10,0,10,1582002000,1583470800,10
dblmjr_loser,0,10,0,-92,1564718400,1564718400,10
LivingMani,0,10,0,165,1582347600,1592193600,10
NInjas101,0,10,0,45,1601956800,1607230800,10
0OOOOOOOOO0,0,10,0,21,1571371200,1612069200,10
popporn,0,10,0,81,1592193600,1592798400,10
bigchilesucks,1,9,8,490,1598414400,1600401600,10
Fuuuuuckmyliiiiifee,0,10,0,68,1602129600,1604898000,10
Grace_Omega,0,10,0,50,1598241600,1608958800,10
Ankerjorgensen,0,10,0,268,1597982400,1605502800,10
TerraWristt,0,10,0,55,1562558400,1592452800,10
owjfaigs222,1,9,12,6,1585627200,1585800000,10
BirdsSmellGood,0,10,0,70,1580274000,1608008400,10
Sivasamy,2,8,167,38,1599105600,1602648000,10
linabliu,0,10,0,33,1606798800,1611896400,10
InsomniaMelody,0,10,0,31,1582866000,1590465600,10
CandyHeadass,0,10,0,-10,1600747200,1602648000,10
nbailey73,1,9,45,50,1578373200,1603771200,10
GhostC1pher,0,10,0,163,1603598400,1605675600,10
Djinnwrath,0,10,0,124,1586404800,1588392000,10
willmeme4crypto,1,9,3,-10,1581310800,1581397200,10
Jaycoht,0,10,0,20,1599537600,1605934800,10
TabascoDan9,0,10,0,63,1607662800,1612155600,10
GrimesGolden,1,9,29,243,1571803200,1578459600,10
werewolfhunger,6,4,314,459,1578546000,1606366800,10
iSaidItOnReddit85,0,10,0,101,1602129600,1605243600,10
MillenniumGreed,2,8,1245,162,1562817600,1607490000,10
Andym2019,0,10,0,-42,1575781200,1575867600,10
fourninefive31,0,10,0,166,1594440000,1597118400,10
YouSuffer,0,10,0,180,1567051200,1604116800,10
chickenismurder,0,10,0,387,1609390800,1609477200,10
pacinothere,9,1,439,6,1559534400,1574485200,10
Squids4daddy,0,10,0,19,1581915600,1592193600,10
PepinLeBref,0,10,0,79,1572494400,1607662800,10
Bigguybroadway2020,0,10,0,51,1600747200,1609304400,10
RoadRunner71,1,8,83,57,1582952400,1595476800,9
ThatsNotPossibleMan,0,9,0,124,1573534800,1598068800,9
MariusIsMe,0,9,0,27,1581397200,1599105600,9
LeninWasRight69_420,0,9,0,96,1600488000,1602993600,9
Gnosweor,1,8,62,48,1577336400,1579582800,9
iGough,0,9,0,-7,1558152000,1580101200,9
ronn7x,0,9,0,90,1593835200,1597636800,9
RojavaLover,0,9,0,9,1607576400,1608526800,9
CommercialMath6,0,9,0,11,1595563200,1595822400,9
zerofallen1,0,9,0,60,1561953600,1597636800,9
allmyheroeskillcops6,0,9,0,91,1548133200,1554177600,9
enderparadise,5,4,53,18,1545195600,1552795200,9
xNovaz,0,9,0,68,1550379600,1551416400,9
Red-White-Green,2,7,215,79,1593144000,1600056000,9
bloxerator,2,7,414,26,1593316800,1596859200,9
queenofcabinfever777,0,9,0,22,1585108800,1601697600,9
MattR9590,1,8,35,18,1569297600,1585108800,9
the-igloo,0,9,0,124,1574658000,1592280000,9
MaggieTheCat515,2,7,63,32,1591934400,1607662800,9
garjian,0,9,0,26,1585800000,1607922000,9
magnFLOR,0,9,0,38,1591848000,1602129600,9
katt3985,0,9,0,71,1570939200,1609390800,9
ayanoyamada,0,9,0,22,1609131600,1611723600,9
DoctorTobogggan,1,8,402,154,1575694800,1602734400,9
Dilsosos,0,9,0,-2,1577250000,1582866000,9
CaulkinCracks,0,9,0,-33,1605070800,1608526800,9
What_Mom,0,9,0,30,1599451200,1611982800,9
Hexx22,0,9,0,-50,1552363200,1555387200,9
old-shaggy,0,9,0,-113,1554955200,1576818000,9
work_is_ass,1,8,46,20,1572753600,1572843600,9
buzzlite,0,9,0,176,1600315200,1608181200,9
TheFatherofOwls,1,8,7,184,1600228800,1612069200,9
Notawettowel,3,6,1671,145,1573448400,1605848400,9
crankygrumpy,0,9,0,55,1566964800,1604116800,9
bwagner777,0,9,0,133,1573707600,1584763200,9
fuckmyboss221,2,7,134,52,1602734400,1604552400,9
Con_McWhite,1,8,7,57,1558497600,1612069200,9
huonong2,0,9,0,-18,1584072000,1599019200,9
Skills-,2,7,24,53,1579237200,1580706000,9
KLakocy,0,9,0,-14,1573275600,1583899200,9
Garbear104,0,9,0,34,1603512000,1603598400,9
Weather53,0,9,0,85,1580274000,1582606800,9
DirtyPenPalDoug,0,9,0,44,1611723600,1612328400,9
c0lumbiner,0,9,0,130,1572321600,1572753600,9
Tastingo,0,9,0,178,1547701200,1594008000,9
ebam,0,9,0,60,1548565200,1603166400,9
thezoomies,0,9,0,53,1545627600,1585800000,9
rush22,0,9,0,20,1574658000,1599192000,9
CaneLoco,0,9,0,-184,1605070800,1607749200,9
stimpfo,0,9,0,447,1593748800,1607922000,9
thedoug12345678,0,9,0,640,1595995200,1607749200,9
DocJeckel,1,8,35,31,1567483200,1592884800,9
Melkutus,0,9,0,88,1568174400,1607490000,9
seejoshrun,1,8,8,1,1600228800,1609650000,9
hardheaded62,0,9,0,-103,1588996800,1599105600,9
lardtard123,0,9,0,23,1606712400,1608526800,9
dilly2x,1,8,5,80,1571112000,1586318400,9
eleikojoe,0,9,0,97,1578459600,1605157200,9
MishaAaron,0,9,0,179,1605416400,1609477200,9
kcrawford85,0,9,0,63,1597464000,1599105600,9
dortmund-ist-gut,1,8,15,22,1600920000,1611982800,9
Medium-Refrigerator,0,9,0,42,1578805200,1590206400,9
Garshy,0,9,0,121,1575262800,1605934800,9
t0ldyouso,0,9,0,135,1576731600,1607835600,9
Beeblebroxologist,0,9,0,61,1577250000,1599278400,9
technol0G,0,9,0,48,1565496000,1588996800,9
vitaminx-x_x,0,9,0,52,1574917200,1580274000,9
chococatc,2,7,77,58,1599278400,1600488000,9
jplayd,0,9,0,35,1556164800,1602907200,9
NaRa0,0,9,0,199,1579928400,1611896400,9
galapagosh,2,7,33,23,1560312000,1595908800,9
Edy_Birdman_Atlaw,0,9,0,74,1569297600,1605675600,9
PowerVerse_,0,9,0,70,1592712000,1592884800,9
thepromise75,2,7,127,37,1563249600,1580792400,9
VelcroEnthusiast,0,9,0,251,1557547200,1562385600,9
willrateyournudes,0,9,0,23,1592366400,1600228800,9
Just_a_Lurker2,0,9,0,8,1606971600,1607490000,9
Fluffysugarlumps,2,7,293,63,1597982400,1605589200,9
zifer24,3,6,834,24,1606021200,1608094800,9
Writer_but_have_ADHD,1,8,2524,276,1590897600,1591329600,9
AlsionGrace,0,9,0,21,1605589200,1608958800,9
Blue-Toaster,0,9,0,62,1564027200,1612155600,9
run_for_the_shadows,1,8,298,178,1573534800,1596254400,9
Gorkanator,1,8,441,27,1604293200,1609218000,9
thorluther,0,9,0,40,1569470400,1582693200,9
margoquinn,0,9,0,37,1588478400,1589169600,9
PaintSniffer69,7,2,1473,7,1507867200,1553659200,9
snuckyballs,0,9,0,-16,1578546000,1578891600,9
SweJake,0,9,0,41,1605157200,1612155600,9
a9dnsn,1,8,237,58,1566360000,1582779600,9
somdtoh,1,8,8,15,1609131600,1609477200,9
cosminahk,3,6,10499,56,1593662400,1605762000,9
Elizabeth_Flynn,0,9,0,151,1550379600,1584244800,9
theghostofme,0,9,0,94,1578200400,1611896400,9
Degree-Weird,1,8,250,548,1604984400,1607230800,9
4ironblocks1pumpkin-,0,9,0,86,1595390400,1600574400,9
tcboswell95,0,9,0,42,1559707200,1575349200,9
very_betic,2,7,20,95,1572667200,1600228800,9
SunshineW0lf,0,9,0,12,1606971600,1607144400,9
angel_of_afterlife,0,9,0,35,1584590400,1584936000,9
LittleBookOfRage,0,9,0,25,1599710400,1599796800,9
FCKWPN,0,9,0,131,1584244800,1609304400,9
Ehcksit,0,9,0,142,1574398800,1604116800,9
enneseven,1,8,22,46,1591675200,1599796800,9
HarryA17,0,9,0,14,1565582400,1573275600,9
SeanCanary,0,9,0,43,1580446800,1606971600,9
p4prik4,3,6,48,15,1580101200,1594872000,9
Xano40,1,8,16,14,1552795200,1553313600,9
elbitjusticiero,0,9,0,38,1577422800,1609390800,9
Hyper31337,0,9,0,91,1592366400,1604552400,9
ZenRit,2,7,58,22,1569902400,1592798400,9
MmmmmmmZadi69,0,9,0,107,1592971200,1608613200,9
dirkie_1325,0,9,0,-88,1572321600,1581051600,9
lewis_von_altaccount,0,9,0,129,1572753600,1588478400,9
IRnotPANTS,0,9,0,17,1584417600,1606885200,9
magical_elf,0,9,0,552,1599105600,1608094800,9
_BAMBOOZLE_,0,9,0,54,1567310400,1587009600,9
Bathkitty,0,9,0,44,1585627200,1606453200,9
ihopeirememberthisun,0,9,0,182,1570766400,1593921600,9
jonnytechno,8,1,1622,4,1602475200,1608958800,9
thegreatestrobot3,0,9,0,73,1600401600,1608699600,9
Moo58,3,6,717,106,1564372800,1589688000,9
iWantToBeARealBoy,0,9,0,35,1607230800,1608094800,9
oasinocean,0,9,0,116,1572667200,1606280400,9
NishVar,0,9,0,3,1606539600,1606626000,9
Fluttyman,0,9,0,61,1607144400,1609045200,9
Pettyofficervolcott,0,9,0,20,1580706000,1603684800,9
BANGSBASS,0,9,0,12,1571112000,1571198400,9
rediraim,0,9,0,50,1575176400,1575349200,9
oopswizard,0,9,0,60,1598414400,1606885200,9
sleepylittlesnake,0,9,0,61,1565668800,1595476800,9
bstanfordb,0,9,0,31,1598500800,1608267600,9
Daily_the_Project21,0,9,0,-38,1599710400,1600833600,9
TurkeyFisher,1,8,5,14,1596945600,1603512000,9
NecstNecstNecst,0,9,0,-54,1597636800,1597723200,9
fringeandglittery,0,9,0,206,1588910400,1609218000,9
4ScreensAtWork,1,8,51,17,1599537600,1601265600,9
force_storm,0,9,0,19,1566532800,1595304000,9
RumpelstiltskinIX,0,9,0,261,1576126800,1604984400,9
MemesXDCawadoody,0,9,0,70,1562558400,1587355200,9
MidnightSloppies,0,9,0,37,1598846400,1605589200,9
Madxgoat,0,9,0,99,1558843200,1583125200,9
PatToole,0,9,0,58,1579755600,1580014800,9
hoedownturnup,2,7,794,45,1592280000,1601092800,9
FiniteEarth,1,8,98,28,1576645200,1576818000,9
soulgiver666,0,9,0,92,1576731600,1582434000,9
WorldlyPlace,1,8,82,512,1572235200,1608094800,9
Bob82794882,0,9,0,33,1547269200,1547355600,9
PlantainNationalism,0,9,0,-6,1562558400,1562731200,9
HerNameIsVoid,0,9,0,91,1580965200,1603080000,9
weednaps,2,7,35,21,1568174400,1601956800,9
unrequited_dream,0,9,0,100,1573707600,1578891600,9
Trioxidus,0,9,0,38,1605157200,1607835600,9
aliceroyal,0,9,0,104,1564891200,1587268800,9
shadowwesley77,1,8,122,55,1602907200,1608699600,9
marcm6246,0,9,0,91,1553140800,1553313600,9
thepfoneguy,0,9,0,193,1594008000,1606194000,9
hamonbry,0,9,0,16,1606885200,1612069200,9
notapersonplacething,1,8,8,47,1483506000,1600574400,9
cudipi,0,9,0,215,1593748800,1603512000,9
Wingsocks,1,8,9,63,1567483200,1575694800,9
nnyforshort,0,9,0,63,1597723200,1609304400,9
grungepants,2,7,343,49,1573275600,1595822400,9
Shwaa4lyfe,2,7,1533,-1,1561089600,1597550400,9
Pyroarcher99,0,9,0,71,1577854800,1588305600,9
swimoffunder,0,9,0,14,1550293200,1550725200,9
WompaPenith,0,9,0,790,1591675200,1606971600,9
conscsness,0,9,0,33,1598932800,1599969600,9
fecundissimus,0,9,0,148,1591848000,1592020800,9
_y0uR_m0M,3,6,4834,21,1592193600,1607662800,9
Noticesthings42069,0,9,0,60,1601611200,1611982800,9
kasira,0,9,0,93,1540180800,1581310800,9
Absurd_Absurdity,0,9,0,53,1599105600,1607144400,9
kingleir306,0,9,0,26,1573707600,1608181200,9
redgrevsmoker,0,9,0,66,1571371200,1607662800,9
IveeLaChatte,1,8,16,77,1581397200,1603857600,9
InfiniteTesseract,0,9,0,18,1612328400,1612501200,9
purrsntea,1,8,13,12,1607317200,1607490000,9
feeling_impossible,3,6,695,761,1575608400,1592712000,9
SandS5000,0,9,0,-48,1540094400,1599105600,9
AgoristGang,0,9,0,71,1576213200,1587355200,9
FerriteNightwish,0,9,0,268,1580274000,1584417600,9
tfitch2140,0,9,0,476,1566878400,1575262800,9
ProlesOfBikiniBottom,6,3,620,11,1593835200,1607662800,9
Dansredditname,1,8,38,37,1577163600,1607403600,9
hahahannah9,0,9,0,96,1579410000,1594699200,9
anonymousradio,1,8,16,25,1609045200,1609390800,9
helgothjb,0,9,0,13,1605502800,1607317200,9
ciel_lanila,0,9,0,135,1574398800,1608008400,9
TaxSeasoning,0,9,0,-55,1592366400,1598673600,9
gucci_gang_,0,9,0,157,1574398800,1608181200,9
ferelpuma,0,9,0,74,1578114000,1604984400,9
TheHaleyGrail,0,9,0,41,1569556800,1571112000,9
POOP_FUCKER,0,9,0,47,1547010000,1548824400,9
VariesRarely,0,9,0,31,1601611200,1603771200,9
wokewood,0,9,0,9,1603425600,1603512000,9
buntren,0,9,0,28,1571803200,1571976000,9
scottie2haute,0,9,0,43,1604293200,1609390800,9
bhedesigns,0,9,0,61,1575262800,1581483600,9
ScientificVegetal,0,9,0,247,1579928400,1608354000,9
Elliottstrange,0,9,0,31,1599019200,1599537600,9
ha1zum,0,9,0,51,1598932800,1607576400,9
WakingForNothing,1,8,55,15,1542085200,1542517200,9
occupy-bread,0,9,0,43,1507867200,1508212800,9
iwatchppldie,0,9,0,66,1566532800,1608958800,9
ludakris,0,9,0,118,1546491600,1609045200,9
cadeawayy,1,8,274,276,1602561600,1604293200,9
Delicatesseract,0,9,0,37,1576386000,1609304400,9
fetus-wearing-a-suit,0,9,0,67,1605762000,1606194000,9
jammerparty,0,9,0,-53,1575522000,1578114000,9
SnooHedgehogs2554,0,9,0,30,1605070800,1605934800,9
WheresWeeezy,0,9,0,267,1560139200,1577422800,9
negativekarz,0,9,0,530,1571630400,1579928400,9
that_nagger_guy,0,9,0,5,1593489600,1597291200,9
CrimsonFoxes,0,9,0,103,1596859200,1599624000,9
najevb2,1,8,94,112,1569988800,1578286800,9
ApexVirtuoso,0,9,0,8,1593576000,1594785600,9
brokenandtired1,2,7,19,14,1606280400,1606712400,9
GeneralBamisoep,0,9,0,185,1577422800,1602820800,9
thisisnotarealname19,0,9,0,74,1600920000,1606971600,9
Kungsooi,0,9,0,38,1607662800,1612242000,9
TrannosaurusRegina,0,9,0,188,1541044800,1607835600,9
Pimecrolimus,0,9,0,77,1605330000,1611982800,9
bigbutchbudgie,1,8,5,243,1570420800,1574226000,9
comicsandpoppunk,0,9,0,-54,1596168000,1597550400,9
RD_1982,0,9,0,36,1573189200,1578891600,9
PlazmaSnake417,0,9,0,61,1595304000,1611896400,9
AalphaQ,1,8,10,182,1573362000,1611896400,9
glowdirt,1,8,37,17,1605848400,1605934800,9
voe111,0,9,0,38,1577854800,1578027600,9
ilovedrivethrus,0,9,0,116,1596686400,1611810000,9
libraintrovert,1,8,13,16,1593576000,1594267200,9
Dw3yN,1,8,66,23,1571630400,1575694800,9
mashtartz,0,9,0,235,1603425600,1606885200,9
YorkMason,1,8,52,60,1576040400,1584936000,9
RapedBySeveral,0,9,0,-7,1596945600,1606885200,9
jmintheworld,0,9,0,-5,1584504000,1584590400,9
vkgkdksksk,0,9,0,44,1595044800,1605502800,9
Bond16,1,8,10,51,1595044800,1598500800,9
ccbeastman,0,9,0,351,1560571200,1585108800,9
Magicpaper2018,1,8,65,28,1582261200,1582520400,9
Derpyderbdaddy,0,9,0,43,1576558800,1597291200,9
Au2o,1,8,0,-34,1576386000,1600660800,9
IAbsolutelyLoveCocks,0,9,0,561,1593057600,1609390800,9
severeXD,0,9,0,123,1576126800,1611982800,9
baked_potato_bae,0,9,0,36,1588132800,1608526800,9
blurpadinka,0,9,0,43,1593835200,1608872400,9
Dobis_PR99,1,8,340,123,1589342400,1589947200,9
Dumbass1171,0,9,0,-106,1601870400,1611896400,9
TheresNoCultHere,0,9,0,51,1554091200,1557892800,9
anonymous9021,2,7,96,24,1591329600,1603857600,9
nekomancey,0,9,0,-45,1548565200,1548651600,9
Mattallurgy,0,9,0,158,1561780800,1608786000,9
Hacksignify,1,8,29,46,1576990800,1588996800,9
RatBaby42069,0,9,0,130,1578805200,1596686400,9
BlackHorse2019,2,7,1813,137,1568001600,1575176400,9
VibraniumDerek,0,9,0,14,1597896000,1599796800,9
WhatDo-I-DoNow,3,6,37,45,1588651200,1608440400,9
wildlinglover19,0,9,0,-9,1568606400,1568692800,9
MendelevandDongelev,0,9,0,46,1597291200,1611896400,9
HecknChonker,0,9,0,164,1601611200,1607835600,9
kungfukenny3,0,9,0,23,1608699600,1611810000,9
Investigator_First,0,9,0,34,1597809600,1600228800,9
ilikesoy_,0,9,0,275,1581397200,1598241600,9
notoriouscardio,1,8,7,106,1579842000,1607403600,9
ForgotPassAgain34,0,9,0,251,1593230400,1601265600,9
RatCity617,0,9,0,344,1572494400,1603598400,9
levian_durai,0,9,0,26,1569211200,1569211200,9
Embryonico,1,8,8,213,1593403200,1607662800,9
Vorty-Vort,1,8,18,49,1549861200,1571371200,9
Sorel_CH,0,9,0,31,1552276800,1606798800,9
Temporary_Salad4819,2,7,57,34,1600747200,1605848400,9
lootingyourfridge,0,9,0,154,1533355200,1549429200,9
chilari,0,9,0,32,1611637200,1612155600,9
iheartennui,0,9,0,26,1537848000,1575176400,9
PM_ME_CUTE_SMILES_,0,9,0,7,1572062400,1599624000,9
testecles_the_great,0,9,0,99,1550206800,1552622400,9
FuckRyanSeacrest,0,9,0,44,1535601600,1551675600,9
guilhermefdias,0,9,0,1,1543381200,1582866000,9
Dream_On_Track,0,9,0,20,1602907200,1603080000,9
DumbNeurosurgeon,0,9,0,200,1593057600,1607317200,9
DisembarkEmbargo,0,9,0,104,1587182400,1602043200,9
Impossible-One6033,0,9,0,-167,1607403600,1607576400,9
time_is_valuable,0,9,0,123,1579755600,1598760000,9
soggy_again,0,9,0,65,1600056000,1607749200,9
Shrimpits,1,8,10,41,1595131200,1600228800,9
jwak4g78qk,0,9,0,6,1605589200,1605589200,9
Thejared138,0,9,0,44,1588219200,1599624000,9
JessicaFromBarovia,0,9,0,114,1564545600,1611637200,9
unfortunate-sunn,0,9,0,155,1597291200,1602302400,9
propita106,0,9,0,18,1606626000,1608699600,9
squiddlumckinnon,0,9,0,34,1560139200,1585454400,9
PrinceOfCups13,0,9,0,33,1541912400,1589342400,9
fvevvvb,0,9,0,4,1604466000,1609477200,9
__secter_,0,9,0,14,1559707200,1585108800,9
plant_van,0,9,0,33,1595822400,1608440400,9
The_Holy_Bison,1,8,45,216,1582866000,1601870400,9
Pistol_YouAThrowAway,2,7,173,51,1551157200,1551416400,9
Thausgt01,2,7,124,190,1569384000,1586059200,9
Antisorq,0,9,0,59,1599796800,1603252800,9
mookerson,0,9,0,-17,1582088400,1583899200,9
hijabimommabear,0,9,0,70,1570507200,1581483600,9
takedownhisshield,3,6,32,15,1572235200,1579496400,9
bumpyshtunkus,1,8,9,155,1590724800,1602043200,9
TheHollowJester,0,9,0,26,1573794000,1609477200,9
pyrocat,0,9,0,113,1592280000,1611896400,9
DoctorTsu,0,9,0,154,1583038800,1602129600,9
Hiipstercoffee,1,8,81,87,1577509200,1606453200,9
illiterateignoramus,0,9,0,19,1557633600,1589860800,9
jubba_,0,9,0,67,1553832000,1599192000,9
Mjt8,0,9,0,4,1574744400,1602820800,9
BadgerBob777,1,8,22,6,1602216000,1602388800,9
Lol_maga_people,0,9,0,46,1576558800,1611982800,9
Chipchow,0,9,0,73,1607922000,1611896400,9
RoverFutbol10,1,8,42,23,1599796800,1599969600,9
ItsAJackal21,2,7,1015,134,1598932800,1609131600,9
saint7412369,0,9,0,4,1593576000,1595217600,9
orourkean,0,9,0,68,1593144000,1593144000,9
initiationviper,1,8,35,186,1581051600,1604379600,9
AndrewKorzeniewski,1,8,23,70,1570420800,1573966800,9
sgbchncvhhrtyr,0,9,0,582,1608267600,1609477200,9
WithThe_Frizz-NoWay,0,9,0,123,1595649600,1609218000,9
lacroixblue,0,9,0,316,1585713600,1604984400,9
Troklokhan,0,9,0,79,1596427200,1607922000,9
Chickenwomp,0,9,0,210,1575608400,1581915600,9
aproofisaproof,3,6,871,148,1546491600,1549342800,9
McBroha,1,8,42,20,1534478400,1534564800,9
skinny1penis,0,9,0,14,1608613200,1609304400,9
JuneCapa,0,9,0,-2,1554091200,1554350400,9
humdrum_sebby,0,9,0,67,1605330000,1608786000,9
Excellent_Potential,0,9,0,76,1606453200,1612155600,9
Moonandserpent,0,9,0,45,1597723200,1603512000,9
mucus_membrain,0,9,0,132,1587096000,1592884800,9
notjordansime,0,9,0,50,1597636800,1606021200,9
donutdumpster,1,8,46,98,1570852800,1589601600,9
Metix59,0,9,0,-29,1585454400,1585540800,9
JeffreyDhmer,7,2,1656,34,1553745600,1606712400,9
silversprout,0,9,0,52,1586318400,1587355200,9
Wave_city_music,6,3,122,30,1580706000,1582002000,9
bigfatmiss,0,9,0,126,1605243600,1608786000,9
andydude44,0,9,0,86,1572235200,1605502800,9
thinkB4WeSpeak,0,9,0,415,1560916800,1611982800,9
rinnip,0,9,0,-4,1585454400,1585627200,9
Jax19n2,0,9,0,-18,1579496400,1579582800,9
ProlapsedUrethraWorm,2,7,133,15,1550725200,1556424000,9
BroDudeBruhMan,0,9,0,989,1594267200,1605762000,9
gabu87,0,9,0,30,1603339200,1608786000,9
WarInMyHead666,0,9,0,40,1583557200,1587182400,9
khlnmrgn,1,8,294,103,1569556800,1591416000,9
Escapedtheasylum,0,9,0,119,1565582400,1606798800,9
kzeash,0,9,0,58,1601438400,1601524800,9
autotldr,0,9,0,21,1429416000,1534478400,9
StoneHolder28,0,9,0,13,1585454400,1585454400,9
telafonecommunist,2,7,55,41,1552021200,1558152000,9
Noobsdie4eva,0,9,0,60,1598500800,1606971600,9
NearbyCitron,1,8,21,49,1598846400,1601697600,9
FlomanNYY1,0,9,0,33,1588651200,1600488000,9
yankeewhiskyzulu,0,9,0,-6,1569124800,1569124800,9
fascist_mods_fuckoff,1,8,88,56,1543813200,1589601600,9
seeker135,0,9,0,56,1584849600,1586836800,9
sunbear1994,4,5,994,94,1551243600,1585108800,9
mrtightywhity,1,8,485,22,1601956800,1605157200,9
SullivansPants,0,9,0,5,1597291200,1597291200,9
DrummerBound,0,9,0,299,1576299600,1602820800,9
pops_secret,0,9,0,39,1589515200,1608613200,9
FoxCQC,1,8,65,74,1587873600,1611982800,9
sarra1833,0,9,0,31,1607058000,1609218000,9
theBirdjudge,0,9,0,14,1593057600,1593144000,9
DannyTTT55,1,8,12,40,1602993600,1603166400,9
Turds_McCool,1,8,552,155,1552107600,1561608000,9
Stryker0777,0,9,0,274,1569988800,1587960000,9
sirspidermonkey,0,9,0,289,1594353600,1609304400,9
otherhand42,0,9,0,296,1541131200,1609304400,9
Yoshi_Yoshisaur,0,9,0,-9,1593662400,1594612800,9
SocialistMinute,1,8,23,13,1600056000,1600228800,9
crityouallday,0,9,0,34,1561608000,1593576000,9
the_ape_speaks,0,9,0,50,1598328000,1604293200,9
IintheSky89,0,9,0,52,1597982400,1609218000,9
anotherfuckingpsycho,1,8,26,18,1584417600,1584504000,9
tangowilde,0,9,0,20,1597032000,1606280400,9
d-bone01,0,9,0,98,1573362000,1608699600,9
RetroRPG,0,9,0,-6,1561694400,1561780800,9
seekingalphaftw,0,9,0,-57,1598328000,1605675600,9
hana_c,0,9,0,40,1599019200,1603771200,9
odd_hami,0,9,0,160,1558411200,1563249600,9
two_cat_morty,0,9,0,159,1596340800,1603684800,9
cannon_soldier,0,9,0,6,1559707200,1559793600,9
TrippingBollocks,4,5,987,10,1574485200,1588910400,9
RADneckRad,0,9,0,88,1564718400,1606280400,9
Galphanore,0,9,0,151,1598328000,1609218000,9
lds43,0,9,0,418,1581483600,1583038800,9
Th3-Dude-Abides,0,9,0,70,1604898000,1608526800,9
TheMagicMrWaffle,0,9,0,88,1550552400,1578200400,9
pleurplus,0,9,0,100,1552276800,1556078400,9
-ghostinthemachine-,0,9,0,264,1558411200,1589688000,9
hyasbawlz,0,9,0,141,1596686400,1596772800,9
jcollins052,0,9,0,22,1585108800,1591243200,9
BaltarsCult,0,9,0,38,1582606800,1609304400,9
eipten,3,6,93,68,1572843600,1611810000,9
jawkneecache,0,9,0,58,1550293200,1561435200,9
rhm1989,1,8,8,123,1552708800,1597550400,9
bl0ndie5,1,8,0,-160,1606021200,1608699600,9
Sus_Ana,0,9,0,49,1592971200,1609477200,9
AtTimesRedditIsGood,0,9,0,12,1599710400,1599796800,9
sarlach,1,8,49,17,1600833600,1603684800,9
peekamin,0,9,0,23,1602734400,1602820800,9
RadioactiveGrrrl,0,9,0,37,1569988800,1576213200,9
Jebusthelostwookie,0,9,0,162,1558411200,1608699600,9
Senriaa,0,9,0,47,1581742800,1584676800,9
NoTakaru,0,9,0,105,1557460800,1575694800,9
3lRey,0,9,0,0,1546405200,1572408000,9
CaptainUnreliable,0,9,0,86,1592798400,1592798400,9
fodderforpicard,0,9,0,100,1581138000,1609218000,9
PrestigiousGur6,1,8,10,32,1600315200,1602388800,9
WifiKeyHolder,0,9,0,-69,1581829200,1591502400,9
CavalryLove,0,9,0,25,1597896000,1600574400,9
MEGACODZILLA,0,9,0,170,1576904400,1608354000,9
nukedcheesynuggets,0,9,0,15,1597204800,1606453200,9
mannamachines,1,8,133,45,1594353600,1594440000,9
fadedblackleggings,0,9,0,125,1579669200,1597032000,9
PartyMark,0,9,0,106,1574312400,1607230800,9
Fully_Automated,2,7,864,50,1539921600,1607835600,9
Onlyfurrcomments,0,9,0,-7,1601265600,1603512000,9
3rdmemberofOUTKAST,0,9,0,108,1560312000,1562731200,9
KevinReems,0,9,0,66,1570507200,1600833600,9
iandmlne,0,9,0,23,1572235200,1577854800,9
2821568,0,9,0,-5,1558238400,1584763200,9
lasthopel,0,9,0,72,1581051600,1601697600,9
1998hiphop,0,9,0,24,1589860800,1597809600,9
AlertArumugam,1,8,31,69,1587960000,1600315200,9
Ainsleygz,0,9,0,59,1569988800,1580878800,9
intlharvester,0,9,0,70,1580014800,1581915600,9
loop_42,0,9,0,123,1576386000,1576990800,9
wifebeatingchampion,5,4,1,3,1544936400,1544936400,9
Dofork,0,9,0,6,1608699600,1608786000,9
Throwawayacccounts,0,9,0,40,1600747200,1606626000,9
Kh4rj0,0,9,0,71,1586923200,1607576400,9
heavensghoul,0,9,0,79,1571889600,1571889600,9
frostysauce,0,9,0,247,1589860800,1600574400,9
freedandelions,0,9,0,99,1567483200,1602129600,9
anonymity_anonymous,0,9,0,314,1584158400,1587614400,9
Myprivatelifeisafk,0,9,0,28,1550811600,1575349200,9
TheBiggestCornField,1,8,22,62,1588824000,1606194000,9
I_Love_Dead_Cops,0,9,0,10,1576472400,1576558800,9
Panigg,0,9,0,254,1576990800,1607576400,9
Glasseshalf,0,9,0,75,1605330000,1606539600,9
39thversion,0,9,0,86,1602475200,1606626000,9
therealEliKubrick,0,9,0,31,1609390800,1609995600,9
HailtoPorn213,0,9,0,145,1606712400,1609304400,9
Danster21,0,9,0,90,1595304000,1607922000,9
taway228e84859,0,9,0,67,1587268800,1588392000,9
SirRandyMarsh,0,9,0,-33,1577336400,1577336400,9
Sir_Balmore,1,8,526,42,1592971200,1596513600,9
Lord-Vortexian,0,9,0,154,1573621200,1605934800,9
bluebogle,2,7,579,104,1593748800,1609304400,9
Treg_Marks,0,9,0,38,1604379600,1606712400,9
gickelson,1,8,165,17,1595908800,1595908800,9
DontCareJustDont,0,9,0,-16,1571112000,1571198400,9
LegitCummer,0,9,0,-252,1589688000,1590638400,9
FangedFucker,1,8,29,9,1608181200,1609390800,9
Wandering_Ranger,0,9,0,38,1593230400,1604898000,9
major-DUTCH-Schaefer,0,9,0,20,1599796800,1607144400,9
Dr_Jan_Itorr,0,9,0,-24,1607576400,1607662800,9
Nalatu,0,9,0,35,1601956800,1603684800,9
ScarlettJoy,0,9,0,6,1585454400,1585540800,9
tobiasvl,0,9,0,302,1548910800,1584158400,9
snowmama0,0,9,0,75,1593230400,1601524800,9
doktormane,0,9,0,-3,1575522000,1603339200,9
naMedraGtnavA,0,9,0,74,1569384000,1574139600,9
dbumba,0,9,0,768,1561348800,1605157200,9
Blvd_Knight,0,9,0,400,1575349200,1580619600,9
DonBullDor,0,9,0,119,1559188800,1560312000,9
BillllyOcean,0,9,0,79,1548738000,1597809600,9
klyrish,0,9,0,510,1571371200,1607490000,9
NihilistDandy,0,9,0,106,1566792000,1590033600,9
Vivee10,2,7,71,32,1567569600,1571025600,9
I_Do_Cannabis_Stuff,0,9,0,187,1599105600,1608872400,9
konahaku,0,9,0,65,1554177600,1560484800,9
stevebostonian,0,9,0,-26,1583557200,1585886400,9
masterfountains,0,9,0,349,1598846400,1605934800,9
redditbunnies,1,8,3,12,1597291200,1597982400,9
its_the_gentleman,1,8,38,41,1578373200,1578373200,9
telewebb,1,8,623,143,1548046800,1558411200,9
Main_Aspect,0,9,0,37,1601092800,1608008400,9
AmbiguousMonk,0,9,0,121,1593057600,1603684800,9
Maxweallth666,1,8,4,58,1572321600,1574398800,9
shigabaloop,3,6,102,25,1591588800,1608267600,9
DurandelTheSword,1,8,281,111,1558152000,1563249600,9
Joel_Hirschorrn,1,8,67,65,1562644800,1576299600,9
hank10111111,1,8,46,48,1575954000,1590552000,9
star-memer,1,8,255,69,1606885200,1606971600,9
cheezbargar,0,9,0,25,1596600000,1608440400,9
leyacin,0,9,0,27,1590724800,1611896400,9
Wazzerachi,0,9,0,26,1589601600,1589947200,9
-scotsman-,0,9,0,39,1586750400,1594958400,9
winds0fchange19,1,8,146,44,1593489600,1593576000,9
metal_citadel,0,9,0,40,1561262400,1591588800,9
HubertMueller,2,7,6387,38,1596168000,1609477200,9
DroppedNotes,0,9,0,60,1578632400,1589688000,9
theblindowl3,0,9,0,40,1602216000,1608958800,9
ambitechstrous,0,9,0,229,1556251200,1601179200,9
v7bennett,0,9,0,36,1584417600,1593057600,9
3WeeksEarlier,0,9,0,145,1575262800,1576904400,9
clld8719,0,9,0,62,1593144000,1596254400,9
blazingbunny,0,9,0,38,1573016400,1582434000,9
blinddivine,0,9,0,55,1585540800,1604293200,9
Ludovico,0,9,0,66,1605934800,1608526800,9
sybban,0,9,0,30,1609304400,1609304400,9
BoomSoonPanda,2,7,598,17,1572930000,1608786000,9
spysappenmyname,0,9,0,154,1578027600,1578459600,9
LilBoopy,0,9,0,125,1587009600,1587009600,9
AnarchE_NoCap,2,7,360,146,1606280400,1606885200,9
kremlinhelpdesk,0,9,0,17,1603598400,1608786000,9
mufassil,0,9,0,73,1576731600,1608267600,9
wtfunhbt,0,9,0,112,1573966800,1596254400,9
Daniyki,0,9,0,30,1606539600,1606885200,9
Federalists2_0,1,8,9,1,1593230400,1597377600,9
yeuzinips,0,9,0,153,1600833600,1608181200,9
cyber__pagan,1,8,11,63,1535256000,1554177600,9
D3R1CK84,1,8,6,12,1586232000,1587614400,9
toriseesyou,3,6,104,14,1578978000,1587009600,9
Mr_Barry_Shitpeas,0,9,0,21,1602648000,1608181200,9
WhyAmIThereAnyway,0,9,0,65,1567569600,1600833600,9
Nectarine_Complete,0,9,0,82,1602561600,1605416400,9
kynelly360,1,8,73,27,1605243600,1605589200,9
LibertarianByTrade,0,9,0,-76,1582002000,1582002000,9
CompassionateCynic,0,9,0,54,1604293200,1607490000,9
paracog,0,9,0,130,1571976000,1607230800,9
kit-kat315,0,9,0,70,1591934400,1592020800,9
chewycapabara,0,9,0,23,1602734400,1602734400,9
memes_of_norway,0,9,0,7,1611982800,1611982800,9
chopperhead2011,0,9,0,2,1606107600,1606798800,9
Ann_Fetamine,0,9,0,26,1601524800,1604466000,9
SuicidalTidalWave,0,9,0,69,1591588800,1609477200,9
YouWillBeWhatEatsYou,0,9,0,67,1593748800,1605934800,9
wasugol12,0,9,0,-7,1608699600,1608872400,9
LocustsRaining,0,9,0,184,1572062400,1586664000,9
stonecoldcoldstone,0,9,0,33,1594958400,1604030400,9
fairygems,0,9,0,42,1575608400,1580706000,9
pickemquick2020,1,8,73,133,1601784000,1608440400,9
Znexx,5,4,2072,43,1546491600,1587441600,9
whataloadof1m,1,8,63,50,1576472400,1579842000,9
Deathoftheages,0,9,0,-16,1579150800,1579237200,9
Mr12i,0,9,0,595,1598760000,1606626000,9
69imwithstupid69,0,9,0,52,1608958800,1609131600,9
NotElaineBenes,1,8,95,68,1550293200,1603425600,9
quietfryit,9,0,2782,0,1577595600,1601092800,9
shdiekejbwhwkwkkeb,0,9,0,92,1592798400,1596081600,9
greenruins09,5,4,470,10,1586404800,1586664000,9
Bannyflaster,1,8,9,54,1598068800,1605589200,9
buckyVanBuren,0,9,0,9,1576558800,1592366400,9
Mckooldude,0,9,0,349,1592107200,1592107200,9
ptsq,0,9,0,72,1564632000,1607662800,9
Wars1d3,0,9,0,-9,1579928400,1592107200,9
MerseySideAlt9,5,4,303,14,1604811600,1605416400,9
AvatarJack,0,9,0,395,1583812800,1599105600,9
CyberPunkButNotAPunk,1,8,121,121,1571112000,1603771200,9
sampsy39,0,9,0,86,1590552000,1606971600,9
fsociety091786,1,8,115,46,1571976000,1601352000,9
Executive-Time,0,9,0,84,1601784000,1609477200,9
justheretonut,0,9,0,10,1590292800,1597636800,9
Captain_Fingerpaint_,0,9,0,138,1545195600,1570075200,9
Bekah679872,0,9,0,44,1581915600,1597464000,9
TehPinkMenace,0,9,0,59,1573189200,1589688000,9
FuckoffDemetri,0,9,0,-5,1550293200,1550293200,9
Reimustein,1,8,26,16,1596772800,1602820800,9
cluckosaurus,1,8,12,43,1599019200,1602734400,9
vulcantoker,0,9,0,63,1577854800,1606626000,9
bc9toes,0,9,0,45,1554350400,1592798400,9
PooFlingerPotPie,0,9,0,-13,1602734400,1609045200,9
YoMammaSoThin,0,9,0,-13,1606453200,1609218000,9
mattjh6,0,9,0,101,1588824000,1602734400,9
DadOfWhiteJesus,0,9,0,144,1603252800,1611896400,9
hagamuffn,0,9,0,47,1570161600,1573966800,9
something455,0,9,0,-9,1603512000,1603598400,9
GoatCam3000,1,8,13,27,1608613200,1608786000,9
AndrewtheRey,1,8,8,11,1582693200,1608440400,9
lurkervonlurkenstein,0,9,0,56,1573189200,1592884800,9
foureeees,1,8,66,120,1566014400,1591675200,9
Ponyboy80808,0,9,0,648,1572062400,1601265600,9
ScorpionGlitch,0,9,0,111,1592971200,1607576400,9
3345892,3,6,548,51,1604984400,1612069200,9
themaskofgod,0,9,0,22,1578978000,1606712400,9
TimeSpiralNemesis,0,9,0,208,1576731600,1604898000,9
signsoflife620,0,9,0,-31,1589601600,1595649600,9
Beardamus,0,9,0,38,1576558800,1608786000,9
shadowmerefax,0,9,0,56,1599019200,1606798800,9
sentunderscore,0,9,0,38,1580360400,1605675600,9
TempusCavus,0,9,0,111,1595044800,1600574400,9
toakheart,2,7,559,116,1595736000,1595908800,9
MotherFuckinTom,0,9,0,22,1596081600,1600833600,9
the-lurker-204,0,9,0,469,1595563200,1606280400,9
BoringWebDev,0,9,0,67,1606626000,1608699600,9
domstar001,1,8,658,123,1593748800,1601006400,9
breadsmith11,0,9,0,141,1551848400,1567569600,9
free_chalupas,0,9,0,179,1560571200,1576645200,9
herpderp2217,0,9,0,92,1592107200,1603598400,9
Aless-dc,0,9,0,119,1600488000,1605934800,9
Slightspark,0,9,0,24,1561953600,1598673600,9
countontay,2,7,367,57,1603252800,1608094800,9
forsakeme4all,2,7,60,44,1594094400,1612069200,9
AWPerative,1,8,22,90,1593057600,1593144000,9
helpthefish,0,9,0,35,1551762000,1554609600,9
grblwrbl,0,9,0,255,1590379200,1608872400,9
psilocush,0,9,0,145,1599796800,1604552400,9
ultramanjones,0,9,0,40,1587009600,1595304000,9
RarelyMyFault,0,9,0,22,1579669200,1606021200,9
ronitrocket,0,9,0,-15,1601352000,1601524800,9
AngstyZebra,0,9,0,77,1583726400,1585454400,9
alackofcol0r,0,9,0,59,1576731600,1601524800,9
BIGGAYBASTARDRELODED,0,9,0,16,1601956800,1603684800,9
Kobe_AYEEEEE,2,7,177,53,1588219200,1608354000,9
kekexaxamimi,0,9,0,-106,1582606800,1600228800,9
IncompetenceFromThem,0,9,0,49,1598155200,1601870400,9
ksav1370,0,9,0,3,1591329600,1591934400,9
CaiusRemus,0,9,0,51,1600660800,1608699600,9
Clocktease,0,9,0,198,1560398400,1601092800,9
piexil,0,9,0,79,1571716800,1584590400,9
Serdones,0,9,0,14,1585454400,1586404800,9
trevor_of_protopia,1,8,203,66,1593057600,1609304400,9
YoMamaSoFatSheBalls,0,9,0,99,1598155200,1609736400,9
reinschlau,2,7,11,21,1418101200,1456462800,9
RedArmband,0,9,0,35,1608526800,1608526800,9
Wasabii12315,0,9,0,3,1597636800,1597809600,9
MetallHengst,0,9,0,255,1571457600,1588219200,9
angrynobody,1,8,169,82,1597377600,1608526800,9
notexactlyflawless,0,9,0,78,1579669200,1598414400,9
PosadoMasachism,1,8,37,74,1578978000,1612069200,9
Anon91887,0,9,0,78,1561694400,1604203200,9
redditaintfun,0,9,0,130,1567137600,1580619600,9
trippy_hedron89,1,8,11,19,1598328000,1608526800,9
NoraJolyne,0,9,0,19,1568347200,1593403200,9
yogthos,9,0,6070,0,1573794000,1605157200,9
vicious_armbar,0,9,0,28,1603512000,1603598400,9
SilviaNorton,1,8,19,183,1568347200,1575262800,9
SoberEnAfrique,0,9,0,136,1595044800,1611810000,9
UnderscoreWolfgang,0,9,0,110,1570680000,1593748800,9
euphi_thedestroyer,1,8,47,32,1559275200,1562126400,9
moresushiplease,0,9,0,118,1600660800,1600833600,9
rianeiru,0,9,0,261,1555041600,1601870400,9
FarMaintenance4,1,8,58,85,1564113600,1604116800,9
TTJoker,1,8,21,23,1597377600,1608181200,9
creatineRAGE,0,9,0,388,1557806400,1589947200,9
u_r_a_bold_1,0,9,0,10,1599019200,1611982800,9
h4ppy60lucky,0,9,0,77,1598328000,1609218000,9
atavisticautist,0,9,0,136,1576126800,1606712400,9
LeeShawBrown,0,9,0,51,1573189200,1584072000,9
shyrussian,0,9,0,143,1577595600,1601956800,9
DylerTurdon5,0,9,0,26,1606280400,1608872400,9
lvanden,0,9,0,160,1560225600,1572148800,9
ItDoesntGetAnybeTtah,0,9,0,48,1608699600,1609304400,9
Zoey1914,0,9,0,75,1607922000,1608613200,9
Hurion,0,9,0,254,1555905600,1598241600,9
RYAN_BENJAMIN,1,8,47,801,1571803200,1603166400,9
roytay,1,8,19,20,1580965200,1607403600,9
iCircletheDrain,0,9,0,64,1602043200,1606798800,9
Gregduvio,1,8,20,-42,1563854400,1564286400,9
marxwasapedo,0,9,0,1,1606971600,1609304400,9
gat-toter,0,9,0,144,1566964800,1571803200,9
rachelk234,0,9,0,16,1581310800,1581397200,9
DustyGecko,1,8,48,20,1579323600,1579410000,9
Pizzahotsauce508,0,9,0,25,1608094800,1608267600,9
Johnny_the_Goat,0,9,0,562,1573534800,1601524800,9
godagrasmannen,1,8,463,35,1564286400,1564372800,9
glitterycakes,0,9,0,101,1608699600,1609304400,9
HungoverHippy42,1,8,0,38,1598760000,1602820800,9
kingofthemonsters,0,9,0,133,1609390800,1612069200,9
fedup_throwaway37,0,9,0,23,1600747200,1608267600,9
str8Gbro,0,9,0,77,1587009600,1608699600,9
Metabro,0,9,0,54,1559966400,1585022400,9
jamesroberttol,0,9,0,48,1592625600,1604898000,9
pakistanstar,0,9,0,88,1560571200,1566878400,9
sucrilhos,0,9,0,61,1558497600,1602648000,9
tunelesspaper,0,9,0,174,1588392000,1611810000,9
HappyDoggos,0,9,0,57,1585972800,1606798800,9
punishedpanda1,1,8,0,12,1593057600,1605675600,9
TryppySurfer,0,9,0,33,1576213200,1588910400,9
IdiotCharizard,0,9,0,4,1585540800,1598500800,9
AliceJoestar,2,7,368,95,1572408000,1597550400,9
LaMaquinaDePinguinos,1,8,6,-3,1574053200,1579237200,9
resoredo,0,9,0,-99,1597636800,1597723200,9
eternalannglo_,0,9,0,29,1547096400,1582952400,9
jbbbr,0,9,0,77,1597982400,1606971600,9
Night_Nin3,0,9,0,-99,1560139200,1591675200,9
fireinthemountains,0,9,0,189,1573534800,1585022400,9
electric_knight,0,9,0,-50,1565755200,1607403600,9
pickleman_22,1,8,59,80,1581397200,1592193600,9
Tiltedwindmill,0,9,0,112,1544158800,1608699600,9
Jessicajf7,0,9,0,32,1569384000,1606971600,9
d3dmouth33,0,9,0,75,1601092800,1605589200,9
BanksOnFire,0,9,0,34,1588737600,1608440400,9
Lowtan,0,9,0,26,1595908800,1604379600,9
Least_Curious_Crab,2,7,59,19,1606798800,1608008400,9
wizardwes,0,9,0,45,1603252800,1612069200,9
VeryWildValar,0,9,0,639,1604203200,1606885200,9
ButterBetterBitter,0,9,0,46,1604293200,1606885200,9
plastigoop,0,9,0,156,1582952400,1602388800,9
turk4lyfe,0,9,0,52,1546837200,1608958800,9
so_jc,0,9,0,33,1549342800,1596686400,9
befatal,1,8,29,25,1590724800,1602475200,9
shrimp0808,3,6,81,26,1579842000,1609304400,9
Tyr808,0,9,0,36,1605502800,1605934800,9
monkeycycling,1,8,10,22,1547787600,1578373200,9
jsudhfkebxkdn,0,9,0,11,1608008400,1608958800,9
shaezan,0,9,0,55,1605157200,1607749200,9
herausragende_seite,0,9,0,67,1599796800,1609390800,9
amulshah7,0,9,0,63,1586404800,1595304000,9
fistasaverb,1,8,1210,54,1594353600,1595476800,9
NoManufacture,0,9,0,94,1607576400,1608094800,9
handsomehouston,1,8,8,93,1544072400,1547182800,9
joe1134206,0,9,0,58,1577422800,1589515200,9
Readyfor50,0,9,0,28,1608354000,1608440400,9
Chotobits,0,9,0,-3,1578459600,1578546000,9
JazzChicken13,1,7,19,40,1596686400,1597032000,8
Zifnab_palmesano,0,8,0,62,1573189200,1581051600,8
LobbyNoise,0,8,0,121,1578114000,1582174800,8
batmannatnat,0,8,0,85,1576386000,1608008400,8
seanofthebread,0,8,0,54,1563595200,1583125200,8
spaceglitter000,1,7,51,38,1551070800,1585454400,8
skywacca,0,8,0,19,1568001600,1591588800,8
yumpo,2,6,58,86,1549342800,1595908800,8
SmallRedBird,0,8,0,24,1589083200,1612069200,8
jeirosbehs,1,7,0,-8,1605589200,1605675600,8
cr0ft,0,8,0,138,1569643200,1612155600,8
carbonandcaffeine,0,8,0,60,1606539600,1609218000,8
Dr_Girlfriend,0,8,0,16,1603512000,1604984400,8
mayonesa,2,6,21,9,1424840400,1430193600,8
TechnoL33T,0,8,0,5,1552276800,1564632000,8
calmkat,0,8,0,64,1571976000,1573534800,8
DIVINEDREWER,0,8,0,10,1603598400,1609304400,8
KaeJS,0,8,0,14,1588824000,1588910400,8
liamgosss,2,6,18,34,1590120000,1590638400,8
UnknownSolder,1,7,2,72,1609304400,1611637200,8
AutomatedGayCommie,0,8,0,274,1592798400,1596168000,8
Craft099,2,6,9,32,1592539200,1609304400,8
MiS_bE_hAbE,2,6,402,55,1592193600,1598673600,8
mythicalhumanvessel,0,8,0,31,1593748800,1609218000,8
mewthulhu,0,8,0,82,1601438400,1607230800,8
420_blz_my_asshole,0,8,0,29,1572148800,1573880400,8
DavyJonesBitLocker,0,8,0,26,1573707600,1579064400,8
Hussor,0,8,0,65,1592539200,1605762000,8
AlmostWardCunningham,0,8,0,-16,1571544000,1579064400,8
mjkjx34,0,8,0,19,1612069200,1612242000,8
Public_Tumbleweed,0,8,0,84,1597204800,1609045200,8
forgetit1243,4,4,3963,31,1592712000,1602388800,8
behaaki,1,7,8,249,1594267200,1608181200,8
AutisticSteak,0,8,0,9,1603771200,1605070800,8
Pm_me_vbux_codes,0,8,0,44,1571630400,1580706000,8
decayin,0,8,0,236,1545022800,1583125200,8
your_pal_crow,0,8,0,-45,1605589200,1607144400,8
Gunlock59,1,7,11,108,1556596800,1557115200,8
TopKekMemerLol,1,7,0,7,1603080000,1606798800,8
Poutine_And_Politics,0,8,0,100,1601524800,1607749200,8
buzz123123,0,8,0,9,1606366800,1606885200,8
afksports,0,8,0,92,1566360000,1586404800,8
foxyfree,0,8,0,232,1560052800,1607662800,8
Best_Toby_Oce,0,8,0,338,1606366800,1607749200,8
Lawlesslawton,0,8,0,15,1559188800,1573621200,8
Mnementh121,0,8,0,17,1597723200,1606539600,8
miaowpitt,0,8,0,72,1593921600,1606626000,8
thedr00mz,0,8,0,59,1584417600,1605589200,8
i-eat-ass,0,8,0,13,1597032000,1597118400,8
chatterwrack,0,8,0,58,1582261200,1611810000,8
Flurman,1,7,19,42,1551589200,1578805200,8
kiddokush,0,8,0,14,1601611200,1601697600,8
octobereighth,0,8,0,134,1564027200,1570593600,8
retroxspect,2,6,144,82,1574658000,1580706000,8
noexqses,1,7,17,74,1572148800,1608699600,8
nyarlathotepkun,1,7,244,107,1581051600,1581138000,8
Pythonixx,0,8,0,75,1608699600,1609390800,8
camaroking98,3,5,132,6,1603598400,1609736400,8
visandrews,0,8,0,25,1570939200,1604466000,8
mrdooter,3,5,96,28,1541480400,1551848400,8
fulltimelurker442,0,8,0,51,1605934800,1606539600,8
verdvai,0,8,0,5,1611982800,1612069200,8
sommeyset,0,8,0,47,1597550400,1598241600,8
DuchesseVonTeschN,0,8,0,235,1594267200,1598760000,8
Mr_Invader,0,8,0,-109,1600660800,1612069200,8
xVoluntasx,0,8,0,42,1471752000,1601611200,8
Juus,0,8,0,62,1549515600,1596772800,8
therris5,0,8,0,160,1580706000,1609304400,8
sparkie740,0,8,0,71,1594785600,1611896400,8
niwin418,0,8,0,50,1594699200,1595217600,8
MunchieMom,1,7,38,53,1593057600,1606366800,8
Nikolai_Roze,0,8,0,104,1575954000,1607835600,8
checkdateusercreated,0,8,0,16,1580101200,1580274000,8
kazingaAML,1,7,35,59,1537848000,1553572800,8
mirandaloveslilly,0,8,0,132,1596168000,1596168000,8
HowCanOurLoopsBeReal,0,8,0,44,1570420800,1573189200,8
JaxJyls,0,8,0,15,1583384400,1607662800,8
cellophane_heart,0,8,0,114,1559275200,1585368000,8
rosewatercookiedough,0,8,0,117,1560744000,1604203200,8
Bambajam,0,8,0,30,1578978000,1592539200,8
acommunistchair,0,8,0,-86,1606539600,1611982800,8
pawpaw69420,0,8,0,157,1599451200,1605762000,8
feather_your_nest,0,8,0,22,1604984400,1608094800,8
arrcron,0,8,0,74,1592107200,1594094400,8
whocaresidont_,0,8,0,76,1597032000,1599019200,8
macdawg2020,0,8,0,71,1569988800,1607576400,8
YearlyTree,0,8,0,11,1578891600,1605589200,8
camillalala_,1,7,31,46,1593662400,1606366800,8
LeRonGuard,0,8,0,49,1586059200,1600747200,8
dcfrenchstudent,4,4,458,42,1555387200,1607576400,8
nniku,1,7,9,8,1593403200,1596859200,8
Shoeverine888,0,8,0,10,1596081600,1600401600,8
Wheresmyswag,0,8,0,107,1564113600,1576386000,8
ServantofHades,0,8,0,274,1577768400,1578459600,8
trimalchio-worktime,0,8,0,339,1577941200,1607922000,8
Wandersii2,0,8,0,13,1559361600,1559361600,8
Mr_Salami,0,8,0,8,1572062400,1581915600,8
-ShagginTurtles-,0,8,0,290,1592798400,1608786000,8
tittyswan,1,7,83,46,1607749200,1607835600,8
Leonum,0,8,0,32,1582952400,1588219200,8
vickbay12345,2,6,67,51,1560744000,1573794000,8
Stockilleur,0,8,0,49,1604898000,1612069200,8
rikaz1,0,8,0,17,1590033600,1609304400,8
blueishbeaver,1,7,19,25,1550898000,1554177600,8
Therical_Lol,0,8,0,33,1601870400,1602734400,8
totalmasscontrol,2,6,37,42,1599796800,1607749200,8
PrintersStreet,0,8,0,55,1606539600,1608786000,8
LightSlateBlue,0,8,0,74,1605157200,1608267600,8
awkwrdoctops,2,6,35,10,1585713600,1586059200,8
Valmond,0,8,0,97,1598500800,1608526800,8
Ishitataki,1,7,3,18,1585195200,1598846400,8
hmoeslund,0,8,0,250,1590120000,1598068800,8
stoned_banana,0,8,0,25,1536552000,1574398800,8
9flamme5homme4babyy,0,8,0,9,1559275200,1569470400,8
ghhouull,0,8,0,47,1562904000,1606539600,8
MaverickTopGun,0,8,0,191,1596600000,1609304400,8
Mommys_boi,1,7,9,17,1597464000,1597636800,8
worldwidescrotes,2,6,11,75,1564027200,1597896000,8
nickisdone,0,8,0,15,1571976000,1573534800,8
crissyloveserotica,0,8,0,142,1607317200,1609304400,8
IamAdogRooRoo,0,8,0,44,1582002000,1587268800,8
TheSrWrangler,1,7,27,116,1556769600,1597896000,8
willflameboy,0,8,0,273,1573102800,1576299600,8
asianmtf,0,8,0,70,1594526400,1596945600,8
dart200d,0,8,0,46,1555387200,1558584000,8
VellDarksbane,0,8,0,108,1601265600,1605502800,8
momotano,0,8,0,15,1611896400,1612069200,8
dominokos,0,8,0,17,1569729600,1569729600,8
SnickerdoodleDragon,0,8,0,17,1598241600,1611810000,8
SemajRakeb,0,8,0,3,1554609600,1558843200,8
iamamzing56,1,7,37,19,1592020800,1592107200,8
darbyisadoll,1,7,623,9,1606280400,1612328400,8
the_bedelgeuse,0,8,0,214,1567051200,1592884800,8
picklefingerexpress,0,8,0,49,1600574400,1612155600,8
Ask_me_4_a_story,0,8,0,211,1572408000,1605934800,8
GameOfUsernames,0,8,0,-3,1592366400,1592366400,8
m_chutch,2,6,51,18,1599019200,1608008400,8
rollinterror666,0,8,0,-29,1591416000,1591588800,8
Finite-Resources,0,8,0,15,1608354000,1608354000,8
Leanansidheh,1,7,92,88,1573534800,1597982400,8
EcksRidgehead,0,8,0,280,1583038800,1606626000,8
nachocouch,0,8,0,96,1573102800,1609218000,8
lowercaseg91,0,8,0,-95,1593489600,1612155600,8
D3thklok1985,0,8,0,127,1592971200,1603252800,8
ImJustAGuyCantSleep,2,6,85,17,1580274000,1580965200,8
Nickadeamus36,2,6,28523,47,1578459600,1612155600,8
harmreductionista,1,7,65,32,1568779200,1584590400,8
Suspicious-Ad-9457,0,8,0,20,1605330000,1609304400,8
KVirello,0,8,0,107,1562731200,1574398800,8
actionableideation,0,8,0,59,1580619600,1583643600,8
Dinomiteblast,0,8,0,56,1571889600,1574744400,8
sadboibryce,0,8,0,43,1569297600,1584590400,8
YeeetAcct,0,8,0,15,1599883200,1607490000,8
OperativePiGuy,0,8,0,114,1578286800,1606712400,8
nousername808,1,7,51,41,1605675600,1607835600,8
wakeuworksleeprepeat,4,4,141,4,1573534800,1573621200,8
k2900,1,7,15,20,1556251200,1575262800,8
ObscurePhantom22,0,8,0,36,1576126800,1576126800,8
the_aquacadet,0,8,0,34,1601697600,1608526800,8
ljeesy,1,7,6,16,1572148800,1593144000,8
MrDeckard,0,8,0,149,1588824000,1606194000,8
goodguygreg808,0,8,0,9,1585454400,1585454400,8
SubStack,1,7,5,23,1550811600,1551589200,8
Newtonip,1,7,12,78,1560657600,1608440400,8
johnkop4,0,8,0,-12,1599364800,1599624000,8
hoka_moka,1,7,908,138,1598500800,1598587200,8
Repulsive-Warthog667,1,7,15,26,1603944000,1608526800,8
caponenz,0,8,0,24,1575349200,1583211600,8
ElGordoDelJordo,1,7,160,74,1593057600,1599537600,8
thomyorkesforke,0,8,0,46,1598155200,1599883200,8
TheChonkatron,1,7,10,21,1563940800,1573534800,8
phantomforeskinpain,0,8,0,59,1579410000,1595476800,8
Omgyd,0,8,0,96,1599883200,1609304400,8
ebam123,0,8,0,14,1607490000,1609390800,8
mrgooglypants,0,8,0,81,1578805200,1608872400,8
VerySlenderMan,0,8,0,-80,1568260800,1569038400,8
GlitterberrySoup,0,8,0,84,1551330000,1604466000,8
Xerxero,0,8,0,110,1559707200,1583643600,8
Trontotron,1,7,37,33,1582261200,1583384400,8
HXMason,0,8,0,95,1572321600,1586232000,8
enfier,0,8,0,-89,1605934800,1608094800,8
hththththt-POW,0,8,0,35,1594440000,1600747200,8
foil-burner,0,8,0,25,1609390800,1609477200,8
marlborogolds,0,8,0,395,1560052800,1568865600,8
SolidMiddle,0,8,0,56,1563249600,1574398800,8
Godfist04,0,8,0,67,1574744400,1594353600,8
confuseum,1,7,3,54,1548910800,1594526400,8
Pirate-parrot,3,5,2218,19,1583211600,1604116800,8
johnnight,0,8,0,20,1562644800,1601265600,8
IAmTheKlitCommander,0,8,0,127,1594526400,1608699600,8
ShrewedNBrewed,0,8,0,61,1612069200,1613278800,8
1x2y3z,0,8,0,91,1553140800,1607576400,8
PoeticProser,0,8,0,138,1599969600,1606539600,8
JudgeMagisterJudas,0,8,0,20,1591243200,1591329600,8
theileana,0,8,0,68,1592280000,1606626000,8
RedButterfree1,0,8,0,86,1573966800,1603771200,8
niceegg420,2,6,89,411,1583812800,1607576400,8
Fun_Ok,0,8,0,-38,1597636800,1597636800,8
lefibonacci,0,8,0,-12,1588392000,1588737600,8
nptown,0,8,0,-46,1575867600,1593576000,8
DonDiabloCastro,0,8,0,21,1561003200,1574744400,8
princessaverage,0,8,0,180,1561176000,1592107200,8
silentjay01,0,8,0,64,1595044800,1607576400,8
riotsquirrelz,0,8,0,531,1582002000,1607058000,8
TheFizzardofWas,0,8,0,54,1573362000,1575867600,8
zesterer,0,8,0,96,1564804800,1587268800,8
makelovetogod,0,8,0,40,1560398400,1563336000,8
0tter99,0,8,0,19,1603684800,1603771200,8
vario_,2,6,22,10,1569211200,1606366800,8
sack0fd3mon,0,8,0,149,1586145600,1597032000,8
just_a_prepper,0,8,0,70,1582520400,1594958400,8
PunishedEnoch,1,7,22,29,1580792400,1580878800,8
CowboyFromHell22,0,8,0,15,1599537600,1606971600,8
SleuthViolet,0,8,0,33,1598414400,1598760000,8
Jirb30,0,8,0,72,1579064400,1590120000,8
Argovan,0,8,0,113,1572235200,1607058000,8
black_rose_,2,6,166,17,1599969600,1606885200,8
leftblnk,1,7,454,43,1577768400,1608699600,8
Iamyourl3ader,0,8,0,-33,1557633600,1557720000,8
BrendanTFirefly,0,8,0,36,1599883200,1599883200,8
SlayerJB,0,8,0,-8,1602388800,1602648000,8
PatrascheTheDog,0,8,0,56,1588219200,1588910400,8
hipyoungmom,1,7,48,73,1592971200,1596254400,8
jaggypants,0,8,0,113,1553486400,1581224400,8
ILuvRedHeadz,0,8,0,9,1573102800,1591416000,8
Okayfirstoff,1,7,50,109,1590724800,1595736000,8
Drivenfar,0,8,0,132,1571112000,1605070800,8
satoshichris,0,8,0,8,1539921600,1539921600,8
jewnowhoiam,0,8,0,98,1586404800,1600833600,8
glennsl_,0,8,0,138,1537070400,1553572800,8
StayIndie,0,8,0,6,1602993600,1605243600,8
inspektorkemp,0,8,0,33,1599019200,1606712400,8
Thiccsburgh,0,8,0,44,1572494400,1576818000,8
razk756744,0,8,0,72,1551502800,1552449600,8
abedomar,1,7,618,46,1590638400,1600228800,8
giotheflow,0,8,0,65,1477368000,1599019200,8
fangss2001,0,8,0,-123,1591416000,1593835200,8
xFuimus,0,8,0,25,1608267600,1608699600,8
tropulus,0,8,0,32,1573794000,1578891600,8
JohnBrownIsAPowerTop,1,7,18,57,1560744000,1585281600,8
Bigbeardhotpeppers,2,6,51,26,1580014800,1607749200,8
notthatdudeyoubanned,0,8,0,223,1591243200,1591329600,8
the_proper_cat,0,8,0,362,1563249600,1595390400,8
MahGoddessWarAHoe,0,8,0,-7,1556164800,1562040000,8
oh_no_aliens,0,8,0,72,1581397200,1581397200,8
songoftheshadow,1,7,27,115,1564545600,1589601600,8
ryankellett,0,8,0,53,1608008400,1608181200,8
meinchemicalbromance,1,7,64,63,1564545600,1569988800,8
tism_trooper,0,8,0,13,1585800000,1588910400,8
AtTheFirePit,0,8,0,113,1545454800,1593403200,8
DriftinFool,0,8,0,7,1599537600,1599710400,8
eucalyptusqueen,0,8,0,86,1580792400,1603166400,8
outofshell,0,8,0,65,1571544000,1596859200,8
rufio_then_bangarang,0,8,0,101,1557633600,1560484800,8
Pickled_Wizard,0,8,0,24,1594785600,1597723200,8
radfemconvert,0,8,0,69,1593403200,1601006400,8
Spandxltd,0,8,0,18,1596168000,1596254400,8
Music_as_Medicine,0,8,0,26,1605589200,1609131600,8
qayqayiam,0,8,0,85,1559361600,1569729600,8
cragokii,1,7,16,91,1582952400,1584590400,8
arcticsummertime,1,7,70,176,1604984400,1608699600,8
ProWaterboarder,0,8,0,-24,1585022400,1585108800,8
Peterx2112,0,8,0,62,1576386000,1600920000,8
FuckingFred,0,8,0,105,1557979200,1563336000,8
Malikia101,0,8,0,-71,1578286800,1586318400,8
XLoveAndPeaceX,0,8,0,202,1608786000,1609045200,8
cocoyumi,0,8,0,127,1574830800,1580274000,8
Peanutbutter_Rain,0,8,0,-60,1581915600,1581915600,8
AnF-18Bro,0,8,0,68,1582002000,1586836800,8
immibis,0,8,0,22,1590379200,1591243200,8
backgammon_no,0,8,0,86,1540180800,1553572800,8
coinintine,0,8,0,289,1595736000,1595822400,8
Chris9183,0,8,0,154,1608267600,1609304400,8
Vermik2020,0,8,0,97,1571457600,1578286800,8
whathughmeanmane,0,8,0,-43,1571544000,1572408000,8
Gatopercevejo,0,8,0,8,1576645200,1576645200,8
VirtualKeenu,0,8,0,4,1591243200,1608094800,8
repressedpauper,1,7,100,23,1602820800,1604379600,8
rubywolf27,0,8,0,251,1566360000,1595736000,8
saul2015,5,3,1248,72,1525233600,1597377600,8
poitinpdx,0,8,0,55,1595131200,1605416400,8
MemeElitist,0,8,0,115,1592798400,1607144400,8
Illustrious-Winter-7,1,7,16,25,1603425600,1603425600,8
Atlantikus,1,7,12,50,1582779600,1608526800,8
Tangerinetrooper,0,8,0,-2,1607230800,1607230800,8
nagurski03,0,8,0,0,1562731200,1602734400,8
noplansnmoodswings,0,8,0,79,1597809600,1597809600,8
nearlyhalfabicycle,0,8,0,45,1546318800,1602475200,8
UlyssesTheta,2,6,978,61,1593921600,1609218000,8
juuuila,3,5,6543,96,1571630400,1575262800,8
StingerTheRaven,0,8,0,38,1562126400,1598328000,8
ImbalancingAct,1,7,51,18,1554868800,1561521600,8
sallydipity,0,8,0,76,1544158800,1590638400,8
KeeperoftheSeeds,0,8,0,64,1594440000,1600315200,8
b_rad_c,1,7,10,24,1588824000,1607144400,8
SoundProofHead,0,8,0,41,1531800000,1579928400,8
bl4ckn4pkins,0,8,0,13,1579755600,1601092800,8
accidental_hippy,0,8,0,120,1575090000,1592193600,8
ShaneRMTanner,0,8,0,300,1562299200,1572667200,8
AhYesAName,0,8,0,139,1588651200,1600315200,8
Biscuitcat10,0,8,0,30,1548910800,1583470800,8
Darkwolf762,2,6,43,588,1583899200,1593489600,8
BenSlimmons,0,8,0,73,1594612800,1607835600,8
Aurilelde,0,8,0,135,1579582800,1605675600,8
DurasVircondelet,0,8,0,20,1587873600,1606626000,8
jagraef,0,8,0,116,1552881600,1587182400,8
BallyBallard,0,8,0,27,1576904400,1590206400,8
littleone1814,0,8,0,14,1611810000,1613106000,8
moshpetty,2,6,188,38,1550293200,1557374400,8
pato2205,0,8,0,109,1588392000,1589428800,8
SerinityEmpire,0,8,0,19,1574139600,1574398800,8
Bartholomeuske,0,8,0,40,1566532800,1609218000,8
HamstersOfSociety,0,8,0,9,1567051200,1568779200,8
mamn_,0,8,0,31,1588564800,1603425600,8
whatifisay227,0,8,0,241,1554868800,1569211200,8
TheAlbin0_,0,8,0,103,1565928000,1605502800,8
zutaca,0,8,0,146,1557288000,1596168000,8
Rimewind,0,8,0,121,1549861200,1580274000,8
fleetingflight,0,8,0,53,1579842000,1599451200,8
BONUSBOX,0,8,0,28,1570248000,1600574400,8
sunnnnysideup,1,7,77,39,1541394000,1548565200,8
FinnRazzel,0,8,0,19,1588737600,1612242000,8
Cadet-Bone-Spurs,8,0,708,0,1559275200,1576040400,8
jaspark23,0,8,0,116,1600833600,1604203200,8
DeSota,0,8,0,42,1551330000,1578373200,8
fuckcorporatejobs,0,8,0,22,1593576000,1594612800,8
snapekillseddard,0,8,0,2,1589601600,1589601600,8
Imagine_sandwiches,0,8,0,71,1585886400,1596081600,8
Myrani,1,7,114,26,1571371200,1605589200,8
BarbarianInvasions,1,7,20,3,1578891600,1599278400,8
JudgeJudyHere,0,8,0,99,1571112000,1597636800,8
Biomoliner,0,8,0,50,1567051200,1579410000,8
45isHumanGarbage,0,8,0,46,1579928400,1600574400,8
GreedyConversations,2,6,65,14,1593230400,1599883200,8
ScruffyTJanitor,0,8,0,18,1551762000,1564459200,8
Jtk317,0,8,0,58,1596686400,1603512000,8
funknut,0,8,0,50,1580965200,1608181200,8
fierybluebeacon,2,6,381,94,1554264000,1605762000,8
aieyeia,0,8,0,41,1557547200,1563249600,8
superkp,0,8,0,96,1584331200,1604379600,8
joeytman,0,8,0,234,1581483600,1597896000,8
PettyWitch,0,8,0,49,1589169600,1602820800,8
justobella,0,8,0,22,1549515600,1564545600,8
DylanTheSlaya03,2,6,336,48,1567569600,1582520400,8
wadamday,0,8,0,-10,1585022400,1585108800,8
NoWheyBro_GQ,0,8,0,22,1554523200,1554523200,8
Buttock,0,8,0,345,1560398400,1607058000,8
StupidSexySundin,0,8,0,90,1601179200,1606626000,8
sinistersomnambulant,0,8,0,451,1594267200,1594353600,8
trilogy-09,0,8,0,6,1578978000,1579064400,8
ZoeMasquerade,2,6,774,105,1574571600,1587268800,8
buffdaddy77,2,6,88,22,1593144000,1606453200,8
CyanideIsFun,0,8,0,138,1576126800,1604293200,8
cryptidkelp,1,7,4,622,1605502800,1608699600,8
TakeaCoat,0,8,0,-29,1598155200,1598328000,8
AdamArcadian,0,8,0,16,1570334400,1611810000,8
jimmyco2008,0,8,0,46,1593403200,1594008000,8
bestsparkyalive,0,8,0,67,1555819200,1574398800,8
nnnnnnnnnngh,0,8,0,36,1585368000,1611896400,8
FrostWyrm98,0,8,0,27,1599019200,1607835600,8
Man_of_Hour,0,8,0,-28,1581915600,1581915600,8
Fatal_furter,0,8,0,72,1577941200,1582866000,8
ImHalfAsianAMA,0,8,0,191,1568088000,1605762000,8
gokaired990,0,8,0,9,1562817600,1562817600,8
CorporateAesthetic,1,7,57,102,1586750400,1603252800,8
justlurkingnjudging,0,8,0,202,1582866000,1601611200,8
Pooptown6969,0,8,0,148,1580706000,1583812800,8
Eats_Beef_Steak,0,8,0,28,1570075200,1579323600,8
Bluehatake,1,7,10,8,1568001600,1580619600,8
dh3792yeg21,0,8,0,32,1592798400,1595390400,8
WSBPauper,1,7,109,24,1603512000,1612155600,8
donjulioanejo,0,8,0,26,1575694800,1589169600,8
TheDangerousOutsider,0,8,0,33,1588651200,1599537600,8
Songbird420,0,8,0,9,1579237200,1579237200,8
intuitive_curiosity,0,8,0,183,1573621200,1596600000,8
Kim_Cardassian,0,8,0,30,1594612800,1599537600,8
rosequeen77,2,6,62,57,1591934400,1602302400,8
Delgumo,0,8,0,226,1584676800,1589688000,8
PM_ME__A_THING,0,8,0,173,1561176000,1584331200,8
poochie186,4,4,1444,67,1593316800,1601611200,8
princeralseithefurry,0,8,0,45,1603080000,1606885200,8
cbfw86,1,7,127,34,1604116800,1611982800,8
Braconomist,0,8,0,297,1587700800,1601092800,8
suicidalsadgirl,0,8,0,23,1593144000,1595649600,8
LetsHearSomeSongs,0,8,0,54,1557720000,1569124800,8
JimJamTheNinJin,0,8,0,-51,1551848400,1570420800,8
scrapsforfourvel,0,8,0,173,1575349200,1608958800,8
Archsys,0,8,0,34,1573362000,1585540800,8
AanthonyII,0,8,0,334,1578027600,1607317200,8
MirthOfMyth,0,8,0,-31,1576818000,1577077200,8
Allahuakbar7,0,8,0,176,1579582800,1603598400,8
hey-koolthing,1,7,123,44,1580274000,1580446800,8
ActionComedyBronson,1,7,35,140,1558843200,1604203200,8
Wf01984,0,8,0,38,1597982400,1598068800,8
kanagan,0,8,0,92,1544590800,1564977600,8
Moose_a_Lini,1,7,24,110,1596340800,1596686400,8
GRIFITHLD,0,8,0,30,1556164800,1556164800,8
Smooth_Jazz_Warlady,0,8,0,42,1599624000,1608786000,8
BusStopsOfLondon,0,8,0,166,1590120000,1593921600,8
KittenSpronkles,0,8,0,101,1592539200,1595563200,8
OldHannover,2,6,28,49,1582779600,1592107200,8
RedditModel,1,7,206,70,1570334400,1606885200,8
SumThinChewy,0,8,0,5,1559102400,1579237200,8
theelous3,0,8,0,3,1585108800,1592798400,8
olivegardengambler,0,8,0,12,1582520400,1582520400,8
hey_grill,1,7,247,102,1605675600,1605934800,8
DallasM19,0,8,0,23,1593230400,1609045200,8
crookedcrab,0,8,0,-3,1590033600,1590120000,8
Jojuj,5,3,54,6,1569556800,1607576400,8
familiybuiscut,0,8,0,95,1575176400,1598760000,8
strawberry_trees,0,8,0,22,1551589200,1561608000,8
unfitspaghetti,0,8,0,254,1592193600,1595390400,8
Doge_Is_Dead,0,8,0,36,1599192000,1608613200,8
sysrq88,0,8,0,11,1555041600,1557374400,8
chasingvisions,0,8,0,163,1558411200,1567051200,8
MistEchoes,0,8,0,256,1561694400,1596427200,8
mazintas,0,8,0,209,1575176400,1575176400,8
usernamechecksout113,0,8,0,69,1602475200,1605848400,8
_lotusflower_,0,8,0,46,1592884800,1604379600,8
AS123x,0,8,0,284,1570334400,1605157200,8
hexi3,3,5,94,24,1591848000,1592625600,8
notrius_,0,8,0,74,1571371200,1590465600,8
VietStamm,0,8,0,85,1572667200,1585454400,8
dedzip,0,8,0,32,1575694800,1576386000,8
mreader369,0,8,0,13,1588910400,1591243200,8
genevieveclaire1234,0,8,0,36,1582347600,1606798800,8
high_rise_low_life,0,8,0,16,1585195200,1609477200,8
thatsaqualifier,0,8,0,-19,1541131200,1541217600,8
CallMeCeeje,0,8,0,9,1607317200,1607317200,8
FragmentOfTime,0,8,0,50,1582088400,1603771200,8
3610572843728,0,8,0,77,1560571200,1603944000,8
BoobaFatt13,0,8,0,34,1605243600,1611810000,8
sirchinz,0,8,0,524,1577682000,1600747200,8
borntoperform,0,8,0,8,1594872000,1599710400,8
TwinkiWeinerSandwich,1,7,617,75,1552363200,1566878400,8
Prince705,0,8,0,101,1556251200,1572843600,8
Irregulator101,0,8,0,113,1585454400,1602734400,8
CultureOnAStick,0,8,0,43,1544590800,1567742400,8
Man_Can92,0,8,0,-29,1608699600,1608786000,8
Pineapple_Predator,0,8,0,34,1597204800,1607317200,8
Ranjii1996,0,8,0,2,1557979200,1566273600,8
nickzahn0212,0,8,0,214,1574053200,1580101200,8
Gibe_Money_Please,0,8,0,-13,1599451200,1599451200,8
aidsjohnson,0,8,0,115,1580446800,1601784000,8
atg115reddit,1,7,119,35,1607490000,1611896400,8
infiniteprogress,1,7,54,43,1581310800,1581397200,8
dogfood666,0,8,0,131,1567224000,1594612800,8
pyrmale,0,8,0,70,1589256000,1598846400,8
TechenCDN,1,7,6,16,1602820800,1609650000,8
Gaunts,0,8,0,58,1558584000,1606971600,8
rest_at_apex,0,8,0,75,1579842000,1607317200,8
neverNOTbeenfunny,0,8,0,21,1570680000,1595390400,8
Type2Pilot,0,8,0,10,1594008000,1594008000,8
Dootzadooter,0,8,0,8,1612069200,1612155600,8
dagon1729,1,7,7,50,1602734400,1611810000,8
agitationvstagnation,0,8,0,154,1596427200,1608786000,8
xiloti,1,7,95,45,1593489600,1608267600,8
GoldenDirewolf,0,8,0,43,1597636800,1609218000,8
wwhhiippiittss,0,8,0,58,1564804800,1577336400,8
CreativeLoathing,0,8,0,190,1570507200,1599969600,8
ThatFungi420,0,8,0,-72,1564459200,1571457600,8
sonofyvonne,0,8,0,37,1608958800,1611982800,8
Ghuldarkar,0,8,0,117,1595822400,1604466000,8
Cerling_Stooper,0,8,0,36,1569816000,1585886400,8
cherrycarnage,0,8,0,48,1568001600,1580792400,8
Outrageous-Durian558,0,8,0,-7,1601956800,1604811600,8
Leomavrick,2,6,101,45,1575867600,1590984000,8
frugalgardeners,3,5,71,42,1580706000,1603598400,8
amw11h,0,8,0,36,1548738000,1573534800,8
Bootstrap_Bob,1,7,8,16,1598932800,1600488000,8
tomartig,0,8,0,-15,1589688000,1606798800,8
EdocKrow,1,7,2,4,1608267600,1608354000,8
Cathedral_Knight,0,8,0,30,1539921600,1550466000,8
QuietKat87,0,8,0,72,1594612800,1608786000,8
smokecat20,0,8,0,157,1560571200,1603598400,8
Novusor,1,7,543,132,1601697600,1608786000,8
PlacodermPatty,0,8,0,104,1593144000,1596513600,8
warrior20195,0,8,0,39,1537329600,1608526800,8
AccomplishedStable3,0,8,0,-49,1587096000,1587096000,8
sunkissedsoda,0,8,0,518,1594699200,1607317200,8
SamPNW,1,7,0,-20,1606626000,1607662800,8
TheShocker1119,0,8,0,89,1598241600,1609304400,8
SaltySpray7,0,8,0,-10,1590379200,1590465600,8
markabordo,0,8,0,-93,1593057600,1596513600,8
IdiomasyEscalada,1,7,542,34,1580274000,1585886400,8
TheMustaKrakish,1,7,43,27,1569297600,1569297600,8
beandiplo,0,8,0,69,1576904400,1607749200,8
scottrstark,0,8,0,53,1602302400,1607490000,8
sanjuroronin,0,8,0,-7,1611982800,1612069200,8
TheToaster2000,0,8,0,60,1542171600,1566360000,8
6thSenseOfHumor,0,8,0,83,1603425600,1609304400,8
ApartheidUSA,2,6,453,29,1600142400,1604203200,8
HrabraSrca,0,8,0,50,1598846400,1603425600,8
Blood_On_The_Rocks,0,8,0,8,1606194000,1606366800,8
ALLCAPVULGARUSERNAME,0,8,0,27,1605243600,1609390800,8
canna_b_md,0,8,0,54,1597982400,1601697600,8
timecoyote,0,8,0,315,1590033600,1599537600,8
Bobz666,1,7,234,109,1561348800,1576731600,8
HaplessTruth,0,8,0,44,1587700800,1588824000,8
ctophermh89,0,8,0,145,1574571600,1606971600,8
craigthelesser,0,8,0,130,1539230400,1599537600,8
Alexandis,0,8,0,117,1603684800,1605243600,8
CatPandaFish,0,8,0,57,1568174400,1585886400,8
Amphi66,0,8,0,120,1581829200,1603339200,8
30minutesto,0,8,0,81,1565150400,1570420800,8
Mike_Hawk_940,0,8,0,10,1608526800,1609218000,8
Scrambled_Lizzy,0,8,0,22,1605502800,1608613200,8
Sentionaut_1167,0,8,0,41,1573966800,1611810000,8
ExcitableSarcasm,0,8,0,170,1604725200,1611810000,8
Arcangel_Zero7,0,8,0,23,1537761600,1640926800,8
TooAwareToCare,0,8,0,25,1602043200,1604466000,8
headguts,0,8,0,54,1552449600,1565668800,8
secondtoasterintub,0,8,0,17,1589342400,1609390800,8
Kyle1873,0,8,0,14,1569124800,1602216000,8
ediciusNJ,0,8,0,96,1598414400,1601870400,8
Giovanimancer,0,8,0,128,1573189200,1573275600,8
itslaur,0,8,0,162,1596168000,1597982400,8
AppleFritterFella,0,8,0,-36,1567051200,1579755600,8
GregConan,0,8,0,40,1584936000,1612155600,8
swifferthecat,1,7,39,200,1608613200,1609304400,8
night_electric,0,8,0,54,1552276800,1591502400,8
LizeLies,0,8,0,300,1605934800,1608699600,8
cloudlesness,0,8,0,67,1572321600,1589601600,8
PanningForSalt,1,7,84,49,1566792000,1612069200,8
ArcadianCognition,0,8,0,23,1568692800,1571803200,8
kiingof15,0,8,0,54,1595649600,1608008400,8
DJLeafBug,0,8,0,21,1594440000,1607490000,8
t0tezevadin,0,8,0,37,1596427200,1602648000,8
CreepyBoringAsshole,1,7,473,70,1593921600,1604725200,8
_______Anon______,0,8,0,28,1603598400,1609304400,8
Ferdydurkeeee,0,8,0,9,1583038800,1606280400,8
Slimeball2222,1,7,1,-39,1605416400,1605934800,8
VenomFZ6R,0,8,0,369,1578805200,1582002000,8
ZacharyACoon,0,8,0,55,1600056000,1603944000,8
kitkatKAPOW,0,8,0,11,1599537600,1599537600,8
bigclivedotcom,0,8,0,21,1572930000,1600920000,8
worker-drone-130531,3,5,152,58,1569470400,1589342400,8
ChomRichalds,0,8,0,651,1592193600,1604293200,8
OSRuneScaper,0,8,0,-3,1592107200,1608267600,8
Milkslinger,0,8,0,184,1573362000,1581051600,8
JadeWishFish,0,8,0,81,1582952400,1611810000,8
enlightenediver,0,8,0,43,1542517200,1562299200,8
huge_clock,0,8,0,-30,1608008400,1608440400,8
1LX50,0,8,0,80,1600833600,1608181200,8
aynaalfeesting,0,8,0,69,1608526800,1609390800,8
happybeard92,0,8,0,199,1555992000,1589428800,8
ImanShumpertplus,0,8,0,-10,1583643600,1600833600,8
killerdolphin313,1,7,3,-20,1572667200,1577336400,8
Mr-Snarky,1,7,1703,131,1566446400,1593662400,8
Trollfailbot,0,8,0,9,1582866000,1608181200,8
Inner_Grape,0,8,0,79,1605762000,1608958800,8
Diesel_Fixer,0,8,0,51,1596254400,1605675600,8
rasamson,0,8,0,14,1590120000,1590206400,8
ipjear,0,8,0,524,1576213200,1579928400,8
analogsquid,0,8,0,35,1597809600,1608267600,8
Nando_L,0,8,0,-15,1604898000,1606366800,8
notsoexoticjoe,0,8,0,26,1605848400,1605848400,8
kelese24,0,8,0,88,1595476800,1609218000,8
AmeliaAndJP,0,8,0,81,1594612800,1603425600,8
spaghetbear,0,8,0,56,1550120400,1556078400,8
LigmaAxis2020,0,8,0,118,1599192000,1607835600,8
clarkinum,0,8,0,599,1593576000,1596340800,8
khag,0,8,0,131,1575262800,1608786000,8
missseldon,1,7,2,69,1596427200,1601697600,8
237FIF,0,8,0,-27,1575349200,1611982800,8
Marvelite0963,0,8,0,57,1586318400,1608181200,8
GhettoCapitalist,0,8,0,41,1558584000,1607490000,8
BurningFlex,0,8,0,185,1603425600,1608008400,8
Sbatio,1,7,130,268,1599019200,1612155600,8
pRp666,0,8,0,68,1600488000,1608267600,8
foldingthetesseract,0,8,0,80,1598500800,1608354000,8
heycanwediscuss,0,8,0,7,1581829200,1581915600,8
catshit01,4,4,269,20,1575262800,1604552400,8
CaptainPi31415,0,8,0,37,1576213200,1584590400,8
BeyondAReason,0,8,0,91,1570593600,1608440400,8
TransSappicWitch,1,7,33,58,1592971200,1605848400,8
TheDividendReport,2,6,187,50,1560830400,1598846400,8
confusedlooks,0,8,0,35,1559793600,1607144400,8
Madeinchueca,1,7,17,25,1608181200,1609131600,8
9-NINE-9,1,7,32,27,1570420800,1605934800,8
dofffman,0,8,0,73,1599451200,1601179200,8
Communist_Taquito,0,8,0,9,1611810000,1611896400,8
FlimsyRaisin,1,7,7,-5,1597118400,1606885200,8
Ohin_,0,8,0,194,1590206400,1605589200,8
darthfluffy66,0,8,0,-46,1609218000,1609218000,8
NuclearWalrusNetwork,0,8,0,38,1572494400,1587182400,8
indoctrinatedcheese,0,8,0,67,1595649600,1602993600,8
lost_man_wants_soda,0,8,0,39,1603857600,1607144400,8
agentorange4tang,2,6,0,6,1543122000,1543122000,8
lalala-bitch,0,8,0,115,1575003600,1604293200,8
Radical-Reviewer,5,3,76,10,1577595600,1590724800,8
ruphmoop,0,8,0,168,1565668800,1567742400,8
InvestmentOk6456,1,7,182,147,1606626000,1607662800,8
machinegunsyphilis,0,8,0,153,1591156800,1598068800,8
mayjor44,0,8,0,6,1585454400,1588132800,8
d_pug,1,7,4,74,1561176000,1582693200,8
fremenator,0,8,0,40,1595995200,1597636800,8
Buscemis_eyeballs,0,8,0,6,1605934800,1605934800,8
ydnamari3,1,7,5622,93,1597723200,1607403600,8
Cheeeks13,0,8,0,120,1575003600,1577768400,8
Jack50517,1,7,4,17,1578805200,1592452800,8
tracyt34,1,7,73,34,1563249600,1578891600,8
djazzie,0,8,0,78,1586923200,1608872400,8
kelsosage139,2,6,52,202,1572930000,1585886400,8
MandaPanda586,1,7,60,13,1572843600,1572843600,8
benjaminabel,0,8,0,77,1538539200,1540612800,8
SchwarzerKaffee,0,8,0,60,1609045200,1609390800,8
gizamo,0,8,0,9,1601179200,1603944000,8
Kumquat_conniption,0,8,0,11,1639285200,1639544400,8
Cats_cats_cats_cats,0,8,0,21,1583384400,1607662800,8
sleepingmylifeaway96,0,8,0,51,1564891200,1612155600,8
BluebirdSubstantial,0,8,0,35,1593144000,1593489600,8
Shenya_the_smol_bean,0,8,0,24,1593662400,1596340800,8
Fallenflake,1,7,10,139,1555905600,1597982400,8
peakedinseventhgrade,1,7,193,40,1605675600,1607403600,8
I__like__food__,0,8,0,114,1589428800,1602820800,8
wenzlo_more_wine,0,8,0,10,1573016400,1594785600,8
samfisher457,2,6,4163,22,1584331200,1606021200,8
DakotaDaze,0,8,0,15,1604725200,1606712400,8
BetterMakeAnAccount,0,8,0,108,1599364800,1605762000,8
brotherbanknotebeard,0,8,0,62,1560657600,1568347200,8
ghostrobot824,2,6,132,17,1546578000,1589860800,8
LeprechaunsKilledJFK,1,7,226,104,1580446800,1609390800,8
Pimplicate,0,8,0,66,1595390400,1607403600,8
_Nerise_,2,6,28,6,1593144000,1594785600,8
NixIsia,0,8,0,138,1578805200,1606453200,8
the-0ld-man,1,7,1,33,1543294800,1569470400,8
nachof,0,8,0,110,1579669200,1589601600,8
onwardtoaction,0,8,0,91,1603425600,1608094800,8
BirdTiddies,0,8,0,-29,1594612800,1594699200,8
fried-tilapia,1,7,17,35,1607058000,1612501200,8
chicagochicagochi99,0,8,0,20,1556942400,1593057600,8
Stopbangingemployees,1,7,67,27,1596427200,1596513600,8
rg25,0,8,0,61,1601438400,1608267600,8
UncouthRuffian,0,8,0,91,1575522000,1578546000,8
nonphysicalstairways,0,8,0,17,1602734400,1602820800,8
Senpai_Danny_Devito,1,7,59,129,1577336400,1584849600,8
ThePhotonVenture,0,8,0,-60,1577854800,1577941200,8
Own-Entertainment584,0,8,0,17,1601870400,1608786000,8
Master_Fernandez_69,0,8,0,-171,1562212800,1586059200,8
Allyjb24,0,8,0,94,1597291200,1608354000,8
CatArwen,0,8,0,42,1599451200,1609131600,8
verkus898,0,8,0,57,1577422800,1600574400,8
slymiinc,0,8,0,112,1577422800,1587441600,8
ruggeriooo19,0,8,0,52,1585454400,1585454400,8
Helpmetoo,0,8,0,35,1563768000,1578805200,8
martyrAD,0,8,0,49,1593057600,1605157200,8
candymakesudandy,0,8,0,87,1600747200,1602388800,8
justarandomperson999,0,8,0,80,1607749200,1609390800,8
wtfimstillliving,5,3,250,16,1576904400,1604984400,8
RakfiskTaco,0,8,0,27,1575954000,1576472400,8
4262,0,8,0,74,1553659200,1592193600,8
IshitONcats,0,8,0,88,1581656400,1609218000,8
Rek-n,0,8,0,112,1593057600,1601611200,8
blastoff117,0,8,0,183,1579755600,1599969600,8
calicoprincess,0,8,0,37,1565150400,1566446400,8
ProbablyFishing,0,8,0,-1,1562731200,1562731200,8
Successful_Seesaw_47,0,8,0,33,1602388800,1608526800,8
coolerofbeernoice,0,8,0,-5,1593921600,1594180800,8
taraist,0,8,0,76,1592280000,1603598400,8
Azirahael,0,8,0,41,1608786000,1608786000,8
RobTheThrone,0,8,0,18,1566446400,1585972800,8
poochmant,0,8,0,1,1604293200,1604379600,8
CKuzy19,0,8,0,67,1590724800,1594008000,8
TJPrime_,0,8,0,138,1602734400,1608613200,8
LassieBeth,0,8,0,46,1593403200,1593921600,8
jonhon0,0,8,0,-4,1594440000,1608872400,8
SquidmanMal,0,8,0,154,1569297600,1584676800,8
nutcasebob,0,8,0,-8,1600660800,1600833600,8
WHY_vern,0,8,0,-95,1576386000,1606366800,8
kennyFACE117,2,6,51,30,1562904000,1567742400,8
person_ergo,0,8,0,7,1550898000,1577941200,8
WaynePayne98,0,8,0,13,1587700800,1587700800,8
grillworst,0,8,0,141,1553140800,1608181200,8
LeafMeAlone7,0,8,0,53,1561348800,1584158400,8
Pie_Dealer_co,2,6,43,23,1608786000,1609218000,8
M68000,0,8,0,40,1546837200,1606971600,8
rividz,0,8,0,181,1592366400,1597464000,8
GraveyardZombie,0,8,0,57,1552021200,1597809600,8
switchboards,0,8,0,28,1602648000,1608526800,8
mostly_ok_now,0,8,0,132,1578978000,1609304400,8
Astandsforataxia69,0,8,0,13,1603339200,1612414800,8
Fredselfish,0,8,0,32,1602648000,1609218000,8
tonyamp97,0,8,0,87,1570420800,1580706000,8
Der_Haupt,0,8,0,41,1598328000,1608354000,8
dspacey,1,7,52,124,1600574400,1602475200,8
toodleoo77,0,8,0,103,1593316800,1609218000,8
TTemp,0,8,0,23,1574139600,1583643600,8
kuwert,0,8,0,132,1594008000,1602820800,8
sirophiuchus,0,8,0,155,1576040400,1605070800,8
wildwill921,0,8,0,28,1545022800,1596686400,8
AfterCapital,0,8,0,65,1599192000,1606885200,8
my2ndaccountfornow,1,7,68,30,1595822400,1597118400,8
sqb987,0,8,0,13,1612069200,1612155600,8
sebwiers,0,8,0,101,1607749200,1611982800,8
AHoneyman,1,7,25,93,1566273600,1576213200,8
aglazeddonut,0,8,0,147,1559102400,1567656000,8
FiveUperdan,0,8,0,47,1544850000,1593576000,8
HackRT,1,7,35,97,1585627200,1608872400,8
BioWarfarePosadist,0,8,0,60,1590984000,1593316800,8
Bertbrekfust,0,8,0,-58,1554436800,1556596800,8
MrDownhillRacer,1,7,53,452,1598155200,1600574400,8
Pigman737,1,7,358,28,1596340800,1596340800,8
Foxbat_Ratweasel,0,8,0,46,1568952000,1608786000,8
sliceofamericano,0,8,0,272,1587873600,1595131200,8
Pietjiro,0,8,0,12,1594958400,1597291200,8
GantzGrapher,0,8,0,100,1596513600,1611637200,8
notruenorseman,0,8,0,83,1567051200,1580187600,8
litgreendude,0,8,0,61,1602820800,1602907200,8
JebediaBillAndBob,0,8,0,-52,1603252800,1603425600,8
Tom8oSoup,1,7,3444,220,1580619600,1580706000,8
MintClassic,0,8,0,112,1549083600,1578805200,8
iateadonut,1,7,3,39,1608354000,1609390800,8
mintymangosteeen,0,8,0,34,1593144000,1599451200,8
nothingwhere,0,8,0,15,1570507200,1571976000,8
Odimm__,0,8,0,62,1606453200,1608613200,8
domiiinater,0,8,0,-28,1608699600,1608699600,8
BernardBug,0,8,0,28,1547701200,1603857600,8
Oscu358,0,8,0,9,1603598400,1604293200,8
xReflexx17,0,8,0,104,1544245200,1575435600,8
battle-obsessed,0,8,0,84,1587355200,1603425600,8
braindrain04,0,8,0,15,1571025600,1572148800,8
Comrade110,0,8,0,164,1582606800,1587182400,8
youarewastingtime,0,8,0,46,1565928000,1609390800,8
darksoulmakehappy,0,8,0,33,1603598400,1609131600,8
FiddyFo,0,8,0,35,1601179200,1606539600,8
TheGodPlant,1,7,24,26,1557806400,1560312000,8
kmsaelens,0,8,0,841,1578459600,1607749200,8
AnzenR3l3as3,0,8,0,66,1589515200,1599710400,8
textbasedpanda,0,8,0,160,1572494400,1605070800,8
onelongsigh94,4,4,77,8,1593835200,1608440400,8
monoatomic,0,8,0,24,1582088400,1605762000,8
MagicDriftBus,0,8,0,89,1587614400,1609304400,8
xanax101010,2,6,83,30,1580101200,1606626000,8
FerbieX,1,7,29,21,1567224000,1583211600,8
StatueOfImitations,0,8,0,77,1562212800,1565236800,8
LoveIsAlmighty,0,8,0,22,1601179200,1604552400,8
DOCisaPOG,0,8,0,56,1560571200,1599451200,8
getthatcatouttahere,0,8,0,866,1583726400,1609304400,8
kommsussertod1,0,8,0,190,1594094400,1609045200,8
draineddyke,0,8,0,54,1569384000,1605330000,8
Scanned-Darkly,1,7,16,15,1592971200,1612155600,8
Marty-the-monkey,0,8,0,4,1607662800,1607749200,8
MuffinJabber,0,8,0,-4,1562731200,1562731200,8
moneysmarter,0,8,0,-47,1542690000,1544850000,8
pooterification,0,8,0,91,1581051600,1581051600,8
PerfectAppointment,1,7,8,119,1546578000,1579582800,8
saucity,0,8,0,44,1583038800,1608613200,8
varietist_department,0,8,0,64,1594008000,1607835600,8
ghost-princex,0,8,0,245,1567051200,1607749200,8
Schoobydoobydoo69,1,7,138,52,1592971200,1593057600,8
xlt12,0,8,0,799,1592798400,1606712400,8
Tomato_Joker,0,8,0,33,1597464000,1608354000,8
Davidfosford,0,8,0,-18,1603252800,1608267600,8
HereForExcel,0,8,0,40,1509076800,1612069200,8
ESLTeacher2112,0,8,0,49,1534219200,1536379200,8
discourse_lover_,0,8,0,83,1580965200,1601438400,8
mojavespider25,0,8,0,418,1584590400,1608267600,8
LuckyRadiation,0,8,0,146,1602820800,1608613200,8
Gerbilguy46,0,8,0,193,1598846400,1608267600,8
smallballofenergy,0,8,0,51,1607490000,1607490000,8
SenchaLeaf,0,8,0,92,1571457600,1606885200,8
blastoiselvl101,0,8,0,27,1555473600,1562385600,8
PS_Scyance,1,7,81,-14,1564891200,1564891200,8
_dumb_bitch_yooce_,0,8,0,209,1563768000,1591416000,8
NixNonFix,7,1,36,1,1593576000,1601352000,8
halfbad105,0,8,0,151,1564977600,1593057600,8
Mablak,0,8,0,287,1575349200,1594440000,8
AAQ94,2,6,39,11,1611896400,1612069200,8
TediousStranger,0,8,0,116,1593230400,1606539600,8
MrMiyamoto,0,8,0,97,1573966800,1597809600,8
DopeMeme_Deficiency,0,8,0,-39,1598500800,1598500800,8
annasinger4,0,8,0,28,1553659200,1557115200,8
Bupod,0,8,0,225,1608699600,1609218000,8
CargoCulture,0,8,0,58,1557633600,1589947200,8
Burrito-Coverings,0,8,0,40,1600315200,1603425600,8
Amandamangonada,0,8,0,55,1590984000,1597377600,8
IndividualDig1996,1,7,10,10,1607403600,1609390800,8
headlesshsmn,1,7,97,285,1594267200,1607230800,8
MartyBitchTits,1,7,197,99,1570420800,1570507200,8
skater30,1,7,1,110,1580878800,1606712400,8
Blob-fish5,0,8,0,38,1582952400,1604898000,8
Lizzymartin96,2,6,297,31,1593403200,1605416400,8
kekentyl,0,8,0,254,1560657600,1592971200,8
Significant_Air_8903,0,8,0,113,1597809600,1609390800,8
Benj_Carm,0,8,0,115,1573016400,1609390800,8
TopSpecialist,0,8,0,-115,1586318400,1586318400,8
thomasutra,0,8,0,149,1595390400,1611810000,8
BubbaLoblaw,0,8,0,104,1602734400,1605934800,8
Redman2010,2,6,4945,462,1582866000,1583125200,8
zen_veteran,0,8,0,-26,1571112000,1593403200,8
taylorceason,0,8,0,88,1583298000,1606798800,8
t087264403,1,7,150,134,1560052800,1560052800,8
pale_28,0,8,0,446,1595822400,1609218000,8
HenryPouet,0,8,0,61,1538280000,1590033600,8
todayyou500,0,8,0,13,1597550400,1599883200,8
epsilonandmore,0,8,0,63,1594526400,1598932800,8
bonertable,0,8,0,-8,1601179200,1601179200,8
Speculum,0,8,0,121,1541653200,1575349200,8
Jamthis12,0,8,0,79,1558497600,1569988800,8
MsLauralily,0,8,0,51,1599278400,1602820800,8
orgonitepanda,0,8,0,359,1602648000,1605762000,8
handsofanangrygod,0,8,0,25,1606798800,1606798800,8
Pakoma7,0,8,0,56,1602129600,1606971600,8
KaiWolf1898,0,8,0,-17,1577768400,1577854800,8
Wellety,0,8,0,-5,1588824000,1592366400,8
invenereveritas,0,8,0,57,1582606800,1608094800,8
tarantonen,0,8,0,10,1573102800,1573102800,8
GoGoZombieLenin,0,8,0,71,1560312000,1603598400,8
deletednaw,0,8,0,162,1580274000,1608699600,8
DG2736,2,6,148,22,1562126400,1604725200,8
aforcefulcoursefull,0,8,0,65,1602734400,1604293200,8
sponospono233,0,8,0,20,1568260800,1575349200,8
KristynaKorbelova,0,8,0,81,1595131200,1595217600,8
Beardage_,1,7,26,73,1598500800,1605070800,8
SueSheMeow,0,8,0,54,1595217600,1604898000,8
peter_kroTHOTkin,0,8,0,56,1576299600,1605502800,8
yellowkats,0,8,0,1168,1553832000,1605502800,8
Scott_Smith,0,8,0,226,1576126800,1603684800,8
daredevil90s,0,8,0,8,1608526800,1608613200,8
ThriftPandaBear,0,8,0,205,1602734400,1603944000,8
tidbitsofblah,0,8,0,66,1560139200,1595476800,8
DrosephWayneLee,0,8,0,104,1556683200,1592193600,8
bugbutt1600,0,8,0,78,1570248000,1598760000,8
SwammyWholsum,1,7,278,33,1599105600,1602820800,8
mangroveassassin,1,7,1009,21,1603425600,1608613200,8
FargoMulchCo,0,8,0,75,1585195200,1594440000,8
glasswallet,0,8,0,16,1602129600,1606885200,8
ShellyGodyoibus,0,8,0,282,1572930000,1590120000,8
Theosarius,0,8,0,27,1597032000,1612069200,8
opposide,1,7,315,64,1606539600,1606539600,8
heartdropsdaily,1,7,163,45,1556078400,1595995200,8
Sot0,1,7,79,12,1608440400,1608526800,8
UltimaDeusUmbra,0,8,0,87,1592280000,1611982800,8
ndnd_of_omicron,1,7,595,109,1609218000,1609304400,8
blooooosh,0,8,0,66,1588737600,1590120000,8
El_Grappadura,0,8,0,73,1586318400,1596600000,8
eifersucht12a,0,8,0,192,1589428800,1606798800,8
LifeisDepressing555,1,7,20,24,1595476800,1606885200,8
fbholyclock,0,8,0,31,1584849600,1607230800,8
defreun,0,8,0,119,1585540800,1585627200,8
goofberries,0,8,0,67,1567483200,1605416400,8
CHOLO_ORACLE,0,8,0,47,1602648000,1608440400,8
Trollselektor,0,8,0,50,1586232000,1605157200,8
navigating-life,0,8,0,100,1579323600,1586232000,8
TremorX,0,8,0,12,1575608400,1597982400,8
thatquietman,2,6,22,36,1590120000,1611896400,8
_austinm,0,8,0,162,1601092800,1607749200,8
Saedran,0,8,0,84,1562299200,1605675600,8
Die-yep-io,0,8,0,102,1588478400,1608786000,8
zedshouse,0,8,0,111,1595390400,1608440400,8
TexasPhanka,0,8,0,95,1553400000,1597809600,8
agent_macklinFBI,0,8,0,93,1565755200,1584158400,8
Barney_Brallaghan,0,8,0,66,1582866000,1604030400,8
Tiresiasksk,0,8,0,47,1605070800,1609045200,8
Everyday_Bellin,0,8,0,-1,1608267600,1608267600,8
jackelope84,0,8,0,73,1603944000,1605762000,8
Zaardo,0,8,0,8,1605502800,1605502800,8
Wassux,0,8,0,24,1585281600,1595131200,8
J_Mauser,0,8,0,48,1588132800,1600660800,8
sabiiitsuki,1,7,57,36,1564286400,1569988800,8
stuck_on_this_planet,0,8,0,86,1550552400,1576818000,8
cloneofcloneofme,2,6,351,181,1575349200,1580360400,8
Radimir-Lenin,0,8,0,-7,1571630400,1578978000,8
biggiepants,1,7,130,105,1563681600,1593748800,8
porkypigdickdock,0,8,0,18,1611982800,1612069200,8
ceylon_butterfly,0,8,0,250,1596600000,1606194000,8
BigNoseMcGhee,0,8,0,28,1558497600,1580014800,8
la_voie_lactee,0,8,0,13,1599883200,1605762000,8
Marcools,0,8,0,-57,1588219200,1591416000,8
xpoisonvalkyrie,0,8,0,59,1596945600,1608958800,8
faded-pixel,0,8,0,23,1583726400,1595908800,8
PinkPirate27,0,8,0,-7,1598155200,1598155200,8
solidheron,0,8,0,112,1601697600,1607835600,8
Plagueis_n_Fries,1,7,24,25,1607490000,1607490000,8
hosford42,0,8,0,69,1594785600,1600574400,8
abraham_meat,0,8,0,235,1582952400,1608354000,8
Hinkil,0,8,0,85,1589169600,1608786000,8
EmilyTheCommie,0,8,0,104,1595476800,1595908800,8
-Cosmocrat-,1,7,196,48,1580878800,1607749200,8
Draconius0013,0,8,0,40,1583211600,1585454400,8
existentialprison,0,8,0,35,1535515200,1545454800,8
KDBA,0,8,0,46,1582520400,1607058000,8
Broadnerd,0,8,0,77,1575349200,1575435600,8
insecurebiatchhelp,0,8,0,22,1597896000,1598587200,8
BeakmansLabRat,0,8,0,37,1606107600,1608354000,8
muffinislove,0,8,0,-35,1562472000,1562558400,8
realButtcleavage,0,8,0,0,1591243200,1591243200,8
somersaultandpepper,0,8,0,31,1583812800,1591329600,8
Shmokable,0,8,0,152,1595304000,1612069200,8
SoonHexica,0,8,0,34,1586318400,1605762000,8
mrurg,0,8,0,38,1593662400,1601956800,8
Yegie,0,8,0,21,1596600000,1597377600,8
Siphyre,0,8,0,-4,1604379600,1611982800,8
JohnnySwanson7,0,8,0,-13,1564545600,1566014400,8
Dubalicious,0,8,0,-3,1606021200,1606021200,8
psychedeliccolon,0,8,0,105,1552622400,1604030400,8
Stop-Hanging-Djs,1,7,7,64,1572321600,1582261200,8
silentpierce,0,8,0,185,1583038800,1608354000,8
1ndigoo,1,7,41,45,1569816000,1588737600,8
pylon43,0,8,0,-54,1602043200,1604030400,8
Lilydaisy8476,0,8,0,53,1601352000,1607922000,8
Seditional,0,8,0,51,1555387200,1605243600,8
COLONpOWL,0,8,0,-67,1607835600,1608094800,8
OptimisticAlone,0,8,0,12,1605416400,1605416400,8
kidfire,0,8,0,-8,1606626000,1606971600,8
romaine4me,0,8,0,37,1571371200,1587700800,8
Carbunclecatt,0,8,0,54,1589947200,1608267600,8
JimBerwick,1,7,23,25,1563768000,1564113600,8
SMc-Twelve,0,8,0,-13,1598760000,1598760000,8
Dougary96,1,7,367,172,1551070800,1603944000,8
delurkrelurker,0,7,0,27,1572062400,1608786000,7
FawkThisWorld,1,6,183,66,1573794000,1577422800,7
SamTomGaf,0,7,0,142,1556510400,1565236800,7
Josh_Drake,0,7,0,62,1583985600,1590033600,7
chairhugs,0,7,0,17,1552536000,1554264000,7
dado6973692,0,7,0,34,1578632400,1593489600,7
Killadelphian,0,7,0,49,1547010000,1603684800,7
eightslipsandagully,0,7,0,206,1600315200,1605157200,7
GanjaWarlord,0,7,0,52,1571371200,1592193600,7
daniellenicole83,1,6,42,25,1594008000,1602388800,7
betterOblivi0n,0,7,0,7,1602302400,1612155600,7
my__jinji,0,7,0,35,1584504000,1596168000,7
chair0147,3,4,19,-8,1601784000,1604293200,7
BigDaddyZuccc,0,7,0,41,1606626000,1607922000,7
MedEng3,0,7,0,2,1598155200,1598155200,7
eleikobro,0,7,0,-12,1608181200,1608699600,7
jh231,0,7,0,22,1597377600,1608613200,7
DntTouchMeImSterile,0,7,0,47,1591243200,1606194000,7
throwaway225899,0,7,0,-41,1605934800,1608094800,7
underinformed,0,7,0,22,1588996800,1607403600,7
Amit_kumar69,1,6,1577,43,1600660800,1605157200,7
alumirust,2,5,74,7,1590292800,1593662400,7
Repentent_sinner,1,6,5,12,1607144400,1611982800,7
grungebobsquarepantz,0,7,0,100,1599019200,1602734400,7
peepalapeep,0,7,0,25,1567137600,1603512000,7
YearofTheStallionpt1,0,7,0,155,1597809600,1608613200,7
dappotaw,1,6,14,44,1573707600,1587182400,7
cpt-j4ck,0,7,0,-6,1604811600,1604811600,7
GigiFranco,1,6,2361,37,1567742400,1567828800,7
Lichtsprecher,0,7,0,221,1573189200,1590897600,7
wafflelator,1,6,19,92,1544590800,1547442000,7
_Bumble_Bee_Tuna_,0,7,0,14,1550725200,1567742400,7
mart1373,0,7,0,38,1581915600,1608267600,7
Lolo_Lad_21,3,4,6239,12,1572930000,1589428800,7
fredisugly,0,7,0,30,1608440400,1609477200,7
tommytwolegs,0,7,0,-4,1560657600,1609045200,7
Little_Danson_Man,0,7,0,31,1577509200,1578286800,7
_Downwinds_,0,7,0,164,1583643600,1607922000,7
Shadow_Being,0,7,0,-80,1576472400,1576558800,7
brotatowolf,0,7,0,70,1558152000,1608613200,7
creuse,1,6,45,340,1595995200,1602993600,7
danirobot,1,6,18,78,1570593600,1598414400,7
Quadbarrelpunch1999,0,7,0,22,1567656000,1573794000,7
spunchy,6,1,23,1,1429416000,1608786000,7
bb2sl7,0,7,0,36,1568692800,1591848000,7
jizzledfreq,0,7,0,21,1553227200,1612155600,7
The1stCitizenOfTheIn,1,6,24,791,1603512000,1608181200,7
hiddenproverb,0,7,0,30,1581483600,1596600000,7
tenders74,6,1,74,9,1586923200,1589515200,7
Brokepapa123,0,7,0,16,1585022400,1597032000,7
Diatomo,0,7,0,239,1578978000,1611810000,7
Geckat,1,6,4,210,1591070400,1597550400,7
shardikprime,0,7,0,6,1609131600,1609218000,7
justcarlos1,0,7,0,6,1562472000,1569038400,7
FrivolousIntern,0,7,0,45,1601265600,1603425600,7
NinjaEnt,0,7,0,722,1588132800,1608440400,7
hanniebunches,0,7,0,-14,1588910400,1592193600,7
Sam2734,0,7,0,60,1576645200,1606194000,7
alansnackbar12342069,0,7,0,-21,1599105600,1600488000,7
Heflar,0,7,0,14,1580619600,1580965200,7
nybargo,0,7,0,29,1606453200,1606885200,7
faithfamilyfootball,0,7,0,44,1581397200,1606453200,7
snwflak3,2,5,66,58,1591243200,1600056000,7
AHabe,0,7,0,45,1584676800,1605675600,7
palmbeach1972,0,7,0,34,1573966800,1595649600,7
Urmom911911,0,7,0,12,1600574400,1600574400,7
experimentaloptomist,0,7,0,311,1597896000,1598587200,7
AnomalyNine,0,7,0,60,1590465600,1594008000,7
Sarcasma19,0,7,0,98,1573534800,1585627200,7
thepimpartist,0,7,0,20,1592539200,1596600000,7
freckleritz,1,6,16,39,1572321600,1600228800,7
tarantulatio,1,6,40,34,1579237200,1579237200,7
bobjanis,0,7,0,25,1575608400,1575608400,7
HS-smilingpolitely,2,5,308,61,1569384000,1570680000,7
SomeAncap2020,1,6,0,3,1596513600,1596600000,7
ExasperatedEmployee,1,6,17,-22,1595390400,1595390400,7
galka02042020,0,7,0,149,1605416400,1608613200,7
massivedefence,0,7,0,238,1565496000,1573016400,7
Xtians_Arent_People,0,7,0,71,1576818000,1579064400,7
benjaminswanson1986,0,7,0,-3,1587873600,1587873600,7
chillax63,0,7,0,10,1609477200,1609477200,7
AlabasterPelican,0,7,0,137,1563508800,1604116800,7
HavanaHologram,0,7,0,49,1606885200,1611982800,7
Cactus-Plant-Flea,0,7,0,95,1601524800,1601870400,7
cancellingmyday,0,7,0,26,1550811600,1581310800,7
moonshinecrew,1,6,2439,381,1580878800,1612069200,7
1zeewarburton,0,7,0,88,1606453200,1606798800,7
speakingofsegues,0,7,0,13,1476849600,1584158400,7
MachoChocolate,0,7,0,60,1606539600,1606539600,7
mkkool,5,2,4741,19,1601524800,1611896400,7
ofk12,1,6,68,205,1599105600,1602216000,7
merinox,0,7,0,21,1593144000,1593921600,7
Sam_Van_Dweller,1,6,17,6,1606107600,1613883600,7
BaconComposter,0,7,0,52,1580619600,1587873600,7
StoneJackBaller71,0,7,0,-60,1599192000,1600142400,7
Emergency_Advantage,0,7,0,235,1593662400,1606626000,7
nugaseya,3,4,230,44,1584590400,1588737600,7
throwawayjoblife,1,6,779,92,1592971200,1593057600,7
ActuallyAWeasel,0,7,0,65,1608440400,1609390800,7
Frekwency,1,6,1053,15,1604116800,1604116800,7
ClintonWeathershed,0,7,0,5,1578718800,1589083200,7
alwaysonthedamnphone,0,7,0,64,1596254400,1602216000,7
CX198,1,6,0,-5,1604898000,1605157200,7
DMCA_OVERLOAD,0,7,0,32,1557288000,1559707200,7
Renotro,0,7,0,55,1579410000,1597809600,7
bigboostedbuick,0,7,0,22,1599710400,1609304400,7
johnthomaslumsden,0,7,0,20,1597636800,1597809600,7
cahcealmmai,0,7,0,19,1557288000,1587614400,7
ScintillaAeternalis,0,7,0,147,1583470800,1608872400,7
Morning-Coffee-fix,1,6,168,23,1606712400,1609045200,7
Mexican5020,0,7,0,90,1574485200,1601179200,7
The_Big_Red_Wookie,0,7,0,66,1567310400,1593230400,7
Neomex,1,6,2,66,1586318400,1598328000,7
Iguanas14,0,7,0,80,1585281600,1590120000,7
Shnig1,0,7,0,9,1567137600,1579582800,7
morleystreet,0,7,0,14,1581915600,1606021200,7
donewiththisshit777,0,7,0,-26,1591243200,1591243200,7
A_Nutt,0,7,0,288,1589428800,1604116800,7
turbospeedsc,0,7,0,-13,1593835200,1605934800,7
2Salmon4U,0,7,0,31,1608526800,1608526800,7
hancocklovedthat,2,5,250,11,1577941200,1584763200,7
PleasecanIcomeBack,0,7,0,115,1592798400,1608526800,7
HairyAwareness,0,7,0,-27,1571889600,1580619600,7
Blabulus,1,6,12,13,1577595600,1609390800,7
Zur-En-Arrrrrrrrrh,0,7,0,99,1596427200,1607144400,7
HyperOnyx,0,7,0,149,1595563200,1604898000,7
zacyzacy,2,5,64,99,1596081600,1607576400,7
mathbbR,0,7,0,106,1578546000,1594872000,7
coleisawesome3,0,7,0,3,1606366800,1609131600,7
Soppphhhiiieee,0,7,0,74,1590638400,1600315200,7
costakicks,0,7,0,176,1571889600,1582866000,7
iamblckhwk,0,7,0,31,1571025600,1609390800,7
Moikee,0,7,0,97,1602648000,1605848400,7
jonordona,0,7,0,155,1548133200,1558670400,7
agmatine,1,6,211,16,1582952400,1603252800,7
Apple-Core22,0,7,0,16,1605157200,1605157200,7
letsloveoneanother,0,7,0,20,1597032000,1598932800,7
HeartOTheCards,2,5,125,62,1566273600,1607490000,7
BlondeAmbition93,1,6,14,11,1596772800,1597032000,7
LashGibson,1,6,13,48,1599796800,1611637200,7
medicalcagefighting,1,6,302,141,1600488000,1600488000,7
RhythmBlue,0,7,0,22,1606107600,1607490000,7
Souk12,1,6,490,52,1598241600,1598241600,7
Filmmaker_rules,0,7,0,17,1568865600,1590638400,7
Tryingsoveryhard,0,7,0,-45,1593316800,1593403200,7
dxiiv,4,3,14941,8,1568779200,1608267600,7
LaCamarillaDerecha,0,7,0,37,1612069200,1612069200,7
Juggernog,0,7,0,29,1572843600,1598932800,7
jasthecat,2,5,79,28,1568606400,1568779200,7
Drinksarlot,0,7,0,74,1575867600,1590724800,7
FartOnCommies,0,7,0,2,1608440400,1608526800,7
SoMuchCrabJuice,1,6,93,21,1555646400,1555905600,7
yagyaxt1068,1,6,16,84,1575003600,1607403600,7
nmcxiii,0,7,0,25,1596600000,1612155600,7
FrankyJuicebox,0,7,0,281,1597809600,1611896400,7
Pew_pew_pew_ow,0,7,0,119,1582606800,1594008000,7
faux_naturale,0,7,0,36,1600401600,1606626000,7
bcwills,0,7,0,37,1600142400,1606280400,7
PM_ME_HENTAI_FEMDOM,0,7,0,15,1557288000,1557374400,7
-Prapor,0,7,0,7,1596168000,1596600000,7
Handseamer,1,6,4,8,1589947200,1605330000,7
darkestgradient,0,7,0,53,1584072000,1584936000,7
alliekat237,0,7,0,6,1570334400,1570420800,7
Jazzeebo,0,7,0,151,1581656400,1585281600,7
OFFENSIVE_GUNSLUT,0,7,0,-10,1559707200,1559707200,7
abdelhamid99,2,5,31,7,1606885200,1607058000,7
Zerio920,3,4,114,-7,1552194000,1566619200,7
cellard00r18,1,6,124,40,1601092800,1602302400,7
LawTeaDough,0,7,0,137,1603512000,1608786000,7
arvada14,0,7,0,6,1571112000,1571371200,7
kec4x,0,7,0,42,1606107600,1612069200,7
vespertine_daydream,0,7,0,81,1590379200,1596772800,7
Lux_Aetheris,0,7,0,53,1604984400,1608786000,7
andryusha_,0,7,0,199,1578978000,1597118400,7
Unable-Explanation89,0,7,0,-21,1607922000,1608440400,7
friendispatrickstar,0,7,0,35,1562817600,1579237200,7
squishysquash23,1,6,9,59,1570766400,1591416000,7
another_stranger_,0,7,0,48,1587873600,1601179200,7
chiguayante,0,7,0,21,1611810000,1612242000,7
CynicalRecidivist,0,7,0,64,1603425600,1608440400,7
ItsEasyToGuess,0,7,0,-14,1580619600,1580619600,7
SelfRisingBootstraps,0,7,0,118,1579064400,1589947200,7
NotQuiteHereYet,0,7,0,34,1578027600,1608786000,7
dat_carovieh,0,7,0,129,1564977600,1578718800,7
A45zztr,0,7,0,43,1550293200,1550293200,7
catdogpigduck,0,7,0,18,1575349200,1583470800,7
WearyConversation0,1,6,16,15,1598328000,1598414400,7
brooklynmoon,6,1,9127,21,1567828800,1574571600,7
MycatSeb,0,7,0,48,1589342400,1607835600,7
cuchioo,2,5,32,14,1576645200,1580533200,7
Capn_Blackbeard,7,0,283,0,1416805200,1548565200,7
turk_turklton,0,7,0,47,1607490000,1608872400,7
the_wonderer2019,0,7,0,15,1583125200,1583985600,7
jsmoo68,1,6,81,78,1570334400,1598500800,7
Xx_Venom_Fox_xX,0,7,0,12,1575435600,1606971600,7
TheHaleStorm,0,7,0,-4,1577509200,1577595600,7
zcewaunt,1,6,8,18,1586232000,1601438400,7
Euphoric_Chipmunk234,0,7,0,20,1604984400,1609218000,7
purpleblazed,0,7,0,110,1571371200,1604379600,7
kayleeelizabeth,0,7,0,36,1580014800,1585454400,7
emirikol2099,0,7,0,6,1605589200,1605589200,7
refreshmysoul,1,6,13,94,1580706000,1589083200,7
Tinkerdudes,0,7,0,56,1605762000,1607230800,7
Lilith777,0,7,0,27,1553572800,1572580800,7
thejaytheory,0,7,0,43,1574312400,1576299600,7
breadisafood,0,7,0,4,1558497600,1574312400,7
CommieLurker,0,7,0,65,1606280400,1609218000,7
dzrtguy,0,7,0,2,1585454400,1604379600,7
Raerhix27,0,7,0,16,1595822400,1601265600,7
AngryAxeman,1,6,26,13,1570161600,1604466000,7
xchironides,0,7,0,73,1573534800,1576645200,7
Lucero5000,0,7,0,24,1593316800,1607144400,7
greenslime300,0,7,0,45,1576299600,1608267600,7
TerrorTonyC,1,6,39,15,1571889600,1594958400,7
Ren19876,0,7,0,218,1601524800,1603512000,7
NurseGryffinPuff,0,7,0,118,1563854400,1604725200,7
thegirlisred,0,7,0,19,1538366400,1538366400,7
perma-monk,0,7,0,64,1609390800,1609477200,7
_lelizabeth,2,5,88,12,1581570000,1608354000,7
Slobboban,0,7,0,50,1575954000,1601956800,7
BigVanVortex,0,7,0,31,1579582800,1600488000,7
Simcom,0,7,0,-37,1569988800,1607576400,7
aliceintrashland,0,7,0,61,1605762000,1608008400,7
NaboKant,0,7,0,24,1594094400,1609477200,7
evlampi,0,7,0,56,1599710400,1606798800,7
screwhammer,0,7,0,37,1592107200,1596772800,7
PSC1111,0,7,0,21,1596945600,1605330000,7
DepressedGhoast,0,7,0,348,1598932800,1608699600,7
Sand-Covered-Grass,0,7,0,51,1578632400,1605502800,7
RedEgg16,0,7,0,49,1572667200,1590033600,7
YoSanford,0,7,0,28,1575176400,1608613200,7
BohemisX,0,7,0,22,1593403200,1608267600,7
BHoles_n_Gravitation,1,6,2,8,1596513600,1599710400,7
siznit,0,7,0,-27,1576126800,1609218000,7
PeacefulChaos94,2,5,19,59,1587614400,1599710400,7
lemonryker,0,7,0,117,1580446800,1604811600,7
mother-of-puppies,3,4,194,15,1565064000,1583125200,7
Matt-Goo,0,7,0,35,1607144400,1609390800,7
sacrificial_blood,1,6,316,48,1579323600,1589860800,7
PlayfuckingTorreira,0,7,0,34,1605070800,1607662800,7
DextTG,0,7,0,92,1574226000,1584417600,7
larcurlmo,0,7,0,-4,1608699600,1609218000,7
autistictanks,0,7,0,42,1601784000,1611810000,7
ayykay74m,0,7,0,622,1604984400,1608786000,7
WashAwayYourSins,0,7,0,30,1562731200,1566964800,7
ComicalKumquat,1,6,17,82,1570075200,1583557200,7
Clarityindistortion,0,7,0,-27,1578114000,1578114000,7
fanficgreen,0,7,0,83,1578459600,1593316800,7
eller_hmpf,2,5,42,25,1540180800,1550379600,7
ddddddaisy,3,4,372,59,1571976000,1596513600,7
The-Sooshtrain-Slut,0,7,0,35,1597377600,1607749200,7
Bored-Imp,1,6,40,342,1598500800,1604552400,7
BishmillahPlease,0,7,0,121,1593144000,1611982800,7
LurkForYourLives,0,7,0,8,1582434000,1608440400,7
Castle_Left,0,7,0,132,1605502800,1612069200,7
enolafaye,1,6,306,38,1561435200,1595217600,7
th_brown_bag,0,7,0,12,1600574400,1600660800,7
mmmmmmmartin,0,7,0,67,1575954000,1576990800,7
euphi_theexecutioner,1,6,40,59,1565064000,1605157200,7
xeandra_a,1,6,791,21,1606280400,1606280400,7
FoxPup98,0,7,0,17,1608872400,1608872400,7
Wisconsin_Death_Trip,0,7,0,40,1591761600,1615867200,7
Rattleshakes1,0,7,0,14,1601956800,1601956800,7
ewilhelml,1,6,29,11,1557288000,1557374400,7
ZoraExplorer,0,7,0,199,1582434000,1594440000,7
Coral_,0,7,0,130,1566964800,1601179200,7
illstartinaminute,1,6,34,40,1609390800,1609650000,7
comcast_is_fascist,0,7,0,10,1596081600,1596340800,7
SwirlingAbsurdity,0,7,0,53,1579064400,1593576000,7
ceiffhikare,0,7,0,70,1564804800,1605243600,7
Grandaddyspookybones,3,4,6107,36,1581915600,1607662800,7
mlapa,0,7,0,37,1590120000,1593316800,7
GNS13,0,7,0,172,1573189200,1608958800,7
beachtruck,0,7,0,27,1563336000,1606626000,7
pygmy,0,7,0,227,1597032000,1606539600,7
idle_palisade,0,7,0,52,1573016400,1597550400,7
fruitlessideas,0,7,0,12,1599278400,1599364800,7
Parzival1127,1,6,36,38,1601352000,1608267600,7
nonsingingduck,0,7,0,28,1592625600,1601524800,7
IDNoob34,0,7,0,12,1597204800,1597204800,7
black_elk_streaks,0,7,0,31,1595995200,1599796800,7
LShep76,0,7,0,72,1577336400,1577854800,7
ActaCaboose,0,7,0,45,1591243200,1599364800,7
Prestigious-Number-7,2,5,423,68,1601179200,1609218000,7
Sergeant_Salmon,2,5,786,62,1583298000,1600574400,7
tandem23,0,7,0,368,1575003600,1587614400,7
ilovechairs,0,7,0,76,1605589200,1611810000,7
throughcracker,0,7,0,51,1552968000,1560657600,7
MrSkullBottom,0,7,0,413,1597550400,1611810000,7
wombatkidd,0,7,0,22,1594785600,1594785600,7
KanchiHaruhara,0,7,0,149,1552536000,1559707200,7
xSKELETONMANx,1,6,7,52,1575608400,1590120000,7
Karamazov__,0,7,0,45,1579150800,1612155600,7
ProjectMeerKatUltra,1,6,37,196,1570420800,1609390800,7
Michelle6987,1,6,477,73,1597550400,1597636800,7
KickingWithMyGnomies,0,7,0,90,1579410000,1580274000,7
Cainde,0,7,0,63,1599192000,1600228800,7
HylianSwordsman1,0,7,0,68,1582606800,1603598400,7
LoriRenae,0,7,0,407,1570075200,1586145600,7
Pay-Dough,0,7,0,139,1562904000,1592712000,7
Coopen87,2,5,30,19,1596772800,1607490000,7
MusicalConman,0,7,0,50,1595217600,1611723600,7
catninjaambush,0,7,0,106,1571544000,1588478400,7
noneyarr,0,7,0,52,1591070400,1592452800,7
bambooandclover,2,5,120,18,1568174400,1575090000,7
joshg8,0,7,0,-23,1560312000,1560312000,7
Fuzzy_Dart666,0,7,0,22,1575522000,1575608400,7
lomojamesbond,0,7,0,25,1608958800,1611896400,7
D33qBlue72,0,7,0,-71,1577422800,1608872400,7
guiesq,0,7,0,107,1587528000,1593921600,7
Khazahk,0,7,0,-121,1578027600,1578805200,7
spaciousglacier,0,7,0,152,1563768000,1564891200,7
Brianmobile,0,7,0,108,1564718400,1588132800,7
wrongkoi,0,7,0,34,1573534800,1602734400,7
FuzzyBagpuss,0,7,0,99,1574139600,1611896400,7
xtenone,0,7,0,61,1589947200,1594353600,7
Corniche1337,0,7,0,9,1575003600,1580965200,7
kzwj,0,7,0,29,1551589200,1566619200,7
dturtleman150,0,7,0,-3,1578891600,1578978000,7
fucko5,0,7,0,-83,1566705600,1566792000,7
CommentingOnVoat,1,6,8,-8,1582779600,1602648000,7
UnholyWardenG,0,7,0,45,1599883200,1602388800,7
MrOrangeWhips,0,7,0,64,1603771200,1607490000,7
Werowl,0,7,0,72,1590638400,1605762000,7
Gustavus_Arthur,0,7,0,-230,1587441600,1596859200,7
awesomesauceitch,0,7,0,8,1569211200,1569211200,7
pandamonium789,0,7,0,40,1575349200,1589169600,7
Tokarev309,0,7,0,125,1611723600,1611896400,7
ALinIndy,0,7,0,118,1572753600,1601179200,7
murderedcats,0,7,0,71,1573707600,1596600000,7
Honeybee_honeybee,0,7,0,52,1604984400,1604984400,7
stugots85,0,7,0,23,1543035600,1584417600,7
SpicyDefenestration,0,7,0,128,1599969600,1599969600,7
alekhineX,1,6,5,9,1435550400,1593662400,7
jasenzero1,0,7,0,308,1596945600,1606712400,7
DjPersh,0,7,0,60,1578027600,1584072000,7
buzzcity0,0,7,0,33,1555732800,1596859200,7
greenlight144000,3,4,180,147,1592452800,1608699600,7
EmbarrassedPaper,2,5,380,113,1570248000,1607490000,7
qglrfcay,0,7,0,113,1569124800,1596686400,7
vinnySTAX,0,7,0,13,1606453200,1606798800,7
TrapaNillaf666,1,6,142,27,1606798800,1607058000,7
tface23,0,7,0,191,1587614400,1606626000,7
TravisShoemocker,0,7,0,32,1560744000,1569211200,7
BrujahRage,0,7,0,33,1446004800,1592452800,7
FabulousLemon,0,7,0,55,1566964800,1593921600,7
jawatrader22,0,7,0,42,1583557200,1585713600,7
This_is_my_phone_tho,1,6,38,7,1572580800,1586232000,7
MarkLove717,1,6,49,11,1605589200,1609131600,7
ShinobiD0E,0,7,0,25,1603166400,1605934800,7
whyamithebadger,0,7,0,31,1599883200,1601352000,7
MrJsmanan,0,7,0,-23,1593230400,1593316800,7
ocular-pat-down,2,5,326,46,1593489600,1602302400,7
Rocket-Ron-,0,7,0,71,1604811600,1611982800,7
michel_fucko,0,7,0,16,1578546000,1582347600,7
pussandra,0,7,0,18,1606885200,1611810000,7
Flvs9778,0,7,0,16,1606021200,1611896400,7
earthtonemalone,0,7,0,928,1591156800,1605934800,7
suchathrill,0,7,0,49,1606626000,1611810000,7
AnInfiniteRick,0,7,0,7,1606626000,1607317200,7
luchinocappuccino,0,7,0,182,1583211600,1597204800,7
haughly,0,7,0,-15,1586491200,1598587200,7
StellaFraser,0,7,0,31,1568347200,1572235200,7
AprilDoll,0,7,0,9,1580187600,1580533200,7
Mistr_MADness,0,7,0,46,1546750800,1568865600,7
stinkybwinkyskksknk,0,7,0,44,1575349200,1582088400,7
InsideTheFall,0,7,0,262,1596427200,1606366800,7
eawick,0,7,0,52,1557806400,1566360000,7
Coconuthead93,0,7,0,-14,1587009600,1596340800,7
Promen-ade,3,4,40,4,1572321600,1580187600,7
ChongoFuck,0,7,0,-2,1554523200,1554696000,7
applejack_v,0,7,0,27,1599192000,1608181200,7
ashaheri,1,6,60,25,1557288000,1559534400,7
windowseat4life,1,6,36,18,1611810000,1611810000,7
political-junkie,2,5,4,55,1564113600,1565755200,7
Reece1492,0,7,0,209,1572753600,1590120000,7
dannydevitofan16,0,7,0,82,1601352000,1606971600,7
TurboSpeedyFast,2,5,36,19,1576213200,1580014800,7
El_Draque,0,7,0,49,1571630400,1606885200,7
Hlodynn,1,6,22,34,1561435200,1563595200,7
scrapneck,0,7,0,38,1581656400,1601352000,7
ramunaspe92,0,7,0,-30,1608094800,1608094800,7
SoSaltyDoe,0,7,0,-12,1598760000,1603166400,7
BiffBarf,0,7,0,148,1559275200,1602043200,7
Prince_Jackalope,0,7,0,64,1578891600,1587096000,7
caramelbeurresaley,1,6,5,18,1553227200,1564027200,7
hvllowedground,0,7,0,16,1571457600,1571803200,7
HotTopicRebel,0,7,0,12,1606626000,1608958800,7
data_dawg,0,7,0,25,1580706000,1607662800,7
Hloddeen,2,5,55,40,1571803200,1574571600,7
Giant-Genitals,0,7,0,227,1606626000,1608526800,7
Mr_AP92,2,5,208,76,1604203200,1606971600,7
BeboTheMaster,0,7,0,71,1554955200,1598241600,7
queencharlie,0,7,0,16,1601006400,1603684800,7
Axehead88,0,7,0,-8,1571976000,1573707600,7
PinkFury_Bibliopegy,1,6,60,21,1601870400,1606194000,7
cloudsnacks,0,7,0,16,1556078400,1566014400,7
Ataletta,0,7,0,92,1596513600,1602820800,7
psdnmstr01,0,7,0,72,1546578000,1586750400,7
AmericanToastman,0,7,0,111,1576299600,1579669200,7
vanticus,0,7,0,23,1599019200,1611982800,7
EZpeeeZee,0,7,0,366,1564027200,1582606800,7
phirdeline,0,7,0,72,1560139200,1562299200,7
gottarespondtothis,0,7,0,17,1572667200,1608526800,7
notnotmildlyautistic,0,7,0,2,1560052800,1561348800,7
catglass,0,7,0,38,1562558400,1582779600,7
renparbar,0,7,0,10,1579582800,1579669200,7
deliciousmaple,2,5,721,28,1585454400,1602648000,7
bluemagic124,0,7,0,27,1564718400,1612069200,7
timeactor,0,7,0,230,1585713600,1602129600,7
thevirginchadiel,2,5,160,11,1567569600,1571371200,7
turnthatshitoff,0,7,0,32,1590552000,1602993600,7
PM_ME_UR_CONSPIRACYS,0,7,0,87,1596859200,1609045200,7
Undreren,0,7,0,54,1601524800,1608181200,7
ataRed,0,7,0,53,1575262800,1605934800,7
CanopyOfAsh,1,6,805,88,1576386000,1576472400,7
Functional_Sus,0,7,0,54,1549602000,1552968000,7
Yourlordensavior,0,7,0,-34,1606626000,1606712400,7
zoonose99,1,6,24,198,1606453200,1608440400,7
Cotton1candy,0,7,0,45,1579669200,1607922000,7
ditkaisgod27,0,7,0,61,1578373200,1608958800,7
PDevos,0,7,0,8,1607403600,1608699600,7
label_and_libel,0,7,0,30,1575435600,1575522000,7
workingisgood,4,3,1089,49,1590984000,1591156800,7
MakeWay4Doodles,0,7,0,245,1597636800,1606539600,7
Aiamai_Lee,0,7,0,52,1579928400,1589169600,7
studentduh,0,7,0,-116,1563163200,1563249600,7
TheRedBow,0,7,0,48,1559102400,1605330000,7
834934820934,1,6,19,13,1579928400,1580533200,7
aoi_kkj,1,6,10,19,1595822400,1596081600,7
Michael2Terrific,0,7,0,1260,1589860800,1598760000,7
Sauron8,2,5,28,10,1569297600,1592280000,7
Wes_Jelqer,0,7,0,61,1574139600,1600488000,7
quincium,0,7,0,10,1588996800,1588996800,7
MulhollandMaster121,1,6,6,51,1575867600,1602907200,7
rabbitscape,1,6,7159,381,1578459600,1607749200,7
DankBagels3,0,7,0,93,1584590400,1597636800,7
engineeringstoned,0,7,0,20,1603080000,1611896400,7
i_hate_beignets,0,7,0,31,1571284800,1603512000,7
Alwaysyourstruly,0,7,0,39,1570420800,1595304000,7
terciocalazans,0,7,0,27,1602475200,1609218000,7
elsaturation,0,7,0,74,1550466000,1602820800,7
areyouagoodboy,0,7,0,67,1552622400,1570420800,7
Jadisons,1,6,30,20,1606626000,1606885200,7
redditforgold,0,7,0,-40,1577595600,1611982800,7
MyLifesParody,0,7,0,51,1581656400,1607144400,7
ThatProfessor3301,1,6,6,19,1574139600,1602561600,7
TheOtherRic,0,7,0,-26,1608526800,1609218000,7
giverope1,0,7,0,62,1576645200,1580533200,7
LaLaRobotica,1,6,292,143,1599796800,1611723600,7
beefflow3000,0,7,0,45,1578891600,1585972800,7
tenaciousfetus,0,7,0,161,1581051600,1596859200,7
gothsartre,1,6,78,10,1606453200,1608008400,7
AhHerroPrease,0,7,0,230,1565755200,1565841600,7
vadimafu,1,6,14,57,1545973200,1607317200,7
EnoughAwake,1,6,1,73,1594267200,1604984400,7
Findingthur,0,7,0,2,1574658000,1575435600,7
thebloodylies,0,7,0,102,1552881600,1585454400,7
Xenos_Str,0,7,0,489,1588996800,1604116800,7
JayTreeman,0,7,0,238,1577422800,1592971200,7
Generalisimo_AI,0,7,0,50,1604116800,1606626000,7
JudgementalPrick,0,7,0,42,1548133200,1605070800,7
dreadlord999111,0,7,0,96,1568865600,1600747200,7
atomicgin,0,7,0,59,1567569600,1572667200,7
SkronkHound,0,7,0,79,1579150800,1606712400,7
truehalf,6,1,40475,11,1584244800,1591156800,7
jamesonSINEMETU,0,7,0,14,1575349200,1584417600,7
foocutuzer,0,7,0,-39,1593835200,1593835200,7
DumbledoresFerrari,0,7,0,7,1562990400,1571889600,7
lileve3D,0,7,0,28,1594699200,1607749200,7
woodenonesie,0,7,0,51,1606021200,1609477200,7
TAOIIII,0,7,0,74,1583726400,1589428800,7
Kaih0,1,6,20,67,1547269200,1562644800,7
SeraphymCrashing,0,7,0,152,1593662400,1611810000,7
enmaku,0,7,0,43,1583643600,1597377600,7
Xelynega,0,7,0,31,1572580800,1572580800,7
mattvan246,0,7,0,36,1593316800,1600747200,7
twelvis,0,7,0,107,1558065600,1560484800,7
UsernameAdHominem,0,7,0,-147,1587873600,1587960000,7
Nercules,0,7,0,35,1578373200,1585800000,7
VeganAilurophile,0,7,0,24,1562040000,1577595600,7
Allymadox,0,7,0,41,1598932800,1605589200,7
Belrick_NZ,0,7,0,6,1576645200,1576731600,7
kaleisonsale,0,7,0,8,1605589200,1608699600,7
jeremyrando,1,6,10,503,1575176400,1600488000,7
Holobrine,1,6,6,71,1592539200,1604552400,7
diuinita,0,7,0,80,1588478400,1589342400,7
Apexblackout7,1,6,25,39,1609304400,1609304400,7
wiglessness,0,7,0,14,1576645200,1579064400,7
OverByChristmas,0,7,0,75,1569297600,1597809600,7
ItzYourBoyy,0,7,0,19,1608354000,1608526800,7
Axelfoley36,1,6,76,37,1593662400,1606453200,7
zealshock,1,6,39,80,1573362000,1600488000,7
ph0on,1,6,325,47,1606366800,1607230800,7
Edvis92,1,6,87,6,1606539600,1606885200,7
ghost_sanctum,0,7,0,28,1587096000,1608440400,7
AmbivalentAsshole,0,7,0,1893,1592280000,1643173200,7
fj333,0,7,0,-18,1605934800,1609131600,7
DonutsAreEthnicFood,1,6,454,76,1555905600,1556164800,7
Marshmellow_Diazepam,0,7,0,120,1570420800,1599710400,7
againstempathy,1,6,376,49,1581742800,1584590400,7
ApartheidReddit,0,7,0,90,1593748800,1598414400,7
im-datboi,0,7,0,22,1581310800,1585454400,7
imyoopers,0,7,0,124,1575608400,1609045200,7
Landis912,0,7,0,-329,1582606800,1582606800,7
koolio92,1,6,14,15,1555473600,1609131600,7
throw-it-away-bye-,1,6,110,40,1584936000,1595736000,7
Xenomorphsexual,1,6,12,15,1571630400,1599451200,7
ihrvatska,0,7,0,56,1583557200,1609045200,7
FortniteChicken,0,7,0,3,1585281600,1608786000,7
xanderrootslayer,0,7,0,175,1599796800,1608786000,7
A_Wondering_Ego,0,7,0,19,1585022400,1585108800,7
mysteryqueue,0,7,0,9,1607144400,1607144400,7
Leelluu,0,7,0,65,1566360000,1593230400,7
muscles_guy,0,7,0,142,1600747200,1608699600,7
lilmuskrat66,0,7,0,22,1591243200,1605070800,7
anrii,0,7,0,44,1576558800,1576904400,7
cantdressherself,0,7,0,214,1605070800,1605848400,7
RedSmileGroup,7,0,6,0,1603944000,1604466000,7
ChristianSgt,0,7,0,237,1550552400,1560916800,7
fartmouthbreather,0,7,0,25,1588824000,1605157200,7
TheJanisJoplin,0,7,0,66,1577336400,1607749200,7
andrezay517,0,7,0,59,1606626000,1606971600,7
manachar,0,7,0,41,1606539600,1612069200,7
nowyouseemenowyoudo2,0,7,0,17,1599969600,1600056000,7
RadagastNPipeweed,0,7,0,176,1605848400,1607317200,7
xdainaxpoller,0,7,0,30,1609218000,1609218000,7
Chem_Student-1986,0,7,0,32,1596340800,1600056000,7
Mogling,0,7,0,-30,1579755600,1579842000,7
awildorchid32,0,7,0,102,1606453200,1611810000,7
Buffer78,4,3,623,18,1525060800,1538193600,7
According_Surround_7,0,7,0,12,1606194000,1606194000,7
_parfait,3,4,47,7,1602561600,1603684800,7
asax9,0,7,0,157,1605502800,1605589200,7
xkillernovax,0,7,0,125,1575781200,1605848400,7
Once_Upon_Time,0,7,0,103,1572930000,1606453200,7
DickieMcGeezaks,0,7,0,18,1589688000,1595304000,7
woosterthunkit,0,7,0,-31,1561953600,1562040000,7
BitCthulhu,0,7,0,9,1573448400,1599710400,7
DogParkSniper,0,7,0,82,1606280400,1607490000,7
Cauterizeaf1,0,7,0,81,1607835600,1608440400,7
Geae,0,7,0,103,1565582400,1574312400,7
Gemnalysis,0,7,0,-66,1606021200,1606107600,7
ProchinaMarxist,2,5,72,14,1602820800,1611723600,7
FrancesJue,0,7,0,104,1529208000,1537848000,7
Don_Draper27,0,7,0,22,1596513600,1604725200,7
jacqueschirekt,0,7,0,24,1561435200,1601352000,7
JudasCartman,0,7,0,62,1609131600,1609218000,7
kflyer,0,7,0,225,1557720000,1602043200,7
selomiga,1,6,5632,206,1599796800,1599883200,7
pauljs75,0,7,0,14,1579582800,1603166400,7
JustLurkinOrWhatever,0,7,0,55,1579669200,1605934800,7
dog_ofwar,0,7,0,54,1597636800,1599796800,7
brikouribrikouri,1,6,42,67,1577595600,1577768400,7
Thesongbird1,0,7,0,38,1547874000,1574744400,7
perogidog,2,5,447,30,1588392000,1596686400,7
RedditMadeMeReddit,0,7,0,-2,1598760000,1611896400,7
NoTimeForInfinity,0,7,0,48,1538539200,1587873600,7
nordicpolarbear,0,7,0,28,1556596800,1565236800,7
Monstercocklol,1,6,0,-10,1604116800,1604116800,7
madolpenguin,1,6,7,59,1585800000,1607749200,7
FenderBellyBodine,0,7,0,88,1575954000,1609304400,7
Ewfah,7,0,23731,0,1568692800,1598587200,7
ZenDragon,0,7,0,61,1572930000,1604293200,7
suck-me-beautiful,1,6,24,43,1565755200,1602993600,7
crispnails,0,7,0,131,1600056000,1606626000,7
PM_ME___YoUr__DrEaMs,0,7,0,80,1552021200,1585540800,7
goingtoclowncollege,0,7,0,2,1580533200,1585368000,7
emd9629,0,7,0,56,1578114000,1589342400,7
Superbearfight,0,7,0,53,1588305600,1607835600,7
TheSweetestRealKid,1,6,0,-17,1582779600,1582779600,7
theseasons,0,7,0,26,1565323200,1590897600,7
Ironwarsmith,0,7,0,29,1604379600,1606280400,7
andreasw,4,3,69,4,1388984400,1429416000,7
darkknight261,3,4,428,50,1595390400,1609131600,7
tartrate10,0,7,0,510,1572148800,1607230800,7
funkytown67_rh,0,7,0,12,1611810000,1612155600,7
ColorCoatDrawing,0,7,0,49,1543899600,1596168000,7
trycoconutoil,3,4,198,10,1584763200,1609131600,7
Duude_Hella,0,7,0,180,1597032000,1608872400,7
spilt_wine,1,6,60,14,1567051200,1576040400,7
menacingFriendliness,0,7,0,23,1604898000,1608094800,7
whyihatepink,0,7,0,136,1580965200,1585195200,7
amberlamps-,0,7,0,64,1605502800,1607576400,7
2PlasticLobsters,0,7,0,32,1580274000,1593230400,7
Bobismuhtakeoutname,0,7,0,136,1559707200,1598673600,7
glytheum,0,7,0,111,1545454800,1573016400,7
NightPilot14,0,7,0,32,1577509200,1607058000,7
Zevojneb,0,7,0,30,1587355200,1608181200,7
maximus10meridius,0,7,0,41,1578200400,1584849600,7
DontJoinTheMilitary,0,7,0,6,1556942400,1600574400,7
BenedictHope,1,6,9,20,1599969600,1605762000,7
krusecontrol91,0,7,0,65,1572753600,1593662400,7
Frank_Qi,3,4,292,89,1567051200,1588824000,7
Ganjiste,0,7,0,67,1607576400,1608786000,7
chucwagn,0,7,0,141,1581138000,1608267600,7
irajputra,1,6,88,13,1560744000,1563249600,7
ivannavomit,0,7,0,445,1591329600,1609131600,7
acherryonyourdesk,2,5,69,41,1554868800,1558670400,7
__uncreativename,0,7,0,152,1582088400,1598068800,7
thegreenwookie,0,7,0,13,1594353600,1600142400,7
BartholomewRoberrts9,0,7,0,66,1563249600,1580533200,7
russellridenour,1,6,46,24,1558929600,1609822800,7
BreakfastHerring,0,7,0,34,1579928400,1602129600,7
EnrapturedForkies,2,5,22,11,1605589200,1607662800,7
audion00ba,0,7,0,7,1609650000,1609650000,7
bonkers909,0,7,0,-31,1588910400,1588996800,7
Disconnorable,0,7,0,26,1598760000,1598760000,7
Commissar_Genki,0,7,0,112,1561867200,1605502800,7
MasterOfNap,0,7,0,507,1597464000,1608526800,7
edgyguy115,1,6,253,119,1582261200,1592366400,7
treerex37,1,6,52,24,1587614400,1587700800,7
RuafaolGaiscioch,0,7,0,128,1585022400,1605416400,7
TomCruiseSexSlave,0,7,0,49,1599019200,1599019200,7
corinne9,0,7,0,186,1604030400,1608440400,7
PureScience385,0,7,0,-24,1557028800,1585108800,7
AdventurousKnee0,0,7,0,-130,1567569600,1570852800,7
krispy3d,0,7,0,336,1598673600,1605934800,7
Agitate_Organize,2,5,364,45,1585800000,1593662400,7
DampSquid68,1,6,8520,16,1592539200,1594612800,7
readwritethink,2,5,1892,30,1575435600,1575694800,7
Kilgore_Trout_Mask,1,6,55,286,1549861200,1558411200,7
meme-com-poop,0,7,0,-4,1581224400,1581224400,7
haotrax,0,7,0,90,1576818000,1576818000,7
Dredd-The-Judge,0,7,0,58,1593835200,1596686400,7
MiddleAgedPlumber,0,7,0,-124,1576299600,1595304000,7
liehvbalhbed,0,7,0,-58,1595649600,1595649600,7
Gay_Lord2020,0,7,0,74,1587096000,1587528000,7
spacemermaid1701,0,7,0,57,1561953600,1569988800,7
fr0nken,2,5,94,14,1582693200,1594008000,7
DojoDash,0,7,0,17,1580706000,1583470800,7
Pas__,0,7,0,15,1569297600,1574139600,7
ContingencyFees,1,6,134,31,1595390400,1595476800,7
nominalRL,0,7,0,8,1585454400,1592107200,7
mimosadanger,1,6,203,241,1581915600,1582779600,7
UniqueSlice,0,7,0,20,1602216000,1609218000,7
uhmlyssa,1,6,282,79,1607490000,1607490000,7
londonsocialite,0,7,0,61,1556683200,1585886400,7
SirMartyMart,0,7,0,-7,1607317200,1608440400,7
thetechnocraticmum,0,7,0,34,1594958400,1598760000,7
LyricRhapsody,1,6,12,9,1577941200,1577941200,7
LionMacDolphin,1,6,34,20,1604203200,1604379600,7
Pheser,0,7,0,70,1573794000,1596427200,7
Defapitator,0,7,0,42,1581483600,1582952400,7
bferencik,0,7,0,107,1605848400,1609131600,7
bondageman420,0,7,0,9,1612069200,1612155600,7
baller_unicorn,0,7,0,27,1538884800,1606798800,7
PellucidlyNebulous,0,7,0,25,1594785600,1608181200,7
nahmate45,5,2,8223,4,1597896000,1609390800,7
anatidayum,0,7,0,32,1580187600,1582434000,7
piauserthrowaway,0,7,0,163,1559534400,1560052800,7
xxxSexMan69xxx,1,6,312,128,1611723600,1612069200,7
DisreguardMe,0,7,0,239,1567137600,1584504000,7
diary_of_jain,3,4,248,14,1560139200,1574571600,7
ireallylikeher1,0,7,0,21,1556510400,1556510400,7
kkris23,0,7,0,130,1600747200,1606712400,7
Pryoticus,0,7,0,157,1578891600,1588392000,7
Eweasy,0,7,0,46,1579064400,1606194000,7
Vapourtrails89,0,7,0,101,1568347200,1592539200,7
JonnyMolotov,0,7,0,-11,1599624000,1599624000,7
plopseven,0,7,0,1237,1599883200,1611982800,7
techknight486,2,5,142,71,1557892800,1588305600,7
anaverageman_,1,6,166,-67,1601352000,1608613200,7
kwnofprocrastination,0,7,0,4,1606885200,1606885200,7
pdxtina,0,7,0,33,1579755600,1579755600,7
ImTooSt8ned,0,7,0,76,1574398800,1588392000,7
AlyxRoberts,0,7,0,140,1570420800,1580965200,7
MeAgainst-Society208,2,5,172,48,1602820800,1606194000,7
FDR_polio,0,7,0,386,1561176000,1577336400,7
Aesopthelion,0,7,0,1,1578286800,1578286800,7
Marvolo_Gaunt,1,6,19,34,1574398800,1589342400,7
Threwmyhandsup,1,6,20,16,1602734400,1602907200,7
Mosesmc45,0,7,0,7,1608699600,1608699600,7
unsignedcharizard,0,7,0,210,1572843600,1600142400,7
ter1997,1,6,96,99,1575435600,1584331200,7
LentilGod,3,4,258,7,1601697600,1607490000,7
thereisnotry_11,5,2,4369,82,1576126800,1586750400,7
leediv,0,7,0,76,1594699200,1604293200,7
morficus,0,7,0,61,1575349200,1585540800,7
Alteredperception90,0,7,0,31,1582866000,1601092800,7
jgzman,0,7,0,31,1552622400,1610168400,7
FA1L3D,1,6,9,6,1571198400,1605416400,7
try_-harder,0,7,0,-20,1601438400,1601611200,7
aeroaquaponic,1,6,4,70,1577768400,1578891600,7
I_am_the_Warchief,0,7,0,116,1605070800,1609218000,7
Deathamong,1,6,17,8,1568174400,1583985600,7
ItsLoudB,0,7,0,33,1577336400,1577336400,7
jayman419,0,7,0,27,1607317200,1609477200,7
Admirable_Role_313,4,3,29,4,1608181200,1609304400,7
ImaginaryEvents,2,5,44,85,1418101200,1580274000,7
PaperlessSand,0,7,0,74,1593230400,1607317200,7
mikeyhoho,0,7,0,38,1587355200,1603684800,7
fliphat,0,7,0,94,1547787600,1572667200,7
Sk8orDye22,0,7,0,159,1592884800,1595995200,7
Oxymoronic23,0,7,0,316,1571716800,1578891600,7
web_dev_vegabond,0,7,0,-2,1588219200,1604811600,7
987penn,0,7,0,1535,1573880400,1588305600,7
TheDevilsTrinket,0,7,0,74,1591675200,1597723200,7
spindledick,0,7,0,7,1578373200,1606971600,7
Blorbis83,2,5,16,10,1588219200,1596340800,7
fearfulANDlazy,1,6,20,12,1555560000,1555732800,7
Arrent,0,7,0,68,1584072000,1598155200,7
oliveang,0,7,0,140,1539921600,1569816000,7
Soccham,0,7,0,17,1596254400,1605589200,7
ATXstripperella,0,7,0,17,1593576000,1605416400,7
sucicdal_man,0,7,0,240,1594612800,1597291200,7
throwawayldr08,0,7,0,19,1607490000,1607922000,7
uvberot,2,5,52,34,1567569600,1574312400,7
Crazytonnie,0,7,0,20,1592712000,1598241600,7
Wannabe_Trebuchet,0,7,0,24,1556424000,1572667200,7
Pawops,0,7,0,26,1568260800,1579064400,7
Sword-of-Akasha,0,7,0,46,1585281600,1587441600,7
Less_Rise_3172,0,7,0,17,1604984400,1607835600,7
vonhudgenrod,0,7,0,13,1575349200,1578632400,7
GubbermentDrone,0,7,0,-35,1556424000,1556424000,7
PloksGrandpappy,0,7,0,46,1591416000,1607144400,7
Bartek_Bialy,2,5,26,28,1413691200,1477368000,7
davidaware,0,7,0,3,1577336400,1577336400,7
LetMyForbynGo,0,7,0,146,1565236800,1606280400,7
NoneHaveSufferedAsI,0,7,0,3,1591329600,1606280400,7
Dethcola,0,7,0,171,1581310800,1605243600,7
good_news_everyone10,2,5,118,38,1594526400,1604030400,7
Danyykiry,0,7,0,139,1608094800,1608181200,7
nomosapiens,2,5,48,37,1568692800,1573189200,7
The-Doomslayer,1,6,17,19,1609131600,1609131600,7
michaelmordant,0,7,0,153,1572321600,1593748800,7
authaire,0,7,0,60,1558843200,1589860800,7
redsuncircle,0,7,0,-20,1608786000,1609045200,7
BigSadAndy,0,7,0,16,1565582400,1572321600,7
LadyForlornn,1,6,7,22,1587182400,1609390800,7
uncle-boris,0,7,0,14,1569902400,1599192000,7
ecpickins,0,7,0,78,1600056000,1606712400,7
im_wide_awake999,1,6,39,45,1583643600,1583726400,7
schizonipple,1,6,40,21,1602993600,1603425600,7
shirtsMcPherson,0,7,0,12,1605589200,1605589200,7
Veryuglybutverycool,1,6,6,6,1606107600,1606107600,7
CookStrait,0,7,0,25,1552276800,1605589200,7
DolliGoth,0,7,0,13,1585627200,1602820800,7
chuusblackgf,1,6,59,33,1578546000,1580274000,7
JiffyTube,1,6,4767,37,1606798800,1608958800,7
tickingboxes,0,7,0,128,1571630400,1611896400,7
jouwhul,0,7,0,6,1579064400,1608526800,7
ExcessiveGravitas,2,5,716,55,1601784000,1607835600,7
Egzitwoond,1,6,43,40,1573621200,1573621200,7
carguitar,0,7,0,29,1594180800,1609477200,7
lizardmancer,3,4,64,16,1605502800,1608613200,7
yoyo_sensei,4,3,325,24,1579842000,1598760000,7
TransgamerLily,1,6,10,17,1592884800,1602734400,7
snowycato,0,7,0,77,1600228800,1609218000,7
WorkerandParasite22,0,7,0,57,1570248000,1585368000,7
rwilkz,0,7,0,40,1556251200,1574830800,7
DaveVoyles,0,7,0,16,1568865600,1569902400,7
lsdmt93,0,7,0,28,1569384000,1603944000,7
PetrichorMemories,1,6,101,101,1547096400,1558411200,7
Misterbert,0,7,0,65,1596254400,1597896000,7
Kdizzle1108,0,7,0,18,1576990800,1600315200,7
pspo1983,0,7,0,11,1604116800,1608699600,7
Cat_Upset,0,7,0,-38,1604552400,1608440400,7
Joe_The_Eskimo1337,0,7,0,19,1564545600,1576472400,7
TheGreatJourney06,1,6,1,18,1605589200,1609390800,7
HelpfulSocialist,1,6,54,140,1591675200,1598932800,7
whosanhoit,0,7,0,74,1593403200,1604379600,7
customguy1,0,7,0,90,1572062400,1588392000,7
6a6566663437,0,7,0,15,1576558800,1576731600,7
cremecatnana,1,6,24,89,1558411200,1574139600,7
Freakintrees,0,7,0,65,1579496400,1606798800,7
icaruswalks_,1,6,258,36,1607662800,1608699600,7
yumthepus,1,6,17,11,1607403600,1607490000,7
SlaimeLannister,0,7,0,676,1605416400,1607317200,7
nathalielemel,0,7,0,27,1594440000,1606626000,7
StrungStringBeans,0,7,0,141,1560744000,1585108800,7
CapableSkin,0,7,0,-21,1605502800,1608699600,7
FattierBrisket,0,7,0,51,1594958400,1602302400,7
Emochind,0,7,0,3,1540872000,1558238400,7
shitsingaporesays,0,7,0,548,1571284800,1591588800,7
PM_Me_Your_Clits_Pls,0,7,0,64,1581570000,1598155200,7
FatAssNTittes,0,7,0,162,1574744400,1578718800,7
GVJoe,0,7,0,144,1595563200,1602648000,7
Pezkato,0,7,0,23,1589169600,1589342400,7
jangleberry112,0,7,0,54,1560312000,1562990400,7
PainTrainMD,0,7,0,-26,1578632400,1603598400,7
Calculon3001,0,7,0,82,1577941200,1601870400,7
Quickglances,0,7,0,-44,1577854800,1604293200,7
woodstockzanetti,2,5,4563,37,1572148800,1602561600,7
nemofoot,2,5,156,15,1582347600,1603857600,7
RetailSucksDick,0,7,0,26,1598414400,1598587200,7
Tahoma78,0,7,0,19,1596254400,1598328000,7
SabbatiZevi,0,7,0,40,1577163600,1603684800,7
KaleAway,0,7,0,55,1607922000,1609304400,7
HermitInACabin,1,6,433,49,1602475200,1602561600,7
Useful-Throat-6671,0,7,0,47,1603339200,1611810000,7
notburneddown,1,6,16,8,1596081600,1596168000,7
seahorse87,2,5,22,14,1601956800,1604811600,7
Godlike1972,0,7,0,48,1605070800,1609390800,7
Square_Buddy,2,5,97,22,1602907200,1607144400,7
empirestateisgreat,0,7,0,-8,1612155600,1612242000,7
ringadingdingbaby,0,7,0,48,1602475200,1606626000,7
Qanno,1,6,9,45,1585800000,1606798800,7
CodenameAwesome,0,7,0,36,1555214400,1599537600,7
gingerbeer52800,0,7,0,119,1606107600,1608267600,7
failedaspotcheck,0,7,0,40,1588392000,1608786000,7
iiwwptp,1,6,71,130,1547787600,1556942400,7
UnchainedMundane,0,7,0,31,1582606800,1600228800,7
BasementElf,0,7,0,36,1606021200,1609045200,7
DudeJustLikeGiveIt,0,7,0,0,1603512000,1603684800,7
Derek_Boring_Name,0,7,0,72,1574830800,1597723200,7
Caminando_,0,7,0,15,1553918400,1555300800,7
Luce_Prima,2,5,62,419,1587009600,1587700800,7
gexisthebext,0,7,0,8,1589083200,1589083200,7
GrittyGaming,0,7,0,147,1594526400,1601092800,7
BobMcGeoff2,1,6,0,-26,1575522000,1575608400,7
awesomedan24,1,6,58,74,1597636800,1608181200,7
SigrdrifumalStanza14,0,7,0,15,1590638400,1595217600,7
DevilMayCarryMeHome,0,7,0,1,1591243200,1591243200,7
Theworldisalie666,0,7,0,62,1563508800,1607403600,7
Arengade,1,6,105,30,1566705600,1608786000,7
cheese_tits_mobile,0,7,0,76,1549602000,1554004800,7
xxtachanka,1,6,0,-48,1592193600,1602043200,7
SparklePeepers,0,7,0,-8,1579755600,1584244800,7
_fillory_clinton_,0,7,0,49,1556078400,1586923200,7
mypepsipussy,0,7,0,152,1572930000,1578632400,7
mattied23,0,7,0,-46,1582606800,1582693200,7
studiojibblys,3,4,4049,201,1590638400,1596945600,7
meatpuppet79,0,7,0,7,1538020800,1550293200,7
waterbear1960,0,7,0,61,1579928400,1597464000,7
VredditDownloader,0,7,0,8,1577941200,1597896000,7
angelhippie,0,7,0,37,1601006400,1604898000,7
BigAbbott,0,7,0,2,1571803200,1577509200,7
mrsteel00,1,6,8,37,1582002000,1582693200,7
akflo,1,6,304,34,1564804800,1583125200,7
FlammDumbFox,0,7,0,46,1554523200,1601265600,7
IAmNoSherlock,2,5,68,76,1606366800,1609218000,7
sol-it-aire,0,7,0,66,1577768400,1589860800,7
Solid-Liquid,0,7,0,26,1552021200,1567396800,7
xm202virus,0,7,0,62,1596945600,1602388800,7
if-we-all-did-this,0,7,0,23,1588478400,1609304400,7
ACABoone,0,7,0,106,1580619600,1583125200,7
Mynotredditaccount,0,7,0,139,1571976000,1606971600,7
The2WheelDeal,2,5,148,36,1595304000,1596859200,7
Butfartter420,1,6,3,30,1572930000,1573362000,7
flufferbutter332,0,7,0,133,1566446400,1582606800,7
ki31,0,7,0,254,1606107600,1606626000,7
ar1cee1,0,7,0,135,1575349200,1578891600,7
arizonafoxx,0,7,0,-19,1563854400,1564113600,7
veryangrycommenter,1,6,3,11,1595822400,1595908800,7
SuperBrentindo,1,6,9,22,1575349200,1608267600,7
Ganem1227,1,6,209,116,1566360000,1598932800,7
Ghipag,4,3,8433,43,1599624000,1607922000,7
govindtak28,0,7,0,16,1595736000,1611723600,7
paradimadam,0,7,0,143,1578718800,1578718800,7
jnyerere89,0,7,0,47,1575522000,1579150800,7
ihaveabugcalledmatt,1,6,9,20,1570593600,1570680000,7
blink18666,0,7,0,84,1602302400,1606798800,7
GDIVX,1,6,0,6,1579669200,1579755600,7
TemetriusRule,0,7,0,109,1602648000,1608008400,7
Bozobot,0,7,0,18,1606453200,1606626000,7
Sweetlikecream,1,6,36,25,1605762000,1609304400,7
Carlos-_-spicyweiner,2,5,1416,32,1546405200,1547874000,7
Adog777,0,7,0,59,1599019200,1599019200,7
kaisoren,0,7,0,-74,1595822400,1599019200,7
Poneke365,0,7,0,14,1598846400,1599796800,7
PhilosophyKingPK,0,7,0,157,1575608400,1611723600,7
Self__Master,1,6,4,18,1582606800,1589342400,7
MotuPatlu34,0,7,0,127,1568606400,1574312400,7
wingfoot49,0,7,0,19,1594267200,1594353600,7
deeterman,0,7,0,-84,1579669200,1598414400,7
wishthiswaseternal,1,6,404,86,1603425600,1603512000,7
ItsBetterToBe,0,7,0,-41,1600401600,1600488000,7
AlwaysBagHolding,0,7,0,10,1585454400,1585540800,7
MissXFox,0,7,0,12,1581224400,1587787200,7
seriouslycommonsense,0,7,0,-1,1597032000,1597032000,7
aldlevine,0,7,0,123,1575781200,1577250000,7
adulting_dude,0,7,0,57,1606280400,1609477200,7
klware,0,7,0,17,1591761600,1602475200,7
mermaiddiva26,2,5,441,44,1598673600,1605330000,7
AngryHorizon,0,7,0,-50,1581656400,1586923200,7
yodes55,0,7,0,294,1545973200,1564632000,7
TopDogChick,0,7,0,68,1564027200,1608267600,7
rickle_pickk,1,6,6,-6,1594180800,1607576400,7
Yalado,0,7,0,53,1601352000,1609304400,7
ohgigi,1,6,1101,26,1599537600,1599624000,7
stephen-f-hawkinson,1,6,232,14,1563422400,1570420800,7
KrebStar9300,0,7,0,131,1591502400,1608613200,7
champchumpchompchimp,0,7,0,1,1577163600,1589601600,7
moihvgvghtfyr,1,6,0,-3,1606712400,1606798800,7
NFTrot,0,7,0,-17,1576818000,1580446800,7
Aurallius,1,6,536,26,1558584000,1608094800,7
JackieNaper1907,1,6,0,37,1598068800,1598155200,7
svarowskylegend,1,6,18,12,1571716800,1571716800,7
mickjaggerspenis,0,7,0,96,1592366400,1608699600,7
Clay_Allison_44,0,7,0,162,1601870400,1601870400,7
An0n_User,0,7,0,16,1607317200,1607922000,7
Atomicn1ck,0,7,0,-28,1606626000,1609131600,7
Gloveboxboy,0,7,0,113,1604379600,1609045200,7
unhealthySQ,0,7,0,57,1552881600,1557460800,7
Memphisinjune,2,5,12,8,1605416400,1605934800,7
capitalistsanta,2,5,91,57,1572321600,1578978000,7
Whit3Knight,0,7,0,-2,1555992000,1558670400,7
bdubble,0,7,0,15,1553486400,1604379600,7
sodiumcopper,0,7,0,21,1567742400,1567742400,7
notnowbutnever,3,4,211,46,1594526400,1598500800,7
Ceasar_Rex,0,7,0,48,1582866000,1588737600,7
Cibyrrhaeot,0,7,0,84,1599796800,1600315200,7
Akumakins,0,7,0,30,1593144000,1606626000,7
Blackbeard1123,0,7,0,33,1582606800,1600747200,7
tehsophz,1,6,62,62,1555300800,1566532800,7
ZayhanS,0,7,0,62,1589428800,1599105600,7
laser76,0,7,0,62,1607230800,1607835600,7
Steezy_Gordita,0,7,0,68,1567915200,1576818000,7
VenkatPottapalli,0,7,0,36,1593144000,1595995200,7
Aufdue,0,7,0,39,1581138000,1597204800,7
zakangi,0,7,0,57,1582088400,1583985600,7
bulk_deckchairs,0,7,0,20,1606021200,1606971600,7
maddskillz350,2,5,204,32,1594872000,1602907200,7
dallastossaway2,0,7,0,49,1581138000,1581224400,7
n00dlejester,2,5,314,76,1573448400,1605589200,7
henrebotha,0,7,0,71,1576213200,1590379200,7
dafyddil,1,6,425,24,1607144400,1607576400,7
NoMuddyFeet,0,7,0,11,1577509200,1588564800,7
bp0547,0,7,0,-23,1588392000,1594785600,7
EchelonEyes,1,6,22,35,1602043200,1607749200,7
HesitantAndroid,0,7,0,50,1599451200,1604984400,7
potn00b28484,0,7,0,-15,1543381200,1564027200,7
Lord_Olchu,0,7,0,12,1606971600,1609304400,7
freakboy2k,0,7,0,126,1551157200,1604293200,7
DRdidgelikefridge,2,5,42,34,1585540800,1588910400,7
bott1111,0,7,0,54,1572235200,1572321600,7
Garytrip02,0,7,0,58,1592971200,1606366800,7
Yggdrasill4,0,7,0,15,1571371200,1606366800,7
GoldPaintedLemons,0,7,0,5,1587441600,1588046400,7
ComedicFish,0,7,0,68,1574571600,1607490000,7
MiffedPolecat,1,6,35,30,1583211600,1606280400,7
mjd188,0,7,0,309,1592884800,1611637200,7
CrapDepot,0,7,0,-305,1592798400,1592798400,7
SirPouncesCock,0,7,0,51,1553227200,1553659200,7
possum_vazsqez,2,5,38,42,1604811600,1609218000,7
neoneccentric,0,7,0,372,1596427200,1608613200,7
Disposable__Male,0,7,0,24,1573707600,1588392000,7
qimerra,0,7,0,12,1576213200,1608354000,7
ezbakeoven20,0,7,0,18,1575867600,1580101200,7
polyam_luv,1,6,169,63,1536984000,1546750800,7
jokoon,1,6,66,44,1441857600,1605330000,7
wishesandhopes,0,7,0,68,1579669200,1589515200,7
wentzsucks,0,7,0,-29,1607662800,1607835600,7
Pinto55,2,5,116,20,1549688400,1576126800,7
th3guitarman,0,7,0,18,1562731200,1608094800,7
blackhodown,0,7,0,169,1603771200,1607662800,7
Higginside,0,7,0,69,1598760000,1607490000,7
keltonny,0,7,0,58,1563595200,1568606400,7
PopRockLine,0,7,0,66,1571630400,1573275600,7
BeMoreKnope,0,7,0,43,1607317200,1608872400,7
MischiefofRats,0,7,0,198,1555992000,1576558800,7
aiakia,0,7,0,147,1603598400,1603771200,7
AngelicDirt,1,6,12,41,1579323600,1605330000,7
fletcheyyy,1,6,91,35,1598414400,1602302400,7
thisguyhaschickens,0,7,0,89,1598328000,1600574400,7
MotherMfker,0,7,0,120,1587441600,1600228800,7
ComradeRudi,1,6,25,99,1568606400,1580533200,7
Brosama220,0,7,0,96,1561262400,1571976000,7
CadetMeow,0,7,0,27,1555473600,1573189200,7
neon_Hermit,0,7,0,73,1603339200,1605070800,7
maedovsand,0,7,0,150,1606280400,1608786000,7
landofskies,0,7,0,137,1583643600,1600488000,7
KingCharlie916,0,7,0,64,1573966800,1578718800,7
Adriannee,0,7,0,-22,1603512000,1603598400,7
Another_Adventure,0,7,0,13,1603512000,1608267600,7
DepressedAndDisabled,0,7,0,39,1541304000,1574658000,7
layouunak,0,7,0,155,1589342400,1589860800,7
petklutz,0,7,0,46,1593835200,1608786000,7
kingshogi,0,7,0,-12,1612069200,1612069200,7
KFCNyanCat,0,7,0,47,1548478800,1598846400,7
Sakaiser,0,7,0,-104,1581397200,1583298000,7
spacecadet309,0,7,0,5,1589083200,1589083200,7
RunawayDev,0,7,0,22,1601179200,1606539600,7
crypticedge,0,7,0,92,1579582800,1606280400,7
LiveTangelo1,0,7,0,79,1592625600,1593662400,7
PM_good_beer,0,7,0,48,1608699600,1611810000,7
me_he_te,0,7,0,95,1603512000,1603512000,7
Comfortablerobot,0,7,0,383,1571803200,1574658000,7
DecayingEternity,1,6,38,133,1582606800,1611896400,7
SteveKimura,1,6,12,14,1544590800,1545109200,7
mrcooliest,0,7,0,-12,1577336400,1578373200,7
Soulfire328,0,7,0,17,1599019200,1606194000,7
StopBangingThePodium,0,7,0,-9,1581224400,1581224400,7
tsorninn,0,7,0,36,1581570000,1609304400,7
UnicornyOnTheCob,2,5,34,-4,1598846400,1606971600,7
wrinklecrinkle3000,0,7,0,23,1597723200,1606021200,7
throwawayloser1998,0,7,0,8,1577077200,1577250000,7
RoombaTheCleaner,0,7,0,34,1611810000,1611982800,7
Fart17,0,7,0,-36,1601179200,1601179200,7
_Swamp_Ape_,0,7,0,158,1604203200,1608181200,7
pajamajoe,0,7,0,8,1605589200,1611982800,7
ENDNOTE1337,1,6,159,89,1580187600,1608958800,7
LordLongbeard,0,7,0,-9,1563336000,1563336000,7
uma_jangle,0,7,0,33,1606539600,1606626000,7
laze916,1,6,48,-8,1586923200,1590465600,7
zug_00,0,7,0,39,1570852800,1582088400,7
KallangPudding,2,5,208,35,1604725200,1605070800,7
bellumed,0,7,0,97,1571630400,1603512000,7
macye,0,7,0,5,1603684800,1607230800,7
mrbuck8,0,7,0,291,1578286800,1596772800,7
dcamp8272,0,7,0,48,1592366400,1599710400,7
venusresor,0,7,0,26,1602129600,1605070800,7
Beredore,0,7,0,-14,1557720000,1559448000,7
stewykins43,0,7,0,42,1604984400,1605848400,7
amfing,0,7,0,546,1552708800,1598760000,7
parkrat1992,0,7,0,53,1581483600,1582606800,7
colin_is_bald,0,7,0,39,1576126800,1602648000,7
ldiosyncrasies,0,7,0,176,1598068800,1608786000,7
tradebat,0,7,0,-44,1577336400,1577336400,7
PiRiNoLsKy,0,7,0,40,1594440000,1604898000,7
Shatneriffic,2,5,71,180,1555300800,1593057600,7
rootbeer_cigarettes,0,7,0,74,1589083200,1603252800,7
Pugsontherun,0,7,0,242,1578632400,1595563200,7
ragnarokda,1,6,5,49,1599624000,1608613200,7
gergo_v,6,1,53,1,1465272000,1570680000,7
Smoke_Me_When_i_Die,0,7,0,133,1573534800,1583643600,7
violetnotblue,0,7,0,51,1594353600,1594785600,7
imaginarybanana,0,7,0,11,1578632400,1578632400,7
JoshMM60,0,7,0,44,1594008000,1605675600,7
DrumletNation,0,7,0,120,1576386000,1583038800,7
Talexis,0,7,0,54,1554264000,1600315200,7
baestmo,0,7,0,21,1567224000,1605070800,7
Ciels_Thigh_High,0,7,0,97,1553140800,1567742400,7
darth_tiffany,0,7,0,54,1548133200,1583125200,7
Mobile_Busy,0,7,0,13,1607144400,1607317200,7
stoneaquaponics,1,6,5,-1,1574398800,1601524800,7
thisismyusername558,0,7,0,57,1569816000,1606971600,7
bringmethebucket,0,7,0,363,1599019200,1607749200,7
Ihopeyougetaids83,0,7,0,-22,1557979200,1560571200,7
Fight_the_Landlords,0,7,0,204,1582866000,1597636800,7
Tempest_xx,0,7,0,119,1544072400,1566878400,7
sadsackle,1,6,45,99,1602907200,1607317200,7
SageeDuzit,3,4,51,10,1601870400,1604203200,7
Shutaru_Kanshinji,0,7,0,21,1591243200,1609131600,7
skslmq-dkxkanzz,0,7,0,151,1579150800,1579237200,7
St-Jaker,0,7,0,-16,1578200400,1583557200,7
ceiimq,0,7,0,108,1571803200,1596427200,7
annoyas,0,7,0,201,1597896000,1603598400,7
spitfire9107,0,7,0,205,1561953600,1603771200,7
RelatableSnail,0,7,0,138,1551934800,1585886400,7
WazzleOz,0,7,0,63,1605934800,1610514000,7
nrdxp,1,6,90,18,1603080000,1608008400,7
Snacks_is_Hungry,0,7,0,59,1575262800,1608958800,7
LFVeganGF,1,6,250,49,1594180800,1597896000,7
jhopkins424242,0,7,0,-10,1585454400,1585540800,7
aharmlessbug,0,7,0,35,1572408000,1576126800,7
Hamlettell,0,7,0,132,1567310400,1605243600,7
jonkik,0,7,0,50,1599710400,1607058000,7
ConcentrateNo7932,0,7,0,-10,1608699600,1610427600,7
gazthechicken,0,7,0,36,1612242000,1612242000,7
ProudPotential,0,7,0,56,1545022800,1550552400,7
BradyBunch88,0,7,0,25,1605157200,1607403600,7
Psychus_Psoro,0,7,0,56,1587182400,1608440400,7
Mayuuke,0,7,0,15,1598673600,1598673600,7
BROILERHAUT,0,7,0,39,1588392000,1592280000,7
PantsGrenades,0,7,0,35,1559620800,1592884800,7
MrStomp82,1,6,753,137,1574744400,1591588800,7
walterdonnydude,0,7,0,87,1563768000,1598673600,7
kanyewestfishdicks,0,7,0,16,1604638800,1607835600,7
A_Union_Of_Kobolds,0,7,0,44,1599969600,1605416400,7
OldThymeyRadio,0,7,0,148,1605934800,1605934800,7
Willow-girl,0,7,0,-5,1605502800,1605502800,7
MrSluagh,4,3,501,9,1565668800,1595563200,7
MindlesslyBrowsing,0,7,0,30,1590724800,1608354000,7
usedOnlyInModeration,1,6,598,26,1558584000,1601179200,7
imagoddamnonionmason,0,7,0,7,1608094800,1608181200,7
NMJ87,1,6,2265,12,1572753600,1582952400,7
satisfied_frog,0,7,0,44,1598241600,1598414400,7
BraveSink7,0,7,0,35,1561694400,1565064000,7
SSGuestapo,1,6,178,10,1595044800,1595390400,7
lxpnh98_2,1,6,34,115,1571889600,1592107200,7
852derek852,3,4,449,25,1578978000,1601352000,7
kinda_a_rapist,0,7,0,47,1594785600,1608613200,7
Islommic_Gommunist,0,7,0,91,1566360000,1594008000,7
50ShadesOfWells,1,6,190,75,1589342400,1608008400,7
secretacct0099887,1,6,149,75,1548306000,1554091200,7
ImjusttestingBANG,1,6,6,31,1579669200,1605157200,7
xPsyche,0,7,0,47,1599278400,1603512000,7
gavinsco,1,6,0,3,1571198400,1571284800,7
otaku175,0,7,0,40,1575090000,1609045200,7
Benni-Boi,1,6,0,8,1608699600,1609218000,7
Sworn_to_Ganondorf,0,7,0,24,1591934400,1602820800,7
cristoper,5,2,71,37,1423198800,1604379600,7
kenzbeanz,0,7,0,183,1604898000,1607749200,7
moonwalkerHHH,0,7,0,30,1595304000,1609218000,7
modern_moron,0,7,0,112,1597291200,1605762000,7
Beehive39,0,7,0,11,1605589200,1606712400,7
turtle_pleasure,0,7,0,43,1572753600,1599796800,7
Jjhend,0,7,0,81,1604379600,1604379600,7
rhmati30,0,7,0,73,1563854400,1568001600,7
agfsvm,0,7,0,28,1559016000,1601524800,7
Nash015,0,7,0,-7,1608786000,1612155600,7
itstimetoendit,0,7,0,13,1567656000,1570593600,7
poopntute,0,7,0,-89,1588478400,1588564800,7
SirVapes_ALot,1,6,99,37,1585195200,1608958800,7
marshall_cooper,0,7,0,17,1573189200,1584676800,7
Swingingbells,1,6,15,42,1560657600,1583211600,7
pigpeyn,1,6,49,71,1578632400,1608181200,7
gori_lla_k1ng,0,7,0,21,1590120000,1590120000,7
unsightful,0,7,0,40,1593489600,1601870400,7
death-and-gravity,1,6,17,99,1578978000,1599192000,7
slytherinpoet,0,7,0,47,1558238400,1605848400,7
AsleepConcentrate2,0,7,0,68,1580792400,1588996800,7
TheHatedMilkMachine,0,7,0,-1,1573362000,1573362000,7
tsuma534,0,7,0,16,1605589200,1608699600,7
iisoprene,1,6,89,50,1591243200,1597032000,7
c0mplexx,0,7,0,107,1578373200,1605416400,7
MichaelTen,1,6,17,9,1586491200,1605848400,7
maybeitsclassified,0,7,0,13,1575781200,1577422800,7
zealouspinach,2,5,31,19,1585022400,1602302400,7
visualAd1720,0,7,0,25,1607749200,1609045200,7
ThePlayfulPython,0,7,0,23,1571889600,1595217600,7
mslayla,0,7,0,136,1572843600,1586232000,7
Nawks22,0,7,0,10,1589774400,1589774400,7
edwfit21,0,7,0,34,1559188800,1578373200,7
Dumplexer,0,7,0,26,1547355600,1547787600,7
dotdox,1,6,1062,129,1606453200,1609218000,7
challengingviews,0,7,0,150,1565582400,1590120000,7
patthew,0,7,0,458,1573966800,1606798800,7
paperboyinnewyork,1,6,24,55,1585713600,1607576400,7
chin_chilling,0,7,0,25,1580792400,1583211600,7
suzybhomemakr,0,7,0,185,1600228800,1609304400,7
avocadoswag,0,7,0,43,1570420800,1573016400,7
spazbot53704,0,7,0,27,1606798800,1608613200,7
4ethicalreasons,3,4,9901,29,1575003600,1595908800,7
tim369369,0,7,0,38,1579410000,1590552000,7
AnotherEdgyUsername,0,7,0,56,1593662400,1608958800,7
AgedDubstep,0,7,0,171,1583643600,1602734400,7
NnonapplicableA,1,6,23,55,1556510400,1560052800,7
SoundOfDrums,0,6,0,-12,1558584000,1606539600,6
Sperauomo,1,5,91,25,1607490000,1609390800,6
highestRUSSIAN,0,6,0,67,1606194000,1607662800,6
crestind,0,6,0,3,1605848400,1609045200,6
ComradeKinnbatricus,0,6,0,60,1577509200,1608440400,6
dirtyweedpipe,2,4,38,32,1562212800,1571371200,6
Moosai,1,5,5,18,1539662400,1598587200,6
dream-kitty,0,6,0,77,1604811600,1608699600,6
UniqueAssUsername,1,5,174,9,1573102800,1592798400,6
MediterraneanJerb,0,6,0,113,1594180800,1597636800,6
TBolt56,0,6,0,38,1583470800,1601265600,6
nibiyabi,0,6,0,92,1574485200,1599883200,6
Guerrin_TR,0,6,0,7,1604379600,1604379600,6
phantosam,0,6,0,65,1603512000,1608699600,6
RedditIsNeat0,0,6,0,44,1552194000,1597982400,6
Infiniteblaze6,0,6,0,8,1608440400,1608526800,6
munchowsen,0,6,0,112,1585627200,1595822400,6
buut-whyy,0,6,0,2,1597982400,1608094800,6
DarksonicHunter,0,6,0,12,1609390800,1612328400,6
Cosmicmermaidx3,0,6,0,103,1590120000,1605589200,6
uneducatedtrumpfan,0,6,0,12,1607403600,1607403600,6
abasam,0,6,0,67,1576731600,1594180800,6
JustYourFriendlyNPC,0,6,0,-38,1567137600,1567224000,6
SenorPariah,0,6,0,28,1572930000,1597032000,6
gonsilver,0,6,0,27,1573362000,1579150800,6
MisterPicklecopter,0,6,0,87,1604203200,1606539600,6
NuggBucket,0,6,0,21,1592280000,1592625600,6
ariana_areola,0,6,0,103,1593835200,1607403600,6
maxuaboy,0,6,0,44,1584763200,1608613200,6
applewww,0,6,0,14,1594699200,1600401600,6
Dewlinedew,0,6,0,87,1598760000,1599364800,6
dragonfruit4,0,6,0,111,1595476800,1600056000,6
MikeyPhoeniX,5,1,3480,2,1558411200,1595217600,6
Lurkingmonster69,0,6,0,223,1585454400,1606712400,6
magicmcguffin,1,5,22,17,1569470400,1573102800,6
kevin_goeshiking,1,5,246,40,1590379200,1590465600,6
evfree,0,6,0,3,1573275600,1573448400,6
Aecholon,0,6,0,10,1605762000,1606971600,6
pekkogekko,0,6,0,77,1589256000,1603425600,6
Zantarius,1,5,20,14,1574658000,1575349200,6
xX420bOnglOrdXx,2,4,52,81,1597291200,1600574400,6
hambramen,0,6,0,-16,1574226000,1597636800,6
alz3223,3,3,107,116,1607922000,1609390800,6
BGYeti,0,6,0,9,1612155600,1612242000,6
ThanksSkeltor,0,6,0,-4,1577422800,1577422800,6
irlharvey,0,6,0,34,1607576400,1609390800,6
phadedlife,0,6,0,117,1602734400,1608267600,6
differenttimediff,1,5,50,7,1575608400,1580792400,6
thegoodguywon,0,6,0,25,1606626000,1607317200,6
Naptownfellow,0,6,0,30,1606626000,1606626000,6
Onetaptwotap,0,6,0,152,1563249600,1569902400,6
fluffy_assassins,0,6,0,46,1597896000,1598846400,6
FearrMe,0,6,0,106,1604379600,1608699600,6
Beardygrandma,0,6,0,35,1582779600,1594612800,6
Furrykedrian98,0,6,0,7,1580360400,1580360400,6
reseteros,0,6,0,-19,1582779600,1582952400,6
GreasyGoblin77,0,6,0,3,1600747200,1600747200,6
SprayInABox,1,5,12,18,1582002000,1601870400,6
DonnieBrasco1234,0,6,0,-12,1571630400,1572580800,6
pedal2kettle,0,6,0,144,1598673600,1608526800,6
AnaErisian,0,6,0,22,1555473600,1592452800,6
PrismInTheDark,0,6,0,86,1585627200,1601352000,6
JonathanPhillipFox,2,4,0,5,1581224400,1606885200,6
SneakyCarl,0,6,0,16,1591329600,1609477200,6
Dhounut1,0,6,0,12,1606366800,1606712400,6
uuuu777777,0,6,0,75,1581310800,1581397200,6
DarthSamus64,1,5,290,87,1566360000,1592798400,6
MisanthropicReveling,0,6,0,277,1594440000,1608699600,6
fckwindows,2,4,207,27,1604466000,1606712400,6
cadaverouswilona,1,5,24,34,1588564800,1591156800,6
SevenBlade,0,6,0,125,1582434000,1608872400,6
172917291729,6,0,125,0,1473912000,1537243200,6
RupturedFlesh,1,5,54,25,1605157200,1605502800,6
Sandra2104,0,6,0,92,1572667200,1594094400,6
EdwardTeach,0,6,0,95,1595217600,1596254400,6
throwawayFI12,0,6,0,-19,1606885200,1608181200,6
realmastodon2,0,6,0,71,1603512000,1607662800,6
Niarac,0,6,0,52,1599364800,1604725200,6
-Xannim-,1,5,179,32,1585540800,1594612800,6
DingleberryofLove,1,5,1242,44,1592625600,1594267200,6
forever__sleep,0,6,0,-15,1542517200,1542517200,6
The_Omnimonitor,0,6,0,37,1541826000,1585540800,6
Indefinite_Regress,1,5,13,12,1606366800,1608440400,6
M_Danglars,0,6,0,31,1578978000,1598328000,6
nickAliasnick,0,6,0,49,1573275600,1575954000,6
RespectNofap,1,5,0,-7,1572580800,1581224400,6
SonderlingDelGado,0,6,0,53,1604116800,1604203200,6
Wanks2Starlets,0,6,0,31,1606712400,1609477200,6
Bradphil87,0,6,0,16,1562385600,1569211200,6
crowkeep,2,4,31,23,1604030400,1605416400,6
WillCle216,0,6,0,11,1587614400,1592712000,6
Heybroletsparty,0,6,0,89,1604293200,1608354000,6
taylordabrat,1,5,85,30,1573534800,1575608400,6
Zaku_Zaku,0,6,0,178,1583812800,1598068800,6
TheRadHatter9,2,4,54,4,1585540800,1604466000,6
yourmovesrweak,0,6,0,60,1584676800,1587528000,6
magmajellyfish,0,6,0,45,1583125200,1602475200,6
afungalmirror,2,4,37,11,1594872000,1599105600,6
JWard515,0,6,0,18,1555041600,1555128000,6
khibii,1,5,2506,160,1561348800,1562472000,6
YoungMalatesta,0,6,0,38,1547269200,1547355600,6
wet_flaps,1,5,72,32,1560484800,1568692800,6
Stellaxi,0,6,0,33,1571976000,1605502800,6
ohdeergas,0,6,0,106,1570075200,1574312400,6
J0esw,1,5,92,312,1596254400,1605070800,6
pukatm,0,6,0,63,1594872000,1595217600,6
hym_of_martyrs,0,6,0,78,1563940800,1572753600,6
VoyeurFoyer,0,6,0,-140,1591848000,1592193600,6
629060311,2,4,68,13,1558411200,1594440000,6
Saoirse_Says,0,6,0,8,1564632000,1565496000,6
lendofriendo,0,6,0,-25,1584072000,1584072000,6
GreatQuestionBarbara,0,6,0,404,1585454400,1611896400,6
PlanBaccount0987,0,6,0,12,1593230400,1593489600,6
cybervision2100,0,6,0,-19,1582693200,1583985600,6
macadamianacademy,3,3,2058,35,1579323600,1596600000,6
aspenlover101,0,6,0,11,1601265600,1601352000,6
urzrkymn,1,5,10,19,1446004800,1551157200,6
dujmanu11,0,6,0,-21,1605934800,1605934800,6
hmitch94,2,4,567,127,1609131600,1609304400,6
JusticiayLibertad,1,5,246,28,1564459200,1574485200,6
ccpossible,0,6,0,26,1575262800,1608008400,6
dankrupt783,0,6,0,17,1569038400,1583038800,6
epicender584,0,6,0,88,1547960400,1561176000,6
adeadart,0,6,0,36,1550293200,1591848000,6
lamerthanfiction,0,6,0,93,1479531600,1575435600,6
_Lumite_,0,6,0,13,1565582400,1570161600,6
RabidPinkBunny,0,6,0,157,1582520400,1605762000,6
KingOfAnarchy,0,6,0,102,1605243600,1608354000,6
Jaytex_85,0,6,0,33,1570852800,1571198400,6
iusethisatwrk,0,6,0,33,1551934800,1600315200,6
AlternateSkye,0,6,0,19,1571803200,1582952400,6
prplelemonade,1,5,17,15,1570334400,1585108800,6
Comosellamark,0,6,0,94,1597291200,1611896400,6
vicarious_simulation,0,6,0,19,1591675200,1602820800,6
Thomas-terraria,0,6,0,-6,1573966800,1574053200,6
tyconson67,0,6,0,3,1602043200,1602043200,6
Oberst-Schulz,0,6,0,6,1609218000,1609218000,6
snazzle-bedazzle,0,6,0,34,1569124800,1607230800,6
Mikerobrewer,1,5,48,33,1564113600,1584936000,6
yaoz889,0,6,0,5,1591243200,1591416000,6
Zuki_LuvaBoi,0,6,0,35,1559620800,1580706000,6
xxswiftpandaxx,0,6,0,90,1585800000,1608786000,6
NgBling,0,6,0,75,1596168000,1604725200,6
superoboe87,0,6,0,77,1597550400,1609477200,6
Piss_On_The_Dead,0,6,0,53,1573189200,1573880400,6
ignatiusjreilly6969,0,6,0,-2,1572408000,1575349200,6
Meat_Vegetable,0,6,0,109,1558929600,1599537600,6
ManthiBoo,0,6,0,25,1546578000,1582779600,6
ESheets,0,6,0,56,1560139200,1587009600,6
niida,0,6,0,59,1587009600,1596168000,6
m0nstera_deliciosa,0,6,0,89,1607490000,1607490000,6
creepymusic,0,6,0,174,1552276800,1597118400,6
turdghoul,0,6,0,17,1575522000,1585454400,6
JamesRobotoMD,0,6,0,16,1550293200,1550293200,6
Echoeversky,0,6,0,243,1605070800,1606453200,6
MoneyMike6666,0,6,0,6,1592798400,1593662400,6
shit_m_lady,1,5,11,26,1597896000,1603339200,6
letmehearmusic9,0,6,0,87,1560398400,1562385600,6
biohacker53,2,4,32,7,1556596800,1604466000,6
lounes_my_dude,2,4,56,128,1582261200,1606971600,6
cummerou1,0,6,0,25,1608440400,1608526800,6
JMetropolis_,2,4,52,19,1588564800,1589169600,6
BenedictThunderfuck,0,6,0,52,1562126400,1576126800,6
oooooh_shit,0,6,0,30,1606021200,1607749200,6
m8yyy,0,6,0,47,1602907200,1602907200,6
Dignidude,0,6,0,29,1558584000,1561262400,6
youngdugs,0,6,0,7,1608267600,1608786000,6
skgody,0,6,0,21,1599537600,1608440400,6
NEIUDUDE,1,5,8,17,1594353600,1599796800,6
spaz239,1,5,5,68,1566014400,1586318400,6
bobbykid,0,6,0,28,1583211600,1621828800,6
Bemteb,0,6,0,12,1595736000,1598846400,6
Hairy-Win,0,6,0,-21,1585627200,1585800000,6
whatoneaarrrthisthat,1,5,76,206,1550552400,1567742400,6
Dusk_Killaz,1,5,0,-19,1594699200,1594785600,6
frizzyflacko,0,6,0,138,1577854800,1601870400,6
leninbodypillow,0,6,0,53,1605589200,1609218000,6
StruffBunstridge,0,6,0,149,1580274000,1597982400,6
Tredward,0,6,0,23,1595822400,1612069200,6
c4mera,1,5,777,9,1599278400,1607835600,6
Astroisbestbio,0,6,0,108,1577509200,1577509200,6
cazador5,0,6,0,84,1595736000,1605848400,6
weedmaster024,2,4,0,-18,1598500800,1607144400,6
xyperus,0,6,0,23,1589601600,1597982400,6
sirena9999,0,6,0,38,1584417600,1585627200,6
jnhforreal,1,5,5,8,1560916800,1560916800,6
OtsuKotsu,3,3,106,10,1586750400,1605762000,6
birdiesarentreal,0,6,0,12,1604030400,1611810000,6
PhysicsFornicator,0,6,0,42,1575522000,1595390400,6
aghastamok,0,6,0,27,1599969600,1599969600,6
CreativeDesignation,0,6,0,122,1607749200,1611896400,6
meowiartee,0,6,0,48,1604379600,1609304400,6
sleepwithmythoughts,1,5,37,35,1580101200,1580101200,6
alteisen99,0,6,0,45,1584676800,1611896400,6
Fiftyfootflowers,0,6,0,17,1576731600,1582088400,6
CRASSBANTAM,0,6,0,50,1557028800,1559880000,6
ParanoidAndroid98,0,6,0,29,1576213200,1606798800,6
Chinesepens,0,6,0,-53,1576386000,1576386000,6
Fhtagnyatta,0,6,0,82,1586232000,1596772800,6
PrrrromotionGiven1,0,6,0,60,1591243200,1591243200,6
NeonKitAstrophe,1,5,14,8,1591848000,1591934400,6
Qualanqui,0,6,0,23,1587873600,1611896400,6
lsc_is_for_the_lazy,0,6,0,-180,1559620800,1559707200,6
jjaaayy,0,6,0,9,1607576400,1607922000,6
CSW07,0,6,0,7,1603771200,1606021200,6
sanguinePlutonian,0,6,0,109,1586318400,1590033600,6
kingstorian,0,6,0,27,1560744000,1561608000,6
47Ronin,0,6,0,43,1580878800,1580965200,6
AtalaPashar,0,6,0,60,1565582400,1586145600,6
Some_Guy223,0,6,0,12,1580792400,1607490000,6
throwaway98714,0,6,0,17,1590984000,1605243600,6
jimmyvcard,0,6,0,-22,1581310800,1583557200,6
asdnaslfadkjfas,0,6,0,-8,1611810000,1612328400,6
sed-dy,0,6,0,85,1565064000,1584331200,6
Ok-Educator-7983,0,6,0,17,1605502800,1605589200,6
manic_hispanic,0,6,0,-36,1582261200,1582347600,6
xRigorMortisx,0,6,0,116,1561953600,1582952400,6
_jillybean,0,6,0,51,1546837200,1551157200,6
DrSavagery,0,6,0,0,1567051200,1568347200,6
Quicksteprain,2,4,148,51,1570334400,1607835600,6
Dick_Handsome,0,6,0,291,1600401600,1601438400,6
erthian,0,6,0,22,1570420800,1598328000,6
whistonreds,1,5,59,33,1583038800,1584676800,6
BesusCristo,0,6,0,67,1605330000,1608094800,6
InvaderMer,1,5,57,22,1604898000,1605070800,6
Full-Classic,0,6,0,18,1585800000,1586404800,6
idontinhale,0,6,0,78,1585368000,1601438400,6
EAGamesOfficial,1,5,5482,11,1566532800,1578718800,6
BarelyHoldingOn123,0,6,0,-29,1606453200,1609477200,6
WelpWeDoneThisIsIt,0,6,0,55,1587268800,1587355200,6
tjsog,0,6,0,21,1601697600,1603512000,6
gwoerp,0,6,0,147,1604379600,1606366800,6
King_atg,0,6,0,26,1587700800,1611896400,6
fewthingsarerelated,1,5,16,49,1570680000,1582434000,6
abcidentical,0,6,0,49,1604552400,1606971600,6
Nox_Aeons,0,6,0,206,1599105600,1608526800,6
The_Grubby_One,0,6,0,70,1600142400,1600142400,6
20EYES,0,6,0,56,1556337600,1584849600,6
Zaxio005,1,5,8,138,1574744400,1582606800,6
Loaf_of_Fred,0,6,0,86,1603771200,1611810000,6
Sathari3l17,0,6,0,51,1599537600,1607490000,6
rickstaysbehind,1,5,3710,11,1583470800,1583470800,6
stootboot,0,6,0,-37,1593230400,1604116800,6
barenakedamy,0,6,0,63,1594094400,1606021200,6
thatguyworks,0,6,0,289,1571371200,1607749200,6
500ls,0,6,0,14,1550466000,1600056000,6
Ronald_Deuce,0,6,0,62,1600401600,1603771200,6
ZakaryDee,0,6,0,82,1559620800,1601524800,6
Aciddrinker90525,0,6,0,1,1580965200,1588305600,6
caleblee01,0,6,0,30,1564632000,1564718400,6
Void010101,2,4,73,9,1555992000,1561435200,6
Sammy_Wants_Death,0,6,0,68,1607576400,1607662800,6
LoveIsDear,1,5,25,30,1602302400,1606971600,6
Sly_141,0,6,0,169,1583470800,1595044800,6
tinyflemingo,0,6,0,27,1548651600,1584504000,6
Sklushi,0,6,0,14,1582347600,1582347600,6
Forged_in_Chaos,0,6,0,234,1567137600,1579237200,6
BrownThunder95,1,5,80,25,1582002000,1599537600,6
L_boddah,0,6,0,26,1584763200,1606712400,6
stockythebear,0,6,0,165,1585800000,1602820800,6
_Th1nKT4nK_,0,6,0,23,1551934800,1554523200,6
langleywaters,0,6,0,44,1555646400,1559188800,6
jellyfish5,0,6,0,13,1583985600,1587268800,6
Cooleybob,0,6,0,50,1580360400,1601179200,6
letrente,3,3,163,87,1607403600,1609218000,6
gubodif,0,6,0,422,1592193600,1605848400,6
sourdoughobsessed,0,6,0,7,1602734400,1610600400,6
CoverYourOrifices,0,6,0,45,1602388800,1612069200,6
ShellySashaSamson,0,6,0,4,1611982800,1611982800,6
estolad,0,6,0,77,1560571200,1572494400,6
sharksquidz,0,6,0,17,1606885200,1608699600,6
mentaldegr,0,6,0,41,1591243200,1608008400,6
Chizwick,0,6,0,117,1580360400,1584590400,6
foiz5,0,6,0,352,1577163600,1594612800,6
FailingItUp,0,6,0,99,1557115200,1561694400,6
watchmything,0,6,0,138,1601956800,1608354000,6
AnotherWarGamer,0,6,0,27,1594440000,1610168400,6
Naviios,0,6,0,8,1592798400,1605502800,6
DriretlanMveti,0,6,0,39,1606280400,1607576400,6
YinTemp,0,6,0,93,1561780800,1563336000,6
amkamins,0,6,0,81,1594353600,1603339200,6
Idonoteatass,0,6,0,-5,1560657600,1598760000,6
INeedWalnuts,1,5,50,10,1564200000,1564286400,6
Y0h_513nn_R3n,1,5,0,-28,1576645200,1576645200,6
NeoQuaker1,0,6,0,14,1596945600,1601524800,6
joemerica15,0,6,0,33,1575435600,1592625600,6
kafkaonthedoor,0,6,0,61,1603080000,1608440400,6
akrobert,0,6,0,26,1601870400,1603684800,6
apolohirou,0,6,0,17,1603512000,1637384400,6
DEL-J,0,6,0,-37,1562212800,1590638400,6
APerfectGentleman628,1,5,2,-6,1569988800,1585108800,6
mxmoon,0,6,0,41,1564891200,1574053200,6
futureslave,0,6,0,260,1589169600,1602302400,6
avidblinker,0,6,0,4,1584244800,1584244800,6
dm80x86,0,6,0,151,1576299600,1603512000,6
military-money-man,0,6,0,18,1598155200,1598155200,6
Isle-of-Ivy,0,6,0,55,1603684800,1606539600,6
bobofatt,0,6,0,87,1562385600,1592107200,6
R-F262020,0,6,0,31,1597896000,1605848400,6
billiejoesGimp,0,6,0,38,1573621200,1573621200,6
Frank9991,0,6,0,0,1599710400,1599796800,6
MrBrainstorm,0,6,0,40,1606885200,1609131600,6
------me,3,3,224,7,1574398800,1576299600,6
CanadianNeedleworker,1,5,267,9,1551934800,1571284800,6
Factorviii,0,6,0,40,1576558800,1602302400,6
Substantial_Potato,0,6,0,142,1583470800,1607922000,6
RustyBuckets6601,0,6,0,6,1571544000,1571544000,6
flashmedallion,0,6,0,310,1611896400,1612328400,6
IvIemnoch,0,6,0,-3,1550293200,1550293200,6
SarahGabriella84,0,6,0,9,1606626000,1606626000,6
Naskoooo,0,6,0,63,1579669200,1593144000,6
Drysfoet,0,6,0,34,1570248000,1582520400,6
Nikanov,1,5,12,24,1577682000,1593921600,6
Brodilda,0,6,0,7,1603425600,1605157200,6
_BarBareek_,1,5,431,18,1595476800,1595736000,6
Yiffre,1,5,119,158,1586664000,1604293200,6
Pilivyt,0,6,0,7,1582952400,1583812800,6
BlindingInferno,0,6,0,208,1582520400,1588824000,6
NaWriters,1,5,12,16,1608699600,1608786000,6
lookmusicisumkool,0,6,0,91,1578891600,1588564800,6
eatlesspoopmore,0,6,0,27,1580792400,1605589200,6
puppytacos,0,6,0,162,1578891600,1601956800,6
Southernbelllle,0,6,0,53,1574830800,1586923200,6
Sickologyy,0,6,0,19,1571457600,1594872000,6
Robot_Penguins,0,6,0,263,1573448400,1595044800,6
OptagetBrugernavn,1,5,348,80,1570248000,1591588800,6
bradgillap,0,6,0,38,1578718800,1595995200,6
thriftedqueer,0,6,0,25,1604811600,1605762000,6
captitank,0,6,0,-15,1601179200,1606626000,6
I_DIG_ASTOLFO,0,6,0,220,1573362000,1589860800,6
truthteller8,0,6,0,110,1595995200,1603425600,6
FlippenDonkey,0,6,0,35,1595649600,1612069200,6
deeeeepweb,0,6,0,25,1573016400,1576386000,6
dreamingawake09,0,6,0,56,1560744000,1577941200,6
dddiamonddd,0,6,0,42,1575435600,1599451200,6
crossover-and-turn,0,6,0,41,1557720000,1590897600,6
sheepwearingajetpack,2,4,57,23,1588910400,1591156800,6
sudo999,0,6,0,363,1580014800,1583384400,6
MonicaKaczynski,0,6,0,53,1542776400,1548651600,6
Relekka,0,6,0,30,1568606400,1568606400,6
Mr_Jenkins97,1,5,74,126,1577509200,1579410000,6
KokiriEmerald,0,6,0,-7,1574139600,1598155200,6
ImHighAsf1223,2,4,41,10,1588824000,1589515200,6
LegitTeddyBears,0,6,0,83,1603598400,1605502800,6
MarthaFarcuss,3,3,616,137,1599105600,1607576400,6
dxlta,1,5,22,38,1568865600,1573189200,6
likeasirjohn,0,6,0,4,1578805200,1592193600,6
heckubiss,2,4,310,8,1598932800,1608786000,6
slippyslapperz,0,6,0,-1,1582779600,1583038800,6
Afro_Superbiker,0,6,0,106,1589342400,1604725200,6
StrawMap,0,6,0,57,1598932800,1600228800,6
ranarrdealer,0,6,0,49,1576645200,1605848400,6
Salt-County,0,6,0,50,1584763200,1592020800,6
OrionOfPoseidon,1,5,144,-5,1592884800,1593230400,6
will-I-ever-Be-me,0,6,0,58,1604811600,1606453200,6
CheckOutMyCrits,0,6,0,32,1588046400,1606366800,6
tradeintel828384839,0,6,0,14,1596772800,1597204800,6
Ishouldnt_haveposted,0,6,0,86,1591329600,1602993600,6
NotARobot4444,1,5,84,15,1603425600,1607749200,6
michaelfkenedy,0,6,0,-16,1573189200,1573189200,6
admor36,4,2,1040,4,1573102800,1573448400,6
Scrotchy96,0,6,0,61,1598414400,1598846400,6
SomeGuyCommentin,0,6,0,57,1592107200,1603598400,6
Eric264,0,6,0,124,1581138000,1583899200,6
WARvault,1,5,15,30,1585800000,1604116800,6
Carverpalaver,0,6,0,186,1603944000,1605243600,6
--ok,0,6,0,-122,1604552400,1611810000,6
ihatescho0l,0,6,0,161,1568952000,1571803200,6
Pokanga,0,6,0,166,1593403200,1599969600,6
pissingorange,1,5,59,65,1559707200,1561176000,6
Many_Being,1,5,100,33,1593144000,1593144000,6
notgtax1,2,4,11,125,1574917200,1579150800,6
RobotReplacement,0,6,0,83,1593403200,1597464000,6
coralto,0,6,0,42,1578718800,1606280400,6
PorkRindEvangelist,0,6,0,297,1599624000,1599624000,6
FBI-MACHINE,0,6,0,20,1591934400,1597204800,6
magikkgurl543,0,6,0,23,1573966800,1600660800,6
tacosophieplato,0,6,0,78,1597291200,1607058000,6
phaggut69,0,6,0,-25,1599710400,1599796800,6
tHe_P4WN3R,2,4,15,10,1604116800,1608354000,6
BelleHades,0,6,0,67,1578027600,1588046400,6
gollumgollumgoll,0,6,0,31,1582866000,1607058000,6
PM_ME_LOUIS_THEROUX,0,6,0,33,1538712000,1560398400,6
raeisok,1,5,73,21,1558324800,1564545600,6
ferras_69,0,6,0,88,1577336400,1580792400,6
thatPhotographyGuy,1,5,38,23,1602129600,1611810000,6
Cantstandit6,0,6,0,108,1603598400,1608786000,6
totallynotusing,0,6,0,146,1606626000,1609045200,6
plop_0,0,6,0,16,1574830800,1600401600,6
Megisphere,0,6,0,5,1608267600,1608699600,6
kennythevamp,0,6,0,28,1608958800,1609131600,6
Pavlovski101,0,6,0,95,1583211600,1598414400,6
neverbuythesun,5,1,998,6,1586577600,1612069200,6
babgh00,0,6,0,28,1554436800,1603425600,6
nah_champa,0,6,0,46,1542603600,1597118400,6
Holy___Diver,0,6,0,34,1588132800,1601697600,6
skiratwork,1,5,11,23,1584504000,1603512000,6
PessimiStick,0,6,0,51,1580014800,1580014800,6
Greedy-North-5061,2,4,140,25,1604293200,1606885200,6
JeffreyRamstein,0,6,0,71,1570507200,1590724800,6
xanxus82,3,3,2052,33,1595995200,1607144400,6
idontknowwhatitshoul,0,6,0,147,1578978000,1599883200,6
Silverlisk,1,5,8,11,1597204800,1597291200,6
malvim,0,6,0,127,1534651200,1566878400,6
shitpoststructural,0,6,0,30,1572408000,1603512000,6
jpowprints,0,6,0,58,1599451200,1599796800,6
mcrp1234,1,5,10,-8,1568001600,1570248000,6
Serbaayuu,0,6,0,67,1582434000,1584072000,6
mattrydell,1,5,45,35,1549256400,1560312000,6
Dr_nick101,0,6,0,185,1603684800,1606194000,6
survivalmaster69,0,6,0,33,1561176000,1595736000,6
kuyo,0,6,0,60,1598846400,1606971600,6
SleepyHex,1,5,18,25,1604293200,1608786000,6
sfsp3,0,6,0,-29,1571112000,1571198400,6
uhh-hmm,0,6,0,144,1581310800,1582174800,6
MidnightBlake,1,5,185,47,1571457600,1603857600,6
Deopunk,0,6,0,19,1595822400,1605934800,6
ohnoitsivy,0,6,0,14,1607662800,1607749200,6
wmrossphoto,0,6,0,-3,1572667200,1583557200,6
roofied_elephant,0,6,0,83,1603944000,1611896400,6
astroelectro,0,6,0,74,1566446400,1567310400,6
LadyBerticus,0,6,0,18,1605502800,1607749200,6
FloofBagel,1,5,1565,78,1562644800,1569038400,6
Nedbigbees,0,6,0,3,1571630400,1580187600,6
champaignthrowaway,0,6,0,97,1585713600,1602129600,6
RefrigeratorGrand619,0,6,0,11,1606194000,1609045200,6
xkcd_friend,0,6,0,36,1547010000,1569211200,6
syzk0,0,6,0,7,1595476800,1595563200,6
kaydeetee86,0,6,0,71,1606107600,1608613200,6
monsterinthewoods,0,6,0,17,1604984400,1605762000,6
kugelblitz0x1,0,6,0,95,1594180800,1608786000,6
vaga_jim_bond,0,6,0,29,1603512000,1603512000,6
USCSSNostromo2122,1,5,7,46,1603166400,1604984400,6
tylan4life,0,6,0,61,1578114000,1612069200,6
Nicholas--s,2,4,106,13,1589083200,1600142400,6
Skyoket,0,6,0,18,1586404800,1608699600,6
WhaddupBoi2,1,5,40,25,1591588800,1591588800,6
NiftyShifty12,0,6,0,38,1594094400,1597809600,6
jovial_pessimist,0,6,0,18,1464321600,1473566400,6
puredionysia,0,6,0,31,1584244800,1589601600,6
insolent_instance,0,6,0,-4,1589688000,1608613200,6
WickedMarowak,0,6,0,79,1577336400,1583384400,6
ShiverMeeTimberz,1,5,8,7,1608267600,1608354000,6
Wessex2018,0,6,0,51,1602129600,1612155600,6
brochill111,0,6,0,115,1580446800,1596772800,6
beautifultuesday,1,5,35,10,1596686400,1596686400,6
ITeechYoKidsArt,0,6,0,18,1578891600,1578891600,6
Lukas11112000,0,6,0,245,1579064400,1601006400,6
SecretBaklavas,2,4,39,30,1602043200,1608440400,6
Ridara,0,6,0,31,1579755600,1599969600,6
zzzxxx1209381,1,5,26,71,1554523200,1601956800,6
anon6s6,0,6,0,22,1605070800,1605070800,6
8_millimeter,0,6,0,55,1546405200,1555905600,6
Kodmin,0,6,0,31,1558497600,1569902400,6
Lolmob,0,6,0,290,1591848000,1609218000,6
ohgodwhypleasestop,0,6,0,39,1546491600,1550638800,6
gaytac0,0,6,0,9,1598673600,1603512000,6
shadeck,0,6,0,12,1597896000,1598241600,6
Glittering-Cash-3009,0,6,0,50,1611982800,1611982800,6
slicydicer,0,6,0,83,1594440000,1606885200,6
brettins,0,6,0,18,1429761600,1581915600,6
namesardum,0,6,0,57,1574658000,1605502800,6
BennyBoy46,0,6,0,16,1592798400,1611896400,6
mlydon11,6,0,16764,0,1594008000,1597809600,6
Vonnegut222,2,4,104,9,1540180800,1543294800,6
neoteucer,0,6,0,78,1599019200,1606021200,6
ummmily,0,6,0,100,1586836800,1606885200,6
VOTE_TRUMP2020,0,6,0,-127,1607662800,1607835600,6
ancaprico,0,6,0,-10,1597550400,1597636800,6
livestreamedcollapse,0,6,0,43,1570939200,1581656400,6
rayowag,1,5,6,6,1600401600,1600574400,6
NEET_POWER,0,6,0,233,1608699600,1608699600,6
seabass559,0,6,0,65,1571457600,1576299600,6
just_breadd,0,6,0,72,1597118400,1608613200,6
Duliandale,2,4,16,17,1560830400,1574744400,6
curphilis,1,5,30,33,1611982800,1611982800,6
___Galaxy,0,6,0,-2,1557547200,1597118400,6
pinkprius,0,6,0,54,1564891200,1600660800,6
melody_spectrum,0,6,0,71,1567828800,1591588800,6
Edenlai4,2,4,74,11,1577595600,1598241600,6
mcs90,1,5,17,87,1603684800,1606798800,6
teeteedoubleyoudee,0,6,0,14,1554868800,1608267600,6
pactum,0,6,0,5,1554955200,1606366800,6
Celouts4,1,5,4,10,1572930000,1573016400,6
KimberStormer,1,5,40,36,1580360400,1599624000,6
WaxOjos,0,6,0,44,1594958400,1595131200,6
Kush_goon_420,2,4,14,43,1599796800,1608440400,6
Tim_buctoo,0,6,0,81,1573016400,1608354000,6
smollbuttslut,1,5,795,107,1577768400,1577768400,6
saneworld_1312,0,6,0,49,1606712400,1606971600,6
Billy_of_the_hills,0,6,0,35,1599364800,1607749200,6
ourstupidtown,0,6,0,59,1586232000,1609045200,6
deluxeassortment,0,6,0,68,1572062400,1604203200,6
ruaidhri,0,6,0,25,1574658000,1574744400,6
Red_Trapezoid,1,5,48,23,1568001600,1599105600,6
_whoop_,0,6,0,24,1587182400,1601611200,6
Lemongrabsays,0,6,0,74,1565323200,1579150800,6
ironyinsideme,2,4,120,40,1589428800,1608786000,6
SEXYBRUISER,1,5,25,49,1547442000,1560139200,6
Overlord_of_Muffins,0,6,0,132,1549515600,1562126400,6
dakbooraktion,0,6,0,72,1567569600,1585627200,6
DuckVendetta,0,6,0,46,1576040400,1591761600,6
SassenachWitch,0,6,0,131,1589428800,1598932800,6
BluegrassBob82,0,6,0,188,1565582400,1577163600,6
ramblingnonsense,0,6,0,11,1464321600,1575867600,6
RobinJ1994,0,6,0,25,1594785600,1595476800,6
CheezusRiced06,0,6,0,-33,1606539600,1606626000,6
AdFickle5437,1,5,26,11,1608094800,1608181200,6
Alanheisenberg717,1,5,27,75,1582088400,1605330000,6
gtaltdmafy,0,6,0,187,1594785600,1604116800,6
frozenslushies,0,6,0,97,1572408000,1602475200,6
swgmuffin,0,6,0,90,1596772800,1612155600,6
fas_nefas,0,6,0,42,1578805200,1598846400,6
doppelbot,1,5,29,18,1569556800,1589169600,6
LL_COOL_BEANS,0,6,0,38,1589601600,1601870400,6
spartafury,0,6,0,30,1600747200,1605589200,6
OutlawShah,1,5,17,37,1575176400,1602820800,6
anonymousguy1988,0,6,0,16,1601265600,1602216000,6
fapingtoyourpost,0,6,0,26,1573534800,1583038800,6
Nola_Asian,0,6,0,13,1581483600,1585195200,6
atheistnun,1,5,14,14,1585281600,1585281600,6
Misty_Canonballs,0,6,0,279,1592971200,1606366800,6
2dab2furious,0,6,0,13,1585627200,1585800000,6
Rh-Misophonianthrope,0,6,0,54,1578978000,1582606800,6
chesthairvest,0,6,0,151,1597291200,1599537600,6
IyesUlfsson,0,6,0,26,1587355200,1597982400,6
bonesthekindacommie,0,6,0,27,1606453200,1606453200,6
JinxyDog,0,6,0,8,1550638800,1550811600,6
PuritanDaddyX,0,6,0,8,1578114000,1582952400,6
jsep81,1,5,8,5,1609218000,1609822800,6
electricdeathrats,0,6,0,38,1602734400,1612155600,6
fl03xx,0,6,0,3,1570680000,1570766400,6
Preact5,0,6,0,181,1589688000,1608786000,6
Stonna,0,6,0,23,1598414400,1604030400,6
cccas,0,6,0,11,1605589200,1606280400,6
BustyRutthole,0,6,0,53,1569384000,1582088400,6
short_and_floofy,0,6,0,106,1602388800,1615266000,6
jorg-washingmachine-,0,6,0,21,1603166400,1606021200,6
jawnnie-cupcakes,0,6,0,17,1600660800,1605416400,6
healthyelegant,0,6,0,13,1560744000,1564545600,6
DoctorWedgeworth,0,6,0,46,1598241600,1600142400,6
SkepticPickle,0,6,0,-4,1602129600,1602216000,6
Teh_Jews,0,6,0,122,1584331200,1594872000,6
Zozoas4,1,5,38,22,1572321600,1607922000,6
cben27,1,5,84,46,1595995200,1599624000,6
youreveningcoat,0,6,0,36,1570939200,1605502800,6
BlackMasala,0,6,0,22,1599796800,1605070800,6
AstralWave,1,5,319,17,1590724800,1608526800,6
Fancybanshee1,0,6,0,44,1584763200,1588996800,6
BenderIsGreat8,0,6,0,139,1591675200,1591761600,6
TacoOfShame,0,6,0,-7,1607835600,1608267600,6
thisllbedownvotedBUT,0,6,0,252,1572667200,1577422800,6
redditrandomity,0,6,0,17,1578459600,1578459600,6
RealityRobin,0,6,0,50,1595131200,1605416400,6
Mamamia520,0,6,0,14,1599105600,1608267600,6
TheSaltySyren,0,6,0,37,1582606800,1604116800,6
TrashcanMan4512,0,6,0,37,1570075200,1570075200,6
kamisdeadnow,0,6,0,44,1598155200,1609390800,6
chief_check_a_hoe,0,6,0,65,1570420800,1605416400,6
PigBenis710,0,6,0,19,1612069200,1612069200,6
Cocopopsticle,0,6,0,47,1604898000,1605589200,6
aaah123456789,0,6,0,63,1598328000,1600315200,6
Hannibus42,0,6,0,-8,1554523200,1556078400,6
thortastic,1,5,41,63,1570248000,1584331200,6
idonthavehayfeaver,0,6,0,-3,1606366800,1606626000,6
Theonewithdust,0,6,0,13,1605243600,1608267600,6
Bitesizedplanet,0,6,0,30,1603598400,1608181200,6
championruby,0,6,0,107,1543467600,1583726400,6
M_Minkoff,1,5,17,276,1583557200,1607835600,6
KingOfTheGrips,1,5,24,15,1580619600,1585540800,6
cara27hhh,0,6,0,118,1579582800,1605934800,6
CentristCanadian,0,6,0,-1,1605589200,1605675600,6
Flesh2Steel,0,6,0,31,1596945600,1597550400,6
crunchykate,1,5,21,20,1602043200,1606971600,6
eatmeatunumpty,0,6,0,7,1600056000,1606539600,6
chrisdub84,0,6,0,70,1580965200,1581138000,6
Conthortius,0,6,0,36,1592107200,1603598400,6
Ralphanese,0,6,0,35,1602648000,1606107600,6
freeandundecided,0,6,0,50,1602043200,1609218000,6
Particle_Cannon,0,6,0,141,1591156800,1601870400,6
Guckalienblue,0,6,0,52,1600574400,1608699600,6
Born_Weird,0,6,0,33,1600401600,1603684800,6
iamambience,0,6,0,106,1571544000,1600488000,6
ImmutableInscrutable,0,6,0,-20,1581138000,1604379600,6
its_danyul,0,6,0,98,1592452800,1592625600,6
peekmydegen,0,6,0,36,1585454400,1585540800,6
croger62,0,6,0,162,1592280000,1604898000,6
Linkerjinx,0,6,0,13,1578027600,1578891600,6
Crims0nsin,0,6,0,24,1586232000,1590379200,6
Kellan_is_a_dick,0,6,0,47,1556856000,1609218000,6
ZombieLeftist,1,5,57,54,1606194000,1609218000,6
Kudemos,0,6,0,25,1586404800,1595649600,6
wellwhatnot,0,6,0,71,1595822400,1595908800,6
DarklordDre1,0,6,0,48,1573794000,1586145600,6
Shazalakazoo,0,6,0,-140,1573362000,1573362000,6
imaginelife2014,0,6,0,19,1581051600,1607403600,6
Ahmad-,1,5,2,98,1574312400,1598500800,6
fieldwing2020,0,6,0,92,1579237200,1589860800,6
OnePieceJunge,0,6,0,86,1574571600,1589860800,6
SunChildy,2,4,344,16,1571284800,1577509200,6
thomas15v,0,6,0,108,1564027200,1594785600,6
gstorhof1,0,6,0,27,1601352000,1604379600,6
glum_plum,0,6,0,122,1605330000,1608872400,6
Swarmcap,0,6,0,-7,1593662400,1597896000,6
scupy42,0,6,0,276,1595822400,1596168000,6
Farker99,2,4,7387,165,1599105600,1600488000,6
Melonnie2000,0,6,0,50,1603425600,1603425600,6
Richinaru,0,6,0,111,1596427200,1604293200,6
pinehole,0,6,0,18,1546405200,1579237200,6
SightUnseen1337,0,6,0,46,1557374400,1583899200,6
kushqt420,0,6,0,43,1556856000,1587268800,6
skepachino,1,5,100,113,1592971200,1600056000,6
non1067,0,6,0,34,1552968000,1582866000,6
dieomama,0,6,0,29,1554955200,1563163200,6
GGQQ1,1,5,13,7,1579928400,1580446800,6
wellthatsffffup,1,5,18,34,1599796800,1600574400,6
mayax81,2,4,14,31,1573189200,1593921600,6
Darq_Potatoes,1,5,41,26,1574485200,1578632400,6
KarlaTheWitch,0,6,0,53,1571630400,1580706000,6
steeemo,3,3,329,16,1575867600,1602820800,6
k-trecker,0,6,0,22,1592452800,1604898000,6
jthebrave,0,6,0,-28,1595649600,1595822400,6
vlads_,0,6,0,8,1562644800,1562731200,6
majordude14,0,6,0,24,1589256000,1592971200,6
cookieseance,6,0,1454,0,1566792000,1582866000,6
silverlight145,0,6,0,73,1578114000,1589601600,6
Dittozkul,0,6,0,-32,1577595600,1580533200,6
Train_go_moo,1,5,79,7,1602129600,1602216000,6
Reputable_Sorcerer,1,5,35,38,1606626000,1607058000,6
OnlyLongComments,0,6,0,3,1589083200,1589083200,6
jessabobessa,0,6,0,27,1573189200,1584244800,6
Gods_of_Sourdough,0,6,0,114,1608181200,1609304400,6
Sage_Lord,0,6,0,-18,1589860800,1589947200,6
templeofhylia,0,6,0,54,1580360400,1611810000,6
GayShh,5,1,48,3,1606280400,1611982800,6
ultitaria,0,6,0,10,1570334400,1608786000,6
taolite,0,6,0,32,1565755200,1565755200,6
BlueWoof,5,1,4365,4,1582261200,1585454400,6
AJM1613,0,6,0,56,1570939200,1572494400,6
mikaflako,0,6,0,39,1578114000,1600747200,6
riskywhisky123,0,6,0,27,1593835200,1598932800,6
Vyslante,0,6,0,32,1598932800,1611810000,6
OblivianOfficial,0,6,0,-43,1592107200,1598760000,6
rerrerrocky,0,6,0,91,1593576000,1595995200,6
icewine999,0,6,0,6,1551330000,1552708800,6
lilchick2,0,6,0,7,1583298000,1583557200,6
Axarraekji,0,6,0,25,1575522000,1597032000,6
BearAggressive,1,5,532,53,1603684800,1608181200,6
YORTIE12,0,6,0,34,1606626000,1606626000,6
shoob13,0,6,0,31,1555905600,1608699600,6
nahtn2,1,5,21,15,1578114000,1585713600,6
StrangeSociety666,0,6,0,53,1580878800,1608699600,6
CptHeywire,0,6,0,43,1566360000,1567569600,6
WeebsMom,1,5,141,42,1562385600,1567137600,6
UngregariousDame,0,6,0,182,1580274000,1607490000,6
endbsjobs,1,5,19,30,1558929600,1559102400,6
seasexual,1,5,28,122,1576040400,1581397200,6
jaime000,1,5,3113,15,1564113600,1597032000,6
VeggieSmooth,1,5,67,20,1574312400,1574398800,6
jacobissimus,0,6,0,179,1560312000,1563768000,6
notyourstranger,0,6,0,60,1583125200,1606626000,6
LemonFreshenedBorax-,0,6,0,30,1552194000,1599969600,6
HomerPepsi,1,5,38,16,1599883200,1609390800,6
asadenvironmentalist,0,6,0,7,1567051200,1576731600,6
katt-w,0,6,0,120,1602734400,1609304400,6
icemyheart99,4,2,2167,15,1601438400,1607576400,6
aunttiti,1,5,1436,50,1567051200,1576386000,6
maecky1,2,4,23,8,1595476800,1601092800,6
BullFr0GG,0,6,0,69,1578027600,1585454400,6
Pancakewagon26,0,6,0,30,1560571200,1608958800,6
SinisterPuppy,0,6,0,-9,1574312400,1575954000,6
testosteronnie,1,5,131,102,1587960000,1602475200,6
TrailerParkUnicorn,2,4,22,61,1554696000,1596168000,6
Fossana,0,6,0,28,1579410000,1599364800,6
redpatcher,0,6,0,106,1544245200,1605070800,6
StuntHacks,0,6,0,65,1579755600,1605157200,6
longseenotime,0,6,0,-52,1592539200,1592798400,6
TheGoldenRoad,3,3,75,5,1430884800,1440820800,6
nanochito,0,6,0,61,1574830800,1577854800,6
TCrob1,0,6,0,143,1568088000,1577336400,6
PlasmaReuse,1,5,12,15,1580965200,1599537600,6
PM_ME_HEDGEHOG,0,6,0,81,1591934400,1609477200,6
Hellion_shark,0,6,0,12,1606539600,1608440400,6
AlvariusMoat,0,6,0,38,1581310800,1588392000,6
JulesDubois,0,6,0,13,1549774800,1587960000,6
SteonThe______,0,6,0,73,1597636800,1599537600,6
the_battousai89,0,6,0,30,1586404800,1589256000,6
cowbellmaster69,1,5,123,15,1591675200,1593230400,6
CubbieCat22,0,6,0,47,1570248000,1581915600,6
Feynmanprinciple,2,4,67,66,1593921600,1598760000,6
GoulashArchipelago68,1,5,11,127,1571544000,1582779600,6
quietboy2,0,6,0,44,1542949200,1551675600,6
Vyzantinist,0,6,0,100,1605934800,1607662800,6
Rumple-skank-skin,1,5,4,27,1611810000,1612069200,6
IEatBabies,0,6,0,23,1594267200,1599019200,6
Pons__Aelius,0,6,0,340,1569038400,1569902400,6
LonelyMan678,0,6,0,54,1575176400,1575694800,6
TrueMultiPking,4,2,197,7,1569643200,1579323600,6
Wagnerian1996,1,5,62,16,1602302400,1605934800,6
Preaddly,0,6,0,269,1577595600,1598846400,6
GrubeMicklethorne,0,6,0,-38,1551934800,1551934800,6
drasticrebel,0,6,0,30,1571371200,1606712400,6
BelizeBestCountry,0,6,0,2,1600488000,1600488000,6
arashcuzi,0,6,0,30,1603425600,1603512000,6
Testiculese,0,6,0,26,1603512000,1603512000,6
Capt_Nat,1,5,19,32,1522900800,1606798800,6
shittyfucknugget,0,6,0,-47,1607576400,1607662800,6
david_z,1,5,23,22,1399003200,1472875200,6
odd_cloud,0,6,0,50,1569470400,1596859200,6
Greyraptor6,0,6,0,47,1601524800,1611810000,6
faithle55,0,6,0,6,1585281600,1585281600,6
UnusefulTruthSeeker,0,6,0,175,1598328000,1602216000,6
rsrsrs0,0,6,0,41,1600315200,1605070800,6
FuzzyNumNums,1,5,75,27,1603080000,1603080000,6
johnmarstonsleftnut,0,6,0,19,1554868800,1554868800,6
le_cochon,0,6,0,262,1591156800,1605934800,6
Teacher_Game,0,6,0,30,1602216000,1603684800,6
funkmachine7,0,6,0,31,1603339200,1607403600,6
RegisteredNumberOne,0,6,0,52,1547355600,1596600000,6
13aseBa77,0,6,0,3,1606626000,1612069200,6
IAmAcatonredditAMA,0,6,0,41,1550811600,1599451200,6
indigoassassin,0,6,0,8,1571803200,1599278400,6
Draymond_Purple,0,6,0,7,1591243200,1591243200,6
sonictheposthog,0,6,0,68,1576990800,1583470800,6
Kenatius,0,6,0,16,1581051600,1589947200,6
mindonthepath,0,6,0,36,1606280400,1609390800,6
elbucho,0,6,0,144,1582779600,1582779600,6
BairBrains,0,6,0,34,1558497600,1564372800,6
RexMortisRexVitae,1,5,85,50,1555300800,1557892800,6
okokimup,0,6,0,50,1572148800,1607144400,6
Dead_Inside_340,0,6,0,-1,1602648000,1602648000,6
mayeralex504,0,6,0,11,1601611200,1601956800,6
bigthrowawayyikes,1,5,136,56,1567483200,1567569600,6
normalcapital,0,6,0,42,1559707200,1562817600,6
SickPlasma,0,6,0,63,1557028800,1603598400,6
bananapants919,0,6,0,30,1573534800,1573534800,6
BlueSubaruCrew,1,5,16,41,1576558800,1587614400,6
TheRoyalFitz,1,5,27,244,1594094400,1606971600,6
nadaguru,0,6,0,312,1593489600,1598500800,6
703lvva,0,6,0,90,1588305600,1597896000,6
doctorwhy88,0,6,0,25,1605070800,1605157200,6
kultronvii,0,6,0,3,1601438400,1607576400,6
BajaBlast90,0,6,0,168,1598328000,1603512000,6
Fluffy-Weapon,0,6,0,-5,1606539600,1608008400,6
ScoopskiPotahtos,0,6,0,15,1585454400,1585454400,6
NumberOneAsshole,0,6,0,13,1611982800,1612069200,6
veronique0210,1,5,54,15,1604984400,1604984400,6
me_bell,0,6,0,58,1602129600,1608613200,6
terces7,0,6,0,177,1605934800,1606021200,6
infernal_llamas,0,6,0,16,1555992000,1555992000,6
seadrift6,0,6,0,316,1574398800,1574485200,6
toastman0304,0,6,0,27,1575003600,1582088400,6
BlackJackV3,0,6,0,40,1567051200,1582434000,6
Kanorado99,0,6,0,14,1590638400,1609131600,6
SpeshulSawce78,0,6,0,9,1585108800,1585108800,6
fuhrertrump,0,6,0,32,1591156800,1605675600,6
xioxiobaby,0,6,0,17,1566360000,1566532800,6
TechDifficult,0,6,0,4,1580446800,1580619600,6
soulbrutha3,0,6,0,831,1593748800,1606798800,6
Adiustio,0,6,0,41,1609218000,1609218000,6
SimpleWayfarer,1,5,19,-4,1588478400,1593662400,6
laurathreenames,0,6,0,25,1605157200,1608958800,6
TheSkyPirate,0,6,0,5,1591329600,1591329600,6
D_Tro,0,6,0,85,1562212800,1602648000,6
BasuraConBocaGrande,0,6,0,82,1548738000,1600920000,6
oaknollestates,0,6,0,-15,1565755200,1565755200,6
Punkybrewster1,1,5,192,19,1542258000,1555300800,6
DakotaEE,0,6,0,24,1585886400,1587096000,6
TBHmodsAreIncels3,0,6,0,-15,1585022400,1585108800,6
oldirtydrunkard,0,6,0,362,1576818000,1581483600,6
qthomascooper,1,5,329,11,1594526400,1601697600,6
BayLakeVR,0,6,0,11,1605157200,1605157200,6
SpiceyFortunecookie,0,6,0,-31,1568952000,1574398800,6
Dr_Herbivore,0,6,0,-1,1595908800,1595908800,6
cheertina,0,6,0,10,1589860800,1592366400,6
Corswagg,0,6,0,22,1596859200,1599192000,6
aspiringvillain,0,6,0,33,1603425600,1604379600,6
ppepegaclapp,4,2,57748,4,1603512000,1605330000,6
arieltron,0,6,0,128,1600488000,1604030400,6
Agaposavros,0,6,0,6,1598414400,1612933200,6
Episodial,0,6,0,124,1547182800,1569988800,6
FreeFantom,0,6,0,34,1598846400,1598932800,6
BoofinBoof,0,6,0,-6,1577509200,1577509200,6
Nolwennie,3,3,844,327,1566532800,1574312400,6
magzdesch,0,6,0,104,1593835200,1606971600,6
MarxistAnarchist,0,6,0,20,1571976000,1576904400,6
voltairemkalt,0,6,0,84,1567137600,1575694800,6
Somanycares,1,5,2533,23,1562644800,1584244800,6
crazy_bava,0,6,0,-29,1571371200,1574917200,6
settingdogstar,0,6,0,90,1598760000,1600574400,6
ivy_bound,0,6,0,2,1595131200,1595217600,6
gligster71,2,4,23,18,1585454400,1594440000,6
BubbsMom,0,6,0,11,1603425600,1603425600,6
Theadyn,1,5,16,25,1565668800,1567224000,6
Kafke,0,6,0,18,1571803200,1571803200,6
BridgeportHotwife,0,6,0,10,1578978000,1579150800,6
frengs,0,6,0,49,1609131600,1609477200,6
SexySPACsMan,0,6,0,58,1592971200,1594872000,6
unclevikki,1,5,1067,7,1584331200,1584590400,6
whynotnever,0,6,0,77,1571112000,1599019200,6
latsyrc_,1,5,24,22,1565668800,1593748800,6
MoyaseOkama,1,5,37,851,1589083200,1598760000,6
ylcard,0,6,0,12,1591243200,1612069200,6
hotfrspock,0,6,0,-41,1576126800,1576213200,6
DabberCoin,0,6,0,14,1546059600,1546059600,6
ShadowUmbreon196,0,6,0,21,1608267600,1609390800,6
jhindle,0,6,0,0,1584244800,1584244800,6
RoseK22,0,6,0,100,1554177600,1558411200,6
CMarieDalliance,0,6,0,25,1588478400,1595822400,6
Beast_Pot_Pie,2,4,33,25,1460001600,1465099200,6
inabox01,0,6,0,24,1554523200,1564718400,6
ZestycloseYoung,0,6,0,25,1578718800,1593748800,6
horrorworthwatching,0,6,0,724,1611982800,1611982800,6
aUserIAm,0,6,0,-1,1595995200,1597118400,6
donttrusthumans,0,6,0,13,1572580800,1579842000,6
Sam2676789,0,6,0,69,1576386000,1597636800,6
jorgery22,0,6,0,367,1595736000,1599883200,6
ichakas,0,6,0,267,1575867600,1600488000,6
YhormOldFriend,0,6,0,36,1548910800,1602129600,6
okgo222,1,5,95,5,1546578000,1588564800,6
karloz1214,2,4,160,16,1600660800,1608958800,6
jablev1288,1,5,18,18,1601870400,1601956800,6
DragonMomma420,0,6,0,69,1576472400,1588392000,6
swampguerillas,1,5,8,15,1585368000,1598328000,6
El_Burrito_,0,6,0,18,1604030400,1605934800,6
mutenshiro,0,6,0,36,1569384000,1569470400,6
gummo_for_prez,0,6,0,28,1589601600,1606971600,6
SuperSaiyanNoob,0,6,0,19,1596686400,1604898000,6
lifeDeCoder,1,5,6,19,1573794000,1573794000,6
dontreallycareforit,0,6,0,214,1590379200,1606453200,6
nowandthenoldfriend,0,6,0,47,1603080000,1609304400,6
20200312_account,1,5,8,30,1595390400,1596081600,6
misathopesincebirth,0,6,0,31,1584244800,1600315200,6
JaytheDrummer,0,6,0,71,1561262400,1572494400,6
lanicaragua,0,6,0,343,1607662800,1611982800,6
afdnzz,0,6,0,57,1581742800,1604725200,6
TheIrishPleb,0,6,0,17,1574398800,1605675600,6
TooStonedForAName,0,6,0,14,1611982800,1612069200,6
lexi_the_leo,1,5,89,11,1594612800,1600574400,6
ToadSox34,0,6,0,13,1560484800,1560571200,6
Cornbre4d,0,6,0,220,1591588800,1603684800,6
Menddi,0,6,0,7,1602820800,1609477200,6
open_ball,0,6,0,58,1574830800,1583470800,6
Horsey_plz,1,5,70,29,1558411200,1582606800,6
InvincibiIity,0,6,0,56,1595131200,1608440400,6
Mazahad,0,6,0,92,1607403600,1608526800,6
whydontwedoX,1,5,14,11,1580965200,1583298000,6
WilliamBarrsGutSebum,0,6,0,25,1592366400,1592366400,6
ProtonCanon,0,6,0,16,1579928400,1602129600,6
YeetasaurusWrex,0,6,0,22,1608094800,1611810000,6
insaniTY151,0,6,0,123,1585108800,1606885200,6
PDK01,0,6,0,-14,1430280000,1591416000,6
TVpresspass,0,6,0,99,1582693200,1608094800,6
tacoshelby,2,4,51,9,1583643600,1583985600,6
riseagainsttheend,0,6,0,16,1559188800,1559188800,6
Crackerbarrelisaids,0,6,0,8,1607835600,1608267600,6
Starfiregrl,0,6,0,6,1471233600,1471233600,6
imhumannotarobot,0,6,0,-67,1581915600,1581915600,6
justsomemaniac,1,5,17,18,1590379200,1602043200,6
Gilead_1999,3,3,86,6,1555992000,1586491200,6
zsdrfty,0,6,0,134,1563508800,1567828800,6
VegiHarry,2,4,65,17,1592020800,1607922000,6
Stereogravy,0,6,0,8,1595304000,1599019200,6
Doodlebug-n-Honeybun,0,6,0,19,1589947200,1590465600,6
Vizor88,0,6,0,17,1604203200,1609304400,6
getrichordietrying_w,0,6,0,31,1604725200,1608786000,6
Sputnikcosmonot,0,6,0,17,1597377600,1608958800,6
flaming_monocle,0,6,0,29,1586404800,1587960000,6
ozzydeleon,1,5,35,15,1574226000,1587873600,6
ZeGooober,0,6,0,33,1594526400,1594526400,6
xrancorx,0,6,0,108,1600315200,1607490000,6
A_boxfull_of_betties,0,6,0,10,1579064400,1583557200,6
Karraq,1,5,96,30,1562299200,1562817600,6
Username185s,0,6,0,3,1600056000,1600488000,6
m_i_k_e1,1,5,29,10,1593230400,1593316800,6
SansFrontera,0,6,0,27,1563768000,1580187600,6
Stamen_Pics,0,6,0,99,1605934800,1606626000,6
SierraMura,1,5,31,20,1594353600,1602561600,6
Geralt1367,3,3,116,12,1565928000,1601438400,6
eatrangelove,0,6,0,53,1602993600,1603339200,6
cmelt274,0,6,0,72,1579928400,1580533200,6
flyting1881,0,6,0,124,1601092800,1601265600,6
pingusbeak,0,6,0,42,1590465600,1607749200,6
artem_m,0,6,0,35,1592107200,1606626000,6
BobartTheCreator2,2,4,40,52,1550379600,1559448000,6
5starmaniac,0,6,0,7,1575003600,1585108800,6
RemindMeBot,0,6,0,6,1553140800,1570507200,6
Hollirc,0,6,0,26,1598328000,1607576400,6
LikelyWeeve,1,5,7,6,1583384400,1583384400,6
nyxnars,0,6,0,50,1595390400,1596254400,6
chicoblancocorto,0,6,0,154,1586404800,1597982400,6
MidoriGurin1971,0,6,0,-4,1591329600,1595649600,6
obviousRUbot,0,6,0,-49,1601956800,1601956800,6
Brutalos,0,6,0,18,1556164800,1593662400,6
spoopyelf,0,6,0,261,1603512000,1607922000,6
That_Will_Do_Donkey,0,6,0,37,1540180800,1547701200,6
earlywhine,0,6,0,22,1567483200,1602475200,6
leafthatshithomie,0,6,0,26,1571630400,1571716800,6
Feshtof,0,6,0,33,1585454400,1585454400,6
blakleafeon,0,6,0,38,1594180800,1597982400,6
WarmetaLFanNumber1,0,6,0,87,1594267200,1607144400,6
mintgoody03,0,6,0,162,1584936000,1609131600,6
wise_joe,0,6,0,146,1603512000,1611896400,6
AustinTN,0,6,0,56,1606712400,1642050000,6
6797042Aw,0,6,0,279,1592107200,1600315200,6
atxtopdx,0,6,0,163,1597809600,1609477200,6
YoungThuggeryy,0,6,0,202,1587182400,1609218000,6
Ihatemoi,0,6,0,6,1612933200,1613019600,6
workersrev,1,5,52,24,1580965200,1601956800,6
one-punch-knockout,4,2,1347,3,1548824400,1554782400,6
VirtualFriendship1,0,6,0,8,1590292800,1590292800,6
BentPin,0,6,0,33,1603425600,1608094800,6
martelaxe,0,6,0,-2,1578286800,1602388800,6
ppenn777,0,6,0,16,1546405200,1591329600,6
Grove-Knight,1,5,15,109,1593921600,1598414400,6
ihatethishit,0,6,0,-11,1556596800,1556769600,6
crackedtooth163,0,6,0,42,1592366400,1594353600,6
iTAMEi,0,6,0,17,1594353600,1594785600,6
Boop121314,1,5,8,56,1596168000,1600574400,6
lewdwiththefood,1,5,279,112,1598241600,1598241600,6
Manobo,0,6,0,40,1592884800,1602820800,6
Itz_Jolly,1,5,57,11,1597032000,1599192000,6
merespell,0,6,0,52,1569988800,1571716800,6
RealShabanella,0,6,0,37,1592798400,1603080000,6
curious-carol,1,5,105,85,1572843600,1578978000,6
Nytemare3701,0,6,0,56,1579842000,1606798800,6
anonoman925,0,6,0,47,1573448400,1602388800,6
mitch44c,0,6,0,61,1552536000,1556856000,6
mursili_ii,0,6,0,75,1582434000,1587182400,6
ekilmebe,0,6,0,18,1566100800,1572580800,6
SickOrphan,0,6,0,-56,1606280400,1606366800,6
Bigmooddood,0,6,0,70,1566705600,1594094400,6
InvestImmediately,0,6,0,-11,1605589200,1605934800,6
LordVictoriud,0,6,0,7,1570075200,1570161600,6
St3llarWind,0,6,0,-5,1599710400,1600142400,6
Michael23B,0,6,0,35,1564804800,1605330000,6
lolertoaster,0,6,0,17,1607490000,1607490000,6
JayWalken,0,6,0,11,1399089600,1573102800,6
KevinDoesnt,0,6,0,17,1583812800,1587960000,6
ColtsFanNY,0,6,0,14,1579496400,1604030400,6
idjaak,4,2,132,14,1557979200,1578978000,6
travelzee,0,6,0,13,1599105600,1609218000,6
general_peabo,0,6,0,102,1605589200,1607576400,6
goodnightbird,0,6,0,108,1578805200,1603857600,6
slubice,0,6,0,43,1605589200,1606021200,6
curiosity163,0,6,0,96,1591675200,1607662800,6
redheadbitch97,0,6,0,38,1603252800,1606539600,6
EscapeTheCubicle,0,6,0,-17,1600833600,1608267600,6
Oceanicul,1,5,50,23,1578632400,1578718800,6
MyNameIsJeffReddit,1,5,0,-9,1597118400,1597204800,6
VisUnitaFortiorStoke,0,6,0,22,1608440400,1608613200,6
CastanhasDoPara,0,6,0,56,1585540800,1603512000,6
tesseracht,0,6,0,393,1603512000,1607317200,6
WyrdThings,0,6,0,96,1606107600,1607922000,6
mrtrinket1984,0,6,0,65,1601611200,1606712400,6
ATLtinyrick,0,6,0,-43,1599710400,1599710400,6
Alansalot,0,6,0,46,1564459200,1566532800,6
jonblaze32,0,6,0,23,1574312400,1576990800,6
accelaboy,0,6,0,35,1515819600,1585281600,6
animeboy12,0,6,0,54,1605243600,1608786000,6
Lyradep,0,6,0,9,1588910400,1605589200,6
Dr-Bigglesworth,1,5,3239,32,1539835200,1569211200,6
esliia,0,6,0,9,1584763200,1608958800,6
rodrun,0,6,0,21,1581570000,1581656400,6
Erikkamirs,0,6,0,214,1572580800,1583557200,6
hopefuldaily,0,6,0,77,1592539200,1602734400,6
Gremlinofpeace,0,6,0,15,1598587200,1598673600,6
yentcloud,0,6,0,11,1596340800,1604725200,6
AndrewAlmighty,0,6,0,361,1576040400,1577682000,6
fillet_feesh,0,6,0,1,1571198400,1576040400,6
AsAGayMan456,0,6,0,-66,1590120000,1591243200,6
ceward5,0,6,0,13,1576472400,1582606800,6
FrozenFlame_,0,6,0,9,1596340800,1596340800,6
Bonzenjonas,2,4,47,47,1605330000,1607317200,6
chidedneck,1,5,44,35,1549515600,1605848400,6
brazblue,0,6,0,92,1562990400,1609218000,6
slidinggoal,0,6,0,27,1543381200,1553832000,6
Kiwikid14,0,6,0,19,1572494400,1573966800,6
jersits,0,6,0,31,1603166400,1606971600,6
whiteexmagic,1,5,96,2,1596340800,1599883200,6
L0verlada,0,6,0,189,1605070800,1609390800,6
summerhe4d,0,6,0,27,1602388800,1609218000,6
arealbotnot,2,4,88,5,1594526400,1608267600,6
theworld777,0,6,0,69,1565409600,1577077200,6
CocoLaKiki,1,5,7,12,1591329600,1605070800,6
SlackPriestess,1,5,28,552,1601784000,1604898000,6
sgp1986,0,6,0,186,1597982400,1600142400,6
CaptainKabLouis,0,6,0,212,1596600000,1607490000,6
Muzanshin,0,6,0,152,1605157200,1611810000,6
j3wbacca996,0,6,0,10,1575003600,1606539600,6
bosey17,0,6,0,146,1565496000,1609304400,6
swangt,0,6,0,54,1595736000,1601956800,6
fablewolfepine,0,6,0,6,1605416400,1605416400,6
asking2die,3,3,475,14,1568606400,1575522000,6
KinqCalb,0,6,0,9,1589169600,1611896400,6
MindfulMowgli,1,5,0,13,1583899200,1599710400,6
bubblegumkingbitch,0,6,0,31,1611810000,1611810000,6
buttsnuggler,0,6,0,151,1570507200,1609390800,6
adriennemonster,0,6,0,14,1589688000,1597032000,6
heckastupidd,0,6,0,33,1572408000,1592971200,6
Rumptis,0,6,0,61,1592193600,1611637200,6
LevelOutlandishness1,0,6,0,134,1602907200,1607749200,6
dgs93,1,5,52,21,1560312000,1560398400,6
holytoledo760,0,6,0,-9,1571112000,1594872000,6
Kittybaby92,0,6,0,6,1608440400,1608526800,6
VOMIT_ON_HIS_SWEATER,0,6,0,225,1585540800,1598932800,6
Shift2812,0,6,0,11,1539662400,1539921600,6
und88,0,6,0,81,1569816000,1608786000,6
ISTYDTC,0,6,0,-32,1584763200,1585108800,6
Say_no_to_3DPD,0,6,0,293,1598673600,1599019200,6
venuswasaflytrap,0,6,0,13,1612414800,1612501200,6
OrYouEndUpLikeHim,0,6,0,131,1598673600,1609304400,6
Arunninghistory,0,6,0,7,1589947200,1589947200,6
mangolennox,0,6,0,37,1588910400,1599451200,6
ArtisticVolume,1,5,14,19,1559880000,1595476800,6
eac061000,0,6,0,10,1596254400,1606021200,6
testcyp76,0,6,0,68,1595822400,1607576400,6
pragmaticweirdo,0,6,0,13,1576645200,1595217600,6
vibrantax,0,6,0,65,1579496400,1607835600,6
furlowe,0,6,0,14,1557547200,1564632000,6
elisarver,0,6,0,60,1605243600,1608786000,6
Mycroft2033,0,6,0,22,1573966800,1578286800,6
handbanana42069,1,5,4,11,1611982800,1611982800,6
MOOShoooooo,0,6,0,38,1604811600,1608526800,6
testAcount001,0,6,0,23,1599883200,1601438400,6
mpyner,0,6,0,-83,1606453200,1608008400,6
lookatthesource,0,6,0,63,1572062400,1572494400,6
Catmom2004,0,6,0,48,1538452800,1610082000,6
redeyesblackdragon_d,1,5,95,24,1605070800,1605157200,6
star_witness11,0,6,0,70,1605848400,1609477200,6
PMmePMsofyourPMs,0,6,0,206,1597723200,1605070800,6
DarthRoach,0,6,0,2,1580360400,1601611200,6
00011101987,3,3,89,29,1580014800,1608613200,6
CoolAssJason,0,6,0,32,1578546000,1602043200,6
loune20,0,6,0,40,1577336400,1577336400,6
randomdrifter54,0,6,0,104,1599710400,1609304400,6
Aingealag,0,6,0,25,1604203200,1611982800,6
GardenofGandaIf,0,6,0,17,1612069200,1612155600,6
dutchpancakes,0,6,0,-16,1573707600,1573794000,6
TerracottaButthole,1,5,222,175,1604898000,1606885200,6
AndrewJS2804,0,6,0,4,1598241600,1602129600,6
CaptainCandor,0,6,0,27,1601524800,1601611200,6
KachowEnthusiast,0,6,0,44,1594612800,1609045200,6
superstar9976,0,6,0,74,1552536000,1598846400,6
peskyadblock,0,6,0,17,1608699600,1608699600,6
SoIfarted,0,6,0,252,1561089600,1561521600,6
seanthebeloved,0,6,0,66,1559620800,1608354000,6
syntheticpanic,0,6,0,100,1555992000,1557028800,6
mmmmmmtoes,0,6,0,8,1599019200,1607576400,6
PassionateGardener,1,5,27,162,1575349200,1583125200,6
Significant_Airline,0,6,0,7,1585454400,1585454400,6
Xalimata,0,6,0,85,1570852800,1605330000,6
friendlyDiscordUser,2,4,67,54,1600488000,1600574400,6
lngots,0,6,0,-20,1508990400,1509163200,6
PeacefulPeoples,0,6,0,41,1577941200,1585368000,6
Pitiful_Sundae,0,6,0,49,1599624000,1608526800,6
CommandLonely8246,1,5,54,154,1603684800,1609390800,6
catcatcatilovecats,0,6,0,72,1598846400,1607058000,6
IamRocko,2,4,1425,38,1606626000,1606626000,6
shadyMFer,1,5,1413,103,1487566800,1576472400,6
pbaydari,0,6,0,7,1612069200,1612155600,6
niarut,1,5,3,-23,1587096000,1597550400,6
A_Chicken_Called_Kip,0,6,0,50,1577682000,1598932800,6
IGetPaidHBU,0,6,0,1,1612069200,1612069200,6
worksuxiknow23,1,5,51,37,1594094400,1594872000,6
King_Moonracer003,2,4,9,11,1564545600,1601870400,6
randomcarrotaf,0,6,0,17,1543986000,1544504400,6
Memeamania,1,5,92,24,1605157200,1607662800,6
kyleehappiness,0,6,0,11,1473652800,1482296400,6
grasscom,1,5,16,19,1598587200,1598587200,6
CrispySnilfJuice,0,6,0,114,1569384000,1583557200,6
jh_stein,1,5,17,18,1608613200,1608613200,6
redzonez,1,5,32,30,1591761600,1591848000,6
ookamismyk,0,6,0,16,1605848400,1607576400,6
AdjudicatorSal,0,6,0,115,1561867200,1576731600,6
calmeharte,0,6,0,-112,1585540800,1585540800,6
Yaglis,0,6,0,90,1538539200,1564977600,6
grouchy_fox,0,6,0,12,1605157200,1608008400,6
TheFemiFactor,0,6,0,-85,1574658000,1574744400,6
ThaKrazyKudu,0,6,0,88,1576040400,1579928400,6
LX_Emergency,0,6,0,52,1570075200,1575954000,6
CosmosGatito,0,6,0,8,1579410000,1593489600,6
Dr_Schittpost,0,6,0,74,1598932800,1602648000,6
calming-tea,0,6,0,5,1607576400,1607576400,6
Dimension124,0,6,0,11,1572321600,1583038800,6
parks_not_narcs,0,6,0,38,1558497600,1561780800,6
Herr_Stoll,0,6,0,70,1579755600,1594872000,6
GoldPlumHack,0,6,0,26,1576645200,1634788800,6
gmano,0,6,0,8,1584676800,1584763200,6
DefinitelySteveIrwin,1,5,20,10,1597896000,1609045200,6
zzzzz94,0,6,0,4,1588737600,1588824000,6
Jastiv,0,6,0,20,1601870400,1601870400,6
itsmeChavalo,0,6,0,96,1606626000,1608613200,6
MajorDish,0,6,0,248,1603252800,1608786000,6
kallen8277,0,6,0,149,1604984400,1607662800,6
angelofessence1,0,6,0,93,1584417600,1606971600,6
sdrawkcaBuoYkcuF,0,6,0,58,1602129600,1612155600,6
The_Canadian_busey,0,6,0,-12,1602129600,1612069200,6
kingofdarkness92,0,6,0,22,1596340800,1602993600,6
icumwhencopsdie,0,6,0,132,1577941200,1577941200,6
ByteWhisperer,0,6,0,59,1578027600,1581915600,6
sunshinechime1,0,6,0,17,1585454400,1585540800,6
Fuck_A_Suck,0,6,0,21,1588737600,1588824000,6
Organic_Rest_3884,0,6,0,3,1608267600,1608267600,6
create3_14,2,4,31,7,1605416400,1608613200,6
fyberoptyk,0,6,0,206,1586577600,1608094800,6
justabloke22,0,6,0,68,1580101200,1582606800,6
conormal,0,6,0,51,1593835200,1604898000,6
heres-a-game,0,6,0,63,1583812800,1583985600,6
SamAreAye,0,6,0,-33,1590120000,1607490000,6
DryDriverx,0,6,0,-25,1599019200,1602475200,6
Suddzi,0,6,0,23,1582434000,1606971600,6
vonmonologue,0,6,0,153,1574398800,1603512000,6
borrego-sheep,1,5,21,6,1596600000,1607230800,6
GenericGaming,0,6,0,38,1598760000,1605675600,6
Oceansunshine789,2,4,591,19,1607144400,1609218000,6
wall_of_swine,0,6,0,2,1560571200,1605589200,6
XxX_Ghost_Xx,0,6,0,13,1565755200,1579755600,6
zwinky588,0,6,0,-1,1582434000,1585281600,6
A_Gentlemens_Coup,0,6,0,58,1535515200,1564027200,6
NewYorkJewbag,0,6,0,70,1574658000,1589947200,6
InvisibleMonsters_,0,6,0,-4,1559448000,1564459200,6
TheHumanite,0,6,0,-2,1492920000,1547874000,6
HormelCovfefee,0,6,0,10,1567742400,1574053200,6
bigtuna94,0,6,0,62,1589169600,1607922000,6
littleman307,0,6,0,2,1596081600,1608267600,6
starcraft542,1,5,23,26,1590465600,1607490000,6
Blugalu,1,5,2,65,1574053200,1605589200,6
onceuponathrow,0,6,0,56,1580014800,1580014800,6
SisRob,0,6,0,330,1561348800,1592539200,6
JSW_pilot,0,6,0,78,1591243200,1596340800,6
imperfcet,0,6,0,39,1584590400,1584590400,6
persianexmuzzie,0,6,0,-10,1578805200,1580360400,6
uprightcleft,0,6,0,112,1576904400,1602993600,6
Carnifex217,0,6,0,20,1594958400,1603771200,6
feeleverythingdeeply,0,6,0,59,1596859200,1599796800,6
ChatGarou,0,6,0,37,1588737600,1602475200,6
poopanatorOg,1,5,12,-10,1608526800,1608526800,6
Splatfan1,0,6,0,27,1586404800,1606885200,6
thePracix,0,6,0,32,1597464000,1608267600,6
Morphray,1,5,77,16,1580101200,1607922000,6
apitchf1,0,6,0,306,1564977600,1597982400,6
ChiefDanny_SA-LS,0,6,0,-32,1592107200,1592280000,6
harmonious_baseline,0,6,0,59,1594526400,1597982400,6
MarkSabre,0,6,0,29,1579928400,1581915600,6
SpacemanTomX,0,6,0,-1,1596686400,1604379600,6
count_the_teeth,0,6,0,51,1576126800,1587700800,6
Stumplestiltzkin,0,6,0,5,1593576000,1605589200,6
MelpomeneAndCalliope,0,6,0,117,1592798400,1600228800,6
Vedoom123,0,6,0,28,1591329600,1598760000,6
throwawaybe112233,0,6,0,9,1576558800,1576818000,6
thomki,0,6,0,38,1595390400,1598414400,6
ezwolfy,0,6,0,12,1575435600,1612155600,6
rrawk,0,6,0,7,1585454400,1585540800,6
PantsOnYourHead,0,6,0,9,1577768400,1577768400,6
Whiterazz1,0,6,0,14,1611982800,1612328400,6
Stardagger13,0,6,0,254,1597291200,1606453200,6
ZomNomNomBeeZ,0,6,0,199,1605934800,1606021200,6
10ta2,0,6,0,15,1585281600,1585972800,6
markymarkceekay,1,5,226,65,1580360400,1606885200,6
ChiefOstenaco,0,6,0,45,1602993600,1607662800,6
freestylelifestyle,0,6,0,25,1510290000,1550725200,6
thaumogenesis,0,6,0,26,1579496400,1605762000,6
vc1298,2,4,57,11,1600833600,1606626000,6
Therathos,1,5,16,42,1525924800,1538452800,6
loldoitagainpls,0,6,0,-4,1607922000,1608181200,6
Cherubin0,0,6,0,2,1590724800,1603771200,6
jpmezart,0,6,0,79,1551157200,1575349200,6
pruwdent,0,6,0,32,1583298000,1598932800,6
xxplantjaysonxx,0,6,0,5,1605070800,1605157200,6
summa,0,6,0,-9,1477368000,1581915600,6
merthyr1831,1,5,2,14,1546491600,1573102800,6
lynx_and_nutmeg,0,6,0,19,1584763200,1600142400,6
FlaGators96,0,6,0,11,1592280000,1603080000,6
HateIsAnArt,0,6,0,3,1599019200,1599019200,6
FinalInitiative4,1,5,52,543,1597982400,1608699600,6
vie_en_rouge,0,6,0,110,1591675200,1604203200,6
__i0__,0,6,0,-26,1576645200,1576731600,6
H3RM1TT,0,6,0,15,1557201600,1563508800,6
refrow2169,0,6,0,3,1585022400,1585108800,6
zobagestanian,0,6,0,66,1609390800,1609390800,6
comradecosmetics,0,6,0,28,1607662800,1611896400,6
PinkieThePie,0,6,0,64,1597118400,1608786000,6
the-knot-thot,0,6,0,35,1552536000,1572753600,6
TroubleEntendre,0,6,0,36,1580446800,1592193600,6
Jefflehem,0,6,0,30,1597204800,1597291200,6
notagan,1,5,38,24,1595390400,1599278400,6
SumDryGuy,0,6,0,44,1589342400,1589342400,6
op_fiscaljackhammer,1,5,47,70,1584504000,1588996800,6
WeirdAstronaut,0,6,0,43,1560484800,1560571200,6
SheitPost3000,0,6,0,42,1601006400,1601265600,6
LivingStatic,0,6,0,20,1597982400,1602907200,6
Upstairs-Round1408,0,6,0,8,1606626000,1606626000,6
nameless_pattern,0,6,0,42,1579410000,1597809600,6
Goodbye-Felicia,0,6,0,-18,1603339200,1603425600,6
belt_of_orions_belts,0,6,0,73,1597723200,1603512000,6
ArcticLupine,0,6,0,46,1593144000,1608440400,6
bobZzZEe,0,6,0,47,1603425600,1608181200,6
fib16,0,6,0,78,1575867600,1580706000,6
Rainbowstarks,0,6,0,13,1592539200,1597204800,6
Peckanip,0,6,0,160,1602561600,1604030400,6
Zyega,0,6,0,35,1602216000,1606453200,6
HiIAmFromTheInternet,0,6,0,-2,1578373200,1578373200,6
leypb,0,6,0,18,1573189200,1590206400,6
Not_My_Real_Acct_,0,6,0,38,1578286800,1578373200,6
maukiepaukie,0,6,0,99,1583384400,1600142400,6
Whatdoyouseek,0,6,0,81,1550638800,1608267600,6
KingCobraBSS,0,6,0,628,1608958800,1609045200,6
CantStopTheBat,1,5,123,73,1552107600,1564977600,6
doctorace,0,6,0,13,1434686400,1451883600,6
KeronCyst,0,6,0,14,1580792400,1580878800,6
Medpac76,1,5,187,78,1554264000,1556596800,6
anonisland5,0,6,0,13,1604030400,1607922000,6
marip0sita,0,6,0,63,1578373200,1580101200,6
Cleverooni,0,6,0,-4,1565755200,1596772800,6
Camachan,1,5,283,39,1595476800,1606021200,6
AlphaBlood,0,6,0,26,1599883200,1599883200,6
Beers_For_Fears,0,6,0,26,1595217600,1608181200,6
newmath11,1,5,21,178,1571284800,1590033600,6
irokes360,0,6,0,41,1596427200,1602820800,6
MeleeMeistro,5,1,12,1,1549256400,1589774400,6
L-and,0,6,0,25,1570680000,1576731600,6
StabilizedDarkkyo,0,6,0,111,1584244800,1597809600,6
PsychedelicSkeptic,0,6,0,261,1608181200,1612242000,6
Calces_in_machina,2,4,142,11,1592280000,1607835600,6
OfGodlikeProwess,0,6,0,38,1573621200,1577941200,6
magnusdeus123,5,1,95,18,1534219200,1551675600,6
CLOUDdude114,0,6,0,-52,1592366400,1592366400,6
crazyhow,0,6,0,16,1606798800,1608872400,6
Qwerty-Hurty,1,5,78,22,1600056000,1600142400,6
ninjacowboywater,0,6,0,-8,1604811600,1608699600,6
cbpiz,0,6,0,-85,1563249600,1563249600,6
E9J0D7,0,6,0,16,1585627200,1596340800,6
munchler,1,5,8,13,1550552400,1573966800,6
WyoComanchero,0,6,0,28,1606021200,1608008400,6
Edghyatt,0,6,0,300,1576126800,1596254400,6
shitidiotturtle,0,6,0,44,1548910800,1585281600,6
HuntinLineman,0,6,0,7,1568433600,1580187600,6
Jolok2000,1,5,0,-4,1576386000,1576386000,6
LordRichteroftheMyst,0,6,0,110,1594526400,1606453200,6
sheyblaze,0,6,0,11,1600574400,1600660800,6
Greymires,0,6,0,703,1604116800,1604116800,6
countrymouse,0,6,0,55,1583812800,1595476800,6
ellieetsch,0,6,0,62,1605416400,1608181200,6
peterlikes,0,6,0,4,1576731600,1591502400,6
-beYOUtiful-,1,5,24,16,1593057600,1593144000,6
lezzbo,0,6,0,84,1570248000,1596686400,6
jbeldham,1,5,159,58,1582088400,1601265600,6
jje414,2,4,1237,20,1551070800,1566100800,6
Orias_Wormwood,0,6,0,27,1564113600,1568347200,6
OnPlanete,0,6,0,3,1582261200,1582347600,6
MECHEpics,0,6,0,12,1591156800,1596427200,6
shelbyvcobra,0,6,0,-56,1606885200,1606885200,6
Emilydeluxe,0,6,0,-2,1591502400,1601784000,6
sg7791,0,6,0,89,1603425600,1609390800,6
molebowl,0,6,0,95,1573707600,1583470800,6
athirstypretzel,1,5,93,49,1602302400,1608181200,6
Kewpie_1917,0,6,0,68,1573880400,1598328000,6
Lunaus,0,6,0,9,1598500800,1608872400,6
Blue_Lotus_Flowers,0,6,0,24,1601179200,1601179200,6
Dangles87,0,6,0,45,1578546000,1596859200,6
userleansbot,0,6,0,6,1552968000,1581829200,6
Phalanx341,0,6,0,-31,1584763200,1584849600,6
_MadPsycho_,1,5,19,26,1593230400,1594785600,6
AStickyMango,0,6,0,100,1591243200,1591329600,6
kijib,5,1,106,1,1478840400,1580360400,6
VoltronBugzilla,0,6,0,-6,1592366400,1609218000,6
MQZ17,0,6,0,72,1544763600,1597118400,6
revoltinglemur,0,6,0,-4,1606712400,1608786000,6
Pianotic,0,6,0,33,1591416000,1593662400,6
lildookielocks,0,6,0,15,1600574400,1608440400,6
Tokestra420,0,6,0,-2,1562731200,1571544000,6
Cynosure64,0,6,0,25,1573448400,1580792400,6
R3D61,0,6,0,-12,1594526400,1605502800,6
NO_trump_NO_Biden,0,6,0,29,1571630400,1571716800,6
chamomilewhale,0,6,0,9,1584504000,1606280400,6
Cottonsocks434,0,6,0,47,1594094400,1605675600,6
cronsumtion,0,6,0,109,1560571200,1597204800,6
Vermilionette,0,6,0,21,1571544000,1606280400,6
Escapererer,0,6,0,12,1577336400,1577509200,6
Tj_h__,0,6,0,237,1549515600,1564718400,6
Ragreff,0,6,0,47,1574744400,1588046400,6
pap_smear420,0,6,0,12,1611982800,1612328400,6
xanosaucy,2,4,731,14,1579928400,1582261200,6
zenneutral,0,6,0,46,1552622400,1553140800,6
buttersmashcomic,0,6,0,234,1559707200,1559707200,6
Shweezy,0,6,0,280,1586404800,1586664000,6
geekchicshipper,0,6,0,270,1584936000,1586836800,6
Zeptun,1,5,301,50,1598155200,1607835600,6
crazyladybutterfly2,0,6,0,27,1540958400,1598846400,6
Anarchicpigeon1978,0,6,0,8,1568952000,1568952000,6
Super_Badd,0,6,0,38,1590033600,1600833600,6
Spazzly0ne,0,6,0,92,1605934800,1609218000,6
Grimey_Rick,0,6,0,28,1604030400,1608526800,6
Savings-Disaster253,0,6,0,-59,1605330000,1605934800,6
Oblivious_Otter_I,0,6,0,135,1606453200,1608354000,6
shiwati,6,0,536,0,1572667200,1595304000,6
vegiraghav,0,6,0,17,1560398400,1604116800,6
Delkomatic,0,6,0,31,1599969600,1602129600,6
iwritefakereviews,0,6,0,20,1595217600,1599019200,6
doomfree2020,1,5,15,-8,1586664000,1593403200,6
rbdk01,6,0,7991,0,1593662400,1607490000,6
blargnblah,1,5,6,12,1603512000,1608267600,6
rotten_vegetable,2,4,250,14,1593576000,1601611200,6
uwotm8_8,0,6,0,183,1595736000,1599883200,6
gofunkyourself69,0,6,0,168,1586404800,1591502400,6
SovelissSunstar,0,6,0,-17,1561521600,1561521600,6
whydoIwearheadphones,0,6,0,46,1561867200,1564372800,6
WiseWinterWolf,0,6,0,420,1597636800,1605934800,6
xyl0ph0ne,0,6,0,75,1576386000,1585022400,6
tiddeltiddel,0,6,0,29,1552363200,1595649600,6
mannenavstaal,0,6,0,13,1588651200,1589428800,6
HaHa_Hyena,1,5,14,18,1594440000,1595390400,6
thislookspromising,1,5,7160,10,1592798400,1608526800,6
Konkoly,0,6,0,207,1548565200,1548738000,6
watchmaking,0,6,0,369,1603425600,1606107600,6
AntiquePurchase,0,6,0,14,1590206400,1591070400,6
dudu_rocks,1,5,300,24,1602561600,1604030400,6
BC_Engineer,0,6,0,10,1599796800,1599883200,6
LoversAlibis,1,5,63,20,1579064400,1579410000,6
Staghound_,0,6,0,50,1594872000,1605502800,6
like_forrealtho,0,6,0,7,1572235200,1572321600,6
echoseashell,0,6,0,28,1561348800,1593835200,6
bungleprongs,0,6,0,21,1574485200,1594699200,6
j5oh,0,6,0,25,1603944000,1609995600,6
tsibutsibu,0,6,0,39,1555473600,1595476800,6
DoctorDeeeerp,0,6,0,222,1599364800,1604552400,6
Cheechster4,0,6,0,54,1546405200,1582693200,6
melonsle,0,6,0,17,1563336000,1564545600,6
vandarkholmepizza,0,6,0,52,1565409600,1567310400,6
BananaInPyjama11,0,6,0,43,1602388800,1607403600,6
LauerPowerErin,0,6,0,34,1574485200,1574485200,6
untitled-man,0,6,0,8,1606798800,1609304400,6
ChapmansMassiveBalls,0,6,0,-16,1608094800,1608094800,6
nowItinwhistle,0,6,0,28,1605243600,1608699600,6
DotHackSigh,0,6,0,20,1606107600,1606798800,6
Thatsnowconeguy,0,6,0,27,1537934400,1552021200,6
SideHug,0,6,0,7,1603512000,1603512000,6
icy_moods,2,4,22,5,1605589200,1608613200,6
gatita111,0,6,0,22,1583726400,1585972800,6
I_Think_Naught,0,6,0,25,1608094800,1609304400,6
LaxeonXIII,0,6,0,94,1587182400,1589688000,6
RaPiiD38,0,6,0,37,1572930000,1599192000,6
DragonSlaayer,0,6,0,48,1588132800,1607230800,6
mglw_nafh,0,6,0,-104,1592971200,1609218000,6
Gman7834,0,6,0,11,1573534800,1578891600,6
2012amica,3,3,344,4,1608699600,1608872400,6
GonadGravy,0,6,0,-124,1611896400,1611982800,6
ferretplush,0,6,0,22,1607922000,1607922000,6
chopinslabyrinth,0,6,0,148,1579928400,1595131200,6
bluerazballs,0,6,0,42,1589688000,1589774400,6
IRAwow,0,6,0,431,1573189200,1597636800,6
SourCreamInTheSauna,0,6,0,46,1562990400,1565582400,6
Inconvenient1Truth,0,6,0,47,1572494400,1608786000,6
Gougeded,0,6,0,197,1604030400,1607749200,6
NegativeReward,0,6,0,81,1588305600,1603512000,6
beetlec0och,2,4,1680,30,1567396800,1574398800,6
TofuTank,1,5,50,41,1580792400,1601438400,6
WinterSkyWolf,1,5,10,20,1563768000,1570161600,6
maneki_neko89,0,6,0,171,1607144400,1608699600,6
taylorttc2020,0,6,0,146,1606366800,1608181200,6
emotional-turtle-,0,6,0,207,1602993600,1607058000,6
bthtm,0,6,0,24,1575954000,1575954000,6
alkahinadihya,0,6,0,56,1605330000,1605330000,6
littledream95,1,5,19,20,1572235200,1579237200,6
thumbneck,0,6,0,12,1591243200,1591243200,6
Hythy,0,6,0,64,1572580800,1580965200,6
rofio01,0,6,0,-20,1601870400,1605934800,6
BeerofDiscord,0,6,0,156,1600228800,1609390800,6
CheeseDaver,0,6,0,60,1571976000,1593835200,6
zando95,0,6,0,23,1568865600,1573794000,6
SadAndFree,2,4,113,38,1559188800,1574658000,6
TheOnlyOmlet,0,6,0,35,1573534800,1587096000,6
KhonMan,0,6,0,-2,1606626000,1606626000,6
TagMeAJerk,0,6,0,168,1601524800,1611896400,6
K20BB5,0,6,0,-49,1567569600,1567656000,6
left1ag,1,5,15,96,1602043200,1611896400,6
prisonerwithoutwalls,0,6,0,14,1605157200,1605589200,6
wimmisky,0,6,0,41,1569988800,1569988800,6
GardeningIndoors,0,6,0,0,1577336400,1577422800,6
Birchfly477788,0,6,0,78,1573189200,1581483600,6
slingerg,0,6,0,-6,1608008400,1608267600,6
almostyelloww,2,4,269,11,1594440000,1597636800,6
capitannn,0,6,0,29,1579582800,1594094400,6
Imperial_Lieutenant9,1,5,50,138,1557288000,1601179200,6
TheTrueQuarian,0,6,0,241,1598673600,1606539600,6
Dont____Panic,0,6,0,4,1601179200,1602043200,6
migratoryslashfan,0,6,0,101,1592625600,1602129600,6
jwhit051490,0,6,0,94,1604898000,1609045200,6
amy-kath-leen,1,5,41,38,1580274000,1580446800,6
fingers,1,5,9,65,1594353600,1606453200,6
Adept-Matter,0,6,0,-5,1590379200,1590379200,6
Jakov_Brebovitsh,0,6,0,29,1601956800,1602129600,6
Admin-12,0,6,0,23,1538712000,1584331200,6
M16-andPregnant,0,6,0,-5,1593403200,1596859200,6
OtherwiseArrival,0,6,0,-4,1606539600,1606885200,6
Kingern,0,6,0,-10,1584763200,1585195200,6
PieFlinger,0,6,0,22,1605416400,1608267600,6
theboymehoy,0,6,0,-81,1604725200,1605502800,6
EmbarrassedCourage11,1,5,187,78,1608958800,1608958800,6
Rozay777,0,6,0,26,1578718800,1584417600,6
mouthybgood90,0,6,0,92,1549170000,1555560000,6
T0xicati0N,0,6,0,79,1584331200,1596168000,6
Ralanost,0,6,0,53,1603512000,1609304400,6
lesshatemorenature,1,5,7,5,1592366400,1592366400,6
thesosig,0,6,0,22,1603684800,1608613200,6
maisiedaise,0,6,0,28,1547010000,1549515600,6
bunnyFYG,5,1,783,65,1573448400,1594440000,6
hairyholepatrol,0,6,0,12,1555387200,1569988800,6
dogboobes,0,6,0,25,1578718800,1604466000,6
jacobburrell,0,6,0,-41,1588564800,1588651200,6
wntrsux,1,5,28,387,1591243200,1602820800,6
Mockingbird893,0,6,0,9,1593835200,1594353600,6
6soul,1,5,111,42,1582606800,1582606800,6
distractiontilldeath,0,6,0,62,1555387200,1604811600,6
allycat101688,0,6,0,13,1567224000,1568001600,6
Background_Location,1,5,17,14,1582261200,1582261200,6
zackkitzmiller,0,6,0,-5,1580274000,1580533200,6
CecondPercon,0,6,0,33,1582088400,1609304400,6
Adria-X,1,5,7,109,1563163200,1601352000,6
Thimble00,1,5,4,8,1607922000,1608354000,6
katiecandy420,0,5,0,39,1559275200,1589169600,5
ltminderbinder,0,5,0,38,1562126400,1602820800,5
bobnvagenes,0,5,0,19,1580446800,1583899200,5
Puzzleheaded_Stress7,1,4,19,50,1600747200,1601006400,5
Licentiousalsatian,0,5,0,7,1571025600,1604552400,5
TheRedBaron11,0,5,0,-3,1602648000,1602734400,5
yearof39,0,5,0,97,1566705600,1603512000,5
pinacoelho,0,5,0,55,1571025600,1573275600,5
BeautyThornton,1,4,224,30,1574744400,1604116800,5
Sobber23,3,2,64,14,1563508800,1607922000,5
DenimX25,0,5,0,17,1588219200,1602820800,5
XFX_Samsung,0,5,0,54,1580706000,1607403600,5
polarbear_77,0,5,0,27,1561435200,1567656000,5
varikonniemi,0,5,0,6,1568952000,1599278400,5
ShenmeNamaeSollich,0,5,0,5,1593576000,1593662400,5
themadstork921,0,5,0,29,1552536000,1572148800,5
dunctanker,0,5,0,46,1588824000,1592107200,5
Nokiddingxxxxxxzzz,0,5,0,91,1548392400,1551330000,5
PhantomGamers,0,5,0,136,1597204800,1611896400,5
Zoinks_like_FUCK,0,5,0,8,1603425600,1603598400,5
whatifuckingmean,1,4,3,17,1541394000,1571025600,5
ObscurityMaster,1,4,25,144,1604984400,1608872400,5
sullender123,2,3,63,15,1576904400,1592280000,5
TNHBrah,2,3,74,5,1591934400,1601870400,5
DefSaiko,1,4,83,40,1593748800,1605762000,5
alex3omg,0,5,0,232,1575176400,1575349200,5
CactusBiszh2019,0,5,0,-22,1598414400,1598414400,5
cavainmarch,2,3,52,7,1562299200,1563681600,5
OrangelightningZING,0,5,0,1292,1593662400,1608958800,5
johnboiii1933,0,5,0,25,1572753600,1600747200,5
yooshnc,0,5,0,9,1607317200,1607317200,5
moose51789,0,5,0,2,1603512000,1603598400,5
Elonine,0,5,0,20,1582952400,1609304400,5
SrGrimey,0,5,0,14,1596772800,1608872400,5
Cheers_Owen_Kellogg,0,5,0,-1,1601611200,1606021200,5
SwagPatel,0,5,0,0,1607576400,1608613200,5
Thefriendlypsycho,2,3,138,44,1569384000,1570680000,5
some_kind_of_bird,0,5,0,39,1591329600,1598414400,5
warriorct726,0,5,0,1,1612069200,1612069200,5
Mertda1,0,5,0,6,1560398400,1561694400,5
nastypanass,0,5,0,23,1590379200,1608699600,5
ughtheinternet,0,5,0,74,1563854400,1598241600,5
ScaredSweet8,1,4,25,8,1599105600,1608354000,5
gamblingprocter,4,1,163,4,1575954000,1594612800,5
pitchforkseller,0,5,0,7,1544590800,1548133200,5
fairywakes,0,5,0,12,1607403600,1607403600,5
pastadedientes,0,5,0,8,1608872400,1609477200,5
koala_munch,0,5,0,43,1546578000,1551416400,5
Ok_Translator5654,1,4,6,11,1593489600,1594440000,5
Tawdry_Audrey,0,5,0,33,1592366400,1595649600,5
Willtrixer,0,5,0,28,1601179200,1606453200,5
Theremin_Dee,0,5,0,12,1603771200,1603944000,5
MalcolmXmas,0,5,0,35,1604293200,1609390800,5
nwordcountbot,0,5,0,13,1559448000,1585713600,5
Adventurous-Reading9,0,5,0,264,1602820800,1603425600,5
kjcraft,0,5,0,4,1608699600,1608786000,5
Disco_Pope,0,5,0,115,1568260800,1574917200,5
A_Gif_Horse,0,5,0,-47,1594872000,1594958400,5
pentakiller19,0,5,0,127,1582866000,1609131600,5
emptythecages,0,5,0,41,1535515200,1601611200,5
Glorious_Eenee,0,5,0,13,1594267200,1607317200,5
Teabagger_Vance,0,5,0,5,1608267600,1608267600,5
Literally_A_Shill,0,5,0,9,1560657600,1560657600,5
thePuck,0,5,0,31,1596600000,1601611200,5
Connecticut06482,0,5,0,54,1579410000,1579582800,5
markmywords1347,0,5,0,8,1587614400,1588996800,5
BudChilton,0,5,0,19,1574398800,1584763200,5
hoopajuba,0,5,0,18,1598587200,1601352000,5
jeanlucpicardtricks,0,5,0,17,1561262400,1591934400,5
1ron_Hungry,0,5,0,2,1607058000,1607576400,5
jon-hill,0,5,0,14,1569384000,1575435600,5
novadelfuego,0,5,0,46,1581051600,1598673600,5
TheWheatSeeker,1,4,18,10,1596772800,1596859200,5
Jakobus_,0,5,0,29,1574139600,1598760000,5
clocksgoback,0,5,0,106,1566532800,1608872400,5
TigerChirp,0,5,0,9,1577422800,1577854800,5
ITEM01,0,5,0,-19,1602216000,1602216000,5
KittenIgnition,0,5,0,-35,1606971600,1607058000,5
cantunderstandlol,0,5,0,100,1564372800,1581915600,5
RecQuery,0,5,0,50,1554004800,1564977600,5
SongofNimrodel,0,5,0,19,1591502400,1591588800,5
Chad-FromHR,0,5,0,2,1583384400,1588824000,5
Linubidix,0,5,0,34,1598846400,1600574400,5
HighMacGuy,5,0,1014,0,1561780800,1578978000,5
neo87br,0,5,0,31,1561694400,1602043200,5
LordBalkoth69,0,5,0,35,1589774400,1604379600,5
Realworld,0,5,0,-25,1582520400,1584331200,5
andthisisthewell,0,5,0,7,1596427200,1597377600,5
HighBudgetPorn,0,5,0,-136,1570939200,1573016400,5
invario,1,4,14,40,1556596800,1578718800,5
EpicLapras,0,5,0,-6,1589083200,1589515200,5
WikiTextBot,0,5,0,10,1499140800,1539921600,5
gbrem97,0,5,0,5,1595736000,1599537600,5
positive_pizza20,0,5,0,135,1592798400,1598068800,5
Meto1183,0,5,0,100,1579755600,1598414400,5
GraphikSF,0,5,0,87,1595822400,1605848400,5
Archangel1313,0,5,0,1,1604379600,1608354000,5
jarsofsalt,0,5,0,23,1578891600,1600574400,5
emolhc,1,4,16,19,1607576400,1607576400,5
trailtruck,0,5,0,8,1602561600,1605243600,5
ALTITUDE10K,0,5,0,-124,1580619600,1602302400,5
PM_ME_SEXY_MONSTERS,0,5,0,27,1590465600,1593316800,5
Odd_Unit1806,0,5,0,64,1609218000,1609390800,5
Scriabi,1,4,38,28,1592366400,1602475200,5
somethingforusall,1,4,35,20,1584244800,1586664000,5
Shark549,1,4,458,55,1572494400,1572494400,5
C0PEcel,0,5,0,32,1600833600,1606712400,5
BodyBagMan,2,3,53,22,1604984400,1609390800,5
Courtaud,0,5,0,52,1584763200,1584849600,5
eatgood99,0,5,0,9,1555214400,1557979200,5
LesovikkDroa,0,5,0,14,1608094800,1608181200,5
positivevitisop1,0,5,0,1,1608267600,1608354000,5
koopdi,0,5,0,36,1603080000,1606021200,5
jeffreywinks,1,4,53,21,1573102800,1579150800,5
thisusernameismeta,0,5,0,72,1585713600,1587960000,5
joevilla1369,1,4,35,5,1575176400,1592884800,5
officialkodos,3,2,703,5,1569988800,1573966800,5
3cc3ntr1c1ty,0,5,0,28,1579064400,1594699200,5
astradexa,0,5,0,10,1581051600,1581051600,5
littlebego,0,5,0,282,1601870400,1609390800,5
wild_vegan,0,5,0,14,1578200400,1580101200,5
leer_zeichen,2,3,205,10,1554264000,1554696000,5
Trumpy_bear,0,5,0,419,1579582800,1605848400,5
Popcorn_vent,0,5,0,12,1602129600,1602302400,5
amurderofcrows,0,5,0,679,1602043200,1605243600,5
SeasonActual,0,5,0,62,1605589200,1605589200,5
masonmason22,0,5,0,140,1564632000,1600142400,5
RoastedBlueBerries,0,5,0,7,1612069200,1612155600,5
_dreamawake_,4,1,109,6,1589515200,1603252800,5
comradebrad6,1,4,29,35,1565668800,1574139600,5
Gobilapras,0,5,0,173,1567828800,1597982400,5
roarde,0,5,0,28,1541304000,1548910800,5
I_am_Moby_Dick_AMA,0,5,0,100,1606453200,1607317200,5
BigBallaBamma,0,5,0,-63,1586750400,1586836800,5
chrisk722,2,3,90,14,1569038400,1580187600,5
deathinmypocket,0,5,0,7,1607058000,1609045200,5
d_v_c,1,4,217,43,1604984400,1605070800,5
yugoslaviancumstains,0,5,0,82,1551589200,1562472000,5
timakro88,0,5,0,144,1596081600,1600833600,5
eyupjudd,0,5,0,47,1587182400,1587960000,5
Brambleshire,0,5,0,13,1453698000,1468209600,5
Sarcastic_Troll,0,5,0,41,1608181200,1608181200,5
hero-of-kvatch44,0,5,0,56,1587096000,1602648000,5
Potatoinajacket26,0,5,0,88,1604203200,1608958800,5
dragonair64,0,5,0,26,1583557200,1602907200,5
boomerkid19,0,5,0,-152,1559016000,1580101200,5
PhoenixAtDawn,0,5,0,23,1549170000,1573102800,5
WorkAcc0unt,1,4,6,11,1570507200,1570593600,5
Prudent-Composer4759,0,5,0,6,1606626000,1607662800,5
viceresearcher,0,5,0,40,1600574400,1606885200,5
mvucic01,0,5,0,7,1594958400,1605502800,5
Jay111502,0,5,0,5,1584763200,1596772800,5
Supersamtheredditman,0,5,0,6,1597118400,1597118400,5
sonoradust,0,5,0,12,1593230400,1594267200,5
JoffSides,0,5,0,25,1548478800,1585281600,5
needlesandpigeons,1,4,37,15,1593489600,1605675600,5
Huntynator,0,5,0,60,1600142400,1607317200,5
Nowarclasswar,1,4,4,20,1607144400,1609304400,5
VeganGrains,1,4,31,19,1561176000,1561348800,5
lafleurcynique,0,5,0,52,1574398800,1576472400,5
johnngnky,0,5,0,7,1600920000,1608872400,5
taeerom,0,5,0,47,1572843600,1597896000,5
D3LB0Y,0,5,0,26,1575435600,1607490000,5
petrichormemory,0,5,0,22,1590724800,1611982800,5
luksi2,0,5,0,7,1595131200,1603684800,5
Pastill,0,5,0,-5,1575349200,1583557200,5
smokingmittens,0,5,0,8,1603512000,1603512000,5
EmRaff7,0,5,0,24,1580101200,1591329600,5
milkslutthroaway,0,5,0,69,1599019200,1599019200,5
MjrPowell,0,5,0,196,1591502400,1609045200,5
florianfmmartin,0,5,0,22,1590984000,1603944000,5
Stonkinidiot,2,3,56,8,1582088400,1583125200,5
DrKillgore,0,5,0,18,1596600000,1598414400,5
opportunitea,0,5,0,98,1564545600,1608181200,5
Headcrabhunter,0,5,0,283,1583899200,1583899200,5
faraznomani,1,4,1525,94,1602129600,1602129600,5
DJMixerC,0,5,0,32,1582952400,1583038800,5
simon_C,0,5,0,40,1607835600,1611896400,5
helloandgooddaytoyou,3,2,301,2,1557028800,1563681600,5
Alexandria_Scott,0,5,0,16,1597118400,1600488000,5
palex00,0,5,0,57,1571889600,1577077200,5
PM_ME_TITS_OR_DOGS,1,4,482,71,1592193600,1604898000,5
tattdup394,0,5,0,20,1551589200,1558324800,5
WildStyleMethod,0,5,0,70,1608440400,1608786000,5
Russet_Wolf_13,0,5,0,24,1593835200,1609304400,5
QueefOnAYogaBall,1,4,143,72,1606885200,1606971600,5
Stacyscrazy21,0,5,0,8,1571630400,1581224400,5
Heckbegone,0,5,0,14,1580101200,1607835600,5
Deepthroat_Your_Tits,0,5,0,73,1555041600,1606885200,5
hobbesnothoppe,0,5,0,-40,1572235200,1572235200,5
poeticdisaster,0,5,0,47,1575435600,1578978000,5
therehere83,0,5,0,82,1558843200,1561003200,5
Delduath,0,5,0,18,1606539600,1606539600,5
eastwes1,1,4,92,12,1608354000,1611896400,5
ArmyMedicalCrab,0,5,0,698,1611723600,1611896400,5
lehmanmalli,0,5,0,23,1584244800,1584331200,5
donaldtrumpsbarber13,0,5,0,7,1588824000,1588824000,5
peacecarrot,0,5,0,11,1576299600,1611896400,5
gotTwisTd,0,5,0,125,1589947200,1591761600,5
Broner_,0,5,0,50,1563940800,1602216000,5
celestine001,0,5,0,35,1585800000,1588392000,5
MaximusGrassimus,1,4,51,32,1579410000,1600228800,5
svaimann,1,4,214,24,1597291200,1597291200,5
SheepDogGamin,0,5,0,0,1576645200,1606021200,5
princessuuke,0,5,0,64,1594440000,1600142400,5
FumbleHuck,2,3,31,6,1605330000,1609045200,5
DataPhreak,0,5,0,22,1554782400,1554782400,5
CasinoOasis2,0,5,0,55,1608267600,1609304400,5
questguest444,1,4,60,22,1599451200,1602475200,5
dhole25,0,5,0,40,1588824000,1600401600,5
SeparatePicture,0,5,0,9,1587614400,1588219200,5
seacucumber17,0,5,0,34,1612155600,1612242000,5
relaxygalaxy,0,5,0,75,1575435600,1605243600,5
ogbobbyj33,0,5,0,4,1585454400,1587528000,5
lukesvader,0,5,0,13,1585108800,1606539600,5
IQuoteShowsAlot,0,5,0,9,1548046800,1604898000,5
Wrathful_Buddha,0,5,0,67,1599278400,1600488000,5
killerb2642,0,5,0,36,1592884800,1603425600,5
Orjen8,0,5,0,32,1538625600,1557633600,5
tryingtosellmyguitar,1,4,40,33,1599278400,1605416400,5
solire,0,5,0,33,1587700800,1606107600,5
lessie1998,1,4,56,18,1600660800,1600660800,5
EpicDash,0,5,0,26,1568088000,1589169600,5
p_thursty,0,5,0,-7,1608440400,1609304400,5
bananasinpjs13,0,5,0,18,1565582400,1579928400,5
xyon21,0,5,0,28,1599019200,1607576400,5
Distinct_Training_70,1,4,37,24,1608526800,1608526800,5
ItsDjBurstHomie,0,5,0,34,1602129600,1603080000,5
AngryMustacheSeals,0,5,0,67,1582002000,1597809600,5
RagingBull7667,0,5,0,159,1604898000,1604984400,5
allyfiorido,2,3,46,38,1597550400,1598846400,5
elko123,0,5,0,88,1582952400,1587009600,5
janet-snake-hole,0,5,0,33,1572235200,1602388800,5
CapriSunBajaBlastoff,0,5,0,45,1586232000,1586232000,5
Tasty67,0,5,0,-10,1603512000,1603598400,5
Crismus,0,5,0,89,1608613200,1608699600,5
NEETwithAchainsaw,0,5,0,73,1560398400,1577682000,5
TOTINOS_BOY,0,5,0,12,1596081600,1596686400,5
Thehighgroundgang,0,5,0,1,1606539600,1606626000,5
de__profundis,1,4,10,8,1592020800,1592020800,5
Strange_Vagrant,0,5,0,17,1602907200,1607317200,5
PM_BREASTS_TO_ME_,1,4,4,19,1589083200,1599278400,5
damnkidzgetoffmylawn,0,5,0,67,1575176400,1588564800,5
buffy122988,0,5,0,10,1594008000,1597377600,5
PosadismFTW,0,5,0,97,1573621200,1581051600,5
Irtexx,1,4,27,-12,1603252800,1603252800,5
getofftheisland,0,5,0,256,1603425600,1603598400,5
okdark,2,3,6,13,1592452800,1594440000,5
jokestoreranoutofyou,0,5,0,-18,1599192000,1599624000,5
Dylmatically,0,5,0,5,1608094800,1608958800,5
pizza_for_nunchucks,0,5,0,104,1600488000,1609304400,5
IAMAHobbitAMA,0,5,0,99,1590379200,1607835600,5
Smile_lifeisgood,0,5,0,60,1547528400,1564459200,5
Crezelle,0,5,0,14,1572930000,1608354000,5
Dannypeck96,0,5,0,18,1582866000,1593662400,5
bgarza18,0,5,0,14,1569124800,1569124800,5
lemonpjb,0,5,0,148,1561348800,1605502800,5
kisswithaspell,1,4,138,107,1563854400,1582174800,5
DaScamp,1,4,56,35,1587441600,1606798800,5
SleezyD944,0,5,0,-18,1586145600,1586318400,5
TheBaconSpaceman,0,5,0,13,1605589200,1609218000,5
fox_ontherun,0,5,0,22,1556251200,1571457600,5
MayUrShitsHavAntlers,1,4,39,34,1604116800,1611982800,5
LittleMissThrowaway_,1,4,6,1,1598760000,1598846400,5
Potter_bop,0,5,0,19,1587441600,1587441600,5
TheWhoooreinThere,0,5,0,14,1587787200,1598673600,5
skb239,0,5,0,14,1605157200,1607662800,5
Verrence,0,5,0,-134,1585454400,1585454400,5
Avery-Bradley,0,5,0,13,1596945600,1597377600,5
dandav95,0,5,0,27,1577163600,1595649600,5
saltinmyhead,0,5,0,188,1570075200,1572753600,5
missgauche,0,5,0,17,1575349200,1606539600,5
SingingBailey,0,5,0,5,1575694800,1575694800,5
straight2thadome,0,5,0,31,1595649600,1602302400,5
Senor_Martillo,0,5,0,6,1556856000,1606885200,5
miles197,0,5,0,8,1553140800,1555214400,5
lin_the_human,0,5,0,10,1556596800,1573102800,5
super_mustard,0,5,0,34,1577941200,1580533200,5
ChildFriendlyMemes,1,4,68,-24,1589774400,1597982400,5
W1ck3d574r,0,5,0,24,1584590400,1593230400,5
Abomb97,0,5,0,9,1591070400,1598846400,5
MobileTurdFactory,0,5,0,74,1589342400,1606971600,5
bfhurricane,0,5,0,-65,1589947200,1597550400,5
CEO__of__Antifa,0,5,0,218,1601524800,1605502800,5
trandy69,0,5,0,-4,1571112000,1601870400,5
Obe4knh,0,5,0,24,1580014800,1580014800,5
ImSatanByTheWay,0,5,0,50,1587268800,1612242000,5
SeemsImmaculate,0,5,0,123,1608958800,1608958800,5
Cb58logan,0,5,0,5,1557115200,1557115200,5
Ok_Physics_6846,0,5,0,22,1606194000,1606453200,5
vhexs,1,4,17,7,1598414400,1598760000,5
BrokenDoorbell,1,4,33,31,1593057600,1601179200,5
PacificNorthLeft,0,5,0,22,1604898000,1606885200,5
BidensLibyanSlave,0,5,0,15,1599019200,1599019200,5
KoolAidDrank,2,3,196,25,1596859200,1601352000,5
tassassi,0,5,0,5,1635307200,1635307200,5
zorbtrauts,0,5,0,17,1547269200,1569038400,5
professionalfriendd,0,5,0,5,1597896000,1601611200,5
GreatQuestion,0,5,0,16,1595908800,1595908800,5
Nomie-chan,0,5,0,25,1555646400,1581915600,5
livewrongandprosper,0,5,0,299,1605934800,1607490000,5
TheSamurabbi,0,5,0,149,1588392000,1608613200,5
NahImmaPass,0,5,0,9,1604898000,1606107600,5
Zombiepikmin,0,5,0,8,1579582800,1580446800,5
UNNAMEDdietbeverage,0,5,0,320,1582002000,1584676800,5
doctorfonk,2,3,16,7,1600142400,1604030400,5
TrimtabCatalyst,0,5,0,57,1567137600,1596340800,5
yasierisme,1,4,509,15,1586232000,1604898000,5
mango_alt,0,5,0,12,1595390400,1595390400,5
reclaimer95997,0,5,0,-34,1605848400,1605848400,5
txmail,0,5,0,-1,1589860800,1589860800,5
jakeryii,1,4,69,13,1582261200,1592280000,5
TheRedSpade,0,5,0,9,1593662400,1605243600,5
wutamisposedtodo,1,4,26,150,1541394000,1563336000,5
frankensteeeeen,0,5,0,18,1597464000,1606280400,5
90s_nihilist,1,4,53,40,1600660800,1606280400,5
FN-2814,0,5,0,77,1569124800,1602734400,5
nuloah,2,3,90,14,1605589200,1606971600,5
Gary_the_metrosexual,0,5,0,93,1584158400,1584158400,5
_xantho_,0,5,0,7,1602648000,1602648000,5
Existential_Stick,0,5,0,21,1600660800,1600747200,5
ClassyDingus,0,5,0,6,1606280400,1606366800,5
RanfurlyDraught,0,5,0,21,1606366800,1607576400,5
September75,0,5,0,78,1589688000,1608958800,5
Kitty_Femme,1,4,23,15,1598241600,1598328000,5
MajesticAssUnicorn,1,4,27,14,1563422400,1583557200,5
McDonaldsPrincess,1,4,298,6,1567569600,1568001600,5
saneworld,0,5,0,13,1607662800,1607662800,5
Commie_Vladimir,0,5,0,18,1567483200,1572580800,5
Out_Lines,0,5,0,23,1596859200,1600660800,5
bil3777,0,5,0,37,1555473600,1561780800,5
Matrix_related,0,5,0,31,1571716800,1571716800,5
jesusleftnipple,0,5,0,13,1602820800,1611896400,5
f0xf0x,0,5,0,10,1579496400,1586145600,5
IN8765353,1,4,45,13,1605589200,1605589200,5
ThreenGumb,0,5,0,39,1587096000,1600401600,5
gonesnake,0,5,0,18,1604898000,1605589200,5
of_the_Fox_Hill,0,5,0,9,1539921600,1557979200,5
Onewaytimemachine,1,4,328,18,1597291200,1597291200,5
danielcorich,1,4,9,401,1590638400,1592971200,5
SensualSunshine,0,5,0,10,1578978000,1580706000,5
badcaseofknife,1,4,83,68,1601352000,1605934800,5
Fionn_Mac_Cumhaill,0,5,0,56,1572408000,1573966800,5
FruscianteDebutante,0,5,0,4,1596945600,1600228800,5
OkContribution,0,5,0,42,1557288000,1571371200,5
multiplesifl,0,5,0,36,1560571200,1564027200,5
Foundinhumanform,1,4,9,8,1595304000,1595304000,5
turquoiserabbit,0,5,0,32,1603339200,1604293200,5
thisisallanqallan,0,5,0,24,1593576000,1594008000,5
Floor_Kicker,0,5,0,40,1605848400,1609045200,5
FredZeplin,0,5,0,127,1567915200,1595304000,5
wowitsverycool,0,5,0,5,1610514000,1610514000,5
Wchijafm,0,5,0,11,1606885200,1607317200,5
t6-angel,0,5,0,29,1586750400,1608008400,5
SmolPPGangg,0,5,0,44,1602734400,1604725200,5
seconddayout,0,5,0,38,1595563200,1608786000,5
mrm5117,4,1,191,1,1549256400,1571803200,5
ConcernedRobot,0,5,0,18,1599624000,1600401600,5
FeelinPrettyCentrist,2,3,1302,83,1565582400,1586923200,5
TomasDemjanic,0,5,0,85,1599278400,1605157200,5
GulliblePirate,0,5,0,15,1573707600,1589947200,5
conchobarus,0,5,0,33,1569297600,1575608400,5
TheRealYeastBeast,0,5,0,-10,1579323600,1590897600,5
megs167,0,5,0,33,1600228800,1608008400,5
JPShartre,0,5,0,37,1593835200,1607317200,5
lifeis______,0,5,0,85,1607490000,1608526800,5
Felons_For_Bloomberg,0,5,0,10,1588996800,1588996800,5
I_Love_BB8,0,5,0,526,1590033600,1596254400,5
PrescriptionDestiny,1,4,13,12,1605762000,1607922000,5
poop_dawg,0,5,0,21,1595304000,1595304000,5
lazy-but-talented,0,5,0,26,1601524800,1601524800,5
monsieur_bear,0,5,0,24,1599537600,1600228800,5
Shrocklover,0,5,0,8,1565841600,1576472400,5
jiminiminimini,0,5,0,153,1582866000,1605762000,5
D4ndem4n,0,5,0,-150,1573275600,1573362000,5
sirouhei,1,4,246,59,1595476800,1603771200,5
iSeven,0,5,0,46,1558411200,1587441600,5
NatashaStyles,0,5,0,24,1591416000,1591588800,5
elhiruko,2,3,91,3,1584763200,1585368000,5
ImPatientHD,0,5,0,-184,1605330000,1605330000,5
EarthtoKitty,1,4,804,48,1607576400,1608008400,5
MoJake23,1,4,25,-23,1608699600,1608699600,5
thebee03,0,5,0,0,1589688000,1589688000,5
albahari,0,5,0,26,1551589200,1595044800,5
nomorebuttsplz,0,5,0,4,1564372800,1582866000,5
SlimeDragon,0,5,0,42,1568347200,1600747200,5
OgMudbone2012,0,5,0,76,1583298000,1600142400,5
the_shaman,0,5,0,26,1595476800,1608699600,5
luckyhuckleberry,0,5,0,134,1564545600,1600228800,5
nouserisgooduser,0,5,0,44,1604030400,1605330000,5
keepingitsession,1,4,40,14,1608440400,1608440400,5
highpothes1s,0,5,0,38,1596513600,1603771200,5
Visible-Coach,0,5,0,43,1597723200,1608958800,5
billytheid,0,5,0,11,1578891600,1611982800,5
squancher1312,0,5,0,7,1600142400,1600142400,5
Carolingcarols334,1,4,23,7,1600833600,1601524800,5
NoFace710,0,5,0,-4,1584244800,1584244800,5
myguygetshigh,0,5,0,14,1571630400,1580014800,5
ZapatistaBrannigan,0,5,0,61,1562299200,1571889600,5
plan135,3,2,4082,3,1601092800,1608008400,5
liometopum,0,5,0,29,1588392000,1608440400,5
CHSummers,0,5,0,73,1574571600,1594353600,5
fourtwentayy,0,5,0,20,1573362000,1573534800,5
HondaSlavic,2,3,124,16,1583384400,1583470800,5
tarbet,0,5,0,37,1579323600,1608872400,5
RebornHellblade,0,5,0,32,1597550400,1608613200,5
GimmickyBulb,0,5,0,-25,1601611200,1601611200,5
Onionpepsi,0,5,0,352,1571284800,1572580800,5
Mugalli,0,5,0,46,1591070400,1598328000,5
howtoeatsnakecomics,3,2,7454,16,1599192000,1606712400,5
TheRowingManiac,0,5,0,117,1580965200,1595563200,5
Hard_Celery,1,4,74,51,1561348800,1592020800,5
apple-fritter-bitch,0,5,0,6,1586059200,1586145600,5
cissphopeful,0,5,0,6,1607576400,1609477200,5
aymswick,0,5,0,70,1589601600,1589688000,5
chrysavera,0,5,0,91,1597636800,1604293200,5
MayonaiseRemover,5,0,153,0,1574830800,1600574400,5
Damianiwins,0,5,0,-27,1567828800,1569038400,5
faustoc5,4,1,4900,88,1588478400,1604811600,5
phxclstramaryllis,0,5,0,28,1578459600,1608526800,5
Xyranthion,0,5,0,35,1569384000,1586491200,5
zeus113,0,5,0,87,1570939200,1573102800,5
clockwork-angel42,1,4,12,22,1608094800,1608181200,5
Spudzy_Mcgee,0,5,0,45,1569211200,1612760400,5
thedayiusedtomakea,0,5,0,23,1611810000,1612155600,5
DependentDocument3,0,5,0,28,1611896400,1611896400,5
Amaterasu127,0,5,0,32,1590379200,1608008400,5
Kuronis,0,5,0,8,1573362000,1592884800,5
yetanothermortal,3,2,736,6,1600315200,1602043200,5
SmudgeKatt,0,5,0,5,1589515200,1598500800,5
BoozeoisPig,0,5,0,11,1534737600,1560571200,5
ttigerccat9601,1,4,3,38,1563508800,1589860800,5
keeplayer109,0,5,0,14,1599796800,1601870400,5
SliceOfTony,1,4,17,66,1574485200,1607490000,5
Petsweaters,0,5,0,164,1585627200,1607576400,5
OptimalBarley,0,5,0,-79,1577163600,1580446800,5
Mintilicious8,0,5,0,42,1592193600,1606971600,5
sfinnqs,0,5,0,74,1594612800,1611810000,5
Scott1574,0,5,0,49,1605762000,1608181200,5
reinstall_gentoo,0,5,0,6,1589515200,1589947200,5
aCoochieMoya,0,5,0,7,1604203200,1604203200,5
orbweaver111,0,5,0,18,1588824000,1593835200,5
iAmDriipgodd,0,5,0,11,1607317200,1608699600,5
Ruleyoumind,0,5,0,18,1581483600,1581570000,5
BearLindsay,0,5,0,9,1605157200,1609218000,5
lobobricord,0,5,0,25,1549602000,1551934800,5
ramenmoodles,0,5,0,127,1602302400,1608440400,5
Gravy_Vampire,0,5,0,35,1579669200,1584072000,5
itsover5555,2,3,36,16,1583812800,1588910400,5
Ferguson97,1,4,4,13,1539921600,1540094400,5
NegotiationDapper552,0,5,0,11,1602734400,1604203200,5
WardOfLucifer,1,4,48,94,1573794000,1607058000,5
OmicronAlpharius,0,5,0,702,1577682000,1585195200,5
anishpatel131,0,5,0,2,1550293200,1550293200,5
SoohillSud,1,4,15,33,1606366800,1608008400,5
bdiebucnshqke,0,5,0,6,1603598400,1603598400,5
TylerDurdenJunior,0,5,0,20,1566964800,1597809600,5
Pdog47,0,5,0,28,1589428800,1609131600,5
wutwenwron,0,5,0,285,1591848000,1593835200,5
Cozyblu,0,5,0,-53,1590897600,1607317200,5
IfinallyhaveaReddit,0,5,0,6,1594353600,1594440000,5
Somebodysuckmeplz,0,5,0,88,1597896000,1598414400,5
yaboimayhem,1,4,183,77,1567656000,1567742400,5
sleppy123,0,5,0,86,1573448400,1575867600,5
pls_lobotomize_me,0,5,0,57,1601611200,1602475200,5
myjobthemesong,0,5,0,91,1605070800,1606194000,5
NameIdeas,0,5,0,11,1591243200,1608526800,5
dbDarrgen,0,5,0,66,1611896400,1612069200,5
somuchforthetolerant,0,5,0,96,1556769600,1557288000,5
weirdlaugh67,0,5,0,14,1604725200,1607835600,5
crazymessytheorist,0,5,0,33,1572753600,1573966800,5
Ce_n-est_pas_un_nom,0,5,0,12,1606626000,1606626000,5
lluuni,0,5,0,282,1581915600,1593230400,5
OSAMA_BEEN_LAFFIN,0,5,0,13,1562990400,1563508800,5
Compostable-Account,0,5,0,-52,1571112000,1571112000,5
Rauchgestein,0,5,0,17,1605157200,1608440400,5
DixieSaturdayNight,0,5,0,7,1593921600,1596168000,5
thejokeoverstander,0,5,0,14,1593835200,1608354000,5
WallStreetendies,0,5,0,-31,1591329600,1591502400,5
holyflabberpoo,0,5,0,21,1588651200,1593576000,5
nofoax,0,5,0,10,1572494400,1572580800,5
welldressedhippie,0,5,0,80,1597377600,1597982400,5
spudt,0,5,0,98,1564545600,1578459600,5
Simond876,0,5,0,35,1575608400,1575608400,5
RWZero,2,3,37,7,1594008000,1594872000,5
ElectroMagnetsYo,0,5,0,72,1579150800,1605934800,5
Habit_Western,0,5,0,-54,1605416400,1609390800,5
calschmidt,0,5,0,21,1595476800,1595563200,5
anarchistascention,0,5,0,101,1580101200,1582261200,5
nutellaisbacon,0,5,0,50,1595390400,1611810000,5
ilovedrugsahhhh,0,5,0,-4,1606366800,1606539600,5
R3D1AL,0,5,0,5,1550293200,1550293200,5
ceol_silver,0,5,0,319,1574571600,1581397200,5
mmafan1500,3,2,313,2,1595563200,1599883200,5
ErrNotFound404,0,5,0,-32,1606712400,1606712400,5
Gramer_Natze,0,5,0,20,1571112000,1584331200,5
DaCrafta,0,5,0,70,1563768000,1570680000,5
yuligan,3,2,93,3,1576299600,1586664000,5
thesundoesntrisehere,0,5,0,75,1597464000,1598241600,5
alamurda510,2,3,44,4,1611810000,1612242000,5
tymayo101,0,5,0,27,1598846400,1598846400,5
hedinc1,0,5,0,23,1601006400,1603771200,5
GerpySlurpy,0,5,0,47,1607749200,1609218000,5
AgigoldVolfpo,0,5,0,41,1606885200,1607058000,5
xMrBojangles,0,5,0,-22,1583899200,1583985600,5
theamazingsime,0,5,0,5,1564372800,1599019200,5
fedawi,0,5,0,42,1583298000,1583470800,5
the_kinseti,0,5,0,166,1603598400,1603598400,5
cassanovuh,1,4,73,29,1601179200,1607058000,5
Hole_Grain,0,5,0,19,1589860800,1590120000,5
wakaOH05,0,5,0,189,1572494400,1597982400,5
xTHEKILLINGJOKEx,0,5,0,10,1605934800,1605934800,5
needout,0,5,0,10,1608699600,1609045200,5
goodwithwurds,0,5,0,53,1547874000,1565323200,5
Alzanth,0,5,0,76,1599710400,1607835600,5
JSavageOne,0,5,0,11,1591329600,1594958400,5
pegasuspaladin,0,5,0,19,1597896000,1600056000,5
bananacanada,0,5,0,17,1543899600,1547269200,5
JCES,1,4,189,15,1570507200,1584072000,5
Andr0medes,0,5,0,79,1570420800,1603080000,5
moonheaux,2,3,46,3,1589256000,1590120000,5
Digrace,0,5,0,61,1570852800,1598846400,5
sNaKeY_b0i,1,4,132,17,1583985600,1589169600,5
kittyrollin,2,3,202,53,1598846400,1599364800,5
glockout40,0,5,0,-47,1576386000,1576386000,5
EmotionalPassenger1,0,5,0,24,1570075200,1579237200,5
broNSTY,0,5,0,62,1577336400,1609218000,5
PicaPica20,0,5,0,186,1605589200,1608872400,5
A_Washcloth,0,5,0,18,1608267600,1609822800,5
astray_black_cat,0,5,0,219,1597291200,1608699600,5
xxkillquickxx,0,5,0,-17,1595131200,1595217600,5
lancesteve,0,5,0,2,1601611200,1601611200,5
kahlzun,0,5,0,46,1596600000,1604984400,5
scienceisanart,0,5,0,23,1595304000,1603598400,5
Tron3462,1,4,21,8,1598068800,1598155200,5
conchopeterpumper,0,5,0,5,1604725200,1604898000,5
LordDavid_AQ3D,0,5,0,24,1604116800,1604293200,5
mralxndr,2,3,320,17,1575867600,1609131600,5
fluxty,0,5,0,-32,1575694800,1575781200,5
_HollandOats_,0,5,0,26,1579582800,1590465600,5
Concentrate_Future,0,5,0,16,1602820800,1604984400,5
brandonheat1,0,5,0,62,1606971600,1607576400,5
Notsosmartboi,0,5,0,16,1593489600,1599710400,5
InTheDarkDancing,0,5,0,48,1589428800,1594440000,5
p7355one,2,3,44,22,1553918400,1591761600,5
Throwaway99878k,0,5,0,-14,1611982800,1612155600,5
Tea_Bender,0,5,0,73,1608786000,1611810000,5
Flimsy_Panda,1,4,43,49,1583470800,1593748800,5
nihilistictablelamp,0,5,0,41,1587009600,1593403200,5
Nanukara,0,5,0,20,1582520400,1608354000,5
phs1706,0,5,0,23,1568260800,1573880400,5
MrManWithTheHandsand,0,5,0,50,1581051600,1608181200,5
rugarune,0,5,0,4,1590120000,1590120000,5
furrtaku_joe,0,5,0,22,1575954000,1578978000,5
killerqueen1010,0,5,0,41,1556251200,1577163600,5
xmetalheadx666x,0,5,0,91,1582606800,1607490000,5
Heavenlyemporor,0,5,0,7,1581742800,1581915600,5
iam_acat,0,5,0,7,1581829200,1582174800,5
Weazlebee,0,5,0,102,1553832000,1574139600,5
Dreyns,0,5,0,17,1595736000,1595908800,5
c_palaiologos,0,5,0,325,1552021200,1562212800,5
nighttrain_21,0,5,0,-62,1594612800,1601611200,5
GodThisTakesTime,0,5,0,47,1599192000,1605330000,5
idahocrab,0,5,0,39,1605157200,1605243600,5
DennisFraudman,0,5,0,83,1561521600,1609390800,5
notthatintomusic,0,5,0,-6,1593230400,1593230400,5
pennycenturie,1,4,355,5,1597896000,1597982400,5
Stooperz,0,5,0,4,1599019200,1599019200,5
younganchorage,0,5,0,26,1603425600,1605675600,5
DevilsFavDemon99,0,5,0,-33,1607922000,1609218000,5
theeverymandoctrine,0,5,0,29,1583643600,1583643600,5
matchanosugar,0,5,0,59,1608008400,1608699600,5
saucymcfoodlefist69,0,5,0,17,1599537600,1608958800,5
acousticentropy,0,5,0,58,1573362000,1575867600,5
kraftymiles,0,5,0,11,1589601600,1605589200,5
bogpudding,0,5,0,49,1578373200,1596600000,5
JPDG,0,5,0,14,1607058000,1607144400,5
miawallacesuglytwin,1,4,972,6,1569988800,1582347600,5
cheapbeers,0,5,0,43,1557288000,1606453200,5
Gucceymane,0,5,0,25,1575522000,1576731600,5
MandatoryMoose,0,5,0,13,1603512000,1606971600,5
CallMeAl_,0,5,0,37,1561694400,1562040000,5
WarpathChris,0,5,0,11,1601870400,1601956800,5
FaceRockerMD,0,5,0,1,1596513600,1596600000,5
DeliciousCombination,0,5,0,2,1603598400,1611982800,5
creepindacellar,0,5,0,70,1546750800,1611896400,5
stealth1ghost,0,5,0,74,1573448400,1583470800,5
LordofWithywoods,0,5,0,85,1600747200,1607403600,5
stillatthestart,0,5,0,43,1602302400,1606366800,5
stevethewatcher,0,5,0,1,1607576400,1607662800,5
4tt1cu5,0,5,0,26,1600920000,1601006400,5
domastsen,0,5,0,25,1571889600,1608526800,5
JFISHER7789,0,5,0,31,1608958800,1608958800,5
PeopleoftheInternet,0,5,0,39,1453179600,1576990800,5
uncledaveslastbender,0,5,0,21,1607835600,1607835600,5
parols,1,4,36,38,1570507200,1603771200,5
fenix-the-cat,2,3,10094,29,1604725200,1608094800,5
Sallysallysourcream,0,5,0,6,1562731200,1585454400,5
Althair,0,5,0,52,1579410000,1601611200,5
__Not__the__NSA__,1,4,350,131,1575262800,1596686400,5
uncommoncommoner,0,5,0,19,1570766400,1609218000,5
Montius_Maximus,0,5,0,78,1549515600,1574312400,5
TheDrugGod,0,5,0,33,1599364800,1606539600,5
S_K_I,0,5,0,62,1535428800,1584158400,5
eyelikesharx,0,5,0,16,1567828800,1599451200,5
reduced_to_a_signal,0,5,0,10,1571630400,1585713600,5
stripedboat,0,5,0,30,1559275200,1559620800,5
CactusPearl21,0,5,0,-48,1605589200,1605589200,5
jasminehead,0,5,0,50,1567828800,1570248000,5
ffyzz,0,5,0,-3,1605589200,1609563600,5
BizWax,0,5,0,118,1600401600,1612155600,5
ResidentDarkness,0,5,0,6,1573534800,1574312400,5
ShadowHeart063,0,5,0,39,1563854400,1587614400,5
mildmanneredqt,0,5,0,5,1596772800,1596859200,5
IwishIwasaPainter,0,5,0,213,1577509200,1579237200,5
KnockOnDoorItsMeGoku,0,5,0,0,1571284800,1571976000,5
rowdy2026,0,5,0,20,1597723200,1597723200,5
montanonic,0,5,0,43,1584331200,1591502400,5
pureshred,0,5,0,37,1599019200,1600056000,5
smileymcgeeman,0,5,0,6,1608094800,1608094800,5
ThrowawayA66count,1,4,25,12,1604030400,1612069200,5
MadamMeouff,0,5,0,5,1603080000,1603512000,5
nonuniqueusername,0,5,0,7,1568347200,1568606400,5
irinablabla,0,5,0,27,1575608400,1576731600,5
iamsheena,0,5,0,78,1599278400,1607749200,5
Taco_Bela_Lugosi,0,5,0,9,1606971600,1606971600,5
Medicvted,0,5,0,7,1585627200,1586145600,5
voiceofonecrying,3,2,11,28,1599796800,1606885200,5
chupacabra_farm,0,5,0,132,1598673600,1604811600,5
nerdyboy321123,0,5,0,223,1592798400,1608786000,5
niftyfisty,0,5,0,14,1605762000,1605934800,5
myreal_nameis,0,5,0,6,1598241600,1605848400,5
Endivine,0,5,0,8,1595563200,1598328000,5
PunjabiPakistani_,0,5,0,-35,1599019200,1608613200,5
zabnjarka,0,5,0,14,1600747200,1608008400,5
phoenixsuperman,0,5,0,18,1591243200,1591243200,5
fidguru,0,5,0,67,1550034000,1551243600,5
NachzehrerL,0,5,0,67,1580014800,1609477200,5
shit-i-love-drugs,0,5,0,37,1552363200,1576904400,5
WitSpittle,0,5,0,10,1606712400,1606885200,5
itsdangeroustakethis,0,5,0,67,1558670400,1575522000,5
Zachmorris4187,1,4,16,46,1567569600,1606021200,5
Reversephoenix77,0,5,0,225,1606712400,1606712400,5
hlodynn_,0,5,0,41,1563940800,1571284800,5
mary999999999,2,3,87,9,1587960000,1589342400,5
happyfinesad,0,5,0,93,1576558800,1600574400,5
fuckyou4206999,1,4,1278,69,1598846400,1607230800,5
deypijp,0,5,0,23,1582779600,1584244800,5
OxBakersTriumph,0,5,0,88,1584676800,1605416400,5
alottasunyatta,0,5,0,10,1605589200,1605589200,5
gnarlyknits,0,5,0,23,1589860800,1589860800,5
professional__idiot3,1,4,187,21,1600747200,1600833600,5
Nesyaj0,0,5,0,55,1591675200,1594526400,5
JJ_The_Diplomat,0,5,0,15,1578027600,1606798800,5
Frockington1,0,5,0,-5,1597636800,1597636800,5
Sp33d0J03,1,4,17,20,1566273600,1601524800,5
dcabines,0,5,0,49,1598328000,1599105600,5
_SuperChefBobbyFlay_,0,5,0,-13,1608181200,1608181200,5
elstoni19,5,0,5,0,1564459200,1568260800,5
LongTermRecovery,1,4,9,43,1576558800,1577941200,5
ParagraphKiller,0,5,0,57,1574139600,1603598400,5
suitable_host,1,4,7,10,1590379200,1605157200,5
psycho__logical,0,5,0,94,1581483600,1600488000,5
Boezo0017,0,5,0,-60,1577509200,1577509200,5
NOWAYXPRESS,0,5,0,43,1576990800,1583125200,5
ReproCompter,1,4,1880,62,1571889600,1571889600,5
RJWier,0,5,0,4,1574312400,1574312400,5
cxazo,2,3,2343,77,1575954000,1602129600,5
Asalth,0,5,0,40,1575954000,1595044800,5
AlertDingo,0,5,0,17,1580101200,1581915600,5
RIPConstantinople,0,5,0,18,1591416000,1603425600,5
funatical,0,5,0,116,1589860800,1607490000,5
sylphyyyy,0,5,0,23,1603512000,1609304400,5
rexulpan,0,5,0,10,1606971600,1612069200,5
seductivestoat,0,5,0,-13,1591243200,1594180800,5
ElonWillSaveUs,0,5,0,49,1564632000,1599364800,5
eshafe85,2,3,254,44,1566532800,1581656400,5
acciowaves,0,5,0,12,1599883200,1608094800,5
Diabegi,0,5,0,107,1570939200,1572494400,5
DaveJaVous,0,5,0,34,1597896000,1605934800,5
uniqueusername4221,0,5,0,24,1569384000,1569470400,5
Tiolao,0,5,0,30,1579064400,1594872000,5
alphazulu8794,0,5,0,-27,1572408000,1572408000,5
Maiqdaliar,0,5,0,10,1585022400,1585108800,5
echocrest,0,5,0,292,1576645200,1577250000,5
HardlyLovelace,0,5,0,69,1582693200,1601524800,5
ore81440,0,5,0,27,1576645200,1594440000,5
SoFetchBetch,0,5,0,13,1576645200,1611982800,5
Educational-Cake7350,0,5,0,16,1612155600,1612155600,5
weedarbie,1,4,11,8,1589947200,1590120000,5
cyanrobin,0,5,0,233,1549774800,1589688000,5
Scottie3Hottie,0,5,0,6,1589947200,1606366800,5
jamesluke1,1,4,7,5,1589688000,1589860800,5
forevereverforeverev,0,5,0,92,1567656000,1597550400,5
OttoAnarchist,0,5,0,67,1562126400,1582520400,5
roopqa,1,4,60,11,1606626000,1606712400,5
WhichWayzUp,0,5,0,21,1561089600,1561089600,5
transdysphoriablues,0,5,0,59,1602820800,1609045200,5
freistil90,0,5,0,7,1572494400,1572494400,5
ComplainyBeard,1,4,14,199,1590638400,1609477200,5
ollowollo,0,5,0,10,1576126800,1602216000,5
nomnombacon,0,5,0,34,1542258000,1543640400,5
HumansWhoDoDrugs,0,5,0,332,1598068800,1598932800,5
dukke0bi,0,5,0,85,1576040400,1576040400,5
Organic-Plantain-645,1,4,22,14,1603425600,1603425600,5
Graknorke,0,5,0,119,1576731600,1594699200,5
NeedsToShutUp,0,5,0,8,1606539600,1609045200,5
Indecisive_action,0,5,0,51,1578459600,1584417600,5
inpleted,0,5,0,38,1564372800,1579928400,5
fartznuggetz,0,5,0,6,1608958800,1608958800,5
CollapseKult,1,4,90,59,1592366400,1599105600,5
20MenInAStreetBrawl,0,5,0,210,1600660800,1607749200,5
terrytapeworm,0,5,0,83,1609304400,1609390800,5
loose-leaf-paper,0,5,0,57,1593835200,1606626000,5
chickensoupbroth,1,4,33,25,1593835200,1609045200,5
CensorshipLover69,0,5,0,-32,1603598400,1608440400,5
Formaggio_svizzero,0,5,0,18,1560398400,1606626000,5
alfalfalaffa,1,4,37,45,1569297600,1601352000,5
6865636172,0,5,0,34,1594094400,1596168000,5
oyellow1,0,5,0,14,1578718800,1604293200,5
Hobagthatshitcray,0,5,0,19,1592798400,1609304400,5
__unavailable__,0,5,0,105,1568952000,1569816000,5
pointofyou,0,5,0,6,1589601600,1589688000,5
Anarchimiste,0,5,0,71,1576558800,1590206400,5
WIDMND305,0,5,0,159,1597032000,1597464000,5
EscapedSnafu,0,5,0,165,1578373200,1601352000,5
Phlebotanist,0,5,0,136,1606107600,1606107600,5
SnooMuffins3591,0,5,0,-2,1603425600,1603512000,5
TonyCarlin210,0,5,0,17,1573016400,1576731600,5
professor_fatass,0,5,0,61,1585454400,1588737600,5
brandonsredditrepo,0,5,0,-12,1563336000,1605070800,5
lukerose02,0,5,0,-16,1569211200,1569211200,5
itsjeremyiguess,0,5,0,-84,1568260800,1568260800,5
sexywheat,0,5,0,15,1578891600,1603684800,5
firstlastfirstlastla,0,5,0,4,1594872000,1596254400,5
Got-99-Problems,1,4,75,4,1593748800,1593835200,5
Fogwa,0,5,0,41,1546837200,1548824400,5
1003rp,0,5,0,69,1598068800,1604030400,5
corpdorp,0,5,0,60,1573275600,1605762000,5
Professor_Bunsen,0,5,0,17,1606885200,1606971600,5
lumimaa,0,5,0,11,1566360000,1566446400,5
K174,0,5,0,13,1576645200,1611810000,5
Sapiencia6,0,5,0,39,1576645200,1599796800,5
krazycarbo,3,2,626,7,1592625600,1594353600,5
doritolocochoco,0,5,0,42,1578459600,1578718800,5
_Oomph_,0,5,0,-10,1582261200,1582606800,5
Dr-Fredric-Bodhamn,0,5,0,-65,1555905600,1555905600,5
Downtown_Reporter111,0,5,0,14,1611896400,1612242000,5
dullmonkey1988,0,5,0,46,1602302400,1611896400,5
OrigamiPisces,0,5,0,21,1584763200,1597809600,5
Suckmyhuckhuck,0,5,0,-330,1597636800,1599710400,5
macak333,0,5,0,25,1558843200,1583812800,5
Cliff_Burtons_Hair,3,2,148,12,1566014400,1573016400,5
ab979,1,4,57,16,1607835600,1607835600,5
haritejasunny97,0,5,0,1,1603512000,1605589200,5
axteryo,0,5,0,20,1604984400,1607144400,5
CVS_is_unsafe,0,5,0,16,1603512000,1603598400,5
Back_Action,0,5,0,109,1597896000,1602820800,5
loveopenly,0,5,0,6,1399089600,1551589200,5
AdorabeHummingbirb,0,5,0,8,1603512000,1603512000,5
barackoghanja,0,5,0,7,1570593600,1607576400,5
BurgerNirvana,0,5,0,-6,1594353600,1594440000,5
StatistDestroyer,0,5,0,-1,1554609600,1580533200,5
Chrimunn,0,5,0,20,1592280000,1607835600,5
JamesBrownspants,0,5,0,26,1590724800,1601092800,5
hexchromosome,0,5,0,19,1554177600,1602129600,5
slutty_lifeguard,0,5,0,99,1561521600,1573189200,5
redditisgay77,0,5,0,72,1561694400,1590033600,5
beelzebabes,0,5,0,81,1605416400,1607317200,5
Ubernaught,0,5,0,3,1583643600,1583643600,5
grimreefer702,0,5,0,17,1594958400,1597377600,5
Sempiternal_Cicatrix,0,5,0,33,1599710400,1602648000,5
surfeitrhythm,1,4,24,20,1608958800,1609045200,5
drdeadringer,0,5,0,9,1607403600,1607403600,5
sometaacc1,0,5,0,29,1594872000,1601870400,5
lapuslazulium,0,5,0,20,1564977600,1569556800,5
Werewolf_King_,1,4,31,16,1560225600,1562731200,5
lentilsintheoven,1,4,11,9,1572843600,1576731600,5
NorthShoreSkal,0,5,0,115,1594699200,1608008400,5
fluidityauthor,1,4,78,14,1574744400,1579410000,5
PepitoTheKoshka,1,4,225,122,1579582800,1586404800,5
Sophistick,0,5,0,2,1550293200,1550293200,5
Osteelios,3,2,85,57,1604293200,1606280400,5
forknox,0,5,0,72,1561521600,1579410000,5
Monaco_Playboy,0,5,0,-26,1585281600,1585281600,5
MagicalGlitterBitch,0,5,0,244,1572753600,1602648000,5
Jarderino,0,5,0,95,1580101200,1605330000,5
nerdinmathandlaw,0,5,0,93,1590984000,1603684800,5
Rickrickrickrickrick,0,5,0,588,1584763200,1584849600,5
FoolhardyBastard,0,5,0,3,1599796800,1608786000,5
ShiningConcepts,1,4,93,22,1544245200,1547010000,5
allabaoutthehype,0,5,0,-5,1578286800,1578373200,5
charismaticzombie,0,5,0,27,1595563200,1602648000,5
Primary-Alarm,0,5,0,38,1579410000,1600401600,5
MegaBiT_Bot,0,5,0,7,1585108800,1596772800,5
adventuresquirtle,0,5,0,55,1605934800,1608699600,5
felinebyline,0,5,0,3,1550293200,1550293200,5
silence_is_goldwyn,1,4,5937,96,1601956800,1603080000,5
ihusmrn,0,5,0,25,1579496400,1583726400,5
LeafFallGround,0,5,0,3,1608181200,1608181200,5
soonergary55,0,5,0,21,1579842000,1581138000,5
cloud665,0,5,0,3,1598155200,1604293200,5
MonstarOfficial,2,3,12,13,1556164800,1594180800,5
LordFuckwaddle,2,3,42,77,1591329600,1592884800,5
thesleepiestnugget,1,4,13,13,1575435600,1575435600,5
TheErroredNoName,0,5,0,150,1554609600,1608786000,5
Hyndergogen1,0,5,0,32,1581570000,1590465600,5
HannibalParka,0,5,0,67,1556683200,1559966400,5
another_old_fart,0,5,0,8,1393563600,1425704400,5
k5r2ans,0,5,0,22,1577077200,1578286800,5
Silorose,1,4,724,25,1552107600,1558411200,5
Onsbance,0,5,0,100,1583211600,1583384400,5
bigparrot29,0,5,0,9,1597032000,1603339200,5
LawlessCoffeh,0,5,0,43,1580274000,1589860800,5
chromatography-jay,0,5,0,244,1608526800,1608699600,5
vegivampTheElder,0,5,0,72,1603166400,1604116800,5
sadsockpuppet1,0,5,0,31,1595908800,1596513600,5
Thenewfoundlanders,0,5,0,133,1593835200,1604811600,5
LawlessMind,0,5,0,19,1577422800,1578546000,5
JohnsJus,0,5,0,-83,1611982800,1612069200,5
nhomewarrior,0,5,0,6,1588132800,1588305600,5
ResponsibleWallaby,0,5,0,20,1529640000,1532664000,5
harryblakk,0,5,0,-47,1576904400,1601870400,5
Schizocel,0,5,0,5,1559707200,1560484800,5
lanalolla,1,4,7,31,1586404800,1606107600,5
heisenfgt,0,5,0,7,1605589200,1605675600,5
dildosaurusrex_,0,5,0,5,1550293200,1550293200,5
holyfatherandlord,0,5,0,21,1587873600,1588737600,5
GOPIsBamboozle,0,5,0,56,1607144400,1607144400,5
InsaneSeaSquirt,0,5,0,67,1577250000,1608267600,5
Jedi_Sith1812,2,3,43,10,1584417600,1585195200,5
Jackazz4evr,0,5,0,51,1574658000,1588737600,5
tonynotalk,0,5,0,21,1563595200,1563768000,5
captaincyrious,0,5,0,9,1583899200,1585454400,5
ListenToGeorgeCarlin,0,5,0,-32,1588824000,1588910400,5
Zeiqix,0,5,0,-11,1603512000,1608613200,5
jam11249,0,5,0,-8,1600142400,1600228800,5
Zaphod_042,0,5,0,122,1562731200,1589601600,5
oh_dough_you_didnt,0,5,0,16,1587528000,1594008000,5
roxyamused,0,5,0,39,1569384000,1605243600,5
strajeo,0,5,0,5,1581570000,1584158400,5
nihilism_or_bust,0,5,0,-16,1606280400,1606366800,5
The_Greek_Geek__,0,5,0,78,1578805200,1584331200,5
rottentomatopi,0,5,0,94,1603598400,1608440400,5
Abstract-ion,0,5,0,35,1548478800,1548478800,5
Treach666,0,5,0,25,1581224400,1581310800,5
hillbilly8643,0,5,0,-4,1597464000,1597464000,5
VisitingPeanut48,0,5,0,123,1597291200,1597377600,5
fruitynoodles,0,5,0,19,1600228800,1609045200,5
Calildur,2,3,35,12,1578027600,1580014800,5
wateranimus,0,5,0,59,1586318400,1596168000,5
hero-ball,0,5,0,91,1599624000,1602129600,5
wapfelite,0,5,0,53,1592366400,1609218000,5
PlanetaryConundrum,0,5,0,92,1573362000,1594440000,5
sparkie_t,0,5,0,45,1548133200,1574830800,5
conscius-ipsum,0,5,0,32,1578200400,1588219200,5
Ghost_of_agnew,3,2,170,6,1601697600,1603252800,5
ziToxicAvenger,0,5,0,3,1609131600,1609131600,5
Love-sex-communism,0,5,0,41,1578027600,1583470800,5
tech_fu,0,5,0,68,1609131600,1609131600,5
lazy_fematoad,0,5,0,16,1606798800,1607058000,5
planet_druidia,0,5,0,25,1563336000,1584417600,5
sokratees,0,5,0,-73,1546578000,1551416400,5
reddit-fart,2,3,55,33,1595476800,1598068800,5
chloethenerdy,0,5,0,29,1600747200,1606885200,5
richiecalling,2,3,174,6,1602561600,1608526800,5
drueburgendy,0,5,0,21,1569902400,1600747200,5
yippiegoldbob,1,4,101,6,1606798800,1608872400,5
Maxentirunos,0,5,0,67,1583384400,1607922000,5
somehoeshit,0,5,0,25,1599796800,1599883200,5
sk_progressive,0,5,0,24,1497412800,1549515600,5
qholmes98,0,5,0,463,1578373200,1592193600,5
THEREJECTDRAGON,0,5,0,68,1597291200,1601611200,5
CHuckLeRB,1,4,50,10,1606539600,1606885200,5
zekromNLR,0,5,0,7,1576213200,1589515200,5
HentaiDisposable420,0,5,0,6,1584936000,1597982400,5
Cooltaha3939,0,5,0,42,1572408000,1573621200,5
JoeRogansChimpArmy,0,5,0,-1,1589688000,1596772800,5
Canadia64,0,5,0,17,1565064000,1581051600,5
hon3yg1rl,1,4,97,77,1558324800,1580533200,5
Sanddancer84,1,4,50,18,1579582800,1579755600,5
anonymous_rhombus,1,4,20,23,1429848000,1550552400,5
th3ist,0,5,0,-47,1559188800,1587528000,5
sableJR,0,5,0,20,1565755200,1605243600,5
MediciPrime,0,5,0,16,1573534800,1593662400,5
eggs_erroneous,1,4,54,18,1595736000,1597377600,5
jonjonescpa,0,5,0,30,1604116800,1608699600,5
--_-_o_-_--,0,5,0,27,1571544000,1612155600,5
foodthingsandstuff,1,4,187,0,1586404800,1587441600,5
No1stupid,0,5,0,71,1550379600,1552107600,5
Acedia_37,0,5,0,109,1572408000,1607576400,5
rxbigs,0,5,0,14,1608267600,1609218000,5
AnwarSadatsDog,0,5,0,268,1598500800,1601524800,5
piearrxx,0,5,0,4,1593576000,1593662400,5
ClickingKeys,1,4,0,-1,1594180800,1594180800,5
TrenSultan,0,5,0,62,1606194000,1609131600,5
bluedew1,0,5,0,90,1602648000,1604379600,5
Jean-Ralphio-Junior,0,5,0,28,1607490000,1607835600,5
PM_ME_UR_BOOKSHELF,0,5,0,18,1588478400,1588478400,5
HauntedMidget,0,5,0,67,1575262800,1577422800,5
falang_32,0,5,0,58,1547269200,1553054400,5
JDA17,0,5,0,25,1554696000,1555560000,5
RudditorTooRude,0,5,0,-67,1575176400,1575262800,5
Dubmove,0,5,0,61,1566014400,1612069200,5
treeefingers,0,5,0,13,1585713600,1596168000,5
levsek,0,5,0,-6,1607317200,1608958800,5
SunnydaleHigh1999,0,5,0,237,1581310800,1600056000,5
NikkiJane72,1,4,6,8,1575262800,1595822400,5
lime_head,0,5,0,16,1593057600,1595908800,5
grandmasgyno,0,5,0,58,1582261200,1603425600,5
someoneperson1088,0,5,0,7,1588737600,1604030400,5
asabasa,0,5,0,10,1597636800,1597723200,5
nemployedav,0,5,0,24,1603598400,1612155600,5
sandgrades,0,5,0,14,1573448400,1576299600,5
grimAuxiliatrixx,0,5,0,156,1578200400,1606453200,5
poopagandist,0,5,0,16,1585972800,1585972800,5
OverFjell,0,5,0,3,1547355600,1585022400,5
dringus-drangus,0,5,0,127,1587096000,1593489600,5
tacticalassassin,1,4,6,148,1579928400,1582693200,5
candycoatedshovel,0,5,0,42,1586923200,1588910400,5
PointmanW,0,5,0,7,1580533200,1599105600,5
Commandophile,0,5,0,20,1571544000,1605070800,5
HueyLewisOfficial,0,5,0,10,1596772800,1604466000,5
Ulexes,0,5,0,82,1564718400,1572408000,5
animus-orb,1,4,20,59,1576990800,1583899200,5
wholesome_capsicum,0,5,0,14,1599105600,1605070800,5
qedesha_,0,5,0,31,1584590400,1593576000,5
godsdongle,2,3,100,41,1566360000,1597464000,5
IJustBeGoinThroughIt,1,4,37,87,1576299600,1581483600,5
BlasiusB,1,4,24,14,1568520000,1597723200,5
auchjemand,0,5,0,8,1593316800,1606539600,5
TenaciousTony_,0,5,0,5,1573362000,1578286800,5
fladermaus210,0,5,0,27,1575954000,1611896400,5
nature-sister,0,5,0,5,1605416400,1608699600,5
CatsDragonsUnicorns,0,5,0,56,1602388800,1604984400,5
VagabondDuck,0,5,0,152,1588737600,1589774400,5
Pariscouscous,0,5,0,6,1558238400,1568952000,5
SGCJanitor,1,4,110,56,1566187200,1574571600,5
rowdyrebbell,1,4,0,-51,1576386000,1585454400,5
oceandrinker_,0,5,0,199,1582693200,1587873600,5
halfjack4,0,5,0,-4,1585022400,1585108800,5
Tracynmega,0,5,0,7,1555041600,1557201600,5
CunninghamsLawmaker,0,5,0,-38,1558497600,1558497600,5
Lennartlau,0,5,0,46,1595217600,1601956800,5
PurpleDido,0,5,0,105,1582520400,1586232000,5
DueTitle6,1,4,51,200,1594785600,1595649600,5
ArsonGable2814,0,5,0,24,1552363200,1558584000,5
zarelion,0,5,0,15,1539921600,1545454800,5
LeagueOfLegendsAcc,0,5,0,58,1549083600,1576126800,5
StressNeck,0,5,0,-25,1573966800,1582088400,5
F-Cloud,0,5,0,89,1547701200,1594872000,5
World_Citizen_3,0,5,0,76,1598414400,1604725200,5
kissingthehomies24,3,2,29,3,1598587200,1601352000,5
subsonik2nine,0,5,0,97,1573448400,1584158400,5
soberupmonk,0,5,0,1,1603512000,1603512000,5
LivingRaccoon,5,0,4048,0,1544418000,1571544000,5
Art-Nova,1,4,46,9,1600660800,1606021200,5
Wololo242,0,5,0,9,1601006400,1601092800,5
basmati_relish_trail,0,5,0,18,1603080000,1604293200,5
amHink,0,5,0,2,1604379600,1609218000,5
worqgui,0,5,0,10,1567483200,1599537600,5
Yoshimi917,0,5,0,35,1599019200,1603425600,5
Yoosha123,1,4,57,1,1606280400,1608786000,5
TTPKMF,0,5,0,224,1579410000,1606712400,5
MommaNamedMeSheriff,0,5,0,54,1605502800,1611982800,5
Goodgoodgodgod,0,5,0,62,1545800400,1603080000,5
TomNobleX,0,5,0,36,1562817600,1587528000,5
jbrandona119,0,5,0,83,1564632000,1574830800,5
youreadiread,1,4,34,7,1599710400,1599710400,5
chinchilladust,1,4,44,22,1557547200,1597636800,5
Elturiel,0,5,0,52,1560916800,1605157200,5
RadonX9,2,3,18,19,1552363200,1557979200,5
Lowprioritypatient,0,5,0,95,1552276800,1609218000,5
defcon-juan,0,5,0,73,1592971200,1605416400,5
TheAgreeTroll,0,5,0,15,1588219200,1589256000,5
FataIity,0,5,0,9,1565841600,1565841600,5
RalphWaldoPickleCh1p,0,5,0,35,1603684800,1606971600,5
r3mod_3tiym,0,5,0,28,1606539600,1606539600,5
blknrd,0,5,0,11,1592971200,1608181200,5
kdokdo,0,5,0,8,1540440000,1603857600,5
misterpoopybutthole5,1,4,532,33,1593662400,1598155200,5
BritPetrol,0,5,0,2,1593230400,1593489600,5
DrenRuse,0,5,0,81,1575349200,1604466000,5
Snoo98679,1,4,53,16,1602648000,1605070800,5
EndMyGame,1,4,9,5,1591761600,1591761600,5
fliesonpotatosalad,0,5,0,52,1588305600,1595908800,5
agray47,0,5,0,46,1600142400,1605330000,5
jprefect,1,4,26,18,1578286800,1597550400,5
Sirxi,0,5,0,10,1564113600,1566792000,5
PillowTalk420,0,5,0,14,1560916800,1611982800,5
water-magick,0,5,0,77,1579323600,1580792400,5
Arlenishn,0,5,0,157,1579064400,1599105600,5
NeinJuanJuan,0,5,0,53,1549515600,1553227200,5
Fraih,0,5,0,121,1580101200,1580706000,5
JayMercutio,1,4,11,4,1573275600,1573275600,5
YolandaWinston21,0,5,0,74,1596168000,1609218000,5
DarkScorpion48,0,5,0,18,1590120000,1590206400,5
beer__noises,1,4,42,19,1571630400,1573707600,5
miserylovescomputers,0,5,0,51,1575608400,1582606800,5
nekolalia,0,5,0,87,1572408000,1574830800,5
basic_math_doit,0,5,0,-25,1607835600,1607922000,5
deejayemcee,0,5,0,42,1560052800,1582174800,5
nymph-62442,0,5,0,19,1599364800,1607835600,5
bebyk,0,5,0,-9,1576213200,1576213200,5
winndixie,0,5,0,25,1541044800,1546059600,5
kkjdroid,0,5,0,34,1551243600,1573707600,5
mytinyequine,0,5,0,40,1603684800,1608699600,5
dovahalexander,1,4,10,14,1545109200,1556596800,5
RobertWarrenGilmore,1,4,13,134,1554955200,1585886400,5
tacoslikeme,0,5,0,11,1577422800,1606626000,5
alesserbro,0,5,0,6,1594440000,1599451200,5
ovrload,0,5,0,78,1598414400,1606280400,5
Gholgie,0,5,0,80,1599710400,1604116800,5
ACheeryHello,0,5,0,7,1608354000,1608354000,5
the-eyes-dontlie,0,5,0,27,1606971600,1608786000,5
srslyeffedmind,0,5,0,44,1568347200,1594958400,5
goatforit,0,5,0,48,1573102800,1574053200,5
coppersgottago,0,5,0,39,1591502400,1595304000,5
gelinrefira,0,5,0,99,1599019200,1599105600,5
Szukov,0,5,0,15,1550206800,1550466000,5
Avarus_Lux,0,5,0,14,1603598400,1603684800,5
FMods,0,5,0,33,1583985600,1603512000,5
revelationsss,0,5,0,439,1578891600,1578978000,5
anltelescope,0,5,0,18,1594267200,1605589200,5
UnknownGraves,3,2,94,26,1571630400,1578114000,5
BarsOfTheBat,0,5,0,2,1611982800,1611982800,5
jaesuk15,0,5,0,119,1567569600,1584504000,5
luckyduckling8989,1,4,25,12,1575435600,1578373200,5
Merryprankstress,0,5,0,33,1578459600,1600660800,5
neo_penguin1,0,5,0,-53,1597636800,1597636800,5
astationwagon,0,5,0,16,1566532800,1566964800,5
shrampdinna122,1,4,10,13,1550638800,1550638800,5
ArMcK,0,5,0,15,1546405200,1605330000,5
vook485,0,5,0,224,1584072000,1596600000,5
DisMyWeedAccount420,0,5,0,117,1588996800,1588996800,5
donuts96,0,5,0,-2,1575867600,1581656400,5
huevo_con_salchicha,0,5,0,130,1607922000,1609218000,5
MorbidMunchkin,0,5,0,23,1603512000,1603598400,5
stregg7attikos,0,5,0,18,1605589200,1611896400,5
Aspiedude1997,0,5,0,15,1580274000,1580360400,5
xisnotx,0,5,0,104,1562817600,1566273600,5
pleasegoanddie,0,5,0,45,1565755200,1565755200,5
Prince_Polaris,0,5,0,57,1600056000,1600142400,5
jhaand,0,5,0,54,1570939200,1595908800,5
zeroicey,2,3,215,37,1599192000,1602734400,5
Khotaman,0,5,0,24,1554782400,1557979200,5
stingysoysauce,0,5,0,18,1599624000,1603944000,5
Valridagan,0,5,0,55,1560139200,1607835600,5
RoadDoggFL,0,5,0,6,1574571600,1574571600,5
pseudoname123,2,3,75,32,1608958800,1611810000,5
weedvegan,0,5,0,75,1582434000,1590120000,5
HeyMrBusiness,0,5,0,12,1603512000,1603512000,5
ruvmesumshittywok,0,5,0,-15,1612155600,1612155600,5
EffieCuriouser,0,5,0,21,1593144000,1593230400,5
fever_dream_321,0,5,0,24,1603252800,1603771200,5
axelztangi,3,2,34,6,1429156800,1487221200,5
Juppe1803,0,5,0,5,1578373200,1578373200,5
legendfriend,0,5,0,8,1594267200,1611982800,5
throwawayjob19r838q9,0,5,0,-6,1605157200,1605243600,5
Caleb_Reynolds,0,5,0,11,1606539600,1606626000,5
Christoph680,0,5,0,16,1591761600,1596168000,5
synthequated,0,5,0,65,1603771200,1606626000,5
corticalization,1,4,75,20,1605243600,1605243600,5
ilurkilearntoo,0,5,0,5,1597896000,1605934800,5
Th4tGuyUKn0,0,5,0,73,1577854800,1600228800,5
danny_ish,0,5,0,66,1591675200,1607317200,5
draken_score,0,5,0,-10,1588132800,1588132800,5
bonizzle,0,5,0,64,1574571600,1584331200,5
Spacct,0,5,0,83,1592366400,1608440400,5
Current_Bill,0,5,0,33,1590724800,1590724800,5
MrDowntempo,1,4,1,21,1569988800,1607922000,5
dwmaidman,0,5,0,22,1588392000,1591416000,5
QueueOfPancakes,0,5,0,-2,1600660800,1600660800,5
artolindsay1,0,5,0,39,1576731600,1578286800,5
Mawi331,0,5,0,60,1589256000,1592625600,5
AwareCel,0,5,0,25,1576213200,1587700800,5
yeahfuckers,0,5,0,37,1546405200,1554868800,5
preacher_knuckles,0,5,0,9,1607922000,1608786000,5
NEWSmodsareTwats,0,5,0,60,1606021200,1606194000,5
memory_fading,0,5,0,53,1599969600,1602561600,5
ksswannn03,0,5,0,39,1603252800,1603684800,5
Hextalionis,0,5,0,75,1560139200,1562644800,5
bazvfrgailpequvf,1,4,40,7,1571457600,1571630400,5
vrindar8,0,5,0,33,1588737600,1608699600,5
angelcloudss,1,4,66,29,1607576400,1607576400,5
opalloollapo,0,5,0,30,1597636800,1600056000,5
parksLIKErosa,0,5,0,58,1593662400,1600488000,5
Feeling_Gur_8828,0,5,0,18,1609304400,1610514000,5
GarretTheGrey,0,5,0,2,1571371200,1571371200,5
Kexbyon,0,5,0,11,1571803200,1579150800,5
dervasavred,0,5,0,369,1568952000,1606971600,5
zombieslayer287,0,5,0,39,1597464000,1608094800,5
Coconuts_Migrate,0,5,0,5,1595822400,1595822400,5
stannis621,2,3,1833,21,1594699200,1606885200,5
Barrythehippo,0,5,0,55,1554350400,1578632400,5
4ChanNoob,0,5,0,19,1572408000,1608786000,5
silverdiver,2,3,1861,68,1561694400,1599019200,5
Cosmobeast88,0,5,0,20,1602043200,1607662800,5
Lonetraveler87,0,5,0,12,1576299600,1607835600,5
superwhitemexican,0,5,0,21,1561003200,1568088000,5
Kuwuii,0,5,0,-22,1580965200,1583125200,5
martian_pedophile,0,5,0,98,1608181200,1609304400,5
Wandering_P0tat0,0,5,0,31,1581915600,1599019200,5
tibner88,0,5,0,17,1600920000,1601006400,5
Specialist-Sock-855,0,5,0,99,1608613200,1609304400,5
takethepiss95,1,4,74,23,1567483200,1567742400,5
dietthecoke,0,5,0,22,1596945600,1597204800,5
AlpacaLoco,2,3,41,19,1580360400,1585195200,5
recontrapuxa,0,5,0,5,1597809600,1597896000,5
Cult_Chief,1,4,129,21,1600660800,1609304400,5
edaum0726,0,5,0,15,1573707600,1588651200,5
coheed2122,0,5,0,12,1604984400,1605070800,5
sarbaddict843,0,5,0,7,1608526800,1608526800,5
thenewunit16,0,5,0,-5,1608786000,1608786000,5
smeelen,0,5,0,65,1579496400,1593921600,5
CJCYDOX,2,3,135,22,1593662400,1605848400,5
moparcam,0,5,0,26,1600920000,1603512000,5
Rphal,5,0,1461,0,1600228800,1601352000,5
korpuskat,0,5,0,19,1551589200,1556337600,5
SpewOfThrowaway,0,5,0,12,1596686400,1596686400,5
utopicunicornn,0,5,0,29,1605070800,1607058000,5
hokage_sama23,0,5,0,23,1587355200,1587355200,5
AllForTheGains,0,5,0,41,1570766400,1598155200,5
xRear,1,4,55,-5,1582520400,1582606800,5
RedxValkyrie,0,5,0,45,1575262800,1577768400,5
coffeecrumpet,0,5,0,10,1599278400,1607058000,5
Mercenarybrute,0,5,0,101,1596254400,1608958800,5
DigitalDreamer81,0,5,0,36,1576904400,1579150800,5
Kirbooo,0,5,0,1,1603512000,1604811600,5
JobMarketWoes,0,5,0,28,1603684800,1609218000,5
Najunix,1,4,59,198,1585540800,1592193600,5
gagavelli,0,5,0,42,1593230400,1599883200,5
CrewmemberV2,0,5,0,21,1606885200,1606885200,5
ABrusca1105,0,5,0,20,1587096000,1598846400,5
mrcal18,0,5,0,115,1592798400,1594785600,5
oatenbiscuits,0,5,0,28,1559102400,1586836800,5
PreferenceUnique3832,0,5,0,4,1607922000,1613624400,5
GnawingonHoney,0,5,0,110,1574571600,1581138000,5
HPSarcasm,0,5,0,27,1586318400,1591588800,5
NoUpVotesForMe,0,5,0,9,1605502800,1605589200,5
None42183,0,5,0,357,1604898000,1605934800,5
CTC42,0,5,0,19,1555041600,1602820800,5
Matthew8312,0,5,0,38,1569038400,1570680000,5
N00B5L4Y3R69,0,5,0,7,1606971600,1607058000,5
hasaan12,0,5,0,3,1590465600,1590552000,5
BabyGotBantz,0,5,0,38,1605675600,1606971600,5
ateur5,1,4,0,0,1606798800,1606885200,5
Crathsor,0,5,0,11,1603598400,1603598400,5
DumbassLearningMath,0,5,0,14,1609304400,1612155600,5
hgwxx7_foxtrotdelta,0,5,0,55,1600574400,1603166400,5
DisguisedGarbageCan,0,5,0,9,1595908800,1595908800,5
JohnYu1379,1,4,9,42,1602216000,1609477200,5
tofu_tot,0,5,0,23,1561348800,1561348800,5
Hamstersparadise,0,5,0,20,1589342400,1589342400,5
-SENDHELP-,0,5,0,141,1605330000,1606194000,5
Obscurian,0,5,0,43,1580878800,1608267600,5
noandthenandthen,0,5,0,-5,1611896400,1611982800,5
Judasiscariothogwllp,0,5,0,59,1590206400,1601265600,5
Luciano_the_Dynamic,0,5,0,21,1568260800,1583985600,5
long_black_road,0,5,0,-10,1571630400,1571716800,5
lefttillldeath,0,5,0,38,1552107600,1604116800,5
hellofriendsilu,0,5,0,29,1601352000,1602993600,5
Tkcolumbia,0,5,0,204,1579064400,1597809600,5
DeviantLogic,0,5,0,33,1584072000,1589342400,5
foopadapoopa,0,5,0,73,1572494400,1572930000,5
cinematicme,0,5,0,17,1605589200,1605675600,5
HurtMyYurt,0,5,0,10,1595304000,1595995200,5
atlantagirl30084,0,5,0,25,1598328000,1598673600,5
SoyBoy14800,0,5,0,19,1574571600,1575608400,5
Rath12,0,5,0,120,1582693200,1588046400,5
FuckThePolice369,0,5,0,81,1587614400,1593489600,5
hungryhungrylesbos,0,5,0,12,1612069200,1612242000,5
thebrownsugar28,0,5,0,10,1594440000,1596340800,5
Kerb3r0s,0,5,0,16,1608526800,1608526800,5
MoonlightPrincess533,0,5,0,51,1603684800,1604030400,5
FirstBladeRyzan,0,5,0,-15,1607490000,1607576400,5
Pink_Pymera,0,5,0,-9,1587182400,1587441600,5
TheNinthFox,1,4,43,20,1578286800,1586923200,5
ComfortableMirror1,0,5,0,4,1545886800,1545973200,5
Temperal_Joe,0,5,0,69,1585368000,1593662400,5
An-Idaho-Potatt,1,4,3,7,1608440400,1608526800,5
LePontif11,0,5,0,-5,1612069200,1612069200,5
zendaddy-,0,5,0,43,1593576000,1596254400,5
Ram-Cowboy39,0,5,0,-63,1578891600,1578891600,5
Nukes4You,0,5,0,35,1587873600,1593057600,5
Distinct_Recognition,0,5,0,75,1594612800,1594612800,5
WhileNotLurking,0,5,0,-17,1590379200,1590379200,5
earlysoviet,0,5,0,-8,1556078400,1556078400,5
stocksrcool,0,5,0,10,1584676800,1584676800,5
HavaianasAndBlow,0,5,0,17,1585108800,1585540800,5
No-Coast-Punk,0,5,0,-45,1578027600,1578114000,5
nuka_girl111,1,4,66,5,1560916800,1561521600,5
cringy_goth_kid,0,5,0,22,1593230400,1599192000,5
Kilokalypso,0,5,0,-4,1606539600,1606712400,5
TravelingDark,1,4,139,192,1580965200,1603512000,5
Jive_Sloth,0,5,0,10,1576472400,1576472400,5
Redsomnambulist,0,5,0,26,1600401600,1604293200,5
BrightandPsyched,0,5,0,127,1575522000,1587873600,5
homelessgranddad,1,4,116,6,1589860800,1606626000,5
death_-,0,5,0,12,1601870400,1601870400,5
whyshouldyouwakeup,1,4,140,81,1603684800,1605848400,5
StringerLord,0,5,0,33,1587268800,1592712000,5
BigBonesBoy,2,3,212,78,1550034000,1562299200,5
stillgloom,0,5,0,-37,1609477200,1609477200,5
littleboy91,0,5,0,3,1594612800,1596427200,5
yaosio,0,5,0,30,1597809600,1605848400,5
123456American,0,5,0,26,1611982800,1611982800,5
qevlarr,1,4,12,78,1576818000,1598760000,5
silverslayer33,0,5,0,36,1585886400,1587009600,5
zielona_ges,0,5,0,22,1591329600,1598932800,5
noah_juan_ishome,0,5,0,9,1603339200,1607576400,5
fapsandnaps,0,5,0,53,1526616000,1565150400,5
RazGrox,0,5,0,85,1574312400,1606539600,5
NoGameStupidClingy,0,5,0,-10,1607835600,1607922000,5
Sempais_nutrients,0,5,0,266,1600660800,1608786000,5
Longshullong,0,5,0,-17,1584676800,1586404800,5
busterlungs,1,4,79,4,1595217600,1606453200,5
Zciero,0,5,0,22,1592107200,1608699600,5
xJohnnyQuidx,2,3,35,9,1598846400,1611982800,5
Matthew288,0,5,0,4,1586923200,1588651200,5
pootietang33,2,3,28,16,1579842000,1590379200,5
claptonistheonlygod,0,5,0,-3,1599019200,1602820800,5
jenneschguet,0,5,0,68,1606280400,1606885200,5
BashTheFash1312,0,5,0,77,1579928400,1597032000,5
MangoMan42,0,5,0,-7,1598760000,1598760000,5
doodlefay,0,5,0,13,1582520400,1605848400,5
gnarlin,0,5,0,91,1568952000,1598846400,5
Nightshiftnoble,0,5,0,33,1597809600,1607403600,5
Nuclearfuzzbomber,0,5,0,23,1595563200,1611810000,5
jelli2015,0,5,0,43,1591502400,1608181200,5
latto744,0,5,0,-31,1597809600,1597896000,5
Stonn,0,5,0,32,1576126800,1590120000,5
solarporpoise,0,5,0,-29,1608958800,1608958800,5
hoboemt,0,5,0,11,1606626000,1611810000,5
AgreeableLie8,0,5,0,51,1552021200,1566964800,5
Superheroicguy,0,5,0,24,1569816000,1569816000,5
Ruhani777,0,5,0,430,1593662400,1606626000,5
loggingaway,0,5,0,67,1563076800,1565409600,5
DJ_Micoh,1,4,20,308,1601092800,1603771200,5
miataman9435,0,5,0,-27,1554868800,1554955200,5
Fifth_Illusion,5,0,1190,0,1572321600,1604466000,5
SweetGale,0,5,0,95,1575781200,1592366400,5
greatsirius,0,5,0,-14,1560916800,1560916800,5
ReedF512,0,5,0,3,1602993600,1603080000,5
SaintAnarchist,0,5,0,30,1601092800,1602216000,5
epic-tangent,0,5,0,6,1611896400,1612069200,5
sillymidon79,0,5,0,-128,1571284800,1573966800,5
Takelu2424,0,5,0,43,1581742800,1608872400,5
i-love-plants,0,5,0,25,1605243600,1608699600,5
TheBeard1986,0,5,0,13,1600401600,1606366800,5
Hagemus,2,3,55,18,1591761600,1607230800,5
homosapiensagenda,2,3,3955,40,1585454400,1587096000,5
Saffron_Socialist,0,5,0,49,1552107600,1581915600,5
Ticklemeplease122,0,5,0,18,1597032000,1597636800,5
zeno-zoldyck,1,4,235,-3,1570420800,1588219200,5
watchtheworldsmolder,1,4,370,16,1611810000,1611896400,5
PM_ME_UR_SOCKS_GIRL,1,4,19,21,1574658000,1574658000,5
Rough_Accident512,0,5,0,75,1602648000,1606107600,5
Lepchin,0,5,0,30,1557288000,1576126800,5
JuryokuNeko,0,5,0,349,1571284800,1597982400,5
NRG_Factor,0,5,0,-24,1598846400,1602388800,5
zombie_penguin42,0,5,0,26,1606280400,1607749200,5
SandwichProt3ctor,0,5,0,-11,1594353600,1600488000,5
appoloman,0,5,0,52,1566705600,1608440400,5
bihari_baller,0,5,0,15,1586836800,1591243200,5
Efficient_Lack_4410,1,4,0,-4,1611810000,1611810000,5
WorriedAccount,1,4,36,10,1573966800,1574226000,5
Movingforwardtimes,0,5,0,29,1579496400,1599451200,5
ChickenpoxForDinner,0,5,0,18,1577336400,1577422800,5
Nolayelde,1,4,52,9,1581310800,1588046400,5
SimplyCmplctd,0,5,0,67,1577854800,1600660800,5
scrumperumper,1,4,112,51,1555300800,1555646400,5
MagicRainbowFairy,1,4,83,12,1603684800,1607922000,5
SchwiftedMetal,0,5,0,19,1606885200,1607835600,5
A_Walking_Mirror,0,5,0,13,1607490000,1612155600,5
Brian_McGee,0,5,0,228,1569988800,1606885200,5
deiscio,0,5,0,2,1572321600,1591761600,5
mike_without_ike,0,5,0,1,1590984000,1591070400,5
Professor_Dogwood,0,5,0,773,1589860800,1589947200,5
CaymanFifth,0,5,0,33,1442894400,1573621200,5
starfleethastanks,0,5,0,85,1584417600,1605762000,5
henryhillfiger34,0,5,0,-7,1589601600,1601524800,5
mycat_hatesyou,1,4,61,54,1557806400,1596772800,5
Sinyail_Music,0,5,0,-53,1579237200,1582693200,5
Timchya,0,5,0,14,1604379600,1606626000,5
therabidfanboy,0,5,0,122,1553832000,1583211600,5
Kropotkistan,1,4,2,14,1599969600,1605762000,5
PacificSquall,0,5,0,8,1611896400,1611982800,5
Ades78,3,2,558,6,1599710400,1603339200,5
insightfulinquisitor,0,5,0,-7,1594699200,1594872000,5
DanteZH41,0,5,0,50,1589601600,1601006400,5
generelperson,0,5,0,77,1561348800,1584158400,5
SweetLilMonkey,0,5,0,115,1597550400,1601179200,5
Lord_Blathoxi,1,4,42,7,1596600000,1597118400,5
Ektemusikk,0,5,0,21,1552107600,1571284800,5
fitchner-au-barca,0,5,0,25,1602648000,1607490000,5
-Bomboclat-,1,4,188,19,1598846400,1606366800,5
FutureAvenir,2,3,43,8,1482642000,1514091600,5
SnizzKitten,0,5,0,32,1537848000,1544590800,5
xvladin,0,5,0,68,1601352000,1609390800,5
ride_whenever,0,5,0,24,1578718800,1597032000,5
Hopz_7,0,5,0,8,1608181200,1608699600,5
AbleTank,0,5,0,42,1603944000,1605070800,5
bathcat7,0,5,0,12,1584590400,1599364800,5
Oikkuli,0,5,0,22,1599710400,1608094800,5
Taroman23,0,5,0,-13,1572580800,1572580800,5
AppropriateDingo,0,5,0,18,1603944000,1606971600,5
CapableStructure851,0,5,0,29,1602561600,1605589200,5
zoeszebra,0,5,0,34,1558670400,1573707600,5
wengerz_coat,1,4,515,28,1565928000,1571976000,5
guy7890,0,5,0,67,1606885200,1609477200,5
nomorefreezepeach,0,5,0,16,1605675600,1605762000,5
harryronredvines,2,3,92,24,1581310800,1592452800,5
CommandersLog,0,5,0,32,1608267600,1608267600,5
Grudlann,0,5,0,102,1588305600,1608440400,5
diphrael,0,5,0,107,1611810000,1611982800,5
baker10923,1,4,14,76,1606107600,1608440400,5
MeaningfulThoughts,0,5,0,31,1591070400,1592280000,5
rosietm,0,5,0,68,1575954000,1576818000,5
xenonisbad,0,5,0,-33,1595476800,1595476800,5
StrongSNR,0,5,0,-1,1596427200,1605589200,5
cautiouslycurious55,0,5,0,62,1597809600,1597982400,5
leonscribblotzi,1,4,8,8,1608354000,1609995600,5
labledcrazy,0,5,0,8,1612069200,1612069200,5
metalprogrammer2,0,5,0,15,1579755600,1579755600,5
Harveyquinn6,0,5,0,150,1581397200,1600401600,5
Gearnerd69,0,5,0,68,1577768400,1585108800,5
MrChunky22,0,5,0,30,1606971600,1607144400,5
TejasRojo,3,2,108,54,1603684800,1606712400,5
Professional-Appeal2,0,5,0,2,1612069200,1612069200,5
FecalFeast,0,5,0,54,1588737600,1600228800,5
MorrisseysUnderbite,1,4,91,88,1606712400,1608440400,5
DryDrunkImperor,0,5,0,112,1566964800,1606626000,5
WhiteSteveNash,0,5,0,9,1597032000,1602648000,5
fuggoffm8,0,5,0,13,1594180800,1595476800,5
reh888,0,5,0,13,1553659200,1607144400,5
donald_trunks,0,5,0,238,1603512000,1610168400,5
holla09,0,5,0,234,1600747200,1609390800,5
Hvymtlr,1,4,80,12,1606107600,1606194000,5
tawacc16,1,4,81,8,1581310800,1584158400,5
OriginalimPoster,0,5,0,43,1602216000,1608526800,5
sicsche,0,5,0,155,1603512000,1603512000,5
hexagon_lux,1,4,6,37,1570507200,1570766400,5
svnnynights,0,5,0,28,1557806400,1609218000,5
-Nerze-,0,5,0,8,1578373200,1578373200,5
JudasWasJesus,0,5,0,48,1585454400,1603425600,5
Chatto_1,0,5,0,92,1598068800,1600574400,5
Aiyon,0,5,0,25,1605589200,1639544400,5
mealteamsixty,0,5,0,124,1601352000,1607144400,5
leelaleela4,1,4,20,8,1576213200,1576213200,5
vpilcx,0,5,0,96,1548565200,1553227200,5
DebtJubilee,0,5,0,22,1570593600,1594267200,5
Curledsquirl,0,5,0,429,1605070800,1606107600,5
DDPJBL,0,5,0,-2,1597291200,1602648000,5
anthropoidal1,0,5,0,27,1595131200,1609045200,5
explainlikeimpenguin,1,4,86,49,1575954000,1586404800,5
PistachioTeddyBear,0,5,0,40,1575090000,1584417600,5
memeprincess135,1,4,67,8,1605589200,1606280400,5
louib716,0,5,0,8,1591329600,1604811600,5
JaggedyCunt,0,5,0,44,1552021200,1563249600,5
Beebeeseebee,0,5,0,40,1565755200,1589428800,5
allthlvsrbrwn,0,5,0,30,1604293200,1604293200,5
J_F_Ketamine,0,5,0,125,1593230400,1593316800,5
StoneColdSteveAustLn,1,4,25,6,1612069200,1612155600,5
_-dickpinch-_,0,5,0,12,1587873600,1589083200,5
LateNightLattes01,0,5,0,19,1576645200,1608786000,5
ytsejamer71,0,5,0,52,1578632400,1593403200,5
CarterzCandy,0,5,0,15,1585972800,1585972800,5
RustyKumquats,0,5,0,37,1585022400,1585195200,5
HyruliEnt,0,5,0,37,1583211600,1583211600,5
DraftyElectrolyte,0,5,0,219,1558238400,1558497600,5
Malevolent_Madchen,0,5,0,17,1576645200,1576645200,5
chemdude001,0,5,0,40,1580101200,1599278400,5
Subversive,0,5,0,92,1583298000,1609304400,5
Lionell_RICHIE,0,5,0,25,1563854400,1570593600,5
rebelrebel2013,1,4,4,55,1573102800,1585800000,5
hyggepuppiescoffee,0,5,0,64,1605416400,1608958800,5
yohannbF,0,5,0,90,1560052800,1562126400,5
NonlexicalNut,2,3,2262,22,1565668800,1566187200,5
potatolulz,0,5,0,82,1600660800,1608613200,5
cuntycartier,1,4,6,29,1573275600,1575522000,5
Cardinalfan1970,0,5,0,4,1609390800,1609563600,5
Maverick0_0,0,5,0,5,1591243200,1591243200,5
calefa,0,5,0,84,1603857600,1608181200,5
bslankster7583,0,5,0,27,1545195600,1546146000,5
starplanet222,3,2,41,3,1578200400,1597636800,5
professorbc,0,5,0,0,1602993600,1603512000,5
bw147,0,5,0,49,1594008000,1595476800,5
Athiaa,0,5,0,8,1574485200,1600142400,5
cerareece,0,5,0,94,1581051600,1606453200,5
MadeForPotatoes,0,5,0,18,1596945600,1597032000,5
putrid_pickles,0,5,0,129,1593921600,1607749200,5
iamdevo,0,5,0,139,1569988800,1597896000,5
Dabstronaut77,0,5,0,25,1600920000,1607662800,5
BrooklynLodger,0,5,0,-61,1599019200,1599019200,5
acacia-club-road,0,5,0,1,1551416400,1551589200,5
mercury_pointer,0,5,0,193,1557720000,1606971600,5
TheEyeDance,0,5,0,60,1596945600,1605589200,5
Theygonnabanme,0,5,0,21,1577941200,1578027600,5
bijinchan,0,5,0,12,1603771200,1609304400,5
granularoso,0,5,0,9,1611896400,1611982800,5
JestJes,0,5,0,36,1563076800,1563249600,5
GonnaGoFat,1,4,54,51,1583557200,1598846400,5
anarcho-stripperism,2,3,288,79,1586836800,1608786000,5
clean-simple,1,4,50,18,1566792000,1569556800,5
meep994,0,5,0,490,1572667200,1589515200,5
PM-me-cat-photos,0,5,0,259,1607058000,1607144400,5
comparablebeast,0,5,0,109,1572148800,1582002000,5
warshbucket,0,5,0,2,1593403200,1593403200,5
Talixius,0,5,0,82,1605762000,1606712400,5
bamename,0,5,0,3,1560657600,1576472400,5
Homowain,1,4,64,58,1579842000,1593489600,5
untrust_us_again,1,4,14,22,1611723600,1612155600,5
retrodetta,0,5,0,141,1576472400,1579150800,5
fossumisawesome,0,5,0,20,1594267200,1597809600,5
argrig,0,5,0,-48,1570075200,1577941200,5
JustaTurdOutThere,0,5,0,-6,1602216000,1602216000,5
sigrid2,0,5,0,12,1598414400,1599624000,5
macncheese323,0,5,0,24,1594872000,1608699600,5
kindathecommish,0,5,0,41,1578114000,1582779600,5
dawnraines,0,5,0,374,1567051200,1581483600,5
ILikeAnimePanties,0,5,0,100,1594872000,1594872000,5
Rustyshacklefrd0,0,5,0,15,1574571600,1578632400,5
UnauthorizedRosin,0,5,0,34,1586836800,1606194000,5
gniyonnasrewsna,0,5,0,-99,1573448400,1591675200,5
BadtzGP,2,3,3901,90,1576990800,1581656400,5
BannedLibertarian,0,5,0,1,1603944000,1608699600,5
LaTaupeAuGuichet,1,4,20,35,1574053200,1599278400,5
Sathie_,0,5,0,51,1591243200,1591329600,5
k2qhVBH3QByIABvzbBYq,2,3,34,61,1586404800,1587960000,5
Ponox,0,5,0,26,1590379200,1602388800,5
Class_Above,0,5,0,8,1585886400,1585972800,5
paisleypond,1,4,9,12,1563768000,1563768000,5
Klowner,0,5,0,133,1576645200,1611896400,5
AlbionPrince,0,5,0,8,1607662800,1608699600,5
blahgblahblahhhhh,0,5,0,-3,1601179200,1601438400,5
minusyume,0,5,0,103,1566446400,1575781200,5
rincon213,0,5,0,7,1598155200,1612069200,5
SubstantialSubstance,0,5,0,66,1582520400,1600833600,5
MightyQuesadilla,0,5,0,176,1564027200,1596686400,5
barefeetskippi,0,5,0,50,1581397200,1590638400,5
Del_Phoenix,0,5,0,16,1579928400,1594353600,5
coso9001,0,5,0,45,1462593600,1578027600,5
vulp4,0,5,0,17,1603684800,1603684800,5
EuroCakes,0,5,0,88,1571371200,1587700800,5
HailOurPeople,0,5,0,18,1599883200,1604725200,5
kinesivan,0,5,0,30,1588305600,1598241600,5
cart_adcock,0,5,0,31,1576990800,1595390400,5
originalbL1X,0,5,0,7,1583812800,1583812800,5
kingofcorndog,0,5,0,0,1599796800,1600228800,5
leonconrayas,1,4,204,9,1576645200,1601611200,5
principleofgender,0,5,0,17,1547528400,1570939200,5
xdeft,0,5,0,-18,1547182800,1556942400,5
pahamaki,0,5,0,10,1574312400,1576645200,5
Ihatevry1,0,5,0,240,1604898000,1609477200,5
famitslit,0,5,0,9,1609218000,1609218000,5
etmanning1,0,5,0,45,1574312400,1581656400,5
HiddenKeefVillage,0,5,0,237,1598414400,1601265600,5
chuchuchurro,0,5,0,19,1595304000,1609736400,5
tabac-en-paris,0,5,0,-94,1606280400,1606280400,5
cereal-dust,0,5,0,29,1608958800,1609045200,5
kerdon,1,4,13,31,1592366400,1601611200,5
wastedmylife1,3,2,56,0,1563249600,1597982400,5
Leulera,0,5,0,55,1547355600,1550466000,5
jlrigby,0,5,0,42,1579237200,1593144000,5
EmpiricSpirit,1,4,13,5,1572408000,1593662400,5
Xetetic,0,5,0,183,1594872000,1607317200,5
Jeppebs02,0,5,0,-31,1593921600,1594267200,5
QueenGloria86,0,5,0,6,1571371200,1576731600,5
Testi_Cles,0,5,0,9,1596427200,1612155600,5
Sentient_96_Corolla,0,5,0,114,1583557200,1590638400,5
fffffuckkkkk,0,5,0,16,1559188800,1559361600,5
toxygen,0,5,0,380,1580533200,1603598400,5
BallisticBovine1,1,4,285,72,1570507200,1570507200,5
BobbyBuci,2,3,272,92,1589774400,1592971200,5
10onthespectrum,0,5,0,338,1595822400,1607662800,5
REALLYANNOYING,0,5,0,71,1571544000,1603512000,5
R-K_WARLORD,0,5,0,-15,1593576000,1593576000,5
theRealJuicyJay,0,5,0,12,1571112000,1592798400,5
BassMaster516,0,5,0,106,1605330000,1609045200,5
MisterBaldo,0,5,0,139,1584158400,1596945600,5
fuckthiscode,0,5,0,76,1561608000,1571716800,5
dnajndvafnvafjnval,0,5,0,-21,1607317200,1611810000,5
jonaselder,0,5,0,2,1591243200,1597896000,5
Dischordgrapes,0,5,0,35,1608440400,1612155600,5
Koebs,0,5,0,-4,1596340800,1602734400,5
OhThrowMeAway,0,5,0,57,1556769600,1574398800,5
Urist_Galthortig,0,5,0,37,1606885200,1612069200,5
nanosurfer,0,5,0,84,1574226000,1608181200,5
wasteofleshntime,0,5,0,153,1598932800,1607922000,5
jfl5058,0,5,0,116,1596168000,1599710400,5
AppleClementine,0,5,0,28,1558929600,1561694400,5
SquirrelNutz8,0,5,0,5,1598500800,1598500800,5
bratimm,0,5,0,24,1565668800,1568088000,5
coleserra,1,4,31,23,1576040400,1608008400,5
GhostlyRobot,0,5,0,107,1546405200,1574139600,5
RoosterComrade,0,5,0,13,1599796800,1607749200,5
ChipsAhoyLawyer,0,5,0,-10,1582779600,1582779600,5
idle-moments,0,5,0,-35,1578286800,1578373200,5
Curious-Mind,0,5,0,105,1591243200,1604116800,5
Clackdor,0,5,0,44,1546405200,1546578000,5
SleepyBoyTV,1,4,10,19,1604898000,1604898000,5
DustJacketGang,0,5,0,32,1606194000,1607490000,5
prsanker,0,5,0,7,1599192000,1606885200,5
PoolsOnFire,0,5,0,-4,1606626000,1608440400,5
EtjenGoda,1,4,72,33,1576558800,1585886400,5
skeptical_moderate,0,5,0,27,1594699200,1594699200,5
mookiana,0,5,0,24,1584590400,1608613200,5
Corporate_Drone31,0,5,0,18,1599278400,1601524800,5
Triangularpaperclip,0,5,0,16,1606194000,1606194000,5
Miss_Smokahontas,0,5,0,39,1588392000,1608181200,5
microcrash,0,5,0,45,1560052800,1576299600,5
mydogatecheesecake,1,4,21,37,1594180800,1597377600,5
oxycontinoverdose,0,5,0,45,1599019200,1599537600,5
dennisthehygienist,1,4,628,18,1571457600,1571544000,5
incenseorange,0,5,0,17,1593489600,1606712400,5
YumariiWolf,0,5,0,71,1596686400,1608267600,5
Maaaaate,2,3,72,7,1554350400,1560312000,5
cbl5257,4,1,64,3,1551330000,1595476800,5
MkGlory,0,5,0,8,1552194000,1606626000,5
Y1ff,0,5,0,31,1560657600,1560657600,5
amfournda,0,5,0,74,1598760000,1606021200,5
greeenyx,0,5,0,69,1568779200,1569729600,5
fuckjayce,0,5,0,88,1556251200,1571544000,5
Inquignosis,2,3,47,6,1485752400,1563768000,5
BoofingPalcohol,0,5,0,190,1595044800,1606194000,5
Auctoritate,0,5,0,11,1609304400,1609304400,5
MinnyWild11,1,4,9,2,1566446400,1580706000,5
IkzyBud,0,5,0,42,1572753600,1608094800,5
novavein,0,5,0,5,1580792400,1583470800,5
CoverYourCoughCunt,0,5,0,299,1593403200,1601870400,5
caitlan311,0,5,0,2,1596600000,1596600000,5
cccircuit,1,4,26,7,1585454400,1586145600,5
moonstone-stardust,1,4,31,11,1592020800,1602388800,5
boonrival,0,5,0,36,1576299600,1606798800,5
RIPmyfirstaccount,0,5,0,12,1602648000,1602648000,5
bv0316,1,4,604,165,1582693200,1582693200,5
Zeroch123,0,5,0,-87,1580533200,1584763200,5
Blindkitty38,3,2,106,6,1604984400,1611637200,5
AVeryNiceBoyPerhaps,0,5,0,18,1564372800,1588392000,5
Sp33d_L1m1t,0,5,0,29,1594785600,1600574400,5
mighty-midget,1,4,202,22,1601006400,1601006400,5
fullautoluxcommie,1,4,3008,40,1585454400,1600142400,5
TChickenChaser,0,5,0,229,1549256400,1568952000,5
DefoNotAWorkAccount,0,5,0,59,1600833600,1603166400,5
Jofishyblubblub,1,4,26,11,1550811600,1550898000,5
fancytranslady,0,5,0,52,1601179200,1608613200,5
therapeuticnihilism,0,5,0,48,1544245200,1545282000,5
datmelo,0,5,0,274,1596859200,1607662800,5
Euthimo2k,0,5,0,95,1606626000,1606626000,5
cheap_dates,0,5,0,180,1608181200,1608699600,5
EggyBr3ad,2,3,155,41,1606280400,1608440400,5
swearydoctor,0,5,0,51,1580706000,1608354000,5
TrekkieTay,0,5,0,42,1592971200,1595390400,5
GreyInkling,0,5,0,75,1578718800,1580274000,5
icontrolmyowndeath,0,5,0,35,1574398800,1576558800,5
LoudCommentor,0,5,0,-4,1591243200,1591329600,5
modsRwads,0,5,0,11,1589688000,1589688000,5
wellhellthenok,0,5,0,-22,1594267200,1594267200,5
gustyo,1,4,152,14,1581829200,1601438400,5
mistergoddess,0,5,0,68,1595304000,1596945600,5
Acceptancehunter,2,3,175,8,1573534800,1582347600,5
schnickelfritz420,0,5,0,10,1572667200,1573102800,5
FuccboiOut,0,5,0,-32,1607835600,1608008400,5
RussianNobody,0,5,0,13,1583298000,1600228800,5
codawPS3aa,0,5,0,38,1567310400,1597291200,5
thereitisnow,0,5,0,96,1560571200,1575435600,5
painfool,0,5,0,91,1573102800,1592798400,5
The_Eraser123,1,4,11,53,1539835200,1568001600,5
Bubbles4455,0,5,0,43,1600142400,1607922000,5
clairelilyff,0,5,0,78,1569297600,1603684800,5
XxRocky88xX,0,5,0,35,1592712000,1592712000,5
PrettyWhore,0,5,0,99,1571630400,1588996800,5
VividToe,0,5,0,484,1599278400,1606453200,5
pectuslady,1,4,4,65,1608699600,1609304400,5
sypher2k6,2,3,207,22,1597032000,1599019200,5
accountforthisstuff,0,5,0,-16,1563768000,1576040400,5
TheShadyBitch,0,5,0,-22,1578373200,1579755600,5
designlevee,0,5,0,183,1591329600,1591675200,5
Groundbreaking_Two49,0,5,0,74,1596686400,1605070800,5
Dannygraves,0,5,0,-19,1566446400,1567051200,5
Camus____,0,5,0,56,1597896000,1602129600,5
atticus_finch25,2,3,21,12,1569211200,1569384000,5
CloudyMN1979,0,5,0,17,1583470800,1607922000,5
PRbox,1,4,11,13,1556683200,1558065600,5
Karlos_Marquez,0,5,0,54,1576731600,1598241600,5
jubi_life,2,3,61,20,1577595600,1585540800,5
Shutupwalls,0,5,0,5,1589947200,1590033600,5
Boogaboob,0,5,0,23,1592712000,1593748800,5
Iridium777,0,5,0,99,1568865600,1595217600,5
igiveup1949,0,5,0,3,1608267600,1609390800,5
Flimsy_Alternative,0,5,0,5,1571889600,1577941200,5
knufflelala,0,5,0,29,1572667200,1587096000,5
PureSmoulder,0,5,0,45,1598760000,1608613200,5
ovopax,1,4,8,19,1569384000,1605934800,5
ChuloCharm,0,5,0,24,1580014800,1609131600,5
the_real_ho_chi_minh,1,4,48,11,1607922000,1607922000,5
baked-Rezi,0,5,0,8,1605934800,1608181200,5
_IowasVeryOwn,0,5,0,177,1540612800,1580619600,5
AnimeCiety,0,5,0,66,1566014400,1566532800,5
The_crow_from_heaven,0,5,0,14,1560744000,1560916800,5
TwoEyedSam,5,0,108,0,1584331200,1595736000,5
Ilovethestarks,2,3,14,14,1594526400,1594699200,5
tarnished713,0,5,0,93,1574139600,1591848000,5
teacherwenger,1,4,23,32,1598587200,1599624000,5
theexportworld,3,2,3,-2,1540008000,1549515600,5
lilmixedbunny85,0,5,0,114,1579237200,1583643600,5
11101001001001111,0,5,0,21,1571371200,1571630400,5
rolling-guy,0,5,0,25,1579842000,1608267600,5
VerdensRigesteAnd,0,5,0,171,1574312400,1597982400,5
the-mucho-macho,1,4,10,70,1575262800,1598846400,5
macaddictr,0,5,0,46,1548651600,1602216000,5
False-Recognition,0,5,0,-2,1598500800,1601697600,5
cis_eraser_420,0,5,0,128,1564545600,1564977600,5
chicken_spears,0,5,0,40,1602648000,1611896400,5
MadicalEthics,0,5,0,29,1563076800,1585368000,5
YesACAB,0,5,0,10,1594180800,1609304400,5
Foolishoe,0,5,0,387,1562212800,1608094800,5
88264,0,5,0,101,1605502800,1606107600,5
UserDrew,0,5,0,124,1540008000,1597896000,5
ClickableLinkBot,0,5,0,12,1524628800,1537848000,5
myxyplyxy,0,5,0,13,1566532800,1607662800,5
Twillard22,0,5,0,-142,1577336400,1595649600,5
Carthraplant,0,5,0,28,1563249600,1563768000,5
learningasimliving,0,5,0,30,1576904400,1577509200,5
StrykerDK,0,5,0,133,1608699600,1608786000,5
SweetTeaDragon,0,5,0,75,1590033600,1607576400,5
imabigblackguy,0,5,0,515,1560571200,1560657600,5
dwerd1999,0,5,0,47,1587787200,1608613200,5
sorryandsafe,3,2,525,6,1569470400,1604898000,5
Better_to_have_been,0,5,0,-14,1601352000,1601438400,5
informareWORK,0,5,0,72,1554696000,1558411200,5
obese_coder,0,5,0,44,1553745600,1554782400,5
stayinalive_cpr,0,5,0,10,1586664000,1592625600,5
Neoreloaded313,0,5,0,99,1593144000,1605243600,5
sooper8,0,5,0,28,1580619600,1598241600,5
triceratopsmom,0,5,0,20,1602993600,1606798800,5
Mycolostomybagleaked,0,5,0,21,1607403600,1608699600,5
RecoveredRepuglican,0,5,0,88,1595390400,1602388800,5
slav2groive,0,5,0,-22,1590724800,1600142400,5
supguyyo,1,4,7,23,1588132800,1593144000,5
LameLord,0,5,0,106,1569902400,1575435600,5
SupGirluHungry,0,5,0,126,1587614400,1592107200,5
WedgieMaster69,2,3,487,26,1579237200,1584417600,5
Guerilla_Cro-mag,0,5,0,13,1603512000,1603598400,5
Watcher_of_Watchers,0,5,0,7,1602216000,1602302400,5
King_Pawpaw,0,5,0,-1,1588651200,1602129600,5
TriblialBrainDamblge,0,5,0,44,1588392000,1603512000,5
dalgft,0,5,0,11,1599364800,1611637200,5
hakoen,0,5,0,1,1580360400,1580878800,5
throwaway152q4,0,5,0,3,1596168000,1596168000,5
GaywetFartz,4,1,183,9,1602388800,1604203200,5
Entitled_Khaleesi,0,5,0,54,1574226000,1581310800,5
overclockedstudent,0,5,0,8,1565496000,1573966800,5
joj1205,0,5,0,33,1606885200,1608354000,5
MyNameAintWheels,0,5,0,6,1553918400,1600574400,5
Morgulblade13,1,4,513,100,1597636800,1597636800,5
NobleChildNotReally,1,4,3,17,1553140800,1577768400,5
Stephenie_Dedalus,0,5,0,39,1604984400,1605330000,5
herrbz,0,5,0,4,1604898000,1604898000,5
wepopu,0,5,0,53,1576558800,1578546000,5
SeagullFanClub,0,5,0,128,1598673600,1609131600,5
Xenait,0,5,0,48,1554868800,1554955200,5
Famous_Profile,0,5,0,33,1598068800,1605070800,5
Jayyburdd,0,5,0,10,1607922000,1607922000,5
irritabletom,0,5,0,60,1564459200,1589688000,5
BeastlyDecks,0,5,0,-27,1571112000,1571198400,5
AutoAdviceSeeker,0,5,0,40,1598673600,1608094800,5
Unknown_anonymity00,1,4,8,12,1575522000,1575522000,5
Swole_Prole,0,5,0,123,1582952400,1597550400,5
Anal-warrior,0,5,0,52,1606626000,1608440400,5
murunbuchstansangur,0,5,0,95,1588564800,1608354000,5
cool_side_of_pillow,0,5,0,30,1556424000,1564459200,5
Lucithecat,0,5,0,15,1611810000,1611810000,5
drojmg,0,5,0,7,1603598400,1603598400,5
Godhelpus1990,0,5,0,-37,1556596800,1572580800,5
Whateverbabe2,0,5,0,-25,1599883200,1602820800,5
JimmyMac80,0,5,0,233,1555992000,1573534800,5
WhyisChapter24Track9,2,3,36,9,1588824000,1593057600,5
NOLA-J,0,5,0,63,1569384000,1595390400,5
badgersprite,0,5,0,194,1601611200,1606712400,5
LennonLoaf,1,4,89,20,1579669200,1579669200,5
BigBeefySquidward,0,5,0,3,1603684800,1603771200,5
feedmesweat,0,5,0,205,1577250000,1608267600,5
ComradeCuddlefish,0,5,0,41,1550638800,1551848400,5
ObamasBalanitis,0,5,0,-15,1569124800,1569124800,5
Lusus_Naturae_,0,5,0,7,1595649600,1595822400,5
newtronicus2,0,5,0,199,1594008000,1611810000,5
MegamiOfWind,0,5,0,11,1570248000,1571803200,5
lisa_hay,1,4,324,58,1600833600,1600920000,5
antikarma98,0,5,0,44,1606453200,1608267600,5
Caucasian_Thunder,0,5,0,22,1597982400,1608094800,5
EmptyDarkness104,3,2,33,2,1600920000,1606712400,5
lHOq7RWOQihbjUNAdQCA,1,4,15,29,1556683200,1564459200,5
cavewrench,1,4,90,67,1598760000,1602302400,5
Kowlz1,0,5,0,65,1600488000,1601524800,5
CerealKillConfirmed,0,5,0,61,1575262800,1587960000,5
newmobsforall,0,5,0,25,1442203200,1577422800,5
digitor,2,3,100,23,1560744000,1602302400,5
TheArtofBenis,0,5,0,12,1568606400,1574053200,5
CivilizedNewt,0,5,0,46,1588737600,1600747200,5
Linkmyster,0,5,0,9,1562040000,1562040000,5
sunscreenonface,0,5,0,23,1561953600,1563163200,5
BleakBrandon,0,5,0,35,1602907200,1608699600,5
sardiath,0,5,0,249,1554350400,1576645200,5
TheEmpressIsIn,3,2,123,2,1600142400,1600920000,5
tabas123,0,5,0,53,1595476800,1599451200,5
Toeasty,0,5,0,220,1566014400,1592712000,5
blues_snoo,0,5,0,37,1556596800,1607403600,5
archangelbyburial,1,4,6,154,1599105600,1600228800,5
SingleWomenNearYou,0,5,0,23,1602820800,1602820800,5
Fuzzatron,0,5,0,8,1598414400,1598500800,5
applesweaters,2,3,359,14,1581051600,1606021200,5
BlueThoth,1,4,9,19,1556164800,1570075200,5
Adventurous-Face-794,0,5,0,53,1605675600,1608872400,5
iDontReallyCareUno,0,5,0,15,1594958400,1594958400,5
ariolitmax,0,5,0,150,1577422800,1577595600,5
chillbuttaholic,0,5,0,48,1602129600,1602388800,5
Phizzsicks,1,4,59,17,1607403600,1607576400,5
aDamnCommunist,0,5,0,14,1593748800,1603425600,5
nixed9,0,5,0,-2,1571803200,1571803200,5
amayagab,0,5,0,65,1603512000,1609218000,5
minyman60,0,5,0,8,1575867600,1588392000,5
Hoboman2000,0,5,0,4,1585454400,1585454400,5
avishai1234,1,4,10,13,1599796800,1605157200,5
DipsytheDankMemelord,1,4,3,9,1602561600,1611982800,5
jorge-cepeda,0,5,0,11,1602648000,1603425600,5
FiredForIncompetence,0,5,0,17,1597377600,1606712400,5
emjemm,0,5,0,134,1600747200,1608699600,5
Solange_Saliere,0,5,0,94,1596513600,1597204800,5
sum41withme,2,3,14,12,1575262800,1575694800,5
thesoleprano,0,5,0,337,1575522000,1591329600,5
pongogene,0,5,0,38,1551848400,1552536000,5
PonderingPattaya,1,4,13,4,1551848400,1557633600,5
Seethesvt,0,5,0,2,1567828800,1608267600,5
psychgirl97,2,3,134,6,1579064400,1596254400,5
PluniaZ,0,5,0,38,1566360000,1567483200,5
kittyvanilla,3,2,38,7,1606712400,1607576400,5
NoBodySpecial51,0,5,0,34,1600228800,1608872400,5
Fr0me,0,5,0,20,1588305600,1589774400,5
Clen23,0,5,0,45,1611896400,1611896400,5
Danny_Mc_71,1,4,464,120,1607144400,1607835600,5
deadlegs12,0,5,0,20,1565841600,1568347200,5
OwnedCaucasian,0,5,0,28,1575435600,1587355200,5
DoTheRightThing1953,0,5,0,29,1575522000,1607230800,5
juicyJerrrry,0,5,0,-58,1576386000,1607403600,5
darklordzz,0,5,0,65,1586404800,1588305600,5
five-methoxy,0,5,0,28,1590120000,1592366400,5
manateemilitia,0,5,0,14,1607576400,1607576400,5
shapirostyle,0,5,0,9,1594267200,1594440000,5
Fv-obR,0,5,0,-5,1603512000,1603598400,5
KV5life,0,5,0,-22,1595476800,1597377600,5
igo4thewings,0,5,0,38,1602129600,1602216000,5
dippingstar,0,5,0,66,1594872000,1605934800,5
darkelf29,0,5,0,6,1600488000,1603684800,5
BeMyLittleSpoon,0,5,0,46,1548306000,1570507200,5
SimonGn,0,5,0,20,1579410000,1579410000,5
RiccardoRichieRich,0,5,0,24,1582952400,1583384400,5
GonzosWhiteShark,0,5,0,682,1611982800,1612069200,5
thchosenjuanliveson,0,5,0,16,1575867600,1575954000,5
farmerkaren81,0,5,0,56,1591329600,1595217600,5
that_one_bastard,0,5,0,9,1607835600,1607835600,5
meowza93,0,5,0,132,1575349200,1588651200,5
RevolutionaryShine9,0,5,0,-18,1590724800,1595995200,5
superscandalous,1,4,12,8,1603425600,1608526800,5
JoeCX,1,4,0,-1,1594180800,1594180800,5
Driftkingtofu,0,5,0,-45,1564891200,1565323200,5
lelieu,1,4,126,36,1568779200,1609390800,5
HauntedPrinter,0,5,0,21,1584331200,1602648000,5
insurehr,4,1,62,1,1590292800,1593662400,5
There_is_a_use,0,5,0,47,1583557200,1608354000,5
PepsiMoondog,0,5,0,364,1597204800,1602648000,5
Hivac-TLB,0,5,0,61,1577163600,1606539600,5
hotrodruby,0,5,0,-15,1605330000,1605330000,5
MikioUchiha98,0,5,0,29,1569643200,1588392000,5
WorldlyLog,0,5,0,5,1607922000,1608008400,5
daughteroffergus,2,3,9062,80,1608354000,1608526800,5
softbarker,1,4,13,41,1582347600,1583384400,5
themadcheshire,1,4,27,15,1601697600,1601784000,5
Swuuusch,0,5,0,0,1573966800,1598760000,5
BasicInsight,1,4,1,-3,1559275200,1559275200,5
SmokeyMcHaze,0,5,0,134,1587268800,1598846400,5
Fink665,0,5,0,39,1592884800,1609390800,5
Keywork29,1,4,404,50,1582779600,1597636800,5
Syreeta5036,0,5,0,12,1577595600,1578632400,5
trashfiremarshmallow,0,5,0,28,1576645200,1592712000,5
An-autistic-cat,0,5,0,19,1600833600,1607144400,5
FulaniQueen,1,4,9,12,1605070800,1612846800,5
Busidoo,0,5,0,17,1573448400,1583985600,5
HerrGeorge,0,5,0,24,1595908800,1607922000,5
LordOfAlpacas,1,4,5,12,1573621200,1573621200,5
MACKSBEE,0,5,0,14,1608613200,1608613200,5
Komrade_Kalashnikov,1,4,28,44,1592884800,1607922000,5
usersquare,0,5,0,13,1554868800,1556683200,5
knat0,0,5,0,35,1568001600,1571025600,5
idiot206,0,5,0,78,1587528000,1607835600,5
wellwellwell0404,1,4,27,10,1560916800,1560916800,5
Mushihime64,0,5,0,21,1573016400,1606971600,5
ArcticFoxBunny,0,5,0,33,1537848000,1546664400,5
city_scape,1,4,53,9,1604984400,1608699600,5
I_beat_reCAPTCHA,0,5,0,7,1565236800,1590033600,5
ezra_is_smelly,3,2,636,20,1598414400,1606626000,5
YesShifuStalin,0,5,0,3,1600142400,1600228800,5
jontejj,0,5,0,11,1564027200,1589774400,5
Dmanadatory,0,5,0,152,1591156800,1591156800,5
FlyingKitesatNight,0,5,0,28,1590379200,1600747200,5
Mikey_B,0,5,0,176,1586404800,1612069200,5
Known-Distribution-9,0,5,0,25,1598500800,1608699600,5
Abnormalsuicidal,0,5,0,0,1607662800,1607749200,5
qtsarahj,0,5,0,38,1577077200,1596081600,5
BadSpellingMistakes,1,4,528,8,1608786000,1612069200,5
IDontAgreeSorry,0,5,0,15,1608181200,1608181200,5
ssprinnkless,0,5,0,12,1525924800,1570939200,5
Gluuon,0,5,0,93,1596427200,1605416400,5
mrjibblets138,1,4,20,15,1584504000,1603425600,5
Onion-Fart,0,5,0,61,1593662400,1606971600,5
EuphemismTreadmill,1,4,3,7,1404273600,1425358800,5
IcedCaramelPie,0,5,0,-26,1579323600,1579496400,5
HifiBoombox,0,5,0,122,1594440000,1608699600,5
cjc160,0,5,0,27,1586750400,1607490000,5
machimus,0,5,0,11,1581138000,1581138000,5
WhatItIsToBurn925,0,5,0,17,1604811600,1605416400,5
suknyuwe,1,4,9,93,1585627200,1602129600,5
Polestar-Lemniscate,1,4,102,7,1601179200,1601265600,5
mawmishere,0,5,0,31,1577336400,1583643600,5
moleyfeeners,0,5,0,20,1607490000,1608354000,5
originof98,0,5,0,20,1587009600,1587182400,5
Kate-a-roo,0,5,0,35,1559620800,1582434000,5
ObedientProle,0,5,0,72,1576645200,1578459600,5
endbuster,0,5,0,23,1590379200,1590379200,5
gaokeai,0,4,0,27,1562299200,1566446400,4
caspain1397,0,4,0,114,1571371200,1591329600,4
ArtOfGnosis,0,4,0,273,1588478400,1601611200,4
life_or_productivity,1,3,6,11,1593489600,1594699200,4
daftcookies,0,4,0,15,1611810000,1611810000,4
Buii3t-Sp33d,0,4,0,36,1595563200,1609218000,4
aakie9,0,4,0,44,1589860800,1591243200,4
zfighterXsurvivor,1,3,3,26,1578200400,1581915600,4
17times2,0,4,0,40,1587096000,1587096000,4
ThereIsNoGoodJob,0,4,0,10,1553140800,1553227200,4
Destinamos,0,4,0,-2,1608440400,1608440400,4
-MrCrowley,1,3,16,15,1574658000,1594440000,4
TylerDurdenUMD,0,4,0,4,1573534800,1579755600,4
pl4tform,0,4,0,34,1603771200,1605243600,4
AnselmFox,0,4,0,-2,1585195200,1585281600,4
Whatacheaptentshow,0,4,0,4,1576645200,1576645200,4
DannyFuckingCarey,0,4,0,13,1574917200,1583899200,4
Catnip_Kingpin,0,4,0,5,1577250000,1577250000,4
DegenerateMetalhead,0,4,0,8,1594094400,1595131200,4
DocTomoe,0,4,0,3,1608699600,1609822800,4
Spacemarine658,0,4,0,221,1575262800,1600228800,4
epicredditor1234,0,4,0,42,1537070400,1542430800,4
Dirty_Commie_Jesus,0,4,0,35,1589428800,1594094400,4
Medieval_Reddit,0,4,0,48,1580533200,1590120000,4
IWannaBeAnArchitect,0,4,0,22,1576040400,1599019200,4
AceNecron,1,3,11,7,1601524800,1601611200,4
We3dmanreturns,0,4,0,73,1601697600,1608699600,4
Nemesinthe,1,3,2355,496,1550552400,1582347600,4
PerryAwesome,0,4,0,19,1607490000,1607490000,4
Sibonda,0,4,0,14,1560312000,1580274000,4
KingCult,0,4,0,36,1550293200,1560744000,4
Wryx,4,0,34,0,1441252800,1452315600,4
nairblizard,0,4,0,7,1572235200,1606971600,4
rodsn,0,4,0,-4,1592107200,1592193600,4
H3phaistos,0,4,0,89,1566878400,1568001600,4
MelissaP256,0,4,0,38,1599883200,1607576400,4
XxShArKbEaRxX,0,4,0,31,1577941200,1602734400,4
gcrimson,0,4,0,9,1565323200,1604203200,4
Haymitch12345,0,4,0,5,1592712000,1595736000,4
Luciferishuman,0,4,0,15,1608526800,1608613200,4
theripoffartist,0,4,0,11,1578459600,1606280400,4
TheWolphman,0,4,0,-22,1605589200,1605589200,4
Agente_del_Gobierno,0,4,0,19,1596168000,1607490000,4
sir-hiss,0,4,0,9,1591502400,1591502400,4
coffeedonutpie,0,4,0,-1,1599105600,1599192000,4
Kwdg,0,4,0,24,1578632400,1579064400,4
SlayingAces,0,4,0,5,1575349200,1575435600,4
remyvdp1,0,4,0,4,1583125200,1583125200,4
ugh168,0,4,0,19,1601784000,1606712400,4
El_Androi,0,4,0,4,1590897600,1595736000,4
PublicDomainKitten,0,4,0,4,1594872000,1594872000,4
robert_taylor_95,0,4,0,-8,1576731600,1588996800,4
Juraceek,0,4,0,-9,1598673600,1599883200,4
Mediocrity-101,0,4,0,6,1608699600,1608872400,4
SHLOMO_SHEKELFELD,0,4,0,12,1561176000,1562731200,4
Electrical_Taste_954,0,4,0,11,1608526800,1608526800,4
Affectionate-Ad7018,0,4,0,-23,1605416400,1609218000,4
shade_of_freud,0,4,0,64,1598155200,1598155200,4
riolay,1,3,24,5,1556510400,1556596800,4
ToughWheel,0,4,0,29,1553832000,1556337600,4
py34567,0,4,0,53,1583298000,1584590400,4
PCOverall,0,4,0,32,1593576000,1600488000,4
Lokiando,0,4,0,7,1601870400,1604379600,4
Garravato,0,4,0,10,1597550400,1611982800,4
jfk_47,0,4,0,15,1585454400,1612069200,4
Minudworfe,0,4,0,12,1608699600,1608786000,4
chaosmosis_1,2,2,1140,42,1554436800,1556078400,4
majines,0,4,0,1,1608267600,1608267600,4
GrantSweatshirt,0,4,0,16,1546491600,1547442000,4
donewittisshit,0,4,0,33,1594267200,1611982800,4
I_Use_Reddit_xD,0,4,0,18,1581483600,1599537600,4
Gardelucina,0,4,0,24,1553486400,1592539200,4
bigmonkeyboy,0,4,0,8,1575694800,1575694800,4
Hotdogsack,0,4,0,5,1585108800,1585108800,4
BlueZen10,0,4,0,11,1607144400,1611810000,4
lordgattpavesini,0,4,0,-26,1571025600,1571112000,4
BrainBoy000,0,4,0,7,1561089600,1561089600,4
XColdLogicX,0,4,0,76,1560484800,1608440400,4
M-o-r-p-h,0,4,0,63,1602388800,1605502800,4
steadysippin,0,4,0,7,1548478800,1556337600,4
sailfist,0,4,0,304,1575608400,1576645200,4
1kIslandStare,0,4,0,73,1576731600,1579842000,4
ahx-dosnsts,0,4,0,6,1575522000,1575608400,4
Altcoop,1,3,28,26,1602561600,1609304400,4
Aep2311,0,4,0,4,1611982800,1611982800,4
CourierSixtyNine,0,4,0,16,1595822400,1605502800,4
jblood31,0,4,0,16,1557720000,1607922000,4
Im-a-magpie,0,4,0,87,1602388800,1605416400,4
photozine,0,4,0,29,1606021200,1607230800,4
NotsoGreatsword,0,4,0,35,1572235200,1606971600,4
Miggy345,0,4,0,33,1598760000,1603252800,4
sandsalamand,0,4,0,7,1588910400,1591675200,4
bioallegiance,1,3,26,9,1557460800,1557547200,4
purplelephant,0,4,0,61,1605589200,1606885200,4
lunalovegoodx,0,4,0,18,1588392000,1593057600,4
QuicheSmash,0,4,0,6,1603512000,1603512000,4
whoop_de_whammy,0,4,0,28,1583298000,1609736400,4
goust23,1,3,38,8,1597982400,1598068800,4
WHlTETHUNDER,0,4,0,16,1579410000,1579496400,4
Iamlamarodom,0,4,0,-55,1595044800,1611810000,4
FlareCoinToTheMoon,0,4,0,-68,1603944000,1604030400,4
mrmniks,0,4,0,-30,1585454400,1594440000,4
derglingrush,0,4,0,1,1591243200,1607317200,4
FloatingBlimpShip,0,4,0,24,1605243600,1605243600,4
N0ahface,0,4,0,-6,1605589200,1605589200,4
shadowwolfsl,0,4,0,9,1584590400,1601784000,4
LunarSol126,0,4,0,191,1578027600,1580360400,4
SeriousGesticulation,0,4,0,78,1594180800,1605762000,4
MurrSuitor,0,4,0,12,1598846400,1608958800,4
Sixshootingtim,0,4,0,-13,1602648000,1602648000,4
Austere5,0,4,0,51,1583298000,1595649600,4
sundayhungover,1,3,31,108,1574053200,1597118400,4
TrentTBTEDI,1,3,4,38,1562817600,1594094400,4
plongedanslesjambes,0,4,0,103,1582952400,1593057600,4
jaredwads,0,4,0,6,1585108800,1585108800,4
FantasticCar3,1,3,10,3,1605934800,1606107600,4
Hypolag,0,4,0,21,1570334400,1576299600,4
Deathwatch72,0,4,0,6,1591502400,1591588800,4
AlanTheBothersome,0,4,0,28,1580446800,1596945600,4
Streetquats,0,4,0,38,1592366400,1592366400,4
mustache_ride_,0,4,0,24,1561780800,1561780800,4
ahhhhhhhhhhhhh93,0,4,0,160,1596168000,1604811600,4
Spiraleddie,0,4,0,14,1609390800,1612069200,4
Chevron7Encoded,0,4,0,8,1573016400,1581310800,4
teebone954,0,4,0,4,1561003200,1561003200,4
hygieia19,2,2,129,12,1565582400,1572667200,4
retro_and_chill,0,4,0,72,1585713600,1589515200,4
paranoidtoad,3,1,126,3,1581051600,1607058000,4
Angryotter97,0,4,0,22,1605330000,1608786000,4
727_The_funny_number,0,4,0,134,1594267200,1608440400,4
Session801,0,4,0,31,1606107600,1607576400,4
mikesanerd,0,4,0,78,1551243600,1552968000,4
craobh,0,4,0,28,1601870400,1607230800,4
TheLakeIsleInnisfree,0,4,0,35,1584936000,1594008000,4
50c878,0,4,0,48,1606194000,1607749200,4
throwavpdway,1,3,34,6,1548910800,1549515600,4
BFairorBSquare,1,3,76,14,1604898000,1606280400,4
Ski-Bummin,0,4,0,91,1593144000,1593144000,4
cilsey,0,4,0,34,1564372800,1606798800,4
hofoot29,0,4,0,19,1598673600,1598760000,4
grinningserpent,0,4,0,-23,1606539600,1606539600,4
asavageant,0,4,0,78,1598155200,1609477200,4
umblegar,0,4,0,18,1583470800,1608094800,4
tatertot2001,0,4,0,4,1599796800,1609563600,4
Rhombico,0,4,0,275,1547874000,1547874000,4
durtiestburd,1,3,88,28,1568174400,1568260800,4
boringdystopianslave,0,4,0,24,1611810000,1611982800,4
bambies,0,4,0,4,1599710400,1599710400,4
1happylife,0,4,0,52,1598760000,1598846400,4
dykepencevp,0,4,0,27,1553918400,1577509200,4
Neirchill,0,4,0,15,1585454400,1594440000,4
PilotOblackbird,0,4,0,16,1585108800,1605070800,4
Klyuchevskaya,0,4,0,3,1588737600,1588824000,4
Test0004,0,4,0,22,1597723200,1598068800,4
oldie_gosey,0,4,0,7,1600747200,1600747200,4
FlexibleCommunist,1,3,6,5,1576126800,1576213200,4
Endewraith,1,3,18,13,1594872000,1594872000,4
dabhiattcehr,0,4,0,7,1608526800,1609390800,4
throwwawayhelp6387,0,4,0,42,1601524800,1601524800,4
8BitMunky,0,4,0,15,1606539600,1608181200,4
wannabesq,0,4,0,28,1573016400,1573016400,4
duffman12,0,4,0,2,1571198400,1586232000,4
Areldyb,0,4,0,57,1424062800,1596859200,4
_K_S_V_,0,4,0,95,1593230400,1597377600,4
IISMRSACK,0,4,0,11,1575954000,1577941200,4
Jiladah,1,3,0,3,1600488000,1600574400,4
ndrums,0,4,0,19,1607490000,1612155600,4
EmperorMing101,0,4,0,250,1608354000,1608872400,4
Mobius1701A,0,4,0,2,1612155600,1612155600,4
anthropocenist,0,4,0,32,1584590400,1584590400,4
syugenius,0,4,0,63,1565755200,1565755200,4
yark2,0,4,0,25,1584244800,1584331200,4
WakingTheCadaver,1,3,9,46,1584763200,1596340800,4
Phodge96,0,4,0,12,1596600000,1606885200,4
elliotcm,0,4,0,22,1602820800,1602907200,4
Bonaccorso_di_Novara,0,4,0,47,1598760000,1607403600,4
throwaway657967,0,4,0,23,1604030400,1605070800,4
Kaio_,0,4,0,15,1599710400,1611982800,4
Sipredion,0,4,0,37,1597377600,1599019200,4
Vakieh,0,4,0,-18,1605934800,1605934800,4
queenofbo0ks,2,2,44,11,1603425600,1605416400,4
secretspareaccount,0,4,0,168,1597464000,1597464000,4
pluxev,0,4,0,7,1479618000,1484110800,4
littlest_lemon,0,4,0,17,1578632400,1582866000,4
forkmerunning,1,3,8,32,1594785600,1608786000,4
oxyclean123,0,4,0,13,1580446800,1602648000,4
Dunnersstunner,1,3,3,8,1565668800,1573102800,4
dank2918,1,3,11,157,1592539200,1605502800,4
braedizzle,0,4,0,9,1600660800,1600920000,4
Loftieleaf,1,3,52,16,1596081600,1602734400,4
itsathrowaway101010,1,3,32,6,1607403600,1607403600,4
opedidntseeyouthere,0,4,0,-14,1606021200,1608094800,4
piiig,0,4,0,10,1599364800,1606453200,4
StonerNorseMan,0,4,0,19,1572843600,1573275600,4
Farkleton56,0,4,0,39,1553054400,1561348800,4
Faminals,0,4,0,33,1585368000,1602475200,4
rhondevu,0,4,0,41,1582606800,1609218000,4
IndiaBusinessPark,1,3,0,1,1594785600,1594785600,4
ronniepotts,0,4,0,71,1563854400,1563854400,4
cain62,0,4,0,35,1611896400,1612069200,4
BuyBitcoinYaDingus,0,4,0,3,1595995200,1597809600,4
condorama,0,4,0,12,1594872000,1600747200,4
Maca2166,0,4,0,-5,1559620800,1559793600,4
Algebra_Child,0,4,0,50,1606712400,1611982800,4
Ryzarony23,0,4,0,42,1578546000,1609304400,4
Pipodedown,0,4,0,5,1596859200,1600747200,4
santacruisin,0,4,0,35,1573707600,1586664000,4
awesome_popsicle,1,3,2,4,1590033600,1590120000,4
biscuitsteve,0,4,0,51,1583384400,1600747200,4
DiscardedShoebox,0,4,0,-3,1606021200,1608786000,4
ShahanshahShami,0,4,0,29,1582866000,1608354000,4
ramot1,0,4,0,11,1575522000,1609477200,4
Chris2112,0,4,0,-13,1592366400,1602216000,4
mr-ocarina,0,4,0,73,1592884800,1596427200,4
2211abir,0,4,0,14,1609045200,1609045200,4
milkshakes_for_mitch,0,4,0,147,1587009600,1604030400,4
Bartleby11,0,4,0,37,1583470800,1585281600,4
rrapoheka,1,3,29,11,1596859200,1596945600,4
woah2020sucks,0,4,0,0,1594440000,1594526400,4
louisgjohnson,0,4,0,60,1559707200,1559707200,4
p1rk0la,1,3,18,56,1562558400,1596340800,4
Thatssomegoodshit444,0,4,0,13,1562126400,1566360000,4
ChaosIsMyLife,0,4,0,47,1606626000,1607144400,4
GimmeDemDumplins,0,4,0,56,1566878400,1603598400,4
respine,1,3,88,5,1603598400,1604203200,4
sub_burn20,0,4,0,13,1595563200,1599019200,4
MildlyWildPigeon,0,4,0,42,1568779200,1568952000,4
Conglacior,0,4,0,8,1596340800,1599019200,4
BallsDeepintheTurtle,0,4,0,145,1607317200,1611896400,4
sphealwithit,1,3,14,3,1601956800,1601956800,4
pablosm11,0,4,0,116,1593835200,1593835200,4
stinkytoesbitch,0,4,0,10,1607230800,1608354000,4
bigbybrimble,0,4,0,57,1575090000,1584763200,4
jerryoc923,1,3,45,23,1578978000,1592107200,4
elkehdub,0,4,0,2,1586318400,1588996800,4
toasted_cracker,0,4,0,8,1573794000,1597118400,4
oligodendrocyt3,0,4,0,15,1600488000,1611637200,4
inmeucu,0,4,0,32,1603771200,1608613200,4
Talmuhdick,0,4,0,7,1555300800,1555300800,4
owlsarenotreal23,0,4,0,48,1552708800,1552795200,4
Arctic-peace45,0,4,0,18,1606280400,1606712400,4
sherm-stick,0,4,0,40,1603512000,1603512000,4
dyslexicgeorge,1,3,656,8,1600747200,1600833600,4
kd_aragorn87,0,4,0,70,1584244800,1588910400,4
worstwerewolf,0,4,0,359,1606626000,1606712400,4
thesnowgirl147,0,4,0,313,1604379600,1608267600,4
DWShimoda,0,4,0,-14,1554523200,1554523200,4
MaxPatatas,0,4,0,12,1574485200,1575090000,4
didyoueatmyshark,0,4,0,6,1584504000,1584590400,4
StopwatchSparrow,1,3,8,91,1570075200,1596254400,4
Kookahforhookah,0,4,0,33,1569211200,1605070800,4
Djentleman_,0,4,0,16,1611982800,1611982800,4
kimkaibear,1,3,7,6,1602043200,1602043200,4
Xenta_Demryt,1,3,109,41,1562731200,1575694800,4
JawTn1067,0,4,0,2,1608267600,1608267600,4
brunomocsa,0,4,0,8,1606539600,1607144400,4
stuckinthebedimade,0,4,0,25,1579669200,1586836800,4
stank-sinatra,0,4,0,92,1550206800,1590984000,4
kransho,0,4,0,25,1563768000,1566360000,4
varkarrus,0,4,0,26,1514091600,1569988800,4
Jelbow,0,4,0,11,1602993600,1612069200,4
trollivier,1,3,149,6,1605502800,1609390800,4
Alazana,0,4,0,75,1584158400,1584244800,4
SmallBirb,1,3,100,16,1575262800,1575262800,4
handris,0,4,0,14,1559102400,1570766400,4
Ace-Ventura,0,4,0,29,1579928400,1584072000,4
BlackHatBadger,0,4,0,2,1611810000,1612501200,4
OptimalCynic,0,4,0,9,1606885200,1606885200,4
RitaMoleiraaaa,0,4,0,13,1573966800,1600747200,4
Nevadajack87,0,4,0,5,1582088400,1582088400,4
makeinstall,0,4,0,10,1599451200,1599451200,4
Lers3390,0,4,0,-5,1606626000,1606626000,4
yagamibank,0,4,0,80,1605157200,1608267600,4
Data1256,0,4,0,8,1547701200,1554004800,4
Trustheuniverse9,0,4,0,9,1570420800,1572667200,4
PuntForRedOctober,1,3,11,15,1606885200,1608872400,4
ViennaKrakow,0,4,0,4,1595736000,1612069200,4
RustyKrank,0,4,0,7,1594353600,1595304000,4
--Edog--,0,4,0,48,1538971200,1551934800,4
clydefrog9,0,4,0,64,1557892800,1608267600,4
bunswithguns,0,4,0,84,1596600000,1607230800,4
ascendantshark,0,4,0,28,1591675200,1600401600,4
bo_bo_go_go_,0,4,0,12,1606971600,1608440400,4
ad_reg,0,4,0,16,1590811200,1598155200,4
ToVoTillo,0,4,0,48,1604030400,1606885200,4
KillingTheWait,1,3,18,6,1608094800,1609390800,4
titandude21,0,4,0,20,1592193600,1604466000,4
meatballsandlingon2,0,4,0,102,1593835200,1612069200,4
MFTPC,0,4,0,-22,1598673600,1598760000,4
classicrando,0,4,0,11,1566273600,1584676800,4
TheInfernalVortex,0,4,0,34,1603512000,1603512000,4
SnooCookies487,0,4,0,38,1607662800,1608786000,4
nevertulsi,0,4,0,-6,1588651200,1595044800,4
dr5ivepints,0,4,0,68,1581138000,1604379600,4
macswell,0,4,0,32,1599451200,1600142400,4
Gentleman_Viking,1,3,43,17,1576990800,1580360400,4
NotClever,0,4,0,6,1591243200,1594526400,4
onechamp27,1,3,17,4,1599883200,1601092800,4
thebornotaku,0,4,0,50,1560657600,1608699600,4
sleepybitchdisorder,0,4,0,7,1597982400,1597982400,4
TheRainbowNinja,0,4,0,12,1559966400,1604293200,4
redsun1478,0,4,0,338,1572408000,1572408000,4
Roddy-,0,4,0,56,1551848400,1604984400,4
bapurasta,0,4,0,8,1556164800,1563768000,4
Ozymandingo2020,0,4,0,13,1603598400,1603598400,4
KingDavid73,0,4,0,109,1593748800,1596945600,4
turtle1123581325,2,2,59,4,1586404800,1596945600,4
MochaBlack,0,4,0,28,1571716800,1586664000,4
Futuristic_Caveman,0,4,0,33,1567656000,1568347200,4
bravelion96,0,4,0,44,1602907200,1608699600,4
_Infinite-questions_,0,4,0,16,1597377600,1597377600,4
ShyWheatSeeds,2,2,54,9,1574312400,1588046400,4
theluckkyg,0,4,0,25,1583812800,1608181200,4
platinum_thoughts,0,4,0,27,1577682000,1583125200,4
daemonexmachina,0,4,0,-21,1579150800,1584072000,4
carlynaner,1,3,10837,65,1604116800,1608526800,4
JuppHartmann,2,2,24,8,1595217600,1598068800,4
El-borto78,0,4,0,275,1602993600,1611896400,4
rangerfan9,0,4,0,10,1568865600,1576472400,4
DuckDuckPro,0,4,0,21,1585195200,1611982800,4
northern_wobbly,0,4,0,60,1508126400,1513486800,4
unextinguishable,0,4,0,15,1600574400,1603252800,4
pickledhands,0,4,0,9,1587096000,1587528000,4
chickendrumleg,0,4,0,-105,1597809600,1597809600,4
MorningStarCorndog,0,4,0,30,1586836800,1586836800,4
FredNasr,0,4,0,173,1606280400,1608354000,4
MuySpicy,0,4,0,18,1572580800,1573707600,4
the-untz,1,3,438,45,1588564800,1588651200,4
Autobrot,0,4,0,51,1584417600,1606626000,4
PoorCobblerFamily,1,3,210,8,1573102800,1574658000,4
ModulusFunction,0,4,0,94,1565496000,1572753600,4
4d6f6d6f7461726f,0,4,0,2,1568088000,1568088000,4
kajEbrA3,0,4,0,-57,1587182400,1587441600,4
Legitimate_Reaction,0,4,0,69,1569124800,1603339200,4
JuanOnlyJuan,0,4,0,4,1597377600,1608267600,4
Greatcommentary,1,3,7,3,1594267200,1601784000,4
manojar,0,4,0,12,1555387200,1559275200,4
Ikeris,0,4,0,30,1548824400,1550638800,4
RuggyDog,0,4,0,13,1589083200,1592193600,4
Southport84,0,4,0,3,1603512000,1603512000,4
polarcub2954,0,4,0,6,1538971200,1538971200,4
Willy_Stonka,0,4,0,112,1608613200,1609131600,4
xyzpdq1,0,4,0,64,1599019200,1609477200,4
rorockll,0,4,0,31,1595044800,1605675600,4
ShotSkiByMyself,0,4,0,9,1603512000,1607835600,4
ForresterAsh1669,0,4,0,193,1575435600,1578805200,4
monobrow_pikachu,0,4,0,16,1599969600,1600056000,4
TheyHaveToGo,0,4,0,49,1574053200,1574398800,4
Diaper-911,1,3,86,38,1608267600,1608786000,4
googleplex1000,0,4,0,129,1558497600,1585281600,4
Sheep_Shagger420,0,4,0,3,1606626000,1606626000,4
comeditime,0,4,0,11,1599451200,1599537600,4
HannibalK,0,4,0,-4,1596513600,1607576400,4
eggbert194,0,4,0,8,1577077200,1592107200,4
dontcareboy,0,4,0,23,1602302400,1608872400,4
sinedpick,0,4,0,-149,1603598400,1609304400,4
SlipStax,0,4,0,8,1565409600,1566273600,4
ayewussup,0,4,0,17,1572408000,1593576000,4
bhd_ui,0,4,0,99,1565755200,1606107600,4
razzytrazza,0,4,0,28,1573016400,1608699600,4
bigrichardpic,0,4,0,166,1568520000,1605157200,4
Ark76RageMonster,0,4,0,-23,1581138000,1581224400,4
AlfieHitchcock,0,4,0,7,1563422400,1605589200,4
KaliStorm,0,4,0,36,1595563200,1595563200,4
Wagz387,1,3,13,7,1591329600,1591416000,4
kaiju505,1,3,73,24,1577682000,1607144400,4
wafflesoulsss,0,4,0,410,1570420800,1608786000,4
lady_in_grey95,3,1,2056,2,1598068800,1601697600,4
pokemon-gangbang,0,4,0,38,1587528000,1589515200,4
redeyesofnight,0,4,0,12,1572667200,1572667200,4
anotherbook,0,4,0,6,1591761600,1591761600,4
Moreshawten,0,4,0,4,1612155600,1612155600,4
wavechecker9000,1,3,8,4,1600488000,1600747200,4
NinjaGrandma,0,4,0,43,1585022400,1604030400,4
Dubleron,0,4,0,8,1606366800,1609563600,4
CommanderKnull,0,4,0,0,1595908800,1595995200,4
vitonga,0,4,0,17,1602129600,1606021200,4
APileOfLooseDogs,0,4,0,76,1560139200,1591502400,4
Worldly-Bid,0,4,0,10,1587873600,1589860800,4
abbelleau,1,3,67,109,1601524800,1608786000,4
Watermelon_ghost,0,4,0,42,1598414400,1611982800,4
RideForHouseMartell,1,3,26,8,1595908800,1597982400,4
curbstompme,0,4,0,36,1581915600,1581915600,4
j1mb0,0,4,0,128,1597723200,1611896400,4
SpaceCommanda,0,4,0,11,1557115200,1572930000,4
slartybartfast6,0,4,0,37,1594353600,1608786000,4
falsehitler,0,4,0,58,1597118400,1606626000,4
dvidsilva,0,4,0,14,1572843600,1577854800,4
Ghoatz,0,4,0,19,1581397200,1606194000,4
xmashamm,0,4,0,5,1598846400,1598932800,4
Kyrios_Rogue,0,4,0,11,1598673600,1598673600,4
Mageecu,0,4,0,116,1559880000,1591934400,4
xSquawk,1,3,8,8,1588737600,1588737600,4
morgause799,0,4,0,116,1572148800,1574658000,4
CoffeeScamp,0,4,0,32,1608699600,1608699600,4
opheodrysaestivus,0,4,0,220,1592798400,1606021200,4
La-Belle-Gigi,0,4,0,17,1602216000,1605070800,4
80_firebird,0,4,0,68,1604984400,1604984400,4
daryl_feral,0,4,0,-13,1575694800,1596513600,4
5tr4nGe,0,4,0,66,1567742400,1591156800,4
DoodMcGuy,0,4,0,146,1603080000,1603080000,4
arknarcoticcrop,0,4,0,15,1594267200,1601092800,4
erm2500,1,3,20,10,1580878800,1597982400,4
TheTigersAreNotReal,0,4,0,11,1598932800,1600574400,4
KIPYIS,0,4,0,16,1608267600,1608267600,4
TekTrixter,1,3,3,38,1571889600,1576472400,4
texican1911,0,4,0,5,1599624000,1599624000,4
Skink4Prez,1,3,2,59,1598932800,1600574400,4
elvecent,0,4,0,8,1579237200,1606021200,4
WebCock,0,4,0,-18,1591243200,1594872000,4
pls_bsingle,0,4,0,135,1581915600,1583298000,4
HealthyCapacitor,0,4,0,21,1598500800,1598500800,4
butthurtberniebro,1,3,334,3,1546405200,1548651600,4
GOpencyprep,0,4,0,12,1554091200,1578978000,4
poopyhelicopterbutt,0,4,0,6,1583643600,1605589200,4
examinedliving,0,4,0,32,1591502400,1611896400,4
carsann,0,4,0,58,1559448000,1561953600,4
filtertippy,0,4,0,43,1592020800,1608094800,4
zoinks690,0,4,0,272,1603684800,1609304400,4
tanitanitani,0,4,0,27,1559188800,1560484800,4
RonPearlmansJaw,1,3,25,5,1608181200,1608181200,4
Forest_Nerd,0,4,0,86,1601956800,1601956800,4
TransTechpriestess,0,4,0,8,1578891600,1580360400,4
Useful_Comfortable,0,4,0,12,1562731200,1566878400,4
Velhalgus,0,4,0,37,1563076800,1577595600,4
latouchefinale,0,4,0,317,1601352000,1601870400,4
Agglet,0,4,0,29,1599710400,1599796800,4
somecrazything,1,3,105,17,1584504000,1600660800,4
genitalgore,0,4,0,90,1597377600,1607317200,4
dame_de_boeuf,0,4,0,87,1606539600,1606626000,4
the-woman-respecter,0,4,0,26,1568952000,1573102800,4
glassesonacat,1,3,13,8,1600315200,1600315200,4
Javlington,0,4,0,12,1597809600,1597809600,4
jacob6875,0,4,0,41,1585454400,1585627200,4
polerix,0,4,0,7,1576731600,1585022400,4
Werecommingwithyou,0,4,0,28,1604293200,1607403600,4
bkorsedal,0,4,0,44,1582520400,1582606800,4
Hi-I-am-Lloyd,0,4,0,5,1596945600,1600228800,4
JSBraga,0,4,0,20,1587268800,1587355200,4
braindead_gamedev,0,4,0,269,1598760000,1608872400,4
Sunny_Reposition,0,4,0,4,1603512000,1604898000,4
vistandsforwaifu,0,4,0,86,1556510400,1593748800,4
Super_Trumby,0,4,0,159,1548219600,1548910800,4
Subbeh,0,4,0,10,1583557200,1606107600,4
TheLuckyDay,0,4,0,6,1605675600,1605675600,4
pillowsandblankets4,1,3,41,22,1596600000,1596686400,4
searchingformytruth,0,4,0,37,1589860800,1592107200,4
Number1Framer,0,4,0,5,1589256000,1589256000,4
bleb_ploleman,0,4,0,178,1599364800,1602648000,4
NakedAndBehindYou,0,4,0,-9,1559102400,1559188800,4
HPLoveshack,0,4,0,32,1537329600,1537416000,4
your_not_stubborn,0,4,0,0,1591243200,1591243200,4
DumbestBoy,0,4,0,18,1571371200,1604203200,4
JayDnG,0,4,0,76,1598846400,1598846400,4
Mizuxe621,1,3,15,5,1565928000,1565928000,4
Serifel90,0,4,0,122,1596427200,1605589200,4
PatronSaintShocking,0,4,0,19,1551330000,1551416400,4
unclejohnsmando,0,4,0,31,1562731200,1605416400,4
DislikedBlackMan,0,4,0,150,1602388800,1604116800,4
Colonel_Xarxes,0,4,0,9,1594267200,1594699200,4
EidenPard,1,3,79,15,1605934800,1608267600,4
iamtherealhusk,0,4,0,13,1580533200,1605330000,4
rauhaal,1,3,29,10,1550120400,1550120400,4
TheIncarnated,0,4,0,10,1604898000,1604984400,4
vinodeveloper,1,3,0,2,1594526400,1594526400,4
Sqeeter,0,4,0,146,1605070800,1605157200,4
lord_gecko,0,4,0,22,1557028800,1606626000,4
shigataganai13,0,4,0,46,1602475200,1602475200,4
catgold,0,4,0,375,1591848000,1592020800,4
HenryFrickofSteel,0,4,0,335,1584936000,1607922000,4
thedancinghippie,0,4,0,10,1567224000,1596600000,4
theallsearchingeye,0,4,0,2,1549515600,1606626000,4
cdubose,1,3,23,7,1552194000,1606626000,4
Quantext609,0,4,0,23,1554955200,1556596800,4
SaveVideo,0,4,0,4,1607835600,1616817600,4
fungusm,0,4,0,129,1606626000,1607490000,4
AltDumpKing,0,4,0,43,1604638800,1609304400,4
rogan537,0,4,0,294,1599624000,1606798800,4
infamouscityyy,0,4,0,10,1586232000,1605589200,4
usuallyded,1,3,3,3,1569988800,1581397200,4
DefinitelyCraig,0,4,0,477,1591934400,1606021200,4
Ahmoody158,0,4,0,38,1605934800,1605934800,4
makeitdooz,0,4,0,9,1588737600,1599796800,4
pvtbrownj,0,4,0,17,1600833600,1602302400,4
camelside,0,4,0,14,1606366800,1606885200,4
jagoorv4,0,4,0,42,1567915200,1595822400,4
high_imperator,1,3,22,-2,1552021200,1560571200,4
Personplacething333,0,4,0,30,1555905600,1600833600,4
highschoolgirlfriend,0,4,0,27,1603771200,1608181200,4
Ella_Minnow_Pea_13,0,4,0,6,1582347600,1608786000,4
shrekzballz,1,3,61,10,1594267200,1596513600,4
Lizkorny,2,2,1008,27,1578978000,1584763200,4
bseabrooks1,0,4,0,26,1597636800,1607403600,4
Kornnish,0,4,0,19,1575781200,1591588800,4
Mr-Fleshcage,0,4,0,11,1591243200,1612069200,4
dantheman2313,0,4,0,515,1584158400,1594958400,4
madcapMongoose,4,0,77,0,1474171200,1550811600,4
franzdemian,0,4,0,43,1606539600,1608354000,4
duelingdelbene,0,4,0,34,1571716800,1596859200,4
arsewarts1,0,4,0,4,1578373200,1578459600,4
philthie,0,4,0,6,1478059200,1478059200,4
brohn_jown,0,4,0,11,1595044800,1602388800,4
American_GrizzlyBear,0,4,0,12,1582779600,1608872400,4
consumerist_scum,0,4,0,33,1584936000,1605502800,4
AntiFeces,0,4,0,16,1572667200,1581138000,4
L0ngRoadH00me,0,4,0,9,1606107600,1606107600,4
DelawareDawg,0,4,0,44,1599105600,1607403600,4
Neoguy396,0,4,0,2,1582261200,1582347600,4
Ttoksie,1,3,10,6,1605416400,1605675600,4
ShadowsDemise42,0,4,0,20,1576645200,1576645200,4
yungcameltoe,0,4,0,4,1567569600,1579669200,4
mooselimbsareterries,0,4,0,4,1594526400,1594526400,4
WholeWheatSam,0,4,0,47,1579928400,1585454400,4
StardewStunner,0,4,0,9,1570161600,1596600000,4
3dPrintedZoidberg,0,4,0,27,1571803200,1571803200,4
fannyathletic,1,3,17,3,1577422800,1578978000,4
contrarycucumber,0,4,0,12,1603425600,1607490000,4
_PhalseProfit_,0,4,0,7,1603166400,1603425600,4
cattlecall_,0,4,0,56,1559620800,1607403600,4
PlaceboDick,0,4,0,17,1577336400,1585800000,4
Peacelovefleshbones,0,4,0,37,1574830800,1605157200,4
ThatsLife15,1,3,23,12,1605502800,1605502800,4
Midna0802,1,3,3,6,1580878800,1592366400,4
HeartJewels,0,4,0,5,1608267600,1612069200,4
lettuceleafer,0,4,0,44,1604293200,1607662800,4
HungryHungryHaruspex,0,4,0,13,1582779600,1582779600,4
ProbablyPewping,0,4,0,11,1571889600,1572580800,4
WhyBry,1,3,173,94,1578027600,1578546000,4
mildly_ethnic,0,4,0,153,1580360400,1595476800,4
Chihuahua_Martini,1,3,7,-51,1550552400,1585454400,4
Asking4Afren,0,4,0,19,1573966800,1585454400,4
Amosthecat,0,4,0,7,1603512000,1603598400,4
prettylikedrugs1,0,4,0,13,1601524800,1601611200,4
FertilityHotel,0,4,0,11,1586836800,1603512000,4
Eastern-Gas2385,2,2,0,4,1606712400,1606712400,4
Seanson814,0,4,0,-20,1581224400,1596081600,4
VltgCtrl,0,4,0,40,1597723200,1598155200,4
HeelBruise,0,4,0,55,1573102800,1573534800,4
boogieboi1776,0,4,0,-73,1602648000,1602648000,4
KommieKon,0,4,0,81,1582261200,1600401600,4
Chef_MIKErowave,0,4,0,-34,1566878400,1566878400,4
N-neon,0,4,0,32,1599883200,1607490000,4
anafuckboi,0,4,0,7,1562040000,1609477200,4
zappinder,0,4,0,232,1589515200,1599192000,4
Chunky_Junky,0,4,0,46,1572235200,1572321600,4
tyelr19,0,4,0,13,1606626000,1606626000,4
EdgyChild,0,4,0,37,1573966800,1580446800,4
Unlikely_Egg,0,4,0,21,1583125200,1590984000,4
ModernViking,1,3,28,4,1583125200,1605762000,4
ToughAsPillows,0,4,0,4,1605416400,1605589200,4
Daftmarzo,0,4,0,33,1555905600,1583643600,4
NakedFox,0,4,0,712,1582866000,1608613200,4
youdoitimbusy,0,4,0,69,1577336400,1579928400,4
Atkinator1,0,4,0,11,1594353600,1594353600,4
Sonar114,0,4,0,4,1606626000,1606626000,4
Over4All,0,4,0,36,1598241600,1608354000,4
guuszo,0,4,0,-40,1574398800,1582088400,4
I77Y,1,3,55,22,1565755200,1582434000,4
CHlVE,0,4,0,17,1573966800,1596254400,4
Carl-Kuudere,0,4,0,8,1578459600,1585800000,4
daywon89,0,4,0,11,1603166400,1603166400,4
ciprian1564,0,4,0,36,1593835200,1597118400,4
Dsxm41780,0,4,0,59,1554523200,1596340800,4
smauryholmes,0,4,0,17,1600660800,1608181200,4
magenta_specter,0,4,0,4,1581224400,1582002000,4
yellow_pineapples,0,4,0,8,1601265600,1601524800,4
SisterRay73,0,4,0,45,1580360400,1607662800,4
taradollar,1,3,6,51,1580965200,1603252800,4
name_is_too_long,0,4,0,63,1552363200,1555819200,4
PegasusAssistant,0,4,0,9,1605675600,1607144400,4
RandomGuy92x,0,4,0,14,1608613200,1609304400,4
Am-I-Dead-Yet,0,4,0,25,1584763200,1584763200,4
ChrisMMatthews,3,1,188,2,1580187600,1591588800,4
Bullet_Tracer,0,4,0,36,1556683200,1607490000,4
datacubist,0,4,0,6,1580360400,1580446800,4
xpdx,0,4,0,73,1576386000,1612069200,4
Gucci__Flip__Flops,0,4,0,37,1581483600,1601611200,4
sixAB,0,4,0,-12,1600056000,1605589200,4
Kellen907,0,4,0,10,1570507200,1577854800,4
Alisonwundrlnd,0,4,0,39,1587441600,1597896000,4
ktMcSqueezy,0,4,0,7,1587268800,1587268800,4
zacmaster78,0,4,0,22,1581829200,1592366400,4
WinterWontStopComing,1,3,124,22,1569988800,1588305600,4
ReckingFutard,0,4,0,-35,1584504000,1584504000,4
greenbluetomorrow,4,0,870,0,1599883200,1608440400,4
couldbeworse2,0,4,0,46,1599105600,1602129600,4
InterdimensionalTV,0,4,0,16,1604379600,1606539600,4
Whitelion99,0,4,0,12,1607144400,1607144400,4
BeeboeBeeboe1,0,4,0,12,1600488000,1603080000,4
fartbarfpeepeepoopoo,1,3,10,24,1594526400,1598414400,4
CrunchyPoem,0,4,0,4,1562126400,1608526800,4
xxxglitterkid,0,4,0,-3,1574053200,1600747200,4
Alex_Plumwood,0,4,0,5,1575608400,1575608400,4
ctchocula420,0,4,0,126,1566619200,1573707600,4
Adrialic,0,4,0,189,1601870400,1608699600,4
chadfromthebar,2,2,241,9,1566446400,1579064400,4
FlameBanan,1,3,23,8,1587873600,1593662400,4
kapitaali_com,1,3,4,130,1576904400,1606539600,4
ProfessionalActive1,0,4,0,-42,1580533200,1580533200,4
PlankLengthIsNull,0,4,0,7,1595476800,1595476800,4
DragonosaurusRex,0,4,0,28,1588737600,1606971600,4
phuckmyluck,0,4,0,-8,1593576000,1593662400,4
theblckcrown,0,4,0,55,1582088400,1595908800,4
ParkerR_93,1,3,19,14,1548306000,1548306000,4
Snugglepuff14,0,4,0,-8,1571112000,1611982800,4
seattlesk8er,0,4,0,30,1602993600,1606107600,4
linecookjb,0,4,0,12,1540008000,1582779600,4
RantyPantyThrowaway,1,3,9,4,1591675200,1591761600,4
OnAvance,0,4,0,170,1563163200,1572494400,4
PM_ME_UR_GALLADE,0,4,0,31,1606194000,1609304400,4
chaspich,0,4,0,3,1599883200,1599883200,4
Kung_Pow_Penis,0,4,0,18,1569988800,1570161600,4
theonewhogroks,0,4,0,206,1593921600,1601179200,4
shellbino,0,4,0,9,1540958400,1589342400,4
Snicklesauce,0,4,0,51,1605157200,1605502800,4
FA_in_PJ,0,4,0,61,1571630400,1590984000,4
Econtake,0,4,0,51,1586923200,1594094400,4
ealoft,0,4,0,149,1608526800,1611810000,4
Chiefesoteric,1,3,111,3,1605589200,1605675600,4
sadboyleto2,0,4,0,33,1591329600,1595390400,4
MoustachePika1,0,4,0,29,1584417600,1607317200,4
TV_PartyTonight,0,4,0,78,1585195200,1585195200,4
missthickbiscuit,0,4,0,21,1611896400,1611896400,4
Relkei,1,3,13,9,1595649600,1599624000,4
DrauxEmporium,0,4,0,104,1585195200,1592798400,4
btopia,0,4,0,6,1569988800,1609218000,4
PackersFan92,0,4,0,5,1606885200,1606885200,4
Laduenadelswing,0,4,0,4,1591243200,1591243200,4
JustAnAccount4Porn,0,4,0,82,1605589200,1605589200,4
S-A-TX,0,4,0,18,1574658000,1574658000,4
WobbleWobbleWobble,0,4,0,17,1599019200,1599019200,4
Omegalulz_,0,4,0,3,1608181200,1612501200,4
CoreoReedy,0,4,0,174,1593057600,1593576000,4
Zamiel2342,0,4,0,16,1595044800,1607922000,4
noquarter8899,0,4,0,9,1602475200,1602734400,4
Chatonblond,0,4,0,37,1603252800,1608526800,4
Capticorn1983,0,4,0,4,1604466000,1605330000,4
perroflautak,0,4,0,5,1608181200,1609563600,4
rattoobattoo,2,2,156,8,1569643200,1570334400,4
twistedlimb,0,4,0,18,1571371200,1609045200,4
pandillasexo,0,4,0,73,1581051600,1585540800,4
distant242,0,4,0,39,1600574400,1601611200,4
AnxiousSimple,1,3,22,20,1584417600,1584417600,4
AugusteRenoi,1,3,12,12,1595131200,1612069200,4
drakirby,1,3,21,7,1573621200,1573621200,4
SquirmySanders,0,4,0,36,1574658000,1585627200,4
seventeenflowers,0,4,0,26,1587096000,1587182400,4
rubabuddabelly,0,4,0,5,1573448400,1573448400,4
JuiceSqueezer88,0,4,0,22,1570680000,1581224400,4
omegian,0,4,0,5,1585454400,1585800000,4
LumpySalamander,0,4,0,13,1595649600,1598846400,4
micro_cosm,0,4,0,16,1582866000,1598587200,4
mts1028,0,4,0,10,1580446800,1602820800,4
h3nny92,0,4,0,11,1583211600,1583298000,4
peepgothboi,1,3,11,6,1604984400,1604984400,4
thatscorpioguy,1,3,10,38,1556596800,1603771200,4
Another_available,0,4,0,18,1577854800,1579669200,4
morethan_nice,0,4,0,12,1552194000,1552194000,4
dianac12,0,4,0,7,1576299600,1579150800,4
BandoJenkins,0,4,0,-13,1580274000,1580360400,4
Saetia_V_Neck,0,4,0,56,1569470400,1599105600,4
RelonML,0,4,0,6,1578373200,1578459600,4
PandaKing185,1,3,101,44,1577163600,1577163600,4
yellow_light_runner,0,4,0,-72,1571630400,1571630400,4
HeadphonesAndBruises,0,4,0,37,1573362000,1574139600,4
minimize,1,3,68,33,1597636800,1604984400,4
Kumora88,0,4,0,26,1598846400,1599019200,4
redLSMC,0,4,0,-126,1572930000,1575781200,4
Lettucehead55,3,1,500,3,1572148800,1595908800,4
zubinmadon,0,4,0,44,1599105600,1612069200,4
Kionnn,0,4,0,67,1607317200,1607403600,4
Oliveira30,0,4,0,36,1596600000,1597118400,4
SoggyNach0s,0,4,0,16,1568692800,1597809600,4
XsentientFr0g,0,4,0,-8,1608526800,1608526800,4
HelpingOneAnother,1,3,194,14,1570420800,1570852800,4
EZPEEZEE,0,4,0,21,1551070800,1579237200,4
Vibe_with_Kira,0,4,0,5,1601438400,1607922000,4
FFB6D5,0,4,0,10,1600833600,1600920000,4
joeyoeyoeyoey,1,3,14,19,1595908800,1595908800,4
SSU9UFY,0,4,0,7,1586491200,1587960000,4
boredmantell,1,3,378,16,1606539600,1606626000,4
Ieatsoapbars,0,4,0,-26,1576126800,1576126800,4
LentilsTheCat,0,4,0,36,1593748800,1593921600,4
BackupDev,1,3,27,8,1572408000,1572408000,4
ElectricPotato911,0,4,0,0,1594008000,1594094400,4
themflatearthers,0,4,0,13,1568433600,1571976000,4
RebelRylee,0,4,0,1,1609045200,1609131600,4
zebra_puzzle,0,4,0,99,1587009600,1587182400,4
940387,0,4,0,6,1606280400,1608267600,4
ichkaodko,0,4,0,26,1597464000,1607490000,4
Electricalfury,0,4,0,60,1572580800,1573275600,4
IHopeShesEighteen,0,4,0,-47,1600660800,1600833600,4
d1444,0,4,0,-5,1586923200,1605502800,4
malacoth33,0,4,0,12,1606971600,1607662800,4
instantaneouscrush,0,4,0,26,1540180800,1540180800,4
teabagsOnFire,0,4,0,7,1582866000,1582866000,4
IIIIIIIIXXXXXX,0,4,0,0,1563940800,1563940800,4
jhbedsole,0,4,0,5,1598414400,1598414400,4
BlueBlood75,0,4,0,40,1579842000,1596772800,4
noporcru,0,4,0,54,1602820800,1602820800,4
weedtese,0,4,0,10,1573880400,1581915600,4
Sativa_Dreams,0,4,0,110,1598846400,1600833600,4
Alphanumeric88,0,4,0,41,1574312400,1584936000,4
imsick44,1,3,59,12,1584158400,1584158400,4
onomatopoeialike,0,4,0,56,1576126800,1576558800,4
AggressiveBMWdriver,0,4,0,-60,1607490000,1608267600,4
guktarjet,0,4,0,5,1598760000,1598760000,4
TheEffinChamps,0,4,0,9,1599796800,1606194000,4
Bonny-Mcmurray,0,4,0,33,1589169600,1596600000,4
bluesycheese,1,3,8,6,1547355600,1559534400,4
mediocreporno,0,4,0,92,1606366800,1611982800,4
3_sleepy_owls,0,4,0,7,1597636800,1607230800,4
Moonlight_Knight_,0,4,0,13,1576731600,1576731600,4
UBHE,0,4,0,28,1586836800,1587009600,4
BluePsychosisDude2,0,4,0,63,1595044800,1595736000,4
askreet,0,4,0,-8,1594872000,1594958400,4
the_nothing_new,0,4,0,22,1581656400,1586836800,4
JakobtheRich,0,4,0,6,1572062400,1603598400,4
ReddishBrownSAND,0,4,0,546,1584590400,1593576000,4
ThatOneNerd776,0,4,0,91,1579410000,1603339200,4
Alic_Metallic,0,4,0,5,1598673600,1598673600,4
Historical_Rewrite,0,4,0,4,1608181200,1608267600,4
Nocturne316,1,3,3875,80,1595131200,1606021200,4
00rb,0,4,0,183,1603512000,1603598400,4
Gobi_The_Mansoe,0,4,0,8,1545022800,1554264000,4
SuspiciousArtist,0,4,0,30,1571544000,1576040400,4
fungalstruggle,0,4,0,58,1582261200,1605934800,4
KamikazeHamster,0,4,0,14,1559102400,1563076800,4
TheLostDestroyer,0,4,0,25,1597896000,1609131600,4
BrilliantAndCowardly,0,4,0,11,1608008400,1612155600,4
nate-the-dude,0,4,0,13,1587614400,1594008000,4
WoodyAlanDershodick,0,4,0,8,1608526800,1608613200,4
Adventus_2,0,4,0,10,1599019200,1599364800,4
Bad_Covid_Haircut,0,4,0,1,1590465600,1590465600,4
boringSeditious87,0,4,0,18,1561608000,1586491200,4
kautau,0,4,0,62,1574830800,1607317200,4
IHaveNoSenseOfHumor_,0,4,0,-19,1605502800,1607403600,4
CaptainMaxCrunch,0,4,0,27,1567569600,1591588800,4
striving4success,0,4,0,29,1605243600,1606280400,4
lfortunata,0,4,0,31,1551070800,1556337600,4
doctabones1337,0,4,0,-12,1563249600,1563422400,4
An_Oglach,0,4,0,5,1588996800,1589083200,4
Sea_Inside,0,4,0,96,1604725200,1611896400,4
brawndobitch,0,4,0,15,1582174800,1606539600,4
t-var,0,4,0,58,1598241600,1600833600,4
TheTobiasProject,1,3,15,9,1570507200,1604116800,4
woman-cat,0,4,0,54,1588132800,1588824000,4
KingOfTheDarknessPL,0,4,0,7,1593748800,1594008000,4
Rubmynippleplease,0,4,0,9,1585454400,1603598400,4
RomeNeverFell,1,3,4,3,1606712400,1606885200,4
h1storyguy,0,4,0,24,1597636800,1598587200,4
apalm8,0,4,0,-4,1595649600,1595736000,4
ArmaniDiamonds,0,4,0,100,1571976000,1611982800,4
MaynardJ222,0,4,0,39,1584676800,1584676800,4
danceparty14,0,4,0,14,1603598400,1603598400,4
uglyslippers,0,4,0,39,1550638800,1577250000,4
mporubca,0,4,0,2,1604379600,1604379600,4
unclebenjenhow,0,4,0,49,1606885200,1609045200,4
reverendjesus,0,4,0,29,1574744400,1575522000,4
elgrandejlm,0,4,0,6,1599019200,1608613200,4
Max_Mushroom,0,4,0,-2,1582866000,1582866000,4
krazyforlove,1,3,78,81,1570248000,1572235200,4
yeetos_doritos,2,2,523,108,1595649600,1607317200,4
chicagotwink20,0,4,0,-16,1601179200,1601179200,4
KingGage,0,4,0,5,1611982800,1612846800,4
dudeiskate,0,4,0,24,1581915600,1585800000,4
defnotevilmorty,0,4,0,64,1576386000,1587096000,4
to_to_or_not_to,0,4,0,29,1581915600,1581915600,4
melkorghost,0,4,0,25,1579928400,1606021200,4
ltlblkrncld,0,4,0,60,1605157200,1605762000,4
UnitCell,0,4,0,13,1599364800,1612155600,4
gayemo1312,1,3,2,7,1549602000,1593835200,4
raisbecka,0,4,0,7,1590811200,1590811200,4
SuitableAd8,0,4,0,-16,1556596800,1559102400,4
SuperDuperSplooge,0,4,0,40,1591934400,1591934400,4
Toolbag88,0,4,0,11,1582174800,1597291200,4
explodedsun,0,4,0,20,1602043200,1611896400,4
ophannim,1,3,3446,6,1576040400,1600056000,4
RonPaulalamode,0,4,0,-13,1597377600,1597896000,4
treelaugh,0,4,0,-65,1606539600,1606626000,4
DoctrDonna,0,4,0,-11,1583899200,1611982800,4
aurifelix,0,4,0,12,1588824000,1590120000,4
ebolalol,0,4,0,25,1560571200,1595995200,4
foresthowls,0,4,0,40,1583643600,1584936000,4
Teavangelion,0,4,0,33,1568865600,1572494400,4
Kydra96,0,4,0,12,1608354000,1609390800,4
8UEV6Z,0,4,0,12,1570161600,1570766400,4
5Flames3,0,4,0,137,1605934800,1607835600,4
absurdistmarxist,0,4,0,-22,1582866000,1582866000,4
reylo69,0,4,0,4,1596427200,1598500800,4
91runaway,0,4,0,11,1589169600,1602043200,4
FleshPanda,0,4,0,-14,1592884800,1605589200,4
RaeVonn,0,4,0,69,1601006400,1601697600,4
BadgerKomodo,1,3,9,13,1601870400,1608526800,4
nounanemptyspace,0,4,0,79,1574139600,1583038800,4
SirMatango,0,4,0,16,1582088400,1582088400,4
TAO369,0,4,0,17,1604466000,1606971600,4
Knight-Jack,1,3,9600,99,1567224000,1576299600,4
CommitteeOfTheHole,0,4,0,18,1572148800,1585627200,4
for_t2,0,4,0,21,1558238400,1586145600,4
NervouslyFervent,0,4,0,56,1572753600,1581570000,4
qwertyson96,0,4,0,7,1550638800,1553486400,4
IWokeUpDisposable,0,4,0,41,1553227200,1557374400,4
moomoo220618,1,3,67,6,1581310800,1595044800,4
darknighties,0,4,0,4,1605589200,1605589200,4
Beep_boop_human,0,4,0,24,1562126400,1583038800,4
FFF1mclauren,0,4,0,8,1600315200,1600315200,4
illybeaton44,0,4,0,31,1567742400,1578373200,4
LikePissInTheRain,0,4,0,95,1581570000,1604379600,4
EvilManiMani,0,4,0,13,1600574400,1609045200,4
elephantjizztail,1,3,17,3,1599710400,1602216000,4
TarragonSpice,0,4,0,4,1575176400,1590552000,4
gthaatar,0,4,0,11,1582088400,1606885200,4
Mirrorcleworld,0,4,0,40,1568433600,1579064400,4
D17a1MT,0,4,0,17,1562212800,1566273600,4
DilapidatedLove,0,4,0,-33,1569988800,1570334400,4
grettp3,0,4,0,33,1568606400,1582347600,4
TheHowlinReeds,1,3,6,54,1571976000,1607662800,4
ronnevee,0,4,0,16,1557547200,1601697600,4
timstrut,0,4,0,15,1595304000,1603080000,4
2whatisgoingon2,0,4,0,5,1577336400,1577422800,4
75joking25serious,0,4,0,-23,1606453200,1607662800,4
greasy_420,0,4,0,72,1601697600,1608526800,4
__slowpoke__,0,4,0,3,1606626000,1607490000,4
firesidepoet,0,4,0,41,1606107600,1606798800,4
PutSumNairOnThatHair,0,4,0,216,1603857600,1606798800,4
Arenb75,0,4,0,-27,1567051200,1567483200,4
Bart_T_Beast,0,4,0,51,1576558800,1598932800,4
Timmuz,1,3,13,7,1454734800,1520053200,4
deuceice,0,4,0,16,1575781200,1604984400,4
Baked__Andy,2,2,109,18,1568952000,1583211600,4
LSC1212,0,4,0,179,1605934800,1606539600,4
VictoriaSobocki,0,4,0,4,1561262400,1573621200,4
CozyTraps4FreeDotCom,0,4,0,31,1571025600,1571198400,4
Irezumi_Fan,0,4,0,23,1599710400,1599710400,4
T-bird89,0,4,0,99,1553572800,1557979200,4
sh17s7o7m,0,4,0,317,1598068800,1598155200,4
lostboy-2019,0,4,0,17,1585713600,1596081600,4
breakfastinbred,4,0,1561,0,1605416400,1606280400,4
proxxi1917,0,4,0,619,1568865600,1592193600,4
MadSpoon33,0,4,0,21,1600833600,1601006400,4
bradipaurbana,0,4,0,6,1578632400,1581138000,4
mrrebuild,1,3,140,18,1603512000,1603598400,4
Statusepilepticus95,1,3,21,10,1555992000,1563249600,4
ashy2_0,0,4,0,8,1608786000,1608958800,4
dog_under_water,0,4,0,13,1557720000,1573794000,4
TrendsettersAssemble,0,4,0,20,1588910400,1588996800,4
DregBox,0,4,0,125,1566446400,1575176400,4
aworldwithoutshrimp,0,4,0,189,1569988800,1584849600,4
dvnjay,1,3,17,9,1603252800,1604203200,4
eayaz,0,4,0,4,1605589200,1605589200,4
normie_lit,1,3,190,3,1598328000,1608267600,4
BryannaW,0,4,0,28,1596859200,1607662800,4
cpnCook1,0,4,0,18,1556510400,1573707600,4
DrCaptRenfield,0,4,0,26,1584504000,1584763200,4
catacomb_kids,0,4,0,15,1591502400,1591588800,4
somanydimensions,0,4,0,480,1572494400,1574830800,4
stas1,0,4,0,10,1602734400,1605070800,4
SaiyanPrinceAbubu,0,4,0,18,1548219600,1550898000,4
OddTapir,0,4,0,556,1600574400,1601006400,4
ManiacDan,0,4,0,15,1604379600,1604466000,4
Gizmoo247,0,4,0,12,1602820800,1602820800,4
etilepsie,0,4,0,61,1578546000,1595217600,4
NoPantsPenny,0,4,0,160,1569902400,1600660800,4
alkapariah,0,4,0,-28,1565582400,1566014400,4
PhillAholic,0,4,0,24,1607403600,1607403600,4
MrObsidy,1,3,14,5,1571198400,1571198400,4
alik604,0,4,0,43,1606626000,1606626000,4
doomofdoctors69,0,4,0,29,1558670400,1567137600,4
onehitwondur,0,4,0,17,1563768000,1582434000,4
KingMurk817,0,4,0,22,1602043200,1604811600,4
Cantothulhu,0,4,0,23,1598414400,1611982800,4
JoeySadie,0,4,0,9,1573534800,1577854800,4
TrustButVerifyEng,0,4,0,12,1611982800,1611982800,4
iMakeSense,1,3,6,5,1549602000,1573275600,4
Adlai-Stevenson,0,4,0,15,1554264000,1554955200,4
unsavvylady,0,4,0,36,1608008400,1608008400,4
TickingTimeBum,0,4,0,143,1569988800,1582693200,4
kimiko2,0,4,0,38,1593230400,1597377600,4
ryanexists,0,4,0,4,1611982800,1612069200,4
Insultingphysicist,1,3,350,13,1587700800,1591502400,4
steppenstone,0,4,0,222,1604466000,1605157200,4
Nathans-warhammer,0,4,0,-17,1578805200,1583726400,4
row_bert,0,4,0,-1,1575090000,1575608400,4
watpompyelah,0,4,0,17,1574139600,1606712400,4
bourbon_legends,0,4,0,51,1594872000,1599796800,4
Apathetic_Zealot,0,4,0,12,1591243200,1592798400,4
TheRealSirFancyson,0,4,0,15,1568865600,1584936000,4
Mo-likes-cows,0,4,0,40,1604116800,1611982800,4
Alien0Street,0,4,0,9,1595476800,1608699600,4
johnnyhaggis,1,3,8,3,1564027200,1565323200,4
Abstract808,0,4,0,3,1607922000,1607922000,4
IWillNeverGetLaid,0,4,0,0,1602129600,1602129600,4
cindernutella,0,4,0,31,1584072000,1592366400,4
bisbomdur,0,4,0,36,1581742800,1581742800,4
Khanhdesu,0,4,0,32,1595217600,1607317200,4
VanguardVolunteer,1,3,1,3,1577422800,1577422800,4
TheArtOfSuperstition,0,4,0,23,1595649600,1604811600,4
NerdBrenden,0,4,0,25,1563768000,1570507200,4
Poopdawg87,0,4,0,53,1603512000,1603598400,4
jarona,0,4,0,8,1548565200,1560571200,4
K-Far,1,3,8,38,1593230400,1604898000,4
digoryk,0,4,0,6,1562731200,1569643200,4
Brauxljo,0,4,0,149,1571198400,1598328000,4
Piece_Maker,0,4,0,12,1585886400,1596600000,4
mplagic,0,4,0,6,1562299200,1593921600,4
Ashlala13,0,4,0,62,1592366400,1592366400,4
hermarc,0,4,0,3,1603598400,1611982800,4
yeeeeeesh11,0,4,0,72,1575781200,1600228800,4
mercadogarca,0,4,0,26,1575003600,1576386000,4
TheLucidCrow,0,4,0,20,1605416400,1606194000,4
6ix02,0,4,0,125,1571284800,1602820800,4
Cindex9183,0,4,0,42,1569124800,1569124800,4
AlphaWizard,0,4,0,6,1585454400,1585540800,4
newredditishorrific,0,4,0,6,1578114000,1593835200,4
transgirltears,0,4,0,110,1576040400,1581656400,4
JonAndTonic,0,4,0,15,1582520400,1600488000,4
ProfessorDanceFace07,2,2,29,6,1606194000,1606798800,4
Lynnieth,0,4,0,186,1594872000,1596513600,4
mayathepsychiic,0,4,0,6,1599537600,1600488000,4
Macqt,0,4,0,5,1604811600,1608699600,4
psychotronic_mess,0,4,0,16,1603598400,1605070800,4
radosla_,0,4,0,5,1608354000,1609045200,4
cornbreadbiscuit,0,4,0,20,1578459600,1578978000,4
defiantcross,0,4,0,-7,1590984000,1600574400,4
Zah96,0,4,0,10,1588046400,1607576400,4
lookin_like_atlas,0,4,0,52,1568952000,1589601600,4
UtterlyCubic,0,4,0,44,1596254400,1611896400,4
DreadfulTomorrow,0,4,0,3,1572494400,1572667200,4
Glowie2012,0,4,0,7,1597896000,1608267600,4
FunkTasticCaskit,0,4,0,430,1564027200,1569384000,4
ContNouNout,0,4,0,9,1593230400,1593230400,4
usedtobejuandeag,0,4,0,54,1606798800,1608699600,4
BeachSally,0,4,0,35,1576299600,1577595600,4
RonnyronDaDon,3,1,10153,43,1572843600,1608354000,4
leitmotive,0,4,0,75,1585195200,1605243600,4
BrockFingSampson,2,2,25,35,1584158400,1584590400,4
Milton__Obote,0,4,0,24,1592280000,1593230400,4
theveryacme,0,4,0,60,1583125200,1604638800,4
moaiii,0,4,0,15,1589515200,1589515200,4
Johnjohnthejohnjohns,0,4,0,11,1591329600,1591416000,4
hopici,0,4,0,47,1604293200,1607749200,4
Korkack,0,4,0,11,1603598400,1603598400,4
SlipperyVulvaOClock,3,1,335,5,1587614400,1588910400,4
GoodTradition7379,0,4,0,7,1610946000,1611810000,4
rattatally,0,4,0,12,1496462400,1583211600,4
CryptoRocky,0,4,0,5,1603425600,1603425600,4
CynicalDepression,0,4,0,-20,1554523200,1554523200,4
Soup__Sucker,0,4,0,12,1602993600,1609045200,4
PascLeRasc,0,4,0,29,1592107200,1592366400,4
tristan412,0,4,0,2,1567137600,1567224000,4
spicylaurenlovegood,1,3,24,8,1600056000,1600660800,4
Siiberia,0,4,0,28,1588564800,1597809600,4
peace_love17,0,4,0,10,1532145600,1552107600,4
tkld,0,4,0,34,1532664000,1580533200,4
Beren_Loves_Luthien,1,3,31,21,1579150800,1588737600,4
6ar6oyle,0,4,0,80,1543726800,1612155600,4
Eis_ber,0,4,0,7,1590033600,1590033600,4
hoppingwilde,0,4,0,6,1583470800,1583470800,4
geedix,1,3,2,68,1557374400,1569124800,4
ViddyDoodah,0,4,0,45,1558584000,1577854800,4
the107,0,4,0,-104,1577509200,1605589200,4
pm_me_steam_gaemes,0,4,0,98,1601524800,1611982800,4
pito-bionico,0,4,0,41,1601611200,1609304400,4
124211212121,0,4,0,33,1567224000,1571544000,4
ElBrayan777,1,3,2188,27,1570507200,1594526400,4
minecraft69wastaken,1,3,23,27,1568088000,1568088000,4
Aniakchak,0,4,0,26,1566705600,1596859200,4
koko969w,0,4,0,7,1561780800,1561780800,4
randomnobody345,0,4,0,13,1582434000,1582434000,4
ThePantsAreFake,0,4,0,8,1611982800,1611982800,4
Psibyl,0,4,0,39,1600574400,1604466000,4
OPengiun,0,4,0,10,1601352000,1601352000,4
toepinky,0,4,0,41,1585281600,1585281600,4
see_four,0,4,0,32,1597982400,1600747200,4
topbitchdawg,0,4,0,83,1599105600,1604898000,4
kildog,0,4,0,33,1568001600,1605070800,4
femundsmarka,0,4,0,11,1602043200,1607490000,4
VoyagerMyu,0,4,0,18,1568692800,1575867600,4
digtillyadrop,0,4,0,13,1588824000,1588824000,4
IIIlllIlIIIlllIlI,0,4,0,51,1609477200,1611810000,4
OnlyUnpleasantTruths,0,4,0,22,1587441600,1588564800,4
mericano,0,4,0,17,1569038400,1577077200,4
ihatethiswebsite10,0,4,0,71,1596945600,1605502800,4
infinity234,0,4,0,3,1596772800,1609304400,4
peanutismywaifu,0,4,0,3,1572843600,1572843600,4
PURE_ARYAN_GENETICS,0,4,0,36,1563249600,1563854400,4
Jahshua159258,0,4,0,34,1611982800,1612069200,4
HMS404,0,4,0,11,1581656400,1591416000,4
yarblesthefilth,0,4,0,-16,1589515200,1590465600,4
angosciia,1,3,13,20,1596340800,1597377600,4
feignapathy,0,4,0,15,1585454400,1585454400,4
AL_12345,0,4,0,75,1546318800,1596600000,4
kahrido,0,4,0,7,1588824000,1588910400,4
alancewicz,0,4,0,124,1575608400,1593403200,4
IWillFindAJob,0,4,0,8,1607230800,1607317200,4
donotusethisaccountu,1,3,48,93,1598673600,1609045200,4
Young_Marge_Bouvier,0,4,0,59,1592884800,1607835600,4
CorneliusDogeTheIII,0,4,0,15,1592107200,1592193600,4
doctorcrimson,0,4,0,29,1603512000,1603598400,4
REDrzn,1,3,12,17,1593057600,1605070800,4
Gostofrij,0,4,0,21,1557979200,1566360000,4
Kylkek,0,4,0,-5,1577854800,1589515200,4
eggsforeverymeal,1,3,2,8,1578027600,1593748800,4
PlatformSix,0,4,0,33,1571630400,1595476800,4
RandomDudeWhoWorks,2,2,117,125,1583557200,1595304000,4
stadium-seating,0,4,0,73,1574312400,1577768400,4
Loud_lady2,0,4,0,99,1570939200,1583470800,4
Nydedrisean,0,4,0,23,1602648000,1608786000,4
Wormstar-Navigator,0,4,0,6,1605675600,1607922000,4
Bassman1976,0,4,0,24,1599710400,1604898000,4
goldenjuicebox,0,4,0,61,1574485200,1606712400,4
Metamodern_Studio,0,4,0,12,1593662400,1593662400,4
Scouth,0,4,0,12,1594440000,1597377600,4
drugdealersdream,0,4,0,449,1603857600,1606971600,4
UncleArkie,0,4,0,228,1600747200,1600833600,4
Plutonium_Nitrate_94,0,4,0,24,1587355200,1608613200,4
uJester,0,4,0,12,1588910400,1591934400,4
ASSHOLEFUCKER3000,0,4,0,-32,1562472000,1593230400,4
Ellioment,0,4,0,53,1605848400,1609304400,4
3margs,0,4,0,111,1580360400,1599278400,4
TheMSAGuy,0,4,0,15,1585454400,1585540800,4
yg301,0,4,0,23,1568001600,1571889600,4
482doomedchicken,1,3,51,13,1599624000,1599710400,4
cblankity,0,4,0,86,1568779200,1578891600,4
vinaldi2x,2,2,140,3,1561521600,1562990400,4
homendailha,0,4,0,-41,1564977600,1564977600,4
SoggySimSponge,0,4,0,13,1600488000,1609131600,4
Scdsco,0,4,0,-15,1540008000,1540008000,4
teenytinybaklava,0,4,0,132,1577422800,1609390800,4
10000thmaniac,0,4,0,17,1571716800,1571803200,4
Yosoy666,0,4,0,19,1558238400,1595476800,4
Vegantarian,0,4,0,70,1556769600,1605848400,4
zerio13,0,4,0,32,1559707200,1590033600,4
RevanTyranus,0,4,0,19,1578027600,1608872400,4
MudraStalker,0,4,0,24,1605070800,1607835600,4
ThaFatBABY,1,3,15,15,1540008000,1607835600,4
anonilla,1,3,452,64,1575435600,1584417600,4
Breyber12,0,4,0,39,1585368000,1607403600,4
PantherPL,0,4,0,77,1576213200,1579150800,4
DawsonDevil,0,4,0,-29,1608526800,1608613200,4
chiagro,0,4,0,11,1605243600,1608786000,4
kb_klash,0,4,0,221,1591934400,1593921600,4
b000bytrap,0,4,0,53,1591502400,1597896000,4
Alakazamon,0,4,0,12,1600315200,1601870400,4
B_Provisional,0,4,0,54,1547010000,1580014800,4
PaulBaumersGhost,0,4,0,28,1590033600,1590984000,4
CapFalcon,0,4,0,-2,1591243200,1591329600,4
Dolly-BR,1,3,5,6,1601352000,1601352000,4
DownWithCzarPlz,0,4,0,11,1607835600,1609045200,4
Creditfigaro,0,4,0,146,1584331200,1594699200,4
REDDITS_SMARTEST_MAN,0,4,0,10,1550293200,1550293200,4
Godmadius,0,4,0,12,1573448400,1573534800,4
AfterTruth,2,2,39,12,1594353600,1599710400,4
wrongprism167,0,4,0,8,1612155600,1612155600,4
hoerogan,0,4,0,20,1582866000,1583211600,4
baekovsky1812,0,4,0,51,1596686400,1600747200,4
SoberSimon,0,4,0,234,1599192000,1603684800,4
Jfof_,0,4,0,0,1555905600,1556596800,4
PeriodSects,0,4,0,-29,1583899200,1583899200,4
WhoFedTheBabadook,0,4,0,70,1535169600,1558152000,4
5Quad,0,4,0,82,1574139600,1593662400,4
Seaweedbits,0,4,0,23,1602820800,1602820800,4
FinnRistola,0,4,0,93,1580533200,1608440400,4
Rusty_Walnut,0,4,0,22,1599278400,1605675600,4
7sterling,0,4,0,6,1593316800,1603684800,4
spicegrl1,0,4,0,26,1590638400,1591243200,4
cocire,0,4,0,51,1560225600,1575781200,4
EL_CH0MP0,0,4,0,21,1602648000,1606971600,4
uNEknown,0,4,0,32,1601956800,1607058000,4
The_Bjorn_Ultimatum,0,4,0,4,1550725200,1607576400,4
I_CHUG_SOYLENT,0,4,0,20,1547528400,1577941200,4
iamonthatloud,0,4,0,8,1600747200,1600833600,4
Analyst_Unlucky,0,4,0,33,1602648000,1606626000,4
Chipupuu,1,3,26,6,1582606800,1601956800,4
Dilkin,0,4,0,0,1546837200,1547614800,4
Turtle-Hermit_,0,4,0,14,1597982400,1597982400,4
MenstruationOatmeal,0,4,0,35,1574830800,1599105600,4
extralyfe,0,4,0,63,1605502800,1606021200,4
queenkerfluffle,0,4,0,64,1597032000,1606971600,4
cupcake_napalm_faery,0,4,0,13,1604030400,1604030400,4
MyNameIsEthanNoJoke,0,4,0,20,1572753600,1608786000,4
bobjoe400,0,4,0,33,1584244800,1584244800,4
littlelebowski98,0,4,0,78,1573102800,1580792400,4
ultrasoy,0,4,0,40,1576904400,1585454400,4
DeadPand,0,4,0,108,1599105600,1601956800,4
cryptocronix,0,4,0,34,1562126400,1578286800,4
Whisper,0,4,0,2,1572321600,1586145600,4
arthurmadison,0,4,0,234,1578891600,1581915600,4
jeffmartin23,1,3,83,15,1599796800,1609218000,4
raptor1138,0,4,0,12,1583211600,1605243600,4
2FirmHands,0,4,0,34,1607835600,1609390800,4
Maddison_Dan,0,4,0,37,1570334400,1584504000,4
Thumpist,1,3,23,12,1549515600,1580274000,4
TheseVirginEars,1,3,71,96,1598500800,1606280400,4
JustAsadINFP,1,3,54,11,1590033600,1593748800,4
This-is-you,0,4,0,12,1599796800,1604552400,4
TossThisWayUpHigh,0,4,0,23,1643259600,1643259600,4
Rianke,1,3,37,19,1572494400,1572580800,4
Godcranberry,0,4,0,59,1573362000,1574312400,4
RexWolf18,0,4,0,2,1607662800,1608181200,4
throwing-away-party,0,4,0,10,1566360000,1606021200,4
candyvanasseldonk,0,4,0,64,1573102800,1585540800,4
CleverUsername5555,0,4,0,44,1579237200,1582866000,4
Grinnzy,0,4,0,791,1606971600,1608699600,4
flowersforbreakfast,1,3,43,12,1563940800,1563940800,4
ryanywurfel,0,4,0,61,1586145600,1589860800,4
stocksy,0,4,0,205,1601265600,1604898000,4
ItsDelicous,0,4,0,7,1548306000,1583298000,4
ty_richness,0,4,0,9,1559361600,1559448000,4
D3M1G0RG0N,0,4,0,35,1583470800,1593144000,4
ROU_Misophist,1,3,7,5,1573707600,1576299600,4
supermatt234,0,4,0,8,1594872000,1606539600,4
MACS5952,0,4,0,-10,1569038400,1569038400,4
SpaceChimera,0,4,0,76,1604984400,1604984400,4
rf3sta,1,3,15,18,1582606800,1584331200,4
f-u-whales,1,3,41,86,1601870400,1606626000,4
Geek4HigherH2iK,0,4,0,42,1597809600,1600488000,4
Phasco2,0,4,0,-18,1574398800,1574485200,4
Tim_Quit_His_Job,0,4,0,10,1591588800,1591675200,4
error405notsearched,0,4,0,30,1600228800,1600315200,4
nazis_must_hang,0,4,0,3,1589947200,1594785600,4
NEETpride,2,2,18,-3,1595822400,1598500800,4
LinBen21,1,3,5,14,1593316800,1593316800,4
___Little_Bear___,1,3,28,24,1566360000,1601179200,4
blogasdraugas,0,4,0,62,1567656000,1574226000,4
tebbundy,1,3,0,-16,1570939200,1577768400,4
hwein9,3,1,361,3,1597204800,1609218000,4
general_derez,0,4,0,144,1594440000,1605589200,4
notdaggers351,0,4,0,71,1562472000,1569988800,4
BeatUpNerds,0,4,0,31,1589428800,1594267200,4
ribcage666,0,4,0,48,1592539200,1604552400,4
KnaxxLive,0,4,0,7,1567569600,1567569600,4
sullyc1011,0,4,0,11,1576645200,1578805200,4
virtixt,0,4,0,34,1602302400,1603166400,4
take-money,0,4,0,10,1580274000,1580274000,4
its_danny_boi,0,4,0,229,1584331200,1587268800,4
coconutmango,1,3,26,15,1611723600,1611810000,4
Cunny1989,4,0,6871,0,1602648000,1606021200,4
PosadismWillWin,0,4,0,61,1572321600,1572667200,4
icetoaneskim0,0,4,0,-6,1571630400,1571716800,4
heywhatsuptoast,0,4,0,176,1587182400,1589688000,4
UnicornMolestor,0,4,0,22,1591243200,1598760000,4
My-Moon-N-Stars,0,4,0,7,1603166400,1603166400,4
Jt018,0,4,0,14,1575522000,1587528000,4
master_x_2k,0,4,0,150,1595476800,1601092800,4
saltbutt,0,4,0,30,1547960400,1555214400,4
eeeyow,0,4,0,62,1563336000,1581570000,4
DoodilyButt,0,4,0,74,1569124800,1575176400,4
Djmatticus,0,4,0,33,1608008400,1608872400,4
alporgainz,0,4,0,15,1561176000,1570939200,4
heliosdiem,1,3,84,17,1596859200,1597377600,4
23dgy4me,0,4,0,64,1608872400,1608958800,4
SockHeroes,0,4,0,2,1600056000,1600056000,4
constant_flux,0,4,0,15,1538884800,1538884800,4
Rabid-Rabble,0,4,0,17,1597636800,1606366800,4
HiResHD,0,4,0,19,1594872000,1602734400,4
Tykespiralizer,0,4,0,17,1579842000,1608699600,4
annievancookie,0,4,0,11,1568865600,1578632400,4
CoffeeGamer93,0,4,0,29,1606798800,1608958800,4
QuantumHope,0,4,0,9,1575608400,1579150800,4
quinn9648,0,4,0,25,1574485200,1574830800,4
bigbrowncommie69,0,4,0,30,1597291200,1601611200,4
DownWithClickbait,1,3,31,8,1576386000,1576558800,4
jalexander333,0,4,0,8,1592280000,1593835200,4
CaptainSoyuz,0,4,0,10,1565496000,1601524800,4
CircutBentSelfEsteem,1,3,55,6,1604898000,1607749200,4
kimjongswoonofficial,0,4,0,144,1596600000,1608008400,4
Jules2106,0,4,0,11,1600660800,1600747200,4
dualitybyslipknot,0,4,0,203,1575090000,1575176400,4
i4k20z3,0,4,0,16,1550638800,1582434000,4
ultravioletu,0,4,0,45,1567569600,1589947200,4
JustSomeGuyOnTheSt,0,4,0,160,1570766400,1599278400,4
coldxrain,0,4,0,4,1547874000,1547960400,4
Dukdukdiya,0,4,0,46,1573275600,1589688000,4
asshands_69,0,4,0,-10,1590811200,1594353600,4
peypeyy,0,4,0,4,1583899200,1605416400,4
IRushPeople,0,4,0,27,1560052800,1573966800,4
ctfsh64,0,4,0,72,1587960000,1590638400,4
thepadsmasher,0,4,0,-8,1599969600,1600660800,4
dadankness,0,4,0,-22,1585022400,1585108800,4
TanyaMimi,1,3,3,7,1592107200,1593057600,4
HazyGaze,1,3,3,20,1438747200,1551330000,4
bandika1137,0,4,0,13,1549688400,1561435200,4
Ambiguous_Puzuma,0,4,0,25,1603166400,1606366800,4
wm5p4rk,0,4,0,27,1586404800,1599537600,4
Ice_Inside,1,3,9,32,1565496000,1607144400,4
nommas,1,3,13,11,1603771200,1604898000,4
RomulusRenaldss,0,4,0,5,1575262800,1575349200,4
TheBlackcat34,0,4,0,31,1581051600,1608267600,4
everyoneisflawed,1,3,75,50,1566446400,1573016400,4
jordasaur,0,4,0,50,1576818000,1600747200,4
Matalya1,0,4,0,5,1572580800,1572580800,4
2006FinalsWereRigged,0,4,0,22,1598500800,1599710400,4
Pheonix0114,0,4,0,30,1605070800,1605762000,4
Sunbiscuit,0,4,0,20,1593316800,1601524800,4
OSU_Matthew,0,4,0,5,1572408000,1589860800,4
lazy_ellis,0,4,0,21,1594872000,1601524800,4
philjmarq,0,4,0,130,1571025600,1579323600,4
Coupyamel,0,4,0,8,1557460800,1567224000,4
KBA3AP,0,4,0,22,1602561600,1602648000,4
yodascousinkevin,0,4,0,16,1560484800,1575435600,4
Dysaniacs,1,3,23,36,1585713600,1585800000,4
Astrokiwi,0,4,0,21,1571371200,1597377600,4
J_vonstrangle20,0,4,0,-7,1604030400,1604030400,4
Akhenaset,0,4,0,338,1579842000,1597809600,4
i_read_your_profile,0,4,0,78,1559188800,1602993600,4
KrazyKat87,0,4,0,127,1576818000,1598155200,4
mrfitzjiggles,1,3,8,88,1577768400,1603771200,4
ImpudentFancyPants,0,4,0,4,1639198800,1639198800,4
dontreadmycommemt,0,4,0,64,1579237200,1581310800,4
moosemoth,0,4,0,163,1603771200,1606366800,4
cool-steve-hvac,0,4,0,75,1577854800,1583557200,4
galaxygirl978,0,4,0,4,1599451200,1599451200,4
Revolutionary-Lynx54,0,4,0,81,1605502800,1608958800,4
Colvrek,0,4,0,6,1601524800,1603080000,4
BreannaNicole13,0,4,0,36,1588651200,1605589200,4
JimmProfit,0,4,0,40,1572930000,1573016400,4
BloodhandsFIN,0,4,0,-19,1545109200,1545195600,4
Taefey7o,0,4,0,12,1572580800,1572580800,4
TheNerdsdumb,0,4,0,7,1592366400,1608526800,4
carpetfoodie,0,4,0,9,1600747200,1607922000,4
politicalanalysis,0,4,0,44,1608354000,1611810000,4
Gilarax,0,4,0,33,1557288000,1578718800,4
swampgremlins,2,2,1204,26,1595995200,1602129600,4
BourbonKing,0,4,0,20,1592107200,1594353600,4
hillbillybogwitch,0,4,0,48,1580619600,1580619600,4
le___tigre,0,4,0,72,1595304000,1611896400,4
isntitnotbadbutkind,0,4,0,56,1557288000,1581915600,4
musicmage4114,0,4,0,44,1606194000,1606280400,4
MushroomSlap,0,4,0,-19,1560312000,1597896000,4
danielpetersrastet,0,4,0,18,1575694800,1604811600,4
Synescolor,0,4,0,196,1577336400,1600056000,4
immigrantdragqueen,0,4,0,43,1593662400,1606971600,4
drleephd,1,3,20,6,1572235200,1606539600,4
-HappyToHelp,0,4,0,10,1605762000,1608958800,4
ZappfeMeIntoOblivion,1,3,13,13,1560312000,1560916800,4
GreenLM,0,4,0,22,1567828800,1579410000,4
klee64,0,4,0,6,1580619600,1580619600,4
WampaCat,0,4,0,119,1578718800,1595908800,4
GamerBuddha,1,3,191,17,1583470800,1588651200,4
Uniqueusername360,1,3,386,43,1583985600,1607317200,4
ProArtichoke,0,4,0,-9,1569124800,1569124800,4
plonkeres,0,4,0,5,1585454400,1589515200,4
dogwithavlog,0,4,0,15,1604811600,1608267600,4
adcarryonly,1,3,13,11,1595995200,1606366800,4
Kackboy,0,4,0,5,1576386000,1576558800,4
wordstrom,0,4,0,57,1575435600,1575694800,4
redwingsofsteel,0,4,0,18,1573534800,1584849600,4
r3dt4rget,0,4,0,0,1548392400,1548392400,4
Waffelpokalypse,0,4,0,18,1568347200,1572580800,4
Nimrochan,1,3,75,23,1589083200,1604984400,4
Larry-Man,0,4,0,0,1605589200,1605675600,4
Jean_Lua_Picard,0,4,0,44,1573621200,1608699600,4
Ismoketomuch,0,4,0,-6,1588392000,1588564800,4
SC2McGosu,0,4,0,-18,1606021200,1606021200,4
NerdyDirtyCurvy,1,3,84,103,1572753600,1602302400,4
crybound,0,4,0,23,1587096000,1591156800,4
MrB_99,0,4,0,29,1602648000,1607835600,4
bibblz,0,4,0,16,1558065600,1609390800,4
BeyondElectricDreams,0,4,0,18,1603598400,1603598400,4
FiveSquared25YT,0,4,0,12,1541131200,1541566800,4
spinderbella,0,4,0,21,1610600400,1612328400,4
shiekhyerbouti42,0,4,0,12,1576472400,1598500800,4
prattja8,0,4,0,85,1554955200,1575349200,4
UberPirate18E,0,4,0,10,1531540800,1559620800,4
_Never-Forgetti_,0,4,0,13,1586232000,1587614400,4
th_aftr_prty,0,4,0,3,1604379600,1604466000,4
Browncoat101,0,4,0,35,1576818000,1599451200,4
LodgePoleMurphy,0,4,0,15,1589860800,1607576400,4
karmicviolence,0,4,0,159,1576904400,1596600000,4
CountMustard,0,4,0,14,1594180800,1594180800,4
roidsnveg,1,3,145,17,1568174400,1568606400,4
j00cifer,0,4,0,7,1582779600,1582779600,4
nmh881,1,3,34,12,1567569600,1567656000,4
BadJokeAlready,0,4,0,121,1575954000,1576904400,4
marimbabeats,0,4,0,17,1595995200,1608699600,4
ButterYourNiceToast,0,4,0,18,1603252800,1608008400,4
EvilMonkeyMimic,0,4,0,49,1540353600,1599105600,4
thetechdude99,0,4,0,15,1608094800,1609390800,4
Bvlvkvy,0,4,0,33,1606194000,1608354000,4
IGuessThisIsFine91,0,4,0,13,1594612800,1612069200,4
ishabwa,0,4,0,9,1580792400,1582261200,4
TheMF-J,0,4,0,18,1580965200,1581051600,4
lunch420,0,4,0,20,1571284800,1583899200,4
Throwawaytimethief,1,3,116,36,1601524800,1601611200,4
WontRead_YourReply,0,4,0,15,1593489600,1595044800,4
SnorfOfWallStreet,0,4,0,17,1603771200,1608181200,4
Drone30389,0,4,0,12,1584417600,1601265600,4
GanjaToker408,0,4,0,179,1595131200,1608267600,4
KnotAgai,0,4,0,155,1559188800,1575262800,4
sargos7,0,4,0,116,1592798400,1593835200,4
BrutusGregori,0,4,0,28,1603857600,1603857600,4
Fortuneon,1,3,8,4,1591416000,1591502400,4
TypicalRedditor42069,1,3,72,22,1546578000,1546837200,4
failed_singingcareer,1,3,0,-12,1575867600,1575954000,4
You_and_I_in_Unison,0,4,0,30,1568520000,1572408000,4
RatMan557,0,4,0,17,1602475200,1606366800,4
Tanire_smite,0,4,0,-15,1599969600,1599969600,4
HuricneDitkaHOF88,1,3,26,8,1553486400,1553572800,4
Leadbelcher7,0,4,0,20,1598760000,1598760000,4
surroundedbywolves,0,4,0,78,1561435200,1563249600,4
KeyboardsAre4Coding,0,4,0,30,1606194000,1607576400,4
antisocial-scientist,0,4,0,6,1603512000,1603598400,4
CrappyOrigami,0,4,0,11,1574312400,1574312400,4
random4232,0,4,0,-13,1572843600,1572930000,4
surfsagger,0,4,0,11,1592712000,1594872000,4
Bagoolia,4,0,19330,0,1602129600,1606107600,4
LaniusLover,0,4,0,157,1579928400,1594526400,4
GigglesBlaze,0,4,0,10,1605416400,1608526800,4
3tigolebitties3,0,4,0,16,1606798800,1606885200,4
kewlaz,0,4,0,9,1606366800,1606971600,4
myfriendsfoundme-1tm,0,4,0,4,1585540800,1607576400,4
Kallerko,0,4,0,24,1572667200,1578891600,4
MelissaOfTroy,0,4,0,53,1547010000,1603598400,4
daviosy,1,3,51,133,1550293200,1557288000,4
marvas,0,4,0,209,1582261200,1593921600,4
-s-t-e-v-e-,0,4,0,8,1607490000,1608354000,4
jessdb19,0,4,0,52,1589860800,1590033600,4
Spacelibrarian43,0,4,0,16,1593662400,1596254400,4
Galore67,0,4,0,20,1581310800,1600574400,4
sarahtonin420,0,4,0,8,1570161600,1573448400,4
Mactavish3,0,4,0,41,1572148800,1580014800,4
WTFunk3001,0,4,0,20,1551675600,1573966800,4
Newtype316,0,4,0,138,1588132800,1593403200,4
S4mb741,0,4,0,26,1595217600,1595390400,4
AlKanNot,0,4,0,27,1566878400,1578978000,4
Keyesblade,0,4,0,133,1559620800,1567828800,4
WizardSugar755,0,4,0,48,1600574400,1607317200,4
ineedabuttrub,0,4,0,389,1571716800,1607144400,4
Greenfireflygirl,0,4,0,30,1605416400,1605416400,4
peterjacksmithpeter,1,3,11,2,1609390800,1609477200,4
Athanord,0,4,0,63,1584504000,1584504000,4
Cyclotron1,1,3,28,4,1599969600,1600056000,4
ThrashCartographer,0,4,0,36,1596686400,1607490000,4
SkillSkillFiretruck,0,4,0,8,1594440000,1598587200,4
chirophilia,0,4,0,10,1582520400,1588219200,4
Papa_Jon,0,4,0,47,1543294800,1550466000,4
DeeBee1968,0,4,0,10,1548306000,1575954000,4
BlueKing7642,0,4,0,29,1580619600,1584504000,4
BigEffective2,0,4,0,27,1590120000,1590120000,4
gonedeadforlife,0,4,0,6,1589515200,1592193600,4
susch1337,0,4,0,31,1576731600,1592107200,4
MexicnGlassCandy,0,4,0,12,1556510400,1595908800,4
notanfbiofficial,0,4,0,36,1597464000,1608526800,4
crybabydeluxe,0,4,0,88,1576126800,1588305600,4
SilentDudee,0,4,0,21,1583211600,1603425600,4
Infinitell,0,4,0,32,1594267200,1597636800,4
TheMurican_,0,4,0,-57,1599796800,1599883200,4
Odin_Christ_,0,4,0,8,1611810000,1611896400,4
SolomanCleric,0,4,0,14,1593748800,1594699200,4
JamesMcGillEsq,0,4,0,-41,1573534800,1573621200,4
Donny_Stevens5,2,2,99,35,1601092800,1608354000,4
SaundersTheGoat,0,4,0,35,1558497600,1581310800,4
Cwhalemaster,0,4,0,2,1571976000,1572062400,4
quick_to_unlearn,0,4,0,-15,1580101200,1580274000,4
PermanentAnarchist,0,4,0,12,1602820800,1604811600,4
diving_sam,0,4,0,256,1594440000,1608267600,4
Royals-2015,0,4,0,4,1577336400,1577336400,4
38isgr8m8,0,4,0,17,1601870400,1601870400,4
TrillinLikeAVillain,0,4,0,4,1584676800,1584676800,4
yungvstplug,0,4,0,14,1605157200,1605157200,4
bingbonggoodbyesir,4,0,6273,0,1598155200,1607317200,4
bobo888,0,4,0,25,1582088400,1590465600,4
NoOneAgreesWithMe,1,3,44,60,1589083200,1589083200,4
RojinShiro,0,4,0,89,1578891600,1582088400,4
D3nj4l,0,4,0,111,1566360000,1580360400,4
SuperSalFad,1,3,0,3,1594180800,1594785600,4
fettywap17388,1,3,15,7,1609390800,1609390800,4
smilin_flash,0,4,0,25,1605157200,1607230800,4
Tom6187,0,4,0,31,1605934800,1608613200,4
fireflyfly3,0,4,0,2,1608526800,1608613200,4
laid_on_the_line,0,4,0,56,1600142400,1600315200,4
EerieEgg,0,4,0,30,1580014800,1588305600,4
Taz-Cnamhin,1,3,18,5,1590552000,1593662400,4
ForensicAstronomy,2,2,27,4,1590465600,1593057600,4
hamdumpster,0,4,0,120,1577336400,1605675600,4
dfaiola18,1,3,73,16,1574917200,1574917200,4
hopelessbabygirl,0,4,0,100,1570593600,1582261200,4
jackparker_srad,1,3,357,29,1581138000,1604898000,4
spindlycashew,0,4,0,222,1598587200,1598673600,4
ScoutforHire,0,4,0,-26,1565668800,1571112000,4
susierooisme,0,4,0,39,1598068800,1598068800,4
ABND_Kevn,0,4,0,21,1555905600,1561780800,4
kingkongscajones,0,4,0,13,1580792400,1587787200,4
BradLabreche,0,4,0,8,1581915600,1608267600,4
ThetruthWithin37,0,4,0,22,1602993600,1603339200,4
yourdadswaifu,0,4,0,65,1575954000,1608008400,4
ribbitcoin,0,4,0,5,1570680000,1570766400,4
morems,0,4,0,-9,1593748800,1611982800,4
HamJaro,0,4,0,78,1586318400,1608786000,4
Skittlesworth,0,4,0,21,1571889600,1573362000,4
ASpanishInquisitor,0,4,0,18,1559275200,1586664000,4
The-Insolent-Sage,0,4,0,32,1591329600,1597636800,4
chizos,0,4,0,44,1575090000,1581570000,4
3bedrooms,0,4,0,22,1539576000,1542085200,4
_doug_fir,4,0,178,0,1557720000,1577422800,4
Alm0stDead,0,4,0,53,1604984400,1605330000,4
Please_Compile,0,4,0,31,1566187200,1566360000,4
jrd_dthsqd,0,4,0,28,1547182800,1578286800,4
LoyalFridge,1,3,5,43,1577595600,1580446800,4
therealharambe420,0,4,0,8,1583643600,1589601600,4
sirpuffypants,0,4,0,-3,1576558800,1577336400,4
audscias,0,4,0,7,1577941200,1578027600,4
meowie91,2,2,17,2,1592798400,1607058000,4
usagi-sam,1,3,26,27,1592193600,1594353600,4
jmatt97,0,4,0,26,1608267600,1608699600,4
Raze_42,0,4,0,0,1605070800,1605070800,4
TwoHighboy,0,4,0,4,1603512000,1603598400,4
goonpunk,0,4,0,23,1557288000,1565323200,4
Luxpreliator,0,4,0,134,1599019200,1608008400,4
hrm0894,0,4,0,97,1570852800,1601179200,4
KaiserSchnell,0,4,0,-13,1595390400,1608094800,4
Arachnolad63,0,4,0,15,1608354000,1608526800,4
Burdenslo,0,4,0,19,1555992000,1605675600,4
13inchpoop,1,3,32,102,1546491600,1581570000,4
canering,0,4,0,50,1584763200,1591329600,4
mcfuckinfries,1,3,13,9,1609218000,1609218000,4
QI89,0,4,0,-11,1597550400,1597636800,4
CaptainCatatonic,0,4,0,28,1582088400,1606971600,4
Qazwsx753421,0,4,0,31,1587873600,1589169600,4
nimbledaemon,0,4,0,1,1585454400,1585540800,4
Bear_faced,0,4,0,15,1583812800,1605416400,4
Remy4409,2,2,23,40,1604898000,1605243600,4
dreamtofalligators,0,4,0,7,1589256000,1589256000,4
Ten7ei,0,4,0,14,1564286400,1566100800,4
Captain_albino,0,4,0,-46,1585800000,1592971200,4
MsSchadenfraulein,0,4,0,34,1585454400,1585713600,4
mipmj,0,4,0,36,1564632000,1608267600,4
nbbby27,0,4,0,76,1557720000,1573362000,4
PhenomeNarc,2,2,25,20,1602820800,1606798800,4
NUKETHEBOURGEOISIE,0,4,0,-6,1603684800,1604552400,4
DamnedestWagonWheel,0,4,0,12,1547269200,1547269200,4
catmilley,0,4,0,14,1575349200,1580706000,4
delta_six,0,4,0,27,1594353600,1596600000,4
Lonesome_Pine,0,4,0,73,1565668800,1581915600,4
Zerop420,1,3,0,-8,1601870400,1601870400,4
telomeracer,0,4,0,53,1597032000,1607662800,4
Franz32,0,4,0,42,1601006400,1607490000,4
WOMENRHELLADUMB,0,4,0,6,1594353600,1597032000,4
gamerdevlop,1,3,33,6,1603857600,1603857600,4
timinc,0,4,0,170,1596686400,1599192000,4
snoosnusnu,0,4,0,52,1603598400,1608354000,4
jafrog,0,4,0,11,1568865600,1575781200,4
e_hyde,0,4,0,10,1603080000,1603512000,4
Ucollect-icollect,0,4,0,24,1541394000,1556683200,4
mircalb,1,3,28,16,1574226000,1587700800,4
Hyper_GhettoWolf,3,1,35,3,1593489600,1598760000,4
XxMAGIIC13xX,0,4,0,2,1592712000,1592884800,4
hpl_fan,3,1,255,3,1582952400,1584676800,4
KayMay1228,0,4,0,57,1605589200,1606280400,4
junius_,1,3,38,12,1597809600,1597896000,4
raymond_noodles,3,1,440,2,1571544000,1579928400,4
_lucy_blue,0,4,0,37,1609304400,1609390800,4
RAWZAUCE420B,0,4,0,-151,1602216000,1602302400,4
2blehelix,0,4,0,118,1586923200,1594267200,4
ulpisen,0,4,0,8,1592366400,1595649600,4
123ihavetogoweeeeee,0,4,0,11,1606885200,1608613200,4
ViridiTerraIX,0,4,0,-10,1593144000,1595908800,4
Curious_Champion6042,0,4,0,23,1601524800,1601611200,4
smokeandglass25,1,3,26,8,1587614400,1587614400,4
NinjasOwnTheNight,1,3,10,13,1593144000,1611896400,4
Casmoose,0,4,0,29,1568520000,1586404800,4
Einn1Tveir2,0,4,0,18,1566187200,1597032000,4
Norrimore,2,2,121,17,1582779600,1600056000,4
PrettyBoiiFreeze,0,4,0,15,1568606400,1568692800,4
slaviccokecowboy,2,2,33,1,1570420800,1584936000,4
Shyamalanislove,0,4,0,40,1605157200,1608958800,4
Mord4k,0,4,0,14,1591416000,1591416000,4
Pontiff117,1,3,56,15,1601006400,1601006400,4
shanwar3,0,4,0,22,1583125200,1599192000,4
breweth,1,3,556,22,1563768000,1567310400,4
HappyHappyBadger,0,4,0,43,1564718400,1597982400,4
zitpop,0,4,0,39,1608958800,1609045200,4
Taildragr,0,4,0,27,1582952400,1587096000,4
TartarusRex0707_,1,3,210,28,1601697600,1602388800,4
dunc1n,1,3,219,151,1570507200,1611982800,4
lollipop999,0,4,0,61,1607835600,1608613200,4
InfinityRelia,2,2,105,13,1602216000,1603080000,4
aspensmonster,0,4,0,40,1538712000,1589774400,4
Me0wingtons,0,4,0,15,1583211600,1608526800,4
coibril,0,4,0,343,1584504000,1586059200,4
WalterBlackboots,0,4,0,12,1578373200,1589601600,4
Shogun462,0,4,0,29,1596340800,1603771200,4
cockfuckedbysekiro,0,4,0,52,1560312000,1560312000,4
zacharyo083194,0,4,0,2,1585454400,1585627200,4
tokyotuner,1,3,59,19,1602216000,1606712400,4
aozeba,0,4,0,14,1609477200,1609477200,4
ElChachito24,0,4,0,31,1600920000,1611723600,4
I_cut_my_own_jib,2,2,537,22,1593230400,1602907200,4
Lzryde,0,4,0,1,1574571600,1574571600,4
doublejay1999,0,4,0,57,1592539200,1598587200,4
Slitelohel,0,4,0,4,1600660800,1605675600,4
RB1412,0,4,0,10,1598846400,1599624000,4
common_rabbit,0,4,0,100,1603684800,1609131600,4
SaltMagician,0,4,0,-7,1579323600,1586923200,4
MinneIceCube,0,4,0,10,1602475200,1607058000,4
kytm,0,4,0,-3,1574139600,1592366400,4
lesbiantrauma,0,4,0,39,1595563200,1599796800,4
elementgermanium,0,4,0,59,1589428800,1604203200,4
Nathan61289543,0,4,0,11,1541912400,1542949200,4
Neinface,0,4,0,49,1608699600,1608958800,4
TreeFjord,0,4,0,50,1581483600,1592539200,4
Frequent_Republic,0,4,0,17,1586059200,1605157200,4
Blake_Thundercock,0,4,0,28,1563681600,1576731600,4
bindi1996,0,4,0,7,1602388800,1602475200,4
ursula_minor01,0,4,0,89,1603425600,1604379600,4
TheDildoUnicorn,0,4,0,12,1571371200,1598241600,4
1d3333,0,4,0,24,1600228800,1600315200,4
StoneySpachoni,0,4,0,10,1596945600,1599192000,4
FrolickingFox741,1,3,117,38,1555041600,1555041600,4
infamouszgbgd,1,3,90,9,1607490000,1609304400,4
mushroots,0,4,0,29,1581397200,1583899200,4
MadOrange64,0,4,0,12,1601179200,1601179200,4
jwatson96,3,1,154,1,1562126400,1570075200,4
Fireheart251,0,4,0,3,1559275200,1568088000,4
LairaKlock,0,4,0,99,1597291200,1611896400,4
Maurarias,1,3,16,19,1574226000,1602475200,4
CalicoMorgan,0,4,0,23,1601784000,1607490000,4
amanofoneway,0,4,0,3,1606626000,1606712400,4
Xijichink,0,4,0,-19,1607835600,1608094800,4
Jepordee,0,4,0,-10,1604030400,1604030400,4
postman475,0,4,0,4,1553140800,1553227200,4
PokeydaRedHorse,1,3,18,9,1575781200,1578373200,4
windsweptcypress,1,3,17,50,1563163200,1568088000,4
spaceman1980,0,4,0,-44,1591761600,1598932800,4
6000eyes,0,4,0,15,1595649600,1595649600,4
Golf_and_Rap,0,4,0,19,1565236800,1591329600,4
Thatstrongguy34,1,3,48,12,1581051600,1594008000,4
TheHungryHeathen,0,4,0,398,1611896400,1611982800,4
jackosan,2,2,25,0,1582088400,1597118400,4
jyajay,0,4,0,66,1592107200,1595563200,4
Dylanrevolutionist48,0,4,0,9,1607144400,1609304400,4
Superflirt23,0,4,0,125,1608613200,1609131600,4
Gfairservice,0,4,0,11,1597118400,1606453200,4
TheTestacularOne,1,3,10,7,1547269200,1547269200,4
blargityblarf,0,4,0,1,1572148800,1572148800,4
lucyboraha,0,4,0,9,1594958400,1597377600,4
Rosin-the-Bow,0,4,0,58,1580101200,1580706000,4
jeepsareforgirls,0,4,0,9,1598587200,1598673600,4
do_ur_best,0,4,0,13,1588132800,1605070800,4
Minimot123,0,4,0,23,1567569600,1580446800,4
dabiiii,0,4,0,85,1574485200,1606971600,4
Bakibenz,0,4,0,135,1594872000,1598846400,4
Kraanerg,0,4,0,409,1597464000,1599624000,4
KdotCole15,0,4,0,35,1611810000,1612155600,4
charliet383,1,3,16,8,1592625600,1603339200,4
Phixioner,0,4,0,15,1557460800,1558238400,4
OddlyTaco,1,3,79,20,1560052800,1566014400,4
FolkPunkBowie,1,3,5,4,1600660800,1600747200,4
ThisIsJustATr1bute,0,4,0,11,1540872000,1540958400,4
DeathByDrumming,0,4,0,-1,1608267600,1608354000,4
Catherine9983,1,3,13,6,1576040400,1589947200,4
majestyofcirce,0,4,0,10,1600920000,1600920000,4
Lolsofunnie,2,2,13,4,1583384400,1583470800,4
FrancisC,0,4,0,15,1580014800,1580533200,4
throwmeabone86,2,2,205,18,1575522000,1611896400,4
Meta_Boy,0,4,0,6,1589169600,1590724800,4
superfucky,0,4,0,51,1608786000,1608786000,4
Jacobletrashe,0,4,0,1,1585454400,1585454400,4
insert_title_here,0,4,0,10,1569470400,1585195200,4
legohab880,0,4,0,23,1596081600,1599192000,4
TotalIdiotNerd,2,2,10,0,1574830800,1603857600,4
123420tale,0,4,0,48,1559016000,1565236800,4
PimeydenHenki,1,3,16,4,1605157200,1605243600,4
irishspringers,0,4,0,146,1611896400,1611896400,4
pastorbasterd,0,4,0,19,1569211200,1569211200,4
laminated_penguin,0,4,0,43,1580533200,1580533200,4
cutecoelacanth,0,4,0,20,1593057600,1600920000,4
keppep,0,4,0,41,1560398400,1566792000,4
sniffinglinesofcorn6,1,3,0,-4,1602648000,1602734400,4
znidz,0,4,0,57,1553832000,1602820800,4
dirtyredsweater,0,4,0,5,1596686400,1608181200,4
ChemEBrew,0,4,0,27,1571803200,1580014800,4
Third_E,0,4,0,4,1576645200,1576645200,4
redditatwork12121,2,2,64,6,1557979200,1566792000,4
CrosiusYYC,0,4,0,85,1563249600,1592712000,4
neb12345,0,4,0,14,1594612800,1612155600,4
DAFERG,0,4,0,2,1580360400,1580360400,4
berts1404,1,3,29,8,1564027200,1580533200,4
DreamHomeFinancing,0,4,0,-49,1591243200,1591416000,4
mutual_fishmonger,1,3,128,49,1585368000,1585627200,4
ratskullz,0,4,0,21,1579755600,1580619600,4
Introvert73271,1,3,67,9,1580533200,1580533200,4
c_marten,0,4,0,26,1586491200,1586664000,4
banjo123717,0,4,0,27,1578978000,1585886400,4
MushieMuncher,0,4,0,92,1587441600,1593662400,4
icicibank,2,2,76,5,1574226000,1608699600,4
bestestdude,0,4,0,28,1604725200,1606280400,4
Strelokk88,0,4,0,49,1560484800,1575608400,4
Aruvanta,0,4,0,101,1570420800,1580014800,4
ASSHOLETEARER6969,3,1,211,15,1592798400,1598587200,4
sbp421,0,4,0,15,1580014800,1600574400,4
TheReprogrammer,0,4,0,7,1560312000,1560312000,4
No-Term6052,0,4,0,126,1611982800,1611982800,4
Mutt_Zeppi_,0,4,0,-9,1574398800,1587441600,4
rabidkiwi13,0,4,0,48,1590465600,1609390800,4
evangelism2,0,4,0,17,1546578000,1546664400,4
Ben2749,1,3,393,42,1550466000,1554264000,4
andante528,0,4,0,21,1595304000,1595390400,4
Firethorn101,0,4,0,23,1604379600,1605502800,4
CreamPuffDelight,0,4,0,22,1572321600,1572321600,4
THATASSH0LE,0,4,0,40,1587528000,1605070800,4
afserkin,1,3,498,83,1598241600,1606885200,4
early2000rockband,0,4,0,200,1564372800,1584072000,4
goldenguuy,0,4,0,27,1595908800,1598068800,4
EllietteB,0,4,0,217,1600142400,1600228800,4
warped655,1,3,10,45,1427515200,1568952000,4
tehwhitemamba,0,4,0,49,1605934800,1611896400,4
peridax0,1,3,33,3,1588737600,1593057600,4
AgentAllisonTexas,0,4,0,101,1595304000,1595304000,4
SteelLegionnaire,0,4,0,8,1588651200,1588824000,4
jonesgrey,2,2,693,4,1580792400,1595131200,4
creatingreality,0,4,0,13,1466395200,1482555600,4
davis946,0,4,0,-20,1585454400,1599451200,4
Tal_Av,1,3,9,3,1584244800,1584676800,4
CatharticRevenge,0,4,0,61,1604898000,1605070800,4
oftcenter,0,4,0,13,1595217600,1596600000,4
hopefulbaker,0,4,0,5,1554264000,1554350400,4
Ruesla,0,4,0,23,1608958800,1608958800,4
wildlifewildheart,1,3,30,5,1592971200,1593057600,4
Slow_Breakfast,0,4,0,6,1604725200,1606798800,4
Kate925,1,3,6,5,1596168000,1596427200,4
Uncle_Rabbit,0,4,0,13,1600747200,1600833600,4
MeatLord,0,4,0,37,1584763200,1599710400,4
Anotsurei,0,4,0,4,1596427200,1596427200,4
imustberadiant,0,4,0,34,1565755200,1566705600,4
DynamicResonater,0,4,0,3,1608267600,1608354000,4
Khue,0,4,0,57,1603512000,1603512000,4
WildfireWoman1972,0,4,0,17,1592539200,1593662400,4
-StupidFace-,0,4,0,4,1590724800,1590724800,4
journeytonowhere,1,3,6,5,1477454400,1566964800,4
Bob-Vance_,0,4,0,-8,1567828800,1567828800,4
lilmookmook,0,4,0,9,1602907200,1604898000,4
shakezillla,0,4,0,2,1565755200,1565928000,4
henkydinkrae,0,4,0,66,1582002000,1605157200,4
tyriant77,0,4,0,8,1578114000,1578114000,4
AluminumOctopus,0,4,0,12,1588132800,1602475200,4
crankedmunkie,0,4,0,171,1592193600,1608267600,4
lowlyloner,0,4,0,16,1574398800,1575608400,4
NeckBeardPrimitivist,0,4,0,0,1596254400,1596513600,4
EndTorture,0,4,0,18,1541394000,1546578000,4
HenSenPrincess,0,4,0,2,1611982800,1612069200,4
capitanDracaris,0,4,0,15,1565236800,1583038800,4
MajesticAsFook,0,4,0,23,1598500800,1604379600,4
slimey_the_guitarist,1,3,977,26,1567656000,1570075200,4
IdlingTheGames,0,4,0,1,1620705600,1620705600,4
ClearProgram,0,4,0,-109,1576558800,1576558800,4
Dbug113,0,4,0,78,1540872000,1569384000,4
House-of-Suns,0,4,0,14,1566878400,1585627200,4
Bulmaxx,0,4,0,1919,1600747200,1611723600,4
nonideologicaltruth,0,4,0,-148,1578286800,1578373200,4
hema2tite,0,4,0,59,1580274000,1581656400,4
Myrmec,0,4,0,32,1573362000,1585108800,4
BlackOmegaPsi,0,4,0,50,1589428800,1594872000,4
momzeggs89,0,4,0,64,1580274000,1588651200,4
Crazyjay1,0,4,0,20,1542430800,1564545600,4
dragons4president,0,4,0,0,1608267600,1608267600,4
Happypengy,0,4,0,27,1596686400,1600401600,4
VirtualRay,0,4,0,30,1560657600,1598932800,4
FLakIsBack,0,4,0,-1,1607317200,1608526800,4
holybaloneyriver,0,4,0,35,1567051200,1569902400,4
RedditGrace,0,4,0,12,1605848400,1608094800,4
TheRazorX,0,4,0,91,1594872000,1607490000,4
cicadawing,0,4,0,60,1599105600,1599192000,4
Terker2,0,4,0,17,1605589200,1605589200,4
muddycats,1,3,53,10,1549256400,1553486400,4
SquirrelicideScience,0,4,0,5,1584763200,1586059200,4
brownmojo,1,3,42,10,1606280400,1606453200,4
Truetree9999,3,1,19,7,1577941200,1586836800,4
AndrewOfBraavos,0,4,0,25,1573794000,1592107200,4
AnarchisTara,4,0,34,0,1605157200,1607835600,4
Ellemwella,1,3,19,7,1590120000,1590379200,4
corasivy,1,3,10,11,1575349200,1575349200,4
nameisalreadytaken53,0,4,0,284,1564372800,1608267600,4
trueblue212,1,3,5,4,1585454400,1597032000,4
Big_Baked_Wolf,0,4,0,67,1603598400,1608699600,4
dorkbisexual,0,4,0,18,1561003200,1590552000,4
throwaway83749278547,0,4,0,27,1579928400,1604116800,4
noonhe,0,4,0,82,1593144000,1601697600,4
CodingLemur,0,4,0,-29,1606626000,1607144400,4
etegan,2,2,54,3,1578632400,1598587200,4
MisterJackpotz,0,4,0,18,1602043200,1607749200,4
masturbatingPotato,0,4,0,-86,1561348800,1561348800,4
GabeGabou,0,4,0,18,1570420800,1570420800,4
BovusSanctus,0,4,0,45,1564459200,1573707600,4
generic_usernamehere,0,4,0,14,1578286800,1578891600,4
BlueJayHR21,0,4,0,-2,1595390400,1598846400,4
bringer-of-light-,0,4,0,33,1598760000,1604725200,4
GuhttR,1,3,28,21,1601697600,1601697600,4
Vesper_Sweater,0,4,0,28,1587182400,1590897600,4
Vaublode,0,4,0,22,1601870400,1602475200,4
chinacatsunflower96,0,4,0,16,1603512000,1607403600,4
CounterPoliceFcuk12,0,4,0,42,1597550400,1605330000,4
cameeeeeeeee,1,3,29,7,1552536000,1555300800,4
heymrpostmanshutup,0,4,0,29,1559102400,1559275200,4
6Kozz6,0,4,0,75,1591329600,1602734400,4
Sanquinity,0,4,0,24,1582002000,1582174800,4
FancyBandit,0,4,0,8,1601956800,1601956800,4
SackNaps,0,4,0,4,1607403600,1611723600,4
HShahzad108277,1,3,3,7,1609218000,1609304400,4
Stormxlr,0,4,0,38,1587960000,1608786000,4
floweringcacti,1,3,17,69,1585540800,1595390400,4
Imaykeepthisone,0,4,0,352,1575781200,1603339200,4
StrongBuffaloAss69,0,4,0,-35,1577422800,1580014800,4
TheTwAiCe,0,4,0,9,1590465600,1603339200,4
bobtheturd,0,4,0,62,1581051600,1589860800,4
Whystare,0,4,0,15,1603598400,1603684800,4
snowytigers,0,4,0,16,1589256000,1608699600,4
LifeUnderTheSheets,1,3,325,39,1576386000,1585454400,4
stationtostationalt,0,4,0,137,1565496000,1588392000,4
brownIve,0,4,0,195,1583384400,1593230400,4
surprised-duncan,0,4,0,7,1601265600,1606021200,4
xylude,0,4,0,65,1559534400,1578027600,4
seawiiitch,1,3,30,29,1568174400,1594872000,4
break1ngst1cks,0,4,0,449,1575435600,1575522000,4
Lowtheparasite,0,4,0,-13,1583470800,1583470800,4
dr-cringe,1,3,40,48,1557720000,1599624000,4
Mononobon,0,4,0,15,1598932800,1598932800,4
thufflepuff,0,4,0,19,1603339200,1605330000,4
Rmeechy7455,0,4,0,-17,1606021200,1606021200,4
osrsgf2147m,0,4,0,440,1589169600,1596600000,4
takeurheart,0,4,0,85,1580965200,1608008400,4
NiceGrandpa,0,4,0,19,1580014800,1580101200,4
averagebloodloss,1,3,267,62,1594872000,1606539600,4
SquishyPeas,0,4,0,8,1608267600,1608267600,4
activitysuspicious,0,4,0,40,1589428800,1602388800,4
lolfishstick,0,4,0,6,1585540800,1600660800,4
finnkat,1,3,134,14,1576126800,1576126800,4
Riblet1965,0,4,0,12,1600660800,1601784000,4
nova_beta,0,4,0,18,1600833600,1600920000,4
Lilyo,2,2,104,12,1607403600,1611982800,4
Crawgdor,0,4,0,27,1579150800,1603512000,4
Juxxta1,0,4,0,6,1555473600,1563508800,4
covert-pops,0,4,0,17,1568865600,1568952000,4
Part_of_the_wave,0,4,0,46,1557288000,1596513600,4
CustomSawdust,0,4,0,12,1584244800,1586664000,4
Blasted_Lands,0,4,0,30,1607403600,1611982800,4
KingConnor2020,0,4,0,16,1591243200,1591243200,4
Lycan-_-Warrior-,0,4,0,35,1591588800,1608526800,4
AgentDaleBCooper,0,4,0,41,1581051600,1588219200,4
mondaysareharam,0,4,0,8,1606366800,1606366800,4
nogodonlystas,0,4,0,54,1583038800,1585627200,4
mueslimeal,0,4,0,25,1555041600,1557201600,4
Randomtngs,0,4,0,55,1573448400,1573621200,4
TemperanceL,2,2,43,8,1595217600,1608699600,4
milkywayT_T,0,4,0,9,1588219200,1588219200,4
gatofishhh,0,4,0,17,1585627200,1608699600,4
igotbannedsoimback,0,4,0,-7,1573362000,1573362000,4
brackattack27,0,4,0,13,1605934800,1608526800,4
MathitiTouEpiktetos,0,4,0,11,1591329600,1592884800,4
iwannafightmorrissey,1,3,27,8,1605502800,1605502800,4
13Ruston,0,4,0,34,1589169600,1603512000,4
froglelefrogle,0,4,0,8,1577422800,1579755600,4
OhmItOut,0,4,0,18,1578632400,1578632400,4
PhenomUprising,0,4,0,8,1597377600,1601092800,4
Brawno,0,4,0,10,1605934800,1605934800,4
Gerbole,0,4,0,22,1606021200,1606885200,4
Dirtybubble_,0,4,0,1,1602129600,1607490000,4
RJ_Arctic,0,4,0,-28,1596859200,1607749200,4
kilranian,0,4,0,8,1608786000,1609304400,4
superblobby,0,4,0,46,1570593600,1575003600,4
MyCatEatsBakedBeans,0,4,0,243,1605157200,1606971600,4
mtpt1719,1,3,195,43,1592539200,1598241600,4
HotPhilly,0,4,0,21,1579237200,1579410000,4
hazadaza,1,3,235,14,1596081600,1596168000,4
WEsellFAKEdoors,0,4,0,97,1558411200,1591416000,4
NebulaMeadow,1,3,16,34,1548046800,1551416400,4
Tokigreed,0,4,0,37,1520658000,1535601600,4
HiImAishi,0,4,0,25,1583125200,1595649600,4
Garfus-D-Lion,0,4,0,12,1571112000,1579669200,4
beastgamer9136,2,2,417,3,1561089600,1599278400,4
mjc500,0,4,0,66,1592107200,1607144400,4
stonebolt,0,4,0,6,1581570000,1581570000,4
Shadesbane43,0,4,0,46,1573534800,1587096000,4
TheVampiressReturns,0,4,0,25,1584244800,1592452800,4
nomsdv,0,4,0,21,1592539200,1594353600,4
Uzbekistank,0,4,0,7,1606798800,1606971600,4
alphacc82,0,4,0,2,1589515200,1589601600,4
Ramitgood,0,4,0,40,1547010000,1565150400,4
zookansas,0,4,0,-9,1600660800,1601179200,4
lullabyxstars,0,4,0,33,1593057600,1598414400,4
TheBigBangTheoryIsOk,0,4,0,24,1556769600,1561608000,4
961402,0,4,0,18,1578286800,1580878800,4
faeriepools,1,3,97,5,1612069200,1612242000,4
pastelglitrr,0,4,0,22,1602648000,1602648000,4
SubsequentNebula,0,4,0,14,1593662400,1593662400,4
ActuallyYeah,0,4,0,8,1597723200,1605589200,4
Niclmaki,0,4,0,11,1592366400,1595649600,4
doughpat,0,4,0,5,1597636800,1597636800,4
turbowo,0,4,0,68,1603944000,1606280400,4
-rng_,0,4,0,1,1597550400,1598760000,4
withinyouandwithout,0,4,0,114,1592280000,1611982800,4
Sonotsugipaa,0,4,0,89,1590120000,1597032000,4
Westfield22,0,4,0,76,1559534400,1562731200,4
martinLives,1,3,15,3,1604116800,1604116800,4
fullhalter,0,4,0,52,1606626000,1607662800,4
Katastrofa2,0,4,0,-64,1580706000,1593403200,4
purheartdumbass,1,3,11,11,1594440000,1597464000,4
JuicedFleeb,0,4,0,13,1572580800,1582261200,4
azjoe13,0,4,0,55,1589256000,1603425600,4
MegatronSalad,0,4,0,6,1597204800,1606453200,4
anaflaviax,0,4,0,22,1587182400,1603252800,4
hotlikebea,0,4,0,20,1588910400,1615953600,4
youaintgotnomoney1,1,3,25,10,1608872400,1609477200,4
jafreako-la-herm,2,2,164,15,1571803200,1575176400,4
jteejay,0,4,0,11,1606453200,1609218000,4
Far_Wolf625,0,4,0,7,1605070800,1605157200,4
KevinKalber,0,4,0,41,1602648000,1602648000,4
pseudonym_mynoduesp,0,4,0,-1,1572148800,1608440400,4
narwhal-lord14,0,4,0,-19,1579928400,1582347600,4
BoySmooches,0,4,0,39,1587182400,1589342400,4
we_shall_overcome,1,3,16,15,1575608400,1580533200,4
brainburnout,0,4,0,171,1587182400,1588305600,4
LawrenceCatNeedsHelp,1,3,43,17,1550379600,1579064400,4
Lifelight77,3,1,1316,3,1599105600,1601092800,4
unokittie,0,4,0,18,1590206400,1605243600,4
International-Act156,0,4,0,6,1601006400,1601611200,4
lovelovehatehate,1,3,137,21,1549515600,1600920000,4
foondoo,1,3,12,4,1534478400,1535256000,4
Specialsnowflake88,1,3,693,29,1592366400,1592366400,4
Gorthax,0,4,0,9,1605243600,1605243600,4
Ghosttalker96,0,4,0,1,1572235200,1606021200,4
AJobIsSlavery,0,4,0,12,1603598400,1603684800,4
ModestRaptor,0,4,0,10,1584072000,1585454400,4
Drelecour,1,3,648,37,1606539600,1608613200,4
FunkyFarmington,0,4,0,7,1552021200,1611810000,4
DeadBolt508,1,3,0,5,1595390400,1595390400,4
beryltheperil1,0,4,0,34,1553918400,1593144000,4
Fledgeling,0,4,0,13,1588996800,1611896400,4
lola_pepsicola,0,4,0,4,1606712400,1606798800,4
trp_sidepiece,0,4,0,6,1597809600,1598414400,4
PinkFreud92,1,3,120,6,1579410000,1597723200,4
Anarchy_How,0,4,0,11,1576904400,1609304400,4
Raptortidbit,1,3,48,33,1551070800,1584417600,4
offlinebound,0,4,0,47,1568779200,1583470800,4
compare_and_swap,0,4,0,4,1608699600,1608699600,4
interuptingjackass,0,4,0,9,1582347600,1585195200,4
raddits,0,4,0,27,1576126800,1604116800,4
Despite_Humanity,1,3,10,8,1567483200,1567569600,4
Enigma_Stasis,0,4,0,6,1573534800,1605070800,4
ScarthMoonblane,0,4,0,-16,1607576400,1607576400,4
hrimfaxi_work,0,4,0,42,1582261200,1607317200,4
sdnightowl,0,4,0,10,1585454400,1585454400,4
Hvsvn3900,0,4,0,10,1547182800,1547182800,4
Nophlter,0,4,0,8,1608267600,1608267600,4
LAMAO_KUN,0,4,0,306,1599364800,1604811600,4
MoldyMayo,0,4,0,26,1593662400,1593662400,4
ITBTEWB,0,4,0,10,1581915600,1598500800,4
born2biscuit,0,4,0,16,1597032000,1600833600,4
matthewbayer,0,4,0,67,1579237200,1582261200,4
anetam7,0,4,0,20,1553745600,1560916800,4
2Punx2Furious,0,4,0,4,1592712000,1605416400,4
sweetcletus,0,4,0,38,1606626000,1606626000,4
theodopolopolus,0,4,0,16,1597377600,1597982400,4
captainvaughn,0,4,0,-1,1594008000,1594008000,4
SkippyHole,0,4,0,97,1598414400,1608699600,4
baron-of-the-bacon,0,4,0,20,1572148800,1575262800,4
timfay4,0,4,0,21,1576386000,1577163600,4
XRenaMarieX,0,4,0,36,1601524800,1601524800,4
meowymcmeowmeow,0,4,0,31,1563336000,1565668800,4
BufloSolja,0,4,0,8,1576731600,1598846400,4
Devilsgun,0,4,0,14,1611810000,1611982800,4
warboatss,1,3,48,13,1560052800,1571198400,4
T4O2M0,0,4,0,0,1577422800,1577422800,4
kingkool88,0,4,0,236,1549515600,1562126400,4
Smokahontas1864,0,4,0,4,1585454400,1607662800,4
InternetAccount06,0,4,0,21,1598846400,1603512000,4
lorenzomofo,0,4,0,14,1603425600,1611982800,4
pm_me_all_dogs,0,4,0,48,1546491600,1608526800,4
lilybean-,1,3,296,13,1593489600,1596340800,4
Arctinius,0,4,0,4,1598760000,1598760000,4
ThSafeForWorkAccount,0,4,0,37,1605589200,1607922000,4
lovejac93,0,4,0,-9,1589860800,1589947200,4
thatoneguy54,0,4,0,122,1572235200,1573102800,4
luvs2meow,0,4,0,99,1593316800,1596859200,4
orionbasssolo,0,4,0,-106,1580014800,1580014800,4
cailenrivers,0,4,0,35,1590724800,1600833600,4
plissryuken,0,4,0,294,1580360400,1580446800,4
_peppermint,0,4,0,51,1575435600,1576126800,4
keklol69,0,4,0,122,1596772800,1606885200,4
thedude1179,0,4,0,4,1600833600,1602129600,4
coolworx,0,4,0,0,1608699600,1608699600,4
Send_me_your_BM,0,4,0,104,1578373200,1607922000,4
YubYub3,0,4,0,41,1591588800,1602302400,4
Asadacrue,0,4,0,176,1583038800,1587614400,4
ChuPointOh,0,4,0,64,1602216000,1606626000,4
magnetsandbananas,0,4,0,10,1580619600,1595217600,4
Socialdem,0,4,0,31,1600142400,1606021200,4
mongreyami,1,3,116,66,1550984400,1550984400,4
hindumafia,0,4,0,9,1603512000,1603512000,4
azader,0,4,0,6,1601697600,1601697600,4
Marc856,4,0,8244,0,1559102400,1612155600,4
xboxisokayiguess,0,4,0,89,1549170000,1550034000,4
sirgrumpycat,0,4,0,16,1580187600,1582693200,4
Alex-Miceli,0,4,0,56,1585108800,1585108800,4
anarcho-cummunist,0,4,0,337,1599019200,1606712400,4
hallcyon11,0,4,0,-24,1548392400,1548478800,4
maplemagiciangirl,0,4,0,31,1584849600,1603771200,4
justcallmesparky2009,0,4,0,38,1589169600,1589169600,4
Flyingbattlebear,0,4,0,24,1601870400,1608181200,4
ncsuwolf,0,4,0,15,1596513600,1606539600,4
Addicted2Accounting,0,4,0,-2,1575349200,1579064400,4
lisapizza1993,1,3,980,12,1565496000,1607662800,4
belongsinagarbagecan,0,4,0,124,1587096000,1587182400,4
OrchardLeaf,1,3,24,11,1611982800,1611982800,4
nymph77,2,2,37,5,1581742800,1605416400,4
mil_1,0,4,0,90,1587096000,1599883200,4
Toltech99,1,3,69,109,1579928400,1597032000,4
climateclimax,4,0,4237,0,1576558800,1577682000,4
HydratedHobo,0,4,0,42,1606539600,1608613200,4
dreadpiratebeardface,0,4,0,12,1584590400,1605070800,4
dan26dlp,0,4,0,5,1594699200,1601006400,4
quohr,0,4,0,77,1575781200,1576645200,4
onlyheretobitchatyou,0,4,0,-8,1585195200,1585281600,4
trishia0321,0,4,0,20,1556424000,1559620800,4
EssentialUSAWorker,0,4,0,40,1587096000,1590724800,4
paulybrklynny,0,4,0,176,1602475200,1611982800,4
kevinkarma,0,4,0,0,1582779600,1582779600,4
unoriginalsin,0,4,0,-1,1599019200,1599019200,4
reillyqyote,0,4,0,32,1597809600,1607922000,4
HarmonicPattern,1,3,42,5,1599969600,1600056000,4
031708k,0,4,0,127,1605675600,1608526800,4
AfternoonSize,0,4,0,5,1591934400,1597291200,4
PathalogicalObject,0,4,0,7,1609563600,1609563600,4
Beeinkc9,0,4,0,204,1557720000,1572667200,4
shitflowering,0,4,0,16,1598241600,1602475200,4
olhonestjim,0,4,0,9,1605416400,1608267600,4
CrissCrossroads,0,4,0,50,1592280000,1592280000,4
knockknockbear,0,4,0,37,1596254400,1596254400,4
inward_acct,0,4,0,83,1585713600,1587700800,4
feelthemusicinmybra,0,4,0,268,1571976000,1573880400,4
lelucif,1,3,38,4,1573275600,1589169600,4
romancenovella,0,4,0,22,1552276800,1553659200,4
hawleyal,0,4,0,4,1585108800,1606626000,4
azthek,0,4,0,7,1604466000,1604552400,4
YahBoyElNino,0,4,0,-26,1590033600,1601179200,4
AverageBubble,0,4,0,16,1571976000,1594353600,4
burnmeupscottyyyy,0,4,0,56,1591156800,1605934800,4
Aesbeth,0,4,0,59,1574658000,1574658000,4
anarcho-cannabist,1,3,33,2,1611810000,1611896400,4
Satoshi-Salaryman,1,3,0,-11,1606107600,1606107600,4
Abortatortatport,0,4,0,22,1569038400,1569124800,4
Watchmaker163,0,4,0,15,1581915600,1601870400,4
Hot_Pocket_Man,0,4,0,18,1593576000,1595822400,4
athielqueen,0,4,0,26,1585540800,1599624000,4
iamwaitingtocompile,0,4,0,17,1596600000,1600315200,4
utterly_baffledly,0,4,0,8,1594440000,1597118400,4
Nebulyra,0,4,0,42,1566532800,1601870400,4
Erober36,0,4,0,-35,1601611200,1601611200,4
Corrision,0,4,0,6,1606280400,1606885200,4
OttoVonBooty,0,4,0,39,1606798800,1606971600,4
fredegarius,0,4,0,99,1601265600,1601265600,4
OnlyPaperListens,0,4,0,28,1583557200,1593835200,4
stnivek,0,4,0,71,1566705600,1566878400,4
Tophat-boi,0,4,0,10,1592712000,1592712000,4
LivinLaRickiLoca,0,4,0,56,1579410000,1585627200,4
aikatema88,0,4,0,6,1609045200,1609045200,4
shikitohno,0,4,0,36,1542862800,1574312400,4
hh200077,0,4,0,5,1581310800,1581397200,4
TheModerateNihilist,0,4,0,64,1604725200,1604811600,4
balls_deep_space,0,4,0,60,1597118400,1608267600,4
MolotovCollective,0,4,0,9,1574744400,1608699600,4
charlesdickens2007,1,3,137,32,1591675200,1591761600,4
kmaser,0,4,0,5,1584676800,1584849600,4
unluckyforeigner,0,4,0,50,1558238400,1561435200,4
Generaltiti,0,4,0,10,1586404800,1586404800,4
FireLordObama,0,4,0,-6,1608094800,1614056400,4
samati,0,4,0,51,1587096000,1606712400,4
dagger80,0,4,0,25,1605934800,1608958800,4
Skoop963,0,4,0,-15,1606626000,1606626000,4
QoolSchitt,0,4,0,5,1595908800,1595908800,4
Tin_Philosopher,0,4,0,53,1571457600,1590897600,4
nordbundet_umenneske,0,4,0,40,1582606800,1607835600,4
FoundationMule1,0,4,0,-26,1597032000,1597032000,4
keetotheley,1,3,131,10,1582174800,1582261200,4
Whomeveritis,1,3,21,5,1574053200,1574571600,4
DustyCupcakes,0,4,0,45,1594094400,1594094400,4
supertimes4u,0,4,0,3,1608267600,1608267600,4
Kitkatrolex,1,3,14,5,1570766400,1570766400,4
Cloak77,0,4,0,23,1596427200,1607749200,4
NateSucksFatWeiners,0,4,0,6,1465185600,1465617600,4
focus_rising,0,4,0,78,1573102800,1576558800,4
frantalones,1,3,18,5,1591070400,1591070400,4
maxdamien27,0,4,0,4,1597982400,1600833600,4
shicky4,0,4,0,4,1586232000,1606971600,4
DullLightning,0,4,0,95,1580533200,1586750400,4
masterofnone_,0,4,0,18,1565496000,1596772800,4
PremierP89,2,2,5473,215,1588392000,1588910400,4
Fountain62,0,4,0,27,1582261200,1582261200,4
ThrowThatAssByke,0,4,0,-99,1570334400,1570852800,4
N1Rom,0,4,0,19,1577336400,1577336400,4
simonon13,0,4,0,6,1600833600,1600920000,4
The_Extraordinaire,0,4,0,-4,1601524800,1609477200,4
zedconus,0,4,0,18,1577854800,1577854800,4
GimmeThatSunshine,0,4,0,16,1602129600,1604811600,4
DirtyBendavitz,0,4,0,50,1584763200,1584849600,4
emilylukns,1,3,13,6,1583125200,1586232000,4
GodVerified,0,4,0,18,1567569600,1583298000,4
floygarry,0,4,0,4,1581310800,1581310800,4
Falkoro,4,0,80,0,1573534800,1574398800,4
akotlya1,0,4,0,11,1607576400,1607662800,4
mcgruntman,0,4,0,29,1548910800,1597896000,4
burke_no_sleeps,0,4,0,30,1599364800,1605934800,4
Chuckcheer,0,4,0,9,1584158400,1590206400,4
dontthink19,0,4,0,15,1595217600,1611637200,4
iansynd,0,4,0,4,1602820800,1606366800,4
johnbeatty08,1,3,403,16,1548478800,1548565200,4
obeyyourbrain,0,4,0,39,1581310800,1612069200,4
Al-Horesmi,0,4,0,224,1577595600,1602820800,4
MavisBanks,0,4,0,107,1600747200,1606885200,4
Eko777,0,4,0,27,1534737600,1588564800,4
smRS6,0,4,0,-2,1588478400,1590897600,4
lafleurricky,0,4,0,65,1583470800,1591416000,4
Drakefoxaroo,0,4,0,34,1602907200,1602993600,4
spiritoradio,2,2,71,15,1574312400,1584763200,4
santino66,0,4,0,15,1574744400,1592366400,4
shyvananana,0,4,0,28,1577854800,1577854800,4
Employment-lawyer,0,4,0,5,1596168000,1596168000,4
Party_Wagon,1,3,28,16,1583557200,1588910400,4
brooklynlad,0,4,0,53,1609045200,1611982800,4
not_theClampdown,1,3,16,10,1595304000,1596945600,4
Subject-Quality,0,4,0,-24,1581310800,1581483600,4
seldomtimely,1,3,27,88,1586923200,1605070800,4
ampleavocado,0,4,0,2,1588392000,1599364800,4
KindDysphoria,0,4,0,64,1600315200,1605070800,4
JiubR,0,4,0,58,1572843600,1597896000,4
argumentativepigeon,0,4,0,4,1639717200,1639803600,4
marx_and_rec,0,4,0,29,1595649600,1603771200,4
blueevey,0,4,0,111,1564459200,1609304400,4
Stiley34,0,4,0,15,1579755600,1598932800,4
aperson79,1,3,13,6,1607058000,1609218000,4
cryptogryphon,0,4,0,35,1582520400,1597723200,4
letdown-chan,0,4,0,19,1585627200,1593403200,4
jamietheslut,0,4,0,9,1579669200,1579755600,4
XLynnsanityX,0,4,0,8,1598155200,1601265600,4
Rafoes,0,4,0,-13,1568520000,1574139600,4
jordino2k4,0,4,0,153,1576040400,1592280000,4
dreadlock_jedi,0,4,0,19,1598241600,1600574400,4
smolboi69420-57,0,4,0,8,1599969600,1604203200,4
HopefulDepressed,0,4,0,7,1605157200,1605589200,4
ATishbite,0,4,0,21,1609045200,1609045200,4
TAW_564,0,4,0,4,1602475200,1609304400,4
Kluyzenaer,0,4,0,0,1608094800,1608181200,4
SmurfSmurfton,1,3,13,18,1604379600,1608094800,4
Empress_of_Penguins,0,4,0,15,1602561600,1608958800,4
Smackdaddy122,0,4,0,8,1598673600,1605330000,4
pikkutaapero,0,4,0,27,1576645200,1576645200,4
Tropink,0,4,0,3,1572843600,1573189200,4
MeanDaddyTom,0,4,0,56,1588996800,1608786000,4
crazy_dude360,0,4,0,153,1571457600,1574398800,4
71MM3,1,3,26,159,1595563200,1603857600,4
dirtielaundry,0,4,0,62,1570420800,1605157200,4
Piperbole_,0,4,0,70,1577422800,1599019200,4
CaptainLookylou,0,4,0,38,1594094400,1594094400,4
DestroyAlexJones,0,4,0,17,1596686400,1596859200,4
pbrown925,1,3,158,18,1580792400,1591934400,4
user975A3G,0,4,0,26,1583470800,1609304400,4
Common_Vegetable,0,4,0,27,1564459200,1578459600,4
LeoSunflower7,0,4,0,6,1601697600,1637125200,4
Kupo_Master,0,4,0,8,1589256000,1591156800,4
AvgGuy100,0,4,0,109,1598760000,1605848400,4
Axuo,0,4,0,32,1580187600,1603425600,4
mozppc,1,3,5901,5,1599105600,1604379600,4
SirHoneyDip,0,4,0,96,1582088400,1606453200,4
WhackNicholson,1,3,23,6,1556164800,1556164800,4
Ragu-Man,0,4,0,55,1595217600,1605589200,4
Ilhanbro1212,0,4,0,213,1600142400,1602734400,4
imsoooverit,0,4,0,24,1577163600,1608699600,4
Thoctar,0,4,0,6,1606194000,1607144400,4
wyytches,1,3,42,19,1548738000,1561694400,4
youare_theuniverse,0,4,0,6,1593316800,1593403200,4
me-need-more-brain,0,4,0,38,1595217600,1605330000,4
masonite616,0,4,0,13,1592193600,1608526800,4
lokazomo,0,4,0,4,1608008400,1608094800,4
SpaceJuggernaut,0,4,0,11,1592884800,1608872400,4
I_smoked_pot_once,0,4,0,7,1609563600,1609563600,4
umblueberrypie,0,4,0,92,1604898000,1607922000,4
Few_Technology,0,4,0,28,1585454400,1585540800,4
hairpiece-assassin,0,4,0,3,1585454400,1606626000,4
Therealgoobyyoobydoo,0,4,0,173,1607576400,1608613200,4
samanthastoat,0,4,0,700,1589083200,1589083200,4
Extra_Meaning,0,4,0,20,1598414400,1603339200,4
pachil,0,4,0,92,1580101200,1580878800,4
Nfeatherstun,0,4,0,61,1574312400,1574312400,4
Unlikely_Birthday_42,1,3,9,3,1608181200,1608181200,4
rejjie_carter,0,4,0,11,1573707600,1574917200,4
thenoelist329,0,4,0,66,1585454400,1608872400,4
AizenSousuke92,0,4,0,31,1583899200,1603512000,4
SoggyBurgerBuns,0,4,0,8,1581570000,1583298000,4
iGotShrekt,2,2,45,2,1546405200,1550206800,4
COLTS_FAN_2008,0,4,0,100,1582866000,1584417600,4
electrogeek8086,0,4,0,5,1585454400,1593662400,4
Swimminginthestyx,0,4,0,45,1582693200,1606021200,4
ponhooo,0,4,0,8,1571544000,1571544000,4
melitza9512p,2,2,1025,24,1586491200,1612155600,4
11168907,0,4,0,19,1573189200,1573189200,4
COVIDNLimez,0,4,0,58,1596168000,1607576400,4
internalizedhatred,1,3,143,32,1606194000,1607403600,4
superneutral,0,4,0,41,1561348800,1589688000,4
notnorse,0,4,0,127,1584072000,1586318400,4
DildoPolice,0,4,0,165,1571976000,1583211600,4
StiltzkinNomad,0,4,0,20,1572667200,1608958800,4
otisandthehuman,0,4,0,65,1540785600,1551934800,4
fighter4love,1,3,15,7,1547182800,1547442000,4
hlIODeFoResT,0,4,0,17,1577336400,1577336400,4
AnotherTalkingHead_,0,4,0,57,1592539200,1605762000,4
The_Trash_God,0,4,0,36,1570680000,1580792400,4
thewakebehindyou,0,4,0,8,1448773200,1448773200,4
allshieldstomypenis,0,4,0,451,1592539200,1593576000,4
Orwell2018,0,4,0,1,1595217600,1595563200,4
johnhawkins1568,0,4,0,41,1551589200,1558065600,4
jerremz,0,4,0,13,1584849600,1594267200,4
Jannis_Black,0,4,0,7,1578805200,1606539600,4
Makeshift5,0,4,0,207,1597896000,1605589200,4
KeithH987,0,4,0,33,1585886400,1587009600,4
ohhdreadful,0,4,0,30,1572148800,1572235200,4
BigCockWooly,0,4,0,-14,1577941200,1579669200,4
Virtual-Knight,4,0,110,0,1583038800,1609045200,4
Ecindd,0,4,0,48,1563336000,1598155200,4
Citiz3n_Kan3r,0,4,0,7,1573275600,1573362000,4
ZigsZag,1,3,2,5,1598328000,1598328000,4
Bemused_Owl,0,4,0,35,1577163600,1605848400,4
meglandici,0,4,0,35,1534651200,1545800400,4
InternationalDiver63,1,3,315,7,1605502800,1606194000,4
TriggerNationz,1,3,20,13,1594785600,1594785600,4
littlestINTP,0,4,0,4,1581051600,1589515200,4
Basura_XXIV,0,4,0,2,1605330000,1606194000,4
1seraphius,0,4,0,8,1570852800,1589515200,4
djck100,1,3,138,4,1582779600,1584676800,4
JCBh9,0,4,0,4,1608872400,1608872400,4
meesersloth,0,4,0,98,1601784000,1607922000,4
Idaho_In_Uranus,0,4,0,40,1582088400,1607317200,4
StansLee,0,4,0,-27,1580101200,1580187600,4
CPT_Rad_Dangerous,0,4,0,20,1595908800,1600228800,4
UnholyDemigod,0,4,0,-42,1595131200,1595217600,4
winter83,0,4,0,33,1570075200,1575176400,4
EvansKite,0,4,0,26,1593057600,1594872000,4
McMing333,0,4,0,25,1595563200,1606712400,4
BigShapes,1,3,170,28,1573448400,1602216000,4
BIGwignumbskull,0,4,0,16,1596081600,1599019200,4
YiMainOnly,0,4,0,1,1541566800,1564200000,4
bustmyassfortheman,0,4,0,13,1603512000,1603512000,4
xCaptainNemox,0,4,0,38,1559966400,1587700800,4
AvalancheQueen,0,4,0,27,1597809600,1606366800,4
themistocles16,1,3,55,18,1568001600,1574658000,4
MrsYouneek,0,4,0,6,1605934800,1608267600,4
fortem24601,0,4,0,4,1578891600,1578891600,4
peshnoodles,0,4,0,44,1576731600,1578891600,4
HorrorThis,0,4,0,66,1584590400,1605589200,4
angel_butts_69,0,4,0,70,1601956800,1604811600,4
apis_bull,0,4,0,59,1559534400,1560052800,4
bluejayrobin,1,3,119,43,1582606800,1593489600,4
MC_AnselAdams,0,4,0,20,1596254400,1609218000,4
wostmoke,0,4,0,2,1585454400,1589083200,4
ThrowAwayJohnny1415,1,3,34,40,1588046400,1588046400,4
South-Bottle,0,4,0,426,1600574400,1600660800,4
ashe8258,0,4,0,27,1561780800,1609477200,4
whythefxckamihere,0,4,0,25,1572148800,1593144000,4
screamqueenjunkie,1,3,194,75,1580014800,1586145600,4
OMGWhyImOld,0,4,0,-2,1607576400,1607662800,4
Legendary_fatass,0,4,0,13,1567656000,1568001600,4
taescience,0,4,0,-7,1606280400,1606366800,4
ImpulsiveDoorHolder,0,4,0,7,1643259600,1643259600,4
ReptileChaos,0,4,0,15,1584072000,1596513600,4
slimztj,0,4,0,114,1598932800,1604116800,4
itsscaryhere,0,4,0,21,1598414400,1607403600,4
digitalray34,0,4,0,-75,1576904400,1576904400,4
MooDexter,0,4,0,40,1569988800,1591934400,4
theactualfinalduck,1,3,2105,105,1594267200,1594612800,4
MeatyOakerGuy,0,4,0,-2,1608181200,1608181200,4
Musichead2468,0,4,0,12,1601179200,1606712400,4
Spectre1-4,0,4,0,-8,1598846400,1598846400,4
soggycedar,0,4,0,70,1581051600,1584504000,4
THISIStheses,1,3,20,17,1586318400,1588046400,4
jettliverpool,0,4,0,46,1580706000,1608008400,4
jeefray,0,4,0,16,1599278400,1608872400,4
ErrorBoy0016,0,4,0,0,1609304400,1609304400,4
SuperbFlight,0,4,0,18,1576126800,1584331200,4
ajm146,0,4,0,17,1485838800,1541653200,4
ALLCAPSAREBASTARDS,0,4,0,53,1580965200,1584158400,4
Lukeskyrunner19,0,4,0,41,1546405200,1578546000,4
PORNKAs,0,4,0,49,1598846400,1602734400,4
kingGlucose,0,4,0,5,1589947200,1589947200,4
dadelibby,0,4,0,153,1573534800,1581397200,4
is_a_goat,0,4,0,127,1558152000,1595476800,4
Leading-Oil1772,0,4,0,15,1606021200,1607490000,4
NotMyFirstDown,0,4,0,3,1606539600,1606626000,4
nickstick_,0,4,0,36,1566446400,1572580800,4
chillicheesethighs,0,4,0,8,1537156800,1578373200,4
ProShitposter9000,0,4,0,57,1594440000,1600315200,4
cassinonorth,0,4,0,8,1579496400,1593403200,4
diddleburgers,0,4,0,28,1559620800,1564372800,4
arbitrary_user_name1,0,4,0,46,1608181200,1608872400,4
GoJoop,0,4,0,1,1602820800,1605243600,4
dirtymind252525,0,4,0,9,1608008400,1609045200,4
Happy_Cancel1315,0,4,0,14,1602648000,1603512000,4
Mardoniush,0,4,0,16,1532836800,1579669200,4
nickvallejo,0,4,0,4,1575608400,1583298000,4
fnatikk50,0,4,0,16,1602561600,1603512000,4
-I-C-Y-,0,4,0,70,1558670400,1559275200,4
NYC_JanKees,0,4,0,14,1612069200,1612155600,4
Arthropodo,0,4,0,12,1601870400,1608181200,4
TerminalJ,0,4,0,92,1600056000,1602993600,4
Fungunkle,0,4,0,52,1596254400,1600660800,4
TeddysGhost,0,4,0,30,1590724800,1594440000,4
Salimbo,0,4,0,8,1606712400,1606712400,4
pagraphdrux,0,4,0,14,1604030400,1604030400,4
Re7oadz,0,4,0,2,1606366800,1606539600,4
TheFireflies,0,4,0,307,1605934800,1611810000,4
slaya222,0,4,0,10,1595908800,1609304400,4
violinin3dart,0,4,0,25,1594094400,1594180800,4
orcgore,0,4,0,23,1605762000,1612155600,4
aHairyWizard,0,4,0,139,1556424000,1577854800,4
UncagedBeast,0,4,0,8,1596859200,1599019200,4
CrackedRefrigerator,0,4,0,10,1595995200,1599624000,4
Luxyyr,0,4,0,-12,1603771200,1603771200,4
petuniapossum,0,4,0,69,1566360000,1572580800,4
CombatJuicebox,1,3,74,17,1603425600,1605070800,4
mymemesnow,1,3,0,4,1573016400,1573189200,4
_THE_asshole,0,4,0,5,1600660800,1600660800,4
Omikets,0,4,0,80,1593316800,1607749200,4
THROWAWAY08130533,0,4,0,0,1605848400,1609045200,4
yvngmysterious13,0,4,0,6,1602820800,1603080000,4
itmaywork,1,3,18,16,1590033600,1608008400,4
SATlRE,0,4,0,18,1586404800,1608267600,4
WutTheDickens,0,4,0,26,1514091600,1607835600,4
Thic_water,1,3,0,-9,1607662800,1607662800,4
Eslavh,0,4,0,47,1568347200,1570507200,4
basil_fresh,0,4,0,19,1594353600,1597809600,4
treeD3d,0,4,0,-41,1600747200,1609045200,4
Pagoyumm,0,4,0,16,1557201600,1558670400,4
Spiritofcreativityty,0,4,0,3,1572494400,1573275600,4
rose_goes97,1,3,7656,6,1605762000,1608094800,4
DilapidatedToast,0,4,0,-4,1558843200,1558929600,4
econsoc,0,4,0,21,1605070800,1605157200,4
MsMacalista,0,4,0,54,1552276800,1601438400,4
JemimahWaffles,0,4,0,5,1598500800,1607662800,4
pLaxton__,0,4,0,-7,1573102800,1573102800,4
AlternativeWalls,0,4,0,29,1578978000,1587355200,4
TruckasaurusEmeritus,0,4,0,238,1566360000,1599796800,4
john_t_fisherman,0,4,0,8,1603512000,1603512000,4
CaptainMorgan1717,1,3,55,9,1603857600,1604030400,4
luke609,0,4,0,4,1589860800,1589947200,4
Snoo38972,0,4,0,-6,1602648000,1602648000,4
TAthrowawey,0,4,0,6,1606280400,1606971600,4
dead-comms,0,4,0,-9,1606885200,1607922000,4
alexmercer13,0,4,0,59,1553832000,1564977600,4
CallMeTerdFerguson,0,4,0,134,1600228800,1605070800,4
phonon9,1,3,75,18,1571025600,1571025600,4
whatsthatsmell111,0,4,0,7,1580360400,1595995200,4
gaylorf,0,4,0,-29,1594785600,1594785600,4
SoHTyte,0,4,0,30,1582952400,1587528000,4
linksslut,1,3,3,41,1591761600,1592280000,4
ThatsMcGuffin2U,0,4,0,11,1606626000,1607144400,4
apostatehobo,0,4,0,24,1606971600,1608354000,4
dildoscwagg12,1,3,35,9,1582174800,1582174800,4
InfiniteFriend1,2,2,55,3,1590206400,1590552000,4
emm_d_kay,0,4,0,22,1593748800,1593748800,4
Dibbix,0,4,0,5,1605330000,1605330000,4
TheRealTowel,0,4,0,71,1575435600,1600488000,4
eza50,0,4,0,11,1581224400,1581224400,4
Conscious_Dancer,2,2,8,3,1604116800,1604898000,4
ScepticScan,0,4,0,99,1601438400,1608526800,4
__pm_me_anything___,0,4,0,-36,1601092800,1601179200,4
BreadCanner,0,4,0,432,1573448400,1575522000,4
OohMERCY,0,4,0,6,1606885200,1606885200,4
AManInBlack2019,0,4,0,-4,1578114000,1578200400,4
APerfectCircle_,0,4,0,22,1553918400,1567396800,4
Randomscreename,0,4,0,151,1597636800,1598846400,4
TheWiseBeast,0,4,0,31,1592712000,1607403600,4
sande96,0,4,0,12,1604116800,1604203200,4
stealingyohentai,0,4,0,17,1587528000,1587528000,4
noff01,0,4,0,-35,1575694800,1575781200,4
whyiseveryonelooking,0,4,0,10,1600574400,1608699600,4
Thiccc_One,0,4,0,-65,1568433600,1568433600,4
make_fascists_afraid,0,4,0,90,1563854400,1603684800,4
nebraskakid467,1,3,31,34,1583211600,1592280000,4
cu_rias,1,3,4,6,1596600000,1596600000,4
lostveggie,1,3,109,7,1602561600,1606453200,4
Snapchat_trap,2,2,136,19,1597809600,1608008400,4
D4ng3rd4n,1,3,0,-2,1606453200,1606885200,4
SS-Shipper,0,4,0,10,1582779600,1595995200,4
anticapitalist,0,4,0,39,1474948800,1540872000,4
nightpanda893,0,4,0,61,1593230400,1605934800,4
userdame,0,4,0,18,1556337600,1561608000,4
kaythomas42000,0,4,0,-7,1585454400,1585454400,4
cluelessinpink,2,2,8470,6,1596859200,1598587200,4
miasunshine,1,3,23,19,1592193600,1594094400,4
shockhopper,0,4,0,91,1600401600,1603598400,4
Kapitaczec,0,4,0,9,1583643600,1583726400,4
flamingmongoose,0,4,0,28,1547874000,1606798800,4
BoltsJustice,0,4,0,25,1576818000,1585972800,4
workathomewriter,0,4,0,55,1607490000,1608786000,4
Erraticepiphany,1,3,15,6,1597464000,1606885200,4
throwawaymycareer93,0,4,0,5,1598328000,1598328000,4
FlannelPlaid,0,4,0,168,1591243200,1591329600,4
McLeod14,0,4,0,15,1583038800,1584244800,4
grants_your_wishes,0,4,0,-30,1588737600,1604293200,4
thrifty_prole,0,4,0,66,1601179200,1608613200,4
dxz,0,4,0,75,1580792400,1599192000,4
itsafraid,0,4,0,17,1580274000,1608094800,4
swoosied,0,4,0,-13,1597636800,1597636800,4
kssir,0,4,0,40,1574053200,1587268800,4
AvignonDoc,0,4,0,51,1605589200,1607490000,4
chill_salmorejo,0,4,0,8,1581051600,1608094800,4
PandorasKeyboard,0,4,0,50,1597723200,1598760000,4
KevinfromWI,0,4,0,10,1593921600,1597550400,4
Faithwolf,0,4,0,51,1608440400,1608440400,4
Nac82,0,4,0,219,1583812800,1587355200,4
Killerhobo107,0,4,0,21,1591934400,1593662400,4
One_Percent_Kid,0,4,0,170,1581915600,1586836800,4
B4dG04t,0,4,0,16,1606107600,1608699600,4
slackeye,0,4,0,-4,1590984000,1592452800,4
iiNexius,0,4,0,34,1605070800,1606626000,4
GORKATHEORKS,1,3,0,-10,1597291200,1597291200,4
Hegemonixx,2,2,115,3,1588824000,1598414400,4
SamAxe7,0,4,0,34,1604203200,1604552400,4
10z20Luka,1,3,10,5,1584244800,1584331200,4
hal_9_thousand,0,4,0,13,1589342400,1589428800,4
knittorney,0,4,0,44,1585713600,1587614400,4
CleverYetTimid,0,4,0,5,1585454400,1585454400,4
UnderKontrol,0,4,0,14,1591156800,1605589200,4
cheapandbrittle,0,4,0,8,1593057600,1599883200,4
satanophonics,0,4,0,4,1608267600,1608440400,4
RustyShackleford14,0,4,0,22,1606194000,1606539600,4
Solomon_Grundle,0,4,0,58,1576558800,1605675600,4
franklinben13,1,3,12,-28,1568001600,1570507200,4
Blueberyllium,0,4,0,157,1602907200,1606280400,4
bigosik_,1,3,7,-1,1598155200,1600660800,4
HeyL_s8_10,0,4,0,30,1607835600,1611896400,4
Pogo_Stick_Rider,0,4,0,4,1579064400,1591675200,4
ariagrayx,0,4,0,59,1579755600,1579928400,4
diondeer7,0,4,0,8,1585108800,1585108800,4
UnboughtStuffedDogs,0,4,0,15,1557806400,1592280000,4
thedoorknob123,0,4,0,46,1556424000,1576386000,4
Dymmesdale,0,4,0,23,1575003600,1602561600,4
Dill-usional,1,3,62,8,1596859200,1608181200,4
Wakka_Grand_Wizard,2,2,31,5,1581483600,1585800000,4
brandoniravioli,0,4,0,-35,1599883200,1599969600,4
trashttss22,0,4,0,97,1602993600,1608354000,4
Ola_Mundo,0,4,0,19,1603339200,1603512000,4
Excuse_my_GRAMMER,0,4,0,6,1607144400,1607230800,4
FalloutLouBegas,0,4,0,61,1608699600,1608786000,4
GiraffeOnWheels,0,4,0,-11,1567569600,1567569600,4
noradosmith,0,4,0,54,1585627200,1598760000,4
SupeerDude,0,4,0,146,1580965200,1586059200,4
dak31,0,4,0,1,1585454400,1587614400,4
Moonrivah25,1,3,47,6,1598846400,1598932800,4
Sharkgutz17,0,4,0,55,1584158400,1603684800,4
coldfu,0,4,0,26,1587182400,1587268800,4
McL0vin_,0,4,0,-3,1580187600,1580187600,4
Drummer4696,1,3,14,15,1548824400,1551762000,4
travisrugemer,1,3,16,12,1565064000,1565064000,4
FinnMertensHair,0,4,0,36,1574485200,1585627200,4
mckennamelder,0,4,0,5,1608354000,1608613200,4
metachor,0,4,0,30,1592107200,1605157200,4
falconfile,0,4,0,22,1574658000,1575954000,4
smartcookiecrumbles,0,4,0,39,1578286800,1578286800,4
Star_Rover,0,4,0,95,1572930000,1595563200,4
puro_odio,0,4,0,18,1599969600,1601956800,4
HectorBot23,0,4,0,7,1608354000,1608440400,4
OxymoronicallyAbsurd,0,4,0,6,1581224400,1581224400,4
itsallinthehips123,0,4,0,36,1598414400,1600228800,4
titlejunk,0,4,0,-2,1601697600,1608786000,4
DoxYourself,0,4,0,5,1559707200,1567828800,4
c3robb,1,3,17,10,1580878800,1580878800,4
kittenvy,0,4,0,129,1568865600,1608699600,4
Absolute__Dumbass,0,4,0,2,1609477200,1609477200,4
ChocolateChippo,0,4,0,18,1607576400,1607576400,4
Snail_Spark,0,4,0,3,1595390400,1607749200,4
KinkyWhiteBread,0,4,0,-1,1557979200,1591243200,4
NotYoBusiness88,1,3,9,22,1577077200,1578027600,4
v458q,0,4,0,6,1608872400,1608872400,4
GayCovid,2,2,68,8,1605589200,1605675600,4
eule_016,0,4,0,300,1576213200,1602734400,4
Grommatick,0,4,0,24,1585540800,1590724800,4
baconlettucesammich,0,4,0,240,1559620800,1562644800,4
omqhaithurr,0,4,0,5,1597809600,1600315200,4
Ab-NoR-maL-,0,4,0,44,1584331200,1587268800,4
SuccoyaHoyaa,0,4,0,20,1552107600,1576472400,4
Mule148,0,4,0,11,1593144000,1595563200,4
sitdownandtalktohim,0,4,0,-4,1582347600,1606626000,4
supbiatches1,0,4,0,20,1593921600,1607144400,4
FreindOfDurruti,1,3,6,5,1606366800,1611896400,4
General_Rain,0,4,0,23,1594612800,1595131200,4
IndependentBall3,0,4,0,7,1589515200,1593403200,4
Junoblanche,0,4,0,9,1598500800,1598587200,4
iwwofx,0,4,0,45,1592625600,1593835200,4
Empero6,0,4,0,29,1598846400,1606453200,4
Excalibur-23,0,4,0,-25,1596600000,1596600000,4
MsMisc,0,4,0,34,1608526800,1608699600,4
Allmightydohllah,0,4,0,13,1557720000,1611982800,4
rozfowler,0,4,0,87,1590638400,1607317200,4
Kythamis,0,4,0,20,1593835200,1595131200,4
Chicken_Rib,0,4,0,33,1601870400,1608267600,4
cookiesprang,0,4,0,59,1559620800,1561694400,4
dmcknig3,1,3,16,8,1582261200,1582347600,4
LunarFire108,0,4,0,124,1573880400,1586664000,4
PermanenteThrowaway,0,4,0,6,1589428800,1599192000,4
simple-fire,0,4,0,51,1599537600,1601611200,4
MurkyMark00,0,4,0,15,1606626000,1606626000,4
RiderOfRohann,0,4,0,13,1611723600,1612069200,4
Captain_Florida,0,4,0,-4,1597636800,1597723200,4
DarthButtercup,0,4,0,76,1608958800,1609045200,4
yrdz,0,4,0,54,1575608400,1609477200,4
grubbygroover,0,4,0,14,1540958400,1547528400,4
ExtraNoise,0,4,0,77,1573275600,1575608400,4
rightoverheremyguy,0,4,0,46,1587614400,1592884800,4
UNLwest,0,4,0,-2,1578891600,1604116800,4
Dots005,1,3,11,23,1605157200,1605243600,4
nithilislidari,0,4,0,31,1548824400,1563940800,4
notathrowaway0709,1,3,9,11,1601092800,1601092800,4
Throw255313578,0,4,0,10,1580965200,1586577600,4
Atomsk647R,0,4,0,337,1600833600,1600833600,4
simplisticallysimple,0,4,0,39,1606971600,1611982800,4
JG0923,0,4,0,12,1587009600,1595649600,4
gotthemorbsM8,0,4,0,22,1582434000,1609045200,4
liefeld4lief,0,4,0,7,1579755600,1598587200,4
donsalametti,0,4,0,18,1587960000,1598500800,4
SpaceJellyBlue,0,4,0,33,1595649600,1598241600,4
DiabolicalMotives,0,4,0,8,1600488000,1611896400,4
Prettyflyforafly91,0,4,0,-17,1599624000,1599624000,4
alexjav21,1,3,45,35,1571630400,1609218000,4
scotiaboy10,0,4,0,20,1562040000,1585281600,4
IOSSLT,0,4,0,18,1587182400,1594180800,4
Sugartooth22,1,3,16,52,1558497600,1566446400,4
mollyadeux,0,4,0,14,1602388800,1605848400,4
LlamaJacks,0,4,0,23,1551848400,1571371200,4
hellotowel,1,3,20,7,1539662400,1540008000,4
smkeybare,0,4,0,54,1572667200,1586232000,4
Etienne93,0,4,0,18,1579755600,1583125200,4
ibrahimsafah,1,3,42,11,1574139600,1581483600,4
iduncan18,0,4,0,13,1580533200,1581051600,4
Massive-Risk,0,4,0,44,1609218000,1611810000,4
prokool6,0,4,0,12,1576731600,1606798800,4
GirlGodd,0,4,0,25,1590292800,1595995200,4
Randomhero_ftw,0,4,0,4,1602820800,1602907200,4
WhoreoftheEarth,0,4,0,10,1591329600,1607144400,4
_tonedeafsiren,2,2,257,5,1560484800,1566792000,4
PrettyBiForADutchGuy,1,3,262,17,1577422800,1581656400,4
ShutYourDumbUglyFace,0,4,0,9,1601524800,1607576400,4
dreadpiratesmith,1,3,10,5,1577854800,1604293200,4
boytjie,0,4,0,-19,1586836800,1586836800,4
hipster3000,0,4,0,-8,1584244800,1607749200,4
30SecondsToFail,0,4,0,8,1606539600,1608958800,4
801ffb67,0,4,0,82,1595390400,1595563200,4
forgotmovie123456,0,4,0,11,1596081600,1596254400,4
986434567654,0,4,0,23,1607662800,1609045200,4
SIXA_G37x,0,4,0,3,1600920000,1604466000,4
pizza_roll_boot,0,4,0,10,1580446800,1580792400,4
spaceyjules,0,4,0,17,1599537600,1608872400,4
Milts,0,4,0,16,1560571200,1563076800,4
gELSK,0,4,0,9,1608526800,1608526800,4
AliveThrouDeath,0,4,0,19,1584676800,1586491200,4
ovrwrkd,2,2,43,15,1574398800,1594267200,4
The-Pokester,0,4,0,7,1557288000,1590120000,4
NowFreeToMaim,0,4,0,-2,1585454400,1607662800,4
bleachisprettygood,0,4,0,36,1565668800,1575694800,4
VertebrateCarnivore,0,4,0,6,1611118800,1612069200,4
frieeeedchicken,0,4,0,-23,1598068800,1599192000,4
FabulousAd9355,1,3,39,11,1611896400,1614315600,4
the5thbuttnugget,0,4,0,815,1608699600,1609218000,4
JustThinkinAhead,1,3,60,9,1559188800,1559188800,4
Danko42069,0,4,0,11,1578632400,1578632400,4
IronProdigyOfficial,0,4,0,80,1560484800,1565755200,4
parkmatter,1,3,9,7,1556856000,1603512000,4
D4SHER,0,4,0,24,1568952000,1575522000,4
s0poo,0,4,0,40,1602648000,1602993600,4
ajblue98,0,4,0,24,1573707600,1573707600,4
theValeofErin,0,4,0,143,1592798400,1608699600,4
kevlarbomb,0,4,0,2,1591243200,1591243200,4
Swaggdonalds,0,4,0,32,1589256000,1604552400,4
the_cats_tao,0,4,0,11,1585108800,1585108800,4
AskAboutFent,0,4,0,121,1580014800,1580014800,4
weldneck105,0,4,0,18,1608786000,1609218000,4
hammie12345678,1,3,12,13,1560139200,1570680000,4
secksy_vecksy,0,4,0,20,1591588800,1594612800,4
mapatric,0,4,0,6,1603512000,1609304400,4
MagicJava,0,4,0,4,1607317200,1612069200,4
brashboy,1,3,119,12,1578027600,1578027600,4
Romeotje,0,4,0,-33,1575176400,1575176400,4
MrBrady23,0,4,0,313,1595390400,1602388800,4
emantheslayer0,1,3,27,7,1578286800,1597809600,4
Jaktenba,0,4,0,0,1582866000,1582952400,4
Lahm0123,0,4,0,12,1564891200,1568001600,4
sometricksupmysleeve,0,4,0,13,1583211600,1584158400,4
C0l0mbo,0,4,0,105,1574139600,1595822400,4
shamooooooooo,0,4,0,-29,1561089600,1573448400,4
breadfag,0,4,0,-38,1580101200,1585195200,4
blakethunderport,0,4,0,114,1559275200,1570939200,4
OWO11119999,0,4,0,28,1575262800,1583985600,4
Rumblesnap,0,4,0,35,1605934800,1605934800,4
Jaz_the_Nagai,0,4,0,16,1569211200,1611896400,4
SpiritDeer,0,4,0,12,1577509200,1591502400,4
TrillegitimateSon,0,4,0,11,1585540800,1587960000,4
BeachWave_Media,0,4,0,234,1606712400,1608613200,4
shubhi1395,2,2,508,316,1596340800,1602302400,4
mirazsyed,0,4,0,28,1555732800,1556164800,4
fuckingzazzed,0,4,0,52,1572843600,1598500800,4
FlaviusCioaba,0,4,0,4,1602561600,1602648000,4
AceStarflyer,2,2,96,15,1596254400,1597896000,4
autistictheory,1,3,22,45,1578200400,1581915600,4
BY_BAD_BY_BIGGA,0,4,0,8,1607576400,1607576400,4
joker38,0,4,0,23,1579150800,1593230400,4
ReachTheSky,0,4,0,-4,1591243200,1605589200,4
-fizzyfish,0,4,0,-5,1608613200,1608699600,4
JMDeutsch,0,4,0,5,1579064400,1579150800,4
SkollFenrirson,0,4,0,18,1578200400,1608613200,4
ZIdeaMachine,0,4,0,241,1589601600,1590724800,4
Youxley,0,4,0,70,1574139600,1584590400,4
memester_supremester,0,4,0,6,1565755200,1566273600,4
macgarthur,0,4,0,39,1604379600,1604466000,4
hisroyalnastiness,0,4,0,8,1602043200,1604811600,4
golevka6489,0,4,0,24,1571198400,1578546000,4
datprussia,1,3,17,9,1599796800,1599796800,4
UppedSolution77,0,4,0,-1,1607230800,1611982800,4
blacktea-whitenoise,0,4,0,42,1575349200,1601438400,4
GorillaX,0,4,0,16,1605589200,1605589200,4
monkeyscalp101,0,4,0,8,1605070800,1611723600,4
Ryoteck,0,4,0,20,1571630400,1594612800,4
salamandan,0,4,0,11,1554091200,1600660800,4
SgtFrampy,0,4,0,-1,1593403200,1593489600,4
DontFeedCapitalists,3,1,24,18,1575090000,1575867600,4
caitmac,0,4,0,9,1585454400,1585454400,4
TheProfessorClout,0,4,0,43,1573534800,1595822400,4
Tschoz,0,4,0,8,1591243200,1591243200,4
thetriggeredf,0,4,0,0,1556683200,1556683200,4
HappyBandicoot7,0,4,0,19,1569988800,1574139600,4
expandd0ng94,0,4,0,25,1571889600,1585368000,4
chancet321,0,4,0,7,1583643600,1585022400,4
RedditorsAreGhey,0,4,0,25,1601438400,1601438400,4
0zzyc0bblep0t,0,4,0,263,1577336400,1604725200,4
lonesomeloser234,0,4,0,7,1597118400,1599710400,4
TunaGamer,0,4,0,9,1544763600,1588305600,4
lock-crux-clop,0,4,0,11,1601438400,1601438400,4
iwanttoparticipate20,0,4,0,5,1606626000,1606626000,4
Paranoid_Paul,1,3,8,9,1559966400,1559966400,4
palindromia,0,4,0,50,1604030400,1608958800,4
tengleha01,0,4,0,-89,1599710400,1601611200,4
lactosepreposterous,1,3,33,8,1598587200,1598587200,4
Thebiggerbag,0,4,0,12,1611723600,1611896400,4
AtomicBlastPony,0,4,0,11,1583125200,1589515200,4
Rafaelow,2,2,2,10,1597636800,1601179200,4
Isexiedyourmom,0,4,0,6,1609304400,1612069200,4
Argent_Mayakovski,0,4,0,19,1578805200,1593748800,4
spaceangel151,1,3,99,8,1603857600,1603857600,4
freeme1999,1,3,150,32,1594958400,1594958400,4
timofat,0,4,0,19,1575867600,1585540800,4
suntem,0,4,0,90,1607576400,1607662800,4
HeartCatchHana,0,4,0,7,1571457600,1604638800,4
Meetballed,0,4,0,-20,1578632400,1578632400,4
meowmix778,0,4,0,-4,1589860800,1589947200,4
Daemonicus,0,4,0,16,1585454400,1585540800,4
SarenRaeSavesUs,0,4,0,22,1572148800,1607403600,4
accountant321,0,4,0,8,1595044800,1607835600,4
S28E01_The_Sequel,0,4,0,-8,1601179200,1601179200,4
JoeJ757,0,4,0,108,1547442000,1585195200,4
melneee,0,4,0,10,1605330000,1606021200,4
shmaygleduck,0,4,0,8,1602388800,1603857600,4
faith20ss,0,4,0,7,1602475200,1602475200,4
jerk_store_manager,0,4,0,-5,1608699600,1608699600,4
Warm-Risk-3352,0,4,0,-11,1608354000,1608354000,4
miserywhip94,0,4,0,485,1556596800,1573621200,4
PayLayAleVeil,0,4,0,324,1575349200,1584504000,4
BearyGoosey,0,4,0,109,1579582800,1606453200,4
Jackal000,2,2,4,5,1594267200,1594267200,4
DarkRollsPrepare2Fry,0,4,0,13,1597118400,1606712400,4
jeosol,0,4,0,18,1575349200,1598068800,4
Inasaba,0,4,0,42,1585108800,1593316800,4
greensighted,0,4,0,19,1605416400,1606798800,4
-eat-the-rich,0,4,0,31,1600315200,1607835600,4
TenseAndEmpty,0,4,0,50,1581656400,1608267600,4
AsexualArowana,0,4,0,109,1577768400,1593576000,4
almostFunctionalLead,0,4,0,101,1593489600,1611723600,4
supersonic3974,1,3,45,5,1436932800,1546837200,4
whelvet,0,4,0,68,1600488000,1600488000,4
_dodged,0,4,0,44,1605243600,1609045200,4
livinghumanlife,0,4,0,9,1590984000,1591070400,4
THE_STRUGGLE_IS_FEEL,0,4,0,19,1424062800,1424149200,4
Parthon,0,4,0,22,1609390800,1611982800,4
Northeastern_J,0,4,0,-3,1605589200,1605675600,4
where_it_hurts,0,4,0,51,1593230400,1593316800,4
mailbriz,0,4,0,43,1555819200,1555819200,4
sodamfat,0,4,0,74,1590292800,1594526400,4
Leon_Trout,0,4,0,52,1563422400,1602561600,4
future-googler-maybe,1,3,92,22,1595304000,1595304000,4
Thumper86,1,3,20,53,1573621200,1602648000,4
Sockmechris,0,4,0,136,1596600000,1597982400,4
Temascos,0,4,0,210,1606971600,1608440400,4
defaultchodenetwork,0,4,0,17,1576126800,1586404800,4
omega_nebula,0,4,0,70,1606885200,1606885200,4
TheHiphopopotamus,0,4,0,15,1552881600,1552968000,4
kesselrunner-12,0,4,0,32,1612069200,1612069200,4
InaMinorKey,0,4,0,108,1599364800,1605243600,4
loring96,1,3,28,9,1598760000,1603512000,4
weeaboolover,3,1,68,2,1571025600,1571716800,4
CrapskiMcJugnuts,0,4,0,87,1593748800,1597982400,4
throwawaywork03294,1,3,67,28,1563076800,1563076800,4
notarobot4932,0,4,0,15,1606539600,1606798800,4
gigrek,0,4,0,417,1603598400,1604203200,4
bannedinonecomment,0,4,0,-6,1603512000,1603512000,4
WhoTooted,0,4,0,-86,1589428800,1589428800,4
tdw91,0,4,0,8,1580706000,1587441600,4
pixie_led,0,4,0,25,1598241600,1600228800,4
A_Dull_Vice,0,4,0,43,1584676800,1602820800,4
Barry2442,1,3,62,12,1591934400,1592020800,4
slow_growing_vine,0,4,0,59,1595908800,1600401600,4
just_a_basic_table,3,1,89,18,1565323200,1571976000,4
Dragonace1000,0,4,0,40,1582779600,1608958800,4
heavymetalhexcode,0,4,0,7,1605243600,1606885200,4
autonomatical,0,4,0,20,1588219200,1606021200,4
MCuri3,0,4,0,21,1572408000,1598587200,4
Cal4mity,0,4,0,-7,1589774400,1589774400,4
moistlysweatyy,0,4,0,469,1608613200,1608613200,4
G-42,0,4,0,35,1603684800,1604116800,4
Socram007,0,4,0,19,1602129600,1606107600,4
EdgeSoSharpItHurts,0,4,0,129,1584590400,1607058000,4
Binary_wolf,1,3,71,35,1594180800,1594180800,4
Tydane395,0,4,0,8,1563595200,1597982400,4
funkybarisax,0,4,0,22,1578718800,1579755600,4
Andyrhyw,0,4,0,39,1552449600,1573534800,4
radeon7770,0,4,0,38,1560052800,1574139600,4
draconothese,0,4,0,45,1589860800,1589860800,4
Chrsch,0,4,0,5,1571630400,1578805200,4
s0angelic,0,4,0,13,1548824400,1601524800,4
74310532,0,4,0,50,1561521600,1573966800,4
AttarWrites,1,3,20,6,1585281600,1585368000,4
Informal-Lake-994,0,4,0,36,1605157200,1606194000,4
aceshighsays,0,4,0,14,1585454400,1588046400,4
CEOofWhimsy,1,3,95,18,1585972800,1585972800,4
Pyk_,0,4,0,17,1596254400,1596340800,4
knowswhatimsaying,0,4,0,139,1594440000,1600142400,4
confused_n_disturbed,0,4,0,5,1572235200,1598414400,4
SketchyMikePemulis,0,4,0,37,1561089600,1561089600,4
hellotrinity,0,4,0,567,1600056000,1606798800,4
owlprocess48,0,4,0,48,1585281600,1588478400,4
zukord,0,4,0,30,1611896400,1611982800,4
younghustleam,0,4,0,30,1573534800,1598846400,4
blinko-blonko,0,4,0,46,1598068800,1598760000,4
StirlingG,0,4,0,1,1572235200,1572235200,4
FiveCellarsBelow,0,4,0,100,1597204800,1602043200,4
Crashman09,0,4,0,12,1597723200,1599278400,4
VeryGreenGrapes,0,4,0,107,1606885200,1607403600,4
2percentmilkdrinker,0,4,0,19,1569470400,1569470400,4
jrp9000,0,4,0,32,1574571600,1574917200,4
JossBurnezz,0,4,0,10,1595822400,1597118400,4
BussSecond,0,4,0,22,1605934800,1605934800,4
aaronshirst,0,4,0,62,1570420800,1605070800,4
Adamp1995,0,4,0,29,1572321600,1599537600,4
TheOnlyPPGun,0,4,0,250,1601611200,1611637200,4
Manictree,3,1,276,3,1548738000,1585281600,4
Socky_McPuppet,0,4,0,23,1561348800,1561348800,4
NoDubzz,0,4,0,-11,1602907200,1603080000,4
beatsaroundthebush_,0,4,0,23,1596772800,1597032000,4
Georgiagirl678,0,4,0,46,1577768400,1588132800,4
circlecityindy,0,4,0,58,1572930000,1573016400,4
arieszx,2,2,28,6,1548133200,1578891600,4
dhhdhshsjskajka43729,0,4,0,4,1606712400,1608699600,4
amborg,0,4,0,146,1602561600,1608008400,4
jembo90,0,4,0,15,1604811600,1605243600,4
oldmanlover24,0,4,0,8,1578632400,1579237200,4
holdmydubbs,0,4,0,15,1593662400,1608354000,4
evilcounsel,0,4,0,22,1553918400,1557115200,4
DeathFart007,0,4,0,46,1604293200,1606280400,4
cwfutureboy,0,4,0,72,1556424000,1600660800,4
chocolateonyx,1,3,36,15,1554177600,1607576400,4
electricfoxx,0,4,0,10,1577854800,1606539600,4
chrisdancy,1,3,11,18,1587960000,1605589200,4
shadowveeeeeeerse,0,4,0,10,1584763200,1604379600,4
DestinyIslandsHikari,0,4,0,19,1570593600,1578027600,4
Ed100996,0,4,0,10,1572580800,1606885200,4
ego_by_proxy,0,4,0,3,1604811600,1611205200,4
doodlebobbin,1,3,12,9,1572667200,1579496400,4
12kmusic,0,4,0,4,1597550400,1597550400,4
spawnfrag,0,4,0,25,1597896000,1600920000,4
calmclear,0,4,0,74,1600056000,1600228800,4
kratoswithcappuccino,0,4,0,-9,1603425600,1607576400,4
Ferdinand_Foch_WWI,0,4,0,-2,1603598400,1603684800,4
EEeeTDYeeEE,0,4,0,130,1560571200,1605934800,4
haleykohr,0,4,0,128,1575176400,1576386000,4
Notanothersaviour,0,4,0,18,1605589200,1608440400,4
NtheLegend,0,4,0,64,1605157200,1607662800,4
Antinatalism_Account,0,4,0,35,1603252800,1605243600,4
mtorres266,0,4,0,12,1594785600,1607230800,4
One_Huge_Skittle,0,4,0,7,1598328000,1609131600,4
Nigma_CM,0,4,0,45,1582088400,1608786000,4
ASubterraneanFire,0,4,0,20,1564545600,1569643200,4
sami27,0,4,0,25,1581742800,1608786000,4
ZePikeno,0,4,0,55,1597204800,1604116800,4
Nomaspapas,0,4,0,27,1553313600,1600228800,4
de02abn,0,4,0,53,1602043200,1608181200,4
kilzfillz,2,2,22,11,1577768400,1606885200,4
MartiMa08,0,4,0,26,1598155200,1598155200,4
beavermakhnoman,0,4,0,71,1538280000,1572321600,4
gentrumpet,0,4,0,435,1566792000,1598587200,4
Aus_pol,0,4,0,39,1551502800,1580706000,4
suicidethrowaway343,0,4,0,6,1585454400,1585540800,4
Fisics_,0,4,0,66,1605675600,1606885200,4
SlowObjective4,0,4,0,-3,1596081600,1596254400,4
nebulausacom,0,4,0,6,1565496000,1565496000,4
lightnlove11,1,3,21,13,1583384400,1583384400,4
puffinpunk,0,4,0,23,1518325200,1541480400,4
Traumartian,0,4,0,-10,1584763200,1605502800,4
toxendon,1,3,42,16,1593144000,1597550400,4
King_Shugglerm,0,4,0,36,1575867600,1595649600,4
HybridVigor,0,4,0,14,1592798400,1605157200,4
dokaebeex,0,4,0,291,1607317200,1611982800,4
Suwoth,0,4,0,-38,1595217600,1595217600,4
salmompants,0,4,0,43,1543294800,1582088400,4
Time-Box128,0,4,0,18,1599278400,1606885200,4
Iw2fd,0,4,0,4,1574917200,1575003600,4
Ham_Ahead,0,4,0,7,1573362000,1599451200,4
please_dont_pry,0,4,0,15,1606712400,1609218000,4
Preform_Perform,0,4,0,25,1579410000,1584590400,4
DarkLinkXXXX,0,4,0,45,1435464000,1549083600,4
BeachBumBill,0,4,0,11,1606798800,1607662800,4
PicklesAreMyFriends,0,4,0,21,1604725200,1609304400,4
galactic-corndog,0,4,0,10,1561780800,1561953600,4
RobG92,0,4,0,23,1593230400,1606194000,4
XVll-L,4,0,4981,0,1556683200,1595131200,4
daltonthekidd,0,4,0,182,1581656400,1600747200,4
Bangonthisdrum,1,3,7,6,1595822400,1595822400,4
HotSexyStuddPaulRudd,0,4,0,33,1611982800,1611982800,4
cactusaddict,1,3,10,6,1595995200,1609218000,4
paskal007r,1,3,8,21,1563336000,1584331200,4
eVoesque,0,4,0,10,1597377600,1597377600,4
Jay_377,0,4,0,30,1611896400,1611982800,4
Abacabbb1583,1,3,14,5,1566792000,1566964800,4
AdamSandDollar,1,3,1578,6,1579842000,1581570000,4
realcevapipapi,0,4,0,-18,1576472400,1576472400,4
Misstori1,0,4,0,4,1567483200,1578891600,4
tyrandan2,0,4,0,18,1605589200,1606194000,4
Drunk_hooker,0,4,0,32,1584244800,1597982400,4
BangTheDrumAllDay,0,4,0,12,1595649600,1601524800,4
MattBowden1981,0,4,0,40,1597291200,1597896000,4
anakarenace,0,4,0,39,1597464000,1609390800,4
Notasockaccount1,1,3,28,13,1588651200,1588824000,4
X_x_Atomica_x_X,0,4,0,29,1585540800,1595476800,4
epicgamesbad,0,4,0,119,1604898000,1604898000,4
lustarfan,0,4,0,60,1605416400,1605502800,4
Ash1102,0,4,0,16,1560571200,1560657600,4
Spl00ky,0,4,0,6,1588996800,1588996800,4
pulsefirepikachu,0,4,0,64,1606626000,1606626000,4
sc_an_mi,0,4,0,32,1565755200,1608526800,4
screwnutbolt360,0,4,0,7,1553572800,1553745600,4
thesunneversleeps,1,3,3714,18,1598328000,1601265600,4
ConfusionIn20s,0,4,0,6,1552194000,1552194000,4
coys66,0,4,0,-15,1606539600,1606539600,4
Sotria,0,4,0,9,1611810000,1611896400,4
Elhmok,0,4,0,4,1608699600,1608699600,4
Decyde,0,4,0,22,1591243200,1597291200,4
icamefromtheshadows,0,4,0,15,1589601600,1589947200,4
the_mars_voltage,0,4,0,100,1607835600,1607922000,4
reduser5309,0,4,0,13,1594008000,1606798800,4
mister_bmwilliams,0,4,0,47,1593144000,1609390800,4
Boraas,0,4,0,42,1573448400,1594440000,4
mdmudge,0,4,0,7,1611982800,1612069200,4
HomeBuyerthrowaway89,0,3,0,24,1593576000,1608181200,3
CloudyFakeHate,0,3,0,159,1569902400,1575435600,3
email253200,0,3,0,-15,1585454400,1585540800,3
GrizzIyadamz,0,3,0,85,1605589200,1605589200,3
agustinomg,0,3,0,-10,1600488000,1600488000,3
Educational_Blunt,0,3,0,2,1609304400,1609477200,3
scientist_salarian1,0,3,0,21,1601524800,1604203200,3
nihilistic-simulate,0,3,0,54,1605934800,1609477200,3
thaw123789,0,3,0,10,1594958400,1595044800,3
tattoosnhempshoes32,0,3,0,1811,1591675200,1605934800,3
jadams2345,0,3,0,12,1602993600,1605157200,3
showercowcap,0,3,0,18,1575349200,1590379200,3
Vondi,0,3,0,42,1592884800,1609304400,3
MangoMelonYT12,0,3,0,13,1581397200,1583125200,3
Smokeydubbs,0,3,0,-17,1576558800,1607230800,3
baconeggencheese,0,3,0,143,1584158400,1589947200,3
ampattenden,0,3,0,23,1565150400,1570334400,3
dombruhhh,0,3,0,2,1603598400,1603598400,3
christawfer47,0,3,0,-11,1599883200,1599969600,3
theHoundLivessss,0,3,0,78,1561089600,1582866000,3
fierce_missy,0,3,0,146,1547182800,1548392400,3
yamirzmmdx,0,3,0,9,1576472400,1596168000,3
Quinn_tEskimo,0,3,0,60,1589860800,1602907200,3
_Monarca_,0,3,0,7,1605934800,1605934800,3
CompetitiveHabit5,0,3,0,5,1591588800,1607749200,3
scorpiothecat,0,3,0,113,1534651200,1534737600,3
BenevolentBlackBear,0,3,0,36,1594612800,1595131200,3
max-aroni-12,1,2,125,5,1607662800,1607662800,3
hfay94,0,3,0,5,1553400000,1553400000,3
amblongus,0,3,0,47,1600574400,1600574400,3
ZedDead9631,0,3,0,60,1574053200,1579582800,3
AdaptedApes,1,2,27,2,1601611200,1601697600,3
D3WM3R,0,3,0,35,1590033600,1592107200,3
scrumchubber,0,3,0,12,1583557200,1584676800,3
elyk516,0,3,0,3,1591329600,1591329600,3
SwimmingCry,0,3,0,66,1578459600,1580014800,3
RespectYoSmelf,0,3,0,65,1550206800,1553486400,3
Chigleagle,0,3,0,8,1576558800,1591329600,3
OnwardsBackwards,0,3,0,14,1603512000,1603512000,3
Grimbunny,0,3,0,29,1558929600,1559188800,3
frankwest16,0,3,0,5,1600488000,1608440400,3
Burnspangler,0,3,0,4,1562299200,1562558400,3
SoTiredOfTheBS1991,1,2,31,5,1602216000,1602302400,3
dog9er,0,3,0,4,1606971600,1607058000,3
Iwannadyeplz,0,3,0,77,1572930000,1573448400,3
strawberry_nivea,0,3,0,47,1602648000,1602993600,3
kjl3080,0,3,0,350,1597809600,1598414400,3
poopstain357,0,3,0,3,1605502800,1605589200,3
MakeItDontBreakIt,0,3,0,28,1588564800,1590379200,3
salambo_number_5,0,3,0,24,1559793600,1560744000,3
ricocee4,0,3,0,14,1582261200,1605070800,3
Gioware,0,3,0,-1,1603339200,1608440400,3
sodacankitty,0,3,0,6,1605416400,1607144400,3
idiotcosmonaut,0,3,0,73,1595476800,1597377600,3
leoberto1,1,2,40,5,1608094800,1608181200,3
UNLUCK3,0,3,0,5,1572580800,1572580800,3
Larsandthegirl,0,3,0,8,1599278400,1608181200,3
Denalix,0,3,0,-97,1599019200,1602129600,3
Strong_Lurking_Game,1,2,30,24,1581483600,1581483600,3
Aareon,0,3,0,18,1572321600,1579755600,3
ambrosebookeater,0,3,0,14,1548565200,1548997200,3
blacklightfirefly,0,3,0,-29,1596254400,1596340800,3
Gasky_Cuspo,0,3,0,3,1574571600,1574571600,3
ihavespacejam,0,3,0,7,1543381200,1550552400,3
MrPlowBC,0,3,0,43,1603684800,1606539600,3
Dave_C-137,0,3,0,13,1559793600,1566273600,3
GiantBlackWeasel,0,3,0,1,1589860800,1606021200,3
ojioni,0,3,0,-11,1602216000,1602216000,3
Hypnotic_Delta,0,3,0,19,1568952000,1582088400,3
RainbowAssFucker,0,3,0,21,1574312400,1608958800,3
TheJogMan,0,3,0,6,1602561600,1609477200,3
kandaf,0,3,0,5,1580878800,1580878800,3
toxic-redhead,0,3,0,13,1606107600,1609131600,3
UncomfortableBamboo,3,0,1553,0,1599883200,1602043200,3
bass_dj420,0,3,0,4,1549515600,1549861200,3
rare-simpleton,0,3,0,10,1606453200,1608699600,3
co89,0,3,0,17,1546664400,1546750800,3
loneheroine,0,3,0,11,1546578000,1561608000,3
jarrydn,0,3,0,5,1602734400,1605157200,3
eleanor_dashwood,0,3,0,44,1575608400,1584417600,3
alieneileen,0,3,0,11,1577509200,1577595600,3
prostateprobate,1,2,4,5,1596081600,1597291200,3
myoldgamertag,0,3,0,3,1584676800,1584763200,3
penquil,0,3,0,11,1579064400,1599105600,3
macklav,0,3,0,9,1603944000,1603944000,3
1191100,0,3,0,11,1546578000,1576645200,3
inkyfingers90,1,2,31,5,1599192000,1599624000,3
leonardops,2,1,1854,3,1586664000,1590033600,3
jabso19,0,3,0,36,1582779600,1608786000,3
moorederodeo,1,2,45,6,1569124800,1576904400,3
FranzAndTheEagle,0,3,0,68,1575608400,1575608400,3
gibilan,0,3,0,21,1550811600,1568001600,3
Aussieneet,3,0,23,0,1566273600,1567137600,3
llllPsychoCircus,0,3,0,47,1604030400,1608613200,3
admiral_radish,0,3,0,21,1555560000,1555560000,3
CreamOfWheat619,0,3,0,0,1602561600,1602561600,3
SadCoconut_,0,3,0,5,1563249600,1569556800,3
ImaginationBreakdown,0,3,0,35,1598241600,1598241600,3
photonbeams,0,3,0,39,1602820800,1602820800,3
mimityty,1,2,23,4,1573621200,1602129600,3
brokenpipboy,0,3,0,24,1587441600,1592366400,3
averaenhentai,0,3,0,131,1595649600,1595822400,3
bloodcoveredmower86,0,3,0,16,1577336400,1604203200,3
DatMildAndDatYak,1,2,1695,40,1563681600,1568347200,3
nonlinear_nyc,0,3,0,11,1606798800,1609131600,3
Meriokert,1,2,1,-6,1568520000,1583470800,3
TechieInTheTrees,1,2,35,3,1605675600,1605675600,3
Racist_FemboyV2,1,2,11255,9,1608181200,1608181200,3
Muscrat55555555,0,3,0,44,1580274000,1580274000,3
Necessary_Evi,0,3,0,3,1593835200,1605589200,3
Justinianus910,0,3,0,65,1600660800,1600660800,3
SwedishNeatBalls,0,3,0,27,1579582800,1588132800,3
Atomicrex2015,0,3,0,109,1588219200,1593576000,3
cheekytinker,0,3,0,2,1606021200,1608786000,3
uhhhhhhhhwhoknows,1,2,332,12,1599624000,1600228800,3
BentKnob98,0,3,0,23,1551934800,1570593600,3
apalm85,1,2,5,22,1585540800,1585800000,3
laxjohnny,1,2,25,2,1598846400,1599105600,3
GMTZ_20,0,3,0,6,1602734400,1602993600,3
Azallp1,3,0,475,0,1601265600,1607403600,3
y_tho_bro,0,3,0,30,1582693200,1592280000,3
envy221,1,2,551,2,1554868800,1579323600,3
Wang_Dangler,0,3,0,280,1568779200,1592107200,3
ObsidianUnicorn,0,3,0,53,1578286800,1611982800,3
Sec0ndS0n,0,3,0,39,1575262800,1579237200,3
wacky1977,0,3,0,-1,1580274000,1585454400,3
Draco877,0,3,0,5,1570420800,1570420800,3
56821,0,3,0,115,1603425600,1608181200,3
leaguegoderino,0,3,0,17,1607490000,1611982800,3
ACNLGal2016,0,3,0,3,1573966800,1573966800,3
Aardwolfington,0,3,0,18,1611637200,1612155600,3
childofhaze_,0,3,0,8,1606712400,1606971600,3
writeidiaz,0,3,0,-1,1608526800,1608613200,3
Slubberdagullion,0,3,0,27,1577422800,1577422800,3
Illernoise,0,3,0,22,1581051600,1597118400,3
CP_Conquer,0,3,0,4,1582606800,1582606800,3
Jkulisz,0,3,0,19,1587614400,1596859200,3
mysonchoji,0,3,0,6,1600488000,1600574400,3
Rainonsnowsurcharge,0,3,0,10,1608613200,1608613200,3
xeillyboi,1,2,2,2,1608699600,1608786000,3
IrrawaddyWoman,0,3,0,6,1578891600,1579064400,3
barmaleyfountainpen,0,3,0,194,1607576400,1609218000,3
ShittyBusinessBill,0,3,0,19,1597204800,1597204800,3
koosekoose,0,3,0,11,1585454400,1608958800,3
funkyshrimps,0,3,0,6,1605502800,1608008400,3
Milleuros,0,3,0,15,1585454400,1585454400,3
cameheretohelpsam,0,3,0,11,1540958400,1546664400,3
sendgarlicbreadpls,0,3,0,16,1579410000,1579410000,3
franzipoli,0,3,0,-14,1590465600,1590465600,3
blankdeluxe,0,3,0,31,1605502800,1605589200,3
chubbysubs,0,3,0,4,1585368000,1585368000,3
TcFir3,0,3,0,146,1599796800,1602907200,3
omgyoucunt,1,2,4,5,1583125200,1583125200,3
Aveira,0,3,0,95,1580706000,1602648000,3
Permatato,0,3,0,7,1606280400,1606280400,3
ChuggingDadsCum,0,3,0,16,1605157200,1605157200,3
IamtheAnvil,0,3,0,46,1575954000,1585627200,3
royalartwear,1,2,138,20,1601697600,1604638800,3
Hiouchi4me,0,3,0,15,1574398800,1587096000,3
SaintDorothyZbornak,0,3,0,3,1594785600,1594958400,3
FuzzyBubs,0,3,0,30,1593662400,1594526400,3
Chunky_clouds,0,3,0,3,1602561600,1602648000,3
retarded-politics,0,3,0,8,1611896400,1612069200,3
intxisu,0,3,0,22,1573534800,1573534800,3
birthdaypartylover,0,3,0,26,1606366800,1612069200,3
CakeSheep,0,3,0,25,1607144400,1607317200,3
Heath__bar,0,3,0,29,1556510400,1602993600,3
becuziwasinverted,0,3,0,3,1601611200,1601611200,3
crimeo,0,3,0,1,1583985600,1584072000,3
Hakunamatata_420,0,3,0,45,1579928400,1604116800,3
gamileon,1,2,4,6,1587441600,1587528000,3
interestedthumbs,0,3,0,73,1567051200,1567051200,3
rainbow_voodoo,0,3,0,6,1596427200,1601697600,3
gabrielleraul,1,2,95,14,1600747200,1606626000,3
ItsJustMyOpinion100,0,3,0,1,1585454400,1585540800,3
Sir_Nassif,0,3,0,73,1575694800,1594008000,3
Appropriate-Wear,1,2,18,26,1580014800,1581483600,3
uzimyspecial,0,3,0,243,1572580800,1598500800,3
RyukEnjoysApples3,3,0,2068,0,1575349200,1575694800,3
MegaNUT721,1,2,10,9,1583125200,1583125200,3
JackRusselTerrorist,0,3,0,-21,1589342400,1589428800,3
UndecidedYellow,0,3,0,174,1546405200,1611896400,3
Shadowstalker75,0,3,0,-23,1603684800,1603684800,3
L_Mic,0,3,0,16,1605502800,1608267600,3
nage_,0,3,0,8,1609304400,1611982800,3
spedgenius,0,3,0,8,1591848000,1591848000,3
thekmind,0,3,0,2,1600574400,1600660800,3
hellenkellersdog,0,3,0,33,1605934800,1607576400,3
RepresentativeLime3,1,2,46,14,1577336400,1584244800,3
Diabolic_Edict,0,3,0,0,1550293200,1550293200,3
sunlit_cairn,0,3,0,64,1563854400,1571976000,3
_Podent_,0,3,0,-98,1581397200,1581483600,3
Saoirse_Bird,0,3,0,19,1596686400,1597464000,3
jintei89,0,3,0,5,1585800000,1585886400,3
gabbagabbahey38,0,3,0,58,1554955200,1606453200,3
MissDecadence,0,3,0,30,1593662400,1596859200,3
GJokaero,0,3,0,18,1584417600,1588305600,3
Fancy1720,0,3,0,8,1581224400,1606021200,3
Kwahn,0,3,0,2,1601092800,1601092800,3
A-T-P,1,2,114,3,1609390800,1609650000,3
yee-lee-skee-skee,0,3,0,12,1578027600,1578027600,3
JakeHodgson,0,3,0,2,1580706000,1604379600,3
Yoffrtlvig,0,3,0,8,1603512000,1605762000,3
Frigginkillya,0,3,0,18,1595390400,1597377600,3
muchmeerkat,2,1,131,1,1579496400,1579582800,3
trollinDC,0,3,0,9,1602734400,1606626000,3
Doctor_Korinthia,0,3,0,8,1580533200,1607490000,3
curtis1222,1,2,61,7,1611810000,1611982800,3
AlienTripod,1,2,361,33,1597550400,1597550400,3
jchazu,0,3,0,15,1565928000,1570334400,3
deanreevesii,0,3,0,21,1602734400,1607835600,3
Warcrimes_Jackson,0,3,0,15,1608181200,1608267600,3
tone_who_knocks,0,3,0,-17,1598673600,1598760000,3
BlabberBucket,0,3,0,6,1611982800,1611982800,3
estillcounty,1,2,55,44,1590120000,1596168000,3
jahambo,0,3,0,28,1611982800,1612069200,3
KingKunta369,0,3,0,12,1593921600,1602648000,3
Superyoshiegg,0,3,0,20,1583812800,1584331200,3
MayoMark,0,3,0,23,1598068800,1608526800,3
BushKnew,0,3,0,-10,1601870400,1601870400,3
New_Drink_5570,0,3,0,-15,1606021200,1606021200,3
NugDrug,0,3,0,66,1568606400,1572843600,3
Seventh_Planet,0,3,0,6,1569816000,1593921600,3
dubt95,1,2,22,4,1585886400,1585972800,3
Alphy101,0,3,0,167,1592798400,1608872400,3
strontiummuffin,0,3,0,30,1599019200,1608354000,3
LambdaKraut57,0,3,0,26,1582952400,1582952400,3
kaleido_dance,0,3,0,8,1597291200,1609390800,3
steven447,0,3,0,8,1573794000,1593662400,3
areyoumymommyy,0,3,0,22,1604379600,1606021200,3
xjasmone,0,3,0,-51,1608094800,1608094800,3
pierrotmoon1,0,3,0,44,1574658000,1587441600,3
ravenouscartoon,0,3,0,9,1573966800,1573966800,3
stupidshot4,0,3,0,4,1605589200,1605589200,3
ArmdragQueen,0,3,0,14,1578286800,1579410000,3
Horyfrock,0,3,0,35,1560398400,1599883200,3
nor312,0,3,0,26,1602129600,1602561600,3
10079010,0,3,0,20,1602129600,1605934800,3
WowHolyCrap,0,3,0,12,1590120000,1597291200,3
96sr1b38u9o,0,3,0,0,1555905600,1568865600,3
PECOSbravo,0,3,0,2,1640322000,1640322000,3
skampson,0,3,0,200,1603425600,1608008400,3
80P360,0,3,0,15,1603252800,1603857600,3
Brushfire22,0,3,0,26,1579237200,1611896400,3
-LTS-,0,3,0,10,1611982800,1611982800,3
Koreyrobin,0,3,0,15,1566792000,1579150800,3
Rthrowaway420,1,2,5,2,1581483600,1581483600,3
astramell,0,3,0,39,1602734400,1603944000,3
gamebox3000,0,3,0,25,1608699600,1609218000,3
stankhead,0,3,0,12,1593748800,1602216000,3
Vwdriver83,0,3,0,45,1544504400,1546578000,3
legend1nfamous,1,2,192,45,1573189200,1584417600,3
MPA_Dad,0,3,0,34,1568174400,1601611200,3
ShivasRightFoot,0,3,0,25,1604984400,1607662800,3
nicannkay,0,3,0,107,1578978000,1582952400,3
MXD14,1,2,16,10,1603857600,1603857600,3
desolateconstruct,0,3,0,30,1577854800,1579410000,3
apparis,0,3,0,20,1607058000,1608440400,3
Despicable_carl,1,2,526,33,1602734400,1602734400,3
ptitz,1,2,225,7,1588478400,1599192000,3
antisupersoldier69,0,3,0,43,1594872000,1595908800,3
drkj,0,3,0,-3,1593316800,1607662800,3
QualityReboot,0,3,0,12,1546578000,1546664400,3
BillyBones8,0,3,0,64,1546059600,1596340800,3
FalconFever7,0,3,0,13,1584417600,1584417600,3
vieleiv,0,3,0,-6,1559620800,1605502800,3
epicataraxia,0,3,0,18,1605848400,1606885200,3
Revolutionary_Cut538,0,3,0,8,1607058000,1607058000,3
brokencig,0,3,0,119,1547787600,1564027200,3
run4success,0,3,0,24,1594267200,1594267200,3
spiff428,0,3,0,21,1602907200,1604293200,3
realjohncenawwe,0,3,0,-39,1599710400,1599710400,3
EchoBop,0,3,0,126,1602302400,1607922000,3
ElectricMahogany,0,3,0,17,1608094800,1608094800,3
judgyjudgersen,0,3,0,265,1571889600,1575522000,3
meh35m,0,3,0,8,1607317200,1608786000,3
enviflux123,0,3,0,-55,1587873600,1587960000,3
Kalinord,0,3,0,-69,1593835200,1601870400,3
xm45-h4t,1,2,12,26,1594353600,1594612800,3
BurningOrangeHeaven,0,3,0,5,1594180800,1594180800,3
MrFilthyNeckbeard,0,3,0,-11,1571112000,1571630400,3
basicallyfinancepod,0,3,0,7,1592107200,1592280000,3
KindaCruise,0,3,0,-20,1603339200,1603339200,3
okordenador,0,3,0,3,1567051200,1567051200,3
Brelya,1,2,78,3,1591588800,1593403200,3
Synecdochic,0,3,0,11,1585540800,1608354000,3
Karraten,0,3,0,27,1605502800,1606539600,3
randomzebrasponge,0,3,0,-11,1592798400,1593230400,3
stoner-kitty007,1,2,21,7,1581570000,1582520400,3
Ardvarkeating101,0,3,0,1,1550293200,1550293200,3
hiphopnoumenonist,1,2,0,1,1603425600,1603425600,3
thebreadstop,0,3,0,1,1611982800,1612069200,3
Jacks_Account,0,3,0,10,1585454400,1585454400,3
FLORI_DUH,0,3,0,-13,1606194000,1607058000,3
PAGE-O-MATIC,0,3,0,11,1601870400,1608008400,3
Senile_Sapien,0,3,0,15,1570852800,1582174800,3
bails0bub,0,3,0,12,1598414400,1598414400,3
WarmCorgi,0,3,0,3,1603512000,1603598400,3
LV__,0,3,0,27,1596945600,1611810000,3
alaskancorgi,0,3,0,30,1579496400,1596513600,3
Carma-X,0,3,0,21,1592625600,1612155600,3
soccerandplants,0,3,0,38,1546405200,1583470800,3
MrTase,0,3,0,7,1574053200,1574139600,3
Jumbobog,0,3,0,6,1608872400,1608872400,3
OhGodOhFuckImHorny,0,3,0,9,1606971600,1608008400,3
KangarooDicks,0,3,0,11,1570334400,1574139600,3
wyckedblonde00,0,3,0,5,1574917200,1578978000,3
hitlerosexual,0,3,0,34,1570075200,1578200400,3
nowayitskim,1,2,10,4,1581310800,1581483600,3
Myfishwillkillyou,0,3,0,12,1561608000,1561608000,3
jjcoola,0,3,0,14,1597377600,1597377600,3
mushroom_clouds,0,3,0,4,1557374400,1557374400,3
EVRYDAYMANSONTHEBLOK,0,3,0,1,1576818000,1576904400,3
justneurostuff,0,3,0,63,1567742400,1574139600,3
Secret_Mention8998,0,3,0,10,1607144400,1607230800,3
GrowGrow_,0,3,0,28,1586491200,1600142400,3
squirrelthetire,0,3,0,7,1606021200,1606712400,3
OrganizedChaos86,0,3,0,6,1603339200,1607403600,3
brooks5150,0,3,0,2,1585454400,1585454400,3
EtherCase,1,2,32,84,1579928400,1606366800,3
Xendrick,0,3,0,162,1554264000,1559620800,3
Shadow_strife,0,3,0,3,1603512000,1603512000,3
koalaposse,0,3,0,9,1592020800,1592020800,3
iloveana02,0,3,0,50,1572235200,1572235200,3
wolfie_angel,0,3,0,13,1584676800,1605762000,3
blizzeron,0,3,0,2,1575262800,1575262800,3
alchemistsoul,0,3,0,41,1569384000,1570680000,3
Gilthoniel_Elbereth,0,3,0,10,1572843600,1588737600,3
PolPotato7171,0,3,0,16,1591243200,1591243200,3
Class_Conscious,0,3,0,8,1584158400,1584158400,3
AkAPeter,0,3,0,6,1612069200,1612069200,3
coontietycoon,0,3,0,20,1604293200,1604293200,3
csumbody,0,3,0,-22,1599537600,1600747200,3
BanksAndTanks,1,2,9,7,1440820800,1442376000,3
Lucidiously,0,3,0,14,1594008000,1603425600,3
whatdoyoudochunky,0,3,0,58,1580619600,1581224400,3
arelevantuser,0,3,0,10,1591243200,1591329600,3
Neckshot,2,1,2703,1,1598068800,1608699600,3
AnOrthodoxHeretic,0,3,0,15,1573966800,1573966800,3
invalidusernamelol,0,3,0,18,1582520400,1582606800,3
bird_nips,0,3,0,-34,1570248000,1570939200,3
justanuvaredditor,0,3,0,7,1598587200,1598673600,3
skyisfalling98,0,3,0,13,1585800000,1588824000,3
CynicalTherapy,1,2,8,2,1591848000,1592020800,3
M4cerator,0,3,0,-14,1608440400,1608440400,3
cookoobandana,0,3,0,56,1570075200,1583125200,3
Bleakfall,0,3,0,9,1606539600,1611982800,3
throwaway9237102827,3,0,132,0,1587700800,1592539200,3
yesyepyea,0,3,0,16,1607144400,1608008400,3
duneymole,0,3,0,24,1571803200,1581397200,3
Crystal_helix,0,3,0,11,1606626000,1608699600,3
TheFallenRefrain,1,2,56,8,1604811600,1604898000,3
miaworm,0,3,0,14,1593403200,1593403200,3
WilliamJoe10,0,3,0,72,1601179200,1602820800,3
velocinapper,1,2,2,2,1541217600,1541394000,3
dopeboyhero,0,3,0,3,1396756800,1409198400,3
Excal2,0,3,0,7,1591243200,1591329600,3
methadoneclinicynic,1,2,42,12,1608786000,1609045200,3
wolferaz,0,3,0,0,1604466000,1604552400,3
nofailending,0,3,0,40,1550552400,1551762000,3
normal_whiteman,0,3,0,-114,1583557200,1608526800,3
atomizedshucks,0,3,0,4,1585540800,1585540800,3
testspecimen85,0,3,0,0,1599105600,1599883200,3
nameduser17,0,3,0,34,1603857600,1606280400,3
Sonic343,0,3,0,21,1602734400,1604984400,3
mandyrooba,0,3,0,70,1597291200,1606021200,3
atbobick,0,3,0,8,1584244800,1584331200,3
brianna399,0,3,0,3,1574053200,1574139600,3
erictheturtle,1,2,15,9,1605762000,1608526800,3
dystopian_mermaid,0,3,0,28,1605243600,1605243600,3
super_marcie,0,3,0,9,1577854800,1586145600,3
RicktatorshipRulez,0,3,0,21,1591934400,1593576000,3
JonesWYC,0,3,0,21,1563249600,1600488000,3
Mondashawan,0,3,0,40,1596772800,1605934800,3
riss85,0,3,0,23,1599364800,1600660800,3
IMBACK881353,0,3,0,6,1597636800,1597636800,3
WinstonCaeser,0,3,0,-27,1590379200,1590379200,3
Waaaaaah6,1,2,5,7,1570680000,1572753600,3
tokun_,0,3,0,5,1611810000,1611810000,3
highway-hawk,0,3,0,59,1570420800,1583726400,3
Dear_Occupant,0,3,0,49,1593748800,1598414400,3
norsurfit,0,3,0,34,1555128000,1559880000,3
LoneWolfpack777,0,3,0,4,1595476800,1595476800,3
amphicoelias,0,3,0,3,1587096000,1588651200,3
Chloe_Zooms,0,3,0,41,1603339200,1603339200,3
Shantotto11,0,3,0,11,1589947200,1612069200,3
tvdinner4me,0,3,0,4,1604379600,1604898000,3
BimboBrothel,0,3,0,38,1563249600,1581310800,3
ineedmoney020,0,3,0,9,1594612800,1596600000,3
miscellaneous_ghb,1,2,6,68,1548738000,1551848400,3
LadiesHomeCompanion,0,3,0,2,1579064400,1579064400,3
Devonforever,1,2,15,14,1588651200,1607317200,3
bigiszi,0,3,0,13,1605934800,1606366800,3
OriginalEssGee,0,3,0,10,1592280000,1608699600,3
transfat97,0,3,0,105,1558497600,1563595200,3
JOJOCHINTO_REPORTING,0,3,0,13,1589256000,1606885200,3
thebrandnewbob,0,3,0,3,1571630400,1578286800,3
tovape75,0,3,0,40,1608440400,1608440400,3
caveatemptor18,0,3,0,15,1603598400,1608613200,3
Iconiqueity,0,3,0,13,1604811600,1607317200,3
huiledesoja,0,3,0,9,1606366800,1606626000,3
spikedwikedes,3,0,32,0,1501387200,1501387200,3
thebindingofJJ,0,3,0,18,1570852800,1580101200,3
Ju99er118,0,3,0,29,1585368000,1595822400,3
inbooth,0,3,0,10,1603512000,1603512000,3
CarolSwanson,2,1,31,2,1554696000,1555128000,3
Epyon214,0,3,0,2,1608786000,1608786000,3
GGTTAG,0,3,0,5,1554091200,1575608400,3
hearstone28473,0,3,0,-51,1568260800,1569643200,3
OMGitisCrabMan,0,3,0,3,1596859200,1596859200,3
BurlysFinest802,0,3,0,3,1568001600,1608872400,3
Treesthrowaway542,0,3,0,45,1570507200,1573534800,3
jannykay12,0,3,0,26,1557633600,1565755200,3
CertainPassenger,0,3,0,5,1550293200,1550293200,3
thiccthixx6,0,3,0,46,1605589200,1608354000,3
Chamomile_socks,0,3,0,3,1611982800,1612069200,3
EsctheCtrl1,0,3,0,2,1587873600,1587960000,3
whykillsirius,0,3,0,20,1580187600,1580187600,3
youjustdontgetitdoya,0,3,0,5,1586404800,1587960000,3
Airway,0,3,0,149,1585022400,1595131200,3
Bleatmop,0,3,0,34,1605502800,1612069200,3
makeearthgreenagain,2,1,24,9,1573448400,1578546000,3
elvishprecisely,1,2,7,4,1612069200,1612069200,3
measured_impulse,0,3,0,64,1603425600,1611982800,3
Jewazza,0,3,0,55,1583726400,1592193600,3
Reddituser8018,0,3,0,6,1606626000,1606626000,3
koko777,0,3,0,8,1578459600,1581051600,3
nitsej,0,3,0,11,1606798800,1608526800,3
PretendDr,0,3,0,53,1586404800,1606453200,3
BabySniffingAyniss,0,3,0,18,1602475200,1602907200,3
JohnnyUtah_QB1,0,3,0,8,1604379600,1604466000,3
t0ymach1n320,0,3,0,7,1561780800,1577336400,3
zatchel1,0,3,0,21,1547096400,1580446800,3
Maxx_Julien,0,3,0,29,1572753600,1581656400,3
Adliad,0,3,0,10,1593921600,1597032000,3
boardrandy,0,3,0,12,1600228800,1600315200,3
AtheistTardigrade,0,3,0,116,1597377600,1600747200,3
Scully_40,1,2,122,2,1575262800,1575349200,3
mutharage,0,3,0,35,1590033600,1606626000,3
RebelMusoSociety,1,2,17,4,1594699200,1594699200,3
kitten-parade,0,3,0,96,1573794000,1589515200,3
Menschenblut,0,3,0,19,1592193600,1592539200,3
fehrsea,0,3,0,12,1587096000,1587182400,3
PM_ME_LEGS_PLZ,0,3,0,3,1560830400,1560830400,3
andresopeth,1,2,63,9,1572321600,1607403600,3
human_stuff,0,3,0,43,1609045200,1609045200,3
st_steady,0,3,0,-21,1589256000,1590552000,3
furpel,0,3,0,28,1575262800,1608526800,3
Animorphimagi,0,3,0,3,1605934800,1605934800,3
NorthernTrash,0,3,0,61,1562644800,1571889600,3
hihistichbird,0,3,0,4,1606798800,1606798800,3
Raoul_Duque,0,3,0,4,1608526800,1608526800,3
soupandsalad999,0,3,0,7,1594180800,1594267200,3
ashleypenny,0,3,0,-5,1573448400,1573448400,3
psychenauts,0,3,0,3,1606626000,1606626000,3
FPSXpert,0,3,0,3,1566360000,1585972800,3
bosslines,1,2,1411,40,1599883200,1602129600,3
MysticAnarchy,0,3,0,48,1572408000,1601611200,3
ThatsWhatXiSaid,0,3,0,10,1603684800,1607662800,3
Apollo989,1,2,11,5,1605330000,1605330000,3
bhexca,0,3,0,292,1598414400,1600228800,3
bromeliadi,0,3,0,9,1602648000,1604811600,3
woke_wizard,2,1,17,0,1594958400,1606453200,3
cggreene,1,2,2,45,1598155200,1598155200,3
iamNaN_AMA,0,3,0,49,1593662400,1609218000,3
nine932038,0,3,0,8,1575781200,1602302400,3
ascension8438,0,3,0,5,1550638800,1556337600,3
ForWhatIDCIC,1,2,12,4,1581397200,1581483600,3
lemonjuicepulp,0,3,0,3,1600660800,1600747200,3
FrozenShoggoth,0,3,0,95,1572062400,1594526400,3
JekesPekes,0,3,0,163,1567483200,1599537600,3
crackerskazoo,0,3,0,33,1587441600,1587441600,3
Sozialismus1917,0,3,0,13,1563940800,1604811600,3
Difficult_Sherbert,1,2,17,11,1576990800,1576990800,3
HedgeFundamentals,1,2,14,91,1549083600,1555128000,3
tinylittledick,0,3,0,1,1606539600,1606626000,3
ApertureScientist999,1,2,11,4,1595390400,1606453200,3
macguffinbeauprix,0,3,0,2,1608699600,1608699600,3
Heretek1914,0,3,0,95,1573275600,1596600000,3
TheDevilsAbortedKid,1,2,1126,4,1608181200,1609304400,3
Xicsess,0,3,0,9,1547182800,1547355600,3
councilmember,0,3,0,32,1601611200,1601611200,3
Gold-of-Johto,0,3,0,19,1590897600,1608699600,3
YoungWalken,0,3,0,42,1593576000,1606712400,3
luckynumbersummer,0,3,0,4,1580446800,1580533200,3
nortern,0,3,0,5,1606539600,1606626000,3
yogawithyogi,1,2,31,3,1604466000,1604466000,3
artsynerdmillenial,0,3,0,89,1560657600,1601179200,3
Aissir,0,3,0,40,1573448400,1597896000,3
628362528,1,2,251,18,1602043200,1602043200,3
checkerboardandroid,0,3,0,18,1606626000,1607317200,3
Bronesby,0,3,0,5,1575608400,1607230800,3
greeklemoncake,0,3,0,5,1596686400,1599710400,3
justin_jamaal_1,0,3,0,53,1565668800,1576990800,3
Teknikal_Domain,0,3,0,15,1598414400,1598414400,3
Crowskull38,0,3,0,7,1601870400,1601956800,3
OffendedPotato,0,3,0,102,1588737600,1588737600,3
LactatingJello,1,2,39,5,1600228800,1600228800,3
h0dgeeeee,0,3,0,3,1594180800,1594180800,3
hithazel,0,3,0,32,1554091200,1566792000,3
nucleareds,1,2,0,3,1557892800,1557979200,3
Squawnk,0,3,0,279,1582952400,1608699600,3
Toutanus,0,3,0,15,1599105600,1608872400,3
DiacytlDong,1,2,19,10,1595563200,1595563200,3
yijiujiu,0,3,0,7,1575608400,1595563200,3
Mosslessrollingstone,0,3,0,48,1583038800,1595563200,3
JezTheAnarchist,0,3,0,5,1593316800,1594180800,3
midnight_squash,0,3,0,31,1557892800,1575262800,3
daandobber,0,3,0,16,1540785600,1549515600,3
Dukkenheim,0,3,0,11,1600401600,1601179200,3
Jamtso78,0,3,0,48,1547787600,1557633600,3
Star-spangled-Banner,0,3,0,7,1602820800,1602820800,3
ilikedatunahere,0,3,0,10,1579755600,1584417600,3
gustavfringo2,0,3,0,-9,1606107600,1606712400,3
WithAGrainOfNutmeg,0,3,0,17,1606539600,1608613200,3
jnsaunde,0,3,0,3,1605589200,1606885200,3
james_dean_daydream,0,3,0,13,1595304000,1596340800,3
Chickenflocker,0,3,0,-42,1600142400,1600142400,3
minisodamiranda,0,3,0,3,1578286800,1578373200,3
Brilliant_Crab_811,0,3,0,26,1600056000,1607403600,3
malrjklco,3,0,61,0,1584590400,1584763200,3
j4ytch,0,3,0,13,1576904400,1576990800,3
PotatoBomb69,0,3,0,11,1578978000,1578978000,3
Jhin-chan,1,2,5154,14,1604898000,1608613200,3
poopoocahcahpeepee,0,3,0,9,1578805200,1578805200,3
rauletto,0,3,0,68,1568952000,1608526800,3
DatBoi780865,0,3,0,11,1607922000,1609131600,3
gambiit,0,3,0,42,1591675200,1594872000,3
scooter_se,0,3,0,188,1582606800,1586232000,3
Tundur,0,3,0,106,1608699600,1609304400,3
knob-0u812,0,3,0,7,1607576400,1607576400,3
ThePrizedJoshua,0,3,0,60,1583125200,1601524800,3
Burany,0,3,0,10,1606280400,1606798800,3
starktor,0,3,0,57,1574312400,1606798800,3
Oobutwo,0,3,0,3,1587355200,1587355200,3
ThanksYouEel,0,3,0,2,1566532800,1572148800,3
flojo535,1,2,237,13,1598414400,1598414400,3
raspberrykoolaid,0,3,0,30,1602734400,1602734400,3
wheresthebody,0,3,0,137,1596340800,1605589200,3
BeerConcious,0,3,0,-3,1582952400,1583038800,3
ZSCroft,0,3,0,18,1597896000,1603512000,3
Ternigrasia,0,3,0,3,1606194000,1606194000,3
TheRedditDancer,0,3,0,8,1607662800,1607662800,3
Davisdab69,0,3,0,-22,1575176400,1575176400,3
PuzzleheadedFall2,0,3,0,-5,1605848400,1605848400,3
FaithfulNordDad,0,3,0,2,1548651600,1550206800,3
PatiHubi,0,3,0,15,1557720000,1585454400,3
Blackadd3r_63,2,1,134,0,1572062400,1576731600,3
plato_playdoh1,0,3,0,86,1575867600,1575867600,3
BestCoast-BC,0,3,0,13,1598068800,1598155200,3
Sludge_Monster900,0,3,0,7,1592712000,1593316800,3
readitallbefore,0,3,0,6,1604466000,1608440400,3
helpwithlabreport,0,3,0,6,1607835600,1612155600,3
Emma_hiipower,1,2,7,2,1602820800,1603080000,3
Xechorizo,0,3,0,128,1583038800,1583038800,3
Milli63,1,2,8,4,1603598400,1603684800,3
Sword_of_Slaves,0,3,0,19,1593230400,1609045200,3
CityofDarkness,0,3,0,50,1572494400,1572580800,3
thebrumber,0,3,0,3,1598587200,1604116800,3
overdark33,0,3,0,8,1581570000,1605157200,3
Mo_Meant_M_On_YT,0,3,0,6,1566705600,1573016400,3
self--,1,2,87,16,1608526800,1608526800,3
Aldebaran-Shellmouth,0,3,0,17,1540785600,1554264000,3
ArtMacCuinn,0,3,0,-1,1595908800,1595908800,3
TheRealLestat,0,3,0,12,1603080000,1608440400,3
Swampdude,0,3,0,57,1582088400,1583470800,3
whiten1nja,0,3,0,26,1607403600,1608094800,3
SmittyBot9000,0,3,0,13,1606712400,1607490000,3
TaZmaniian-DeviL90,0,3,0,13,1602648000,1605934800,3
pewpewpewman1,0,3,0,7,1603857600,1606885200,3
a7x2319,0,3,0,-13,1611982800,1612069200,3
404FoxNotFound,0,3,0,8,1581483600,1581915600,3
Zingshidu,0,3,0,2,1605589200,1605589200,3
MissDesignDiva,0,3,0,105,1602216000,1612069200,3
Metaalacritous,0,3,0,23,1561435200,1562990400,3
jackxiv,1,2,21,18,1597550400,1597636800,3
kjacobs92,0,3,0,19,1601092800,1601092800,3
safetravels,0,3,0,130,1594094400,1598068800,3
suicidebycopitalism,0,3,0,9,1590379200,1593921600,3
TwoscoopsDrumpf,0,3,0,20,1601524800,1602302400,3
mrbluesky__,0,3,0,19,1605416400,1605416400,3
r64fd,0,3,0,18,1547787600,1598673600,3
Stargazer1919,0,3,0,41,1591156800,1591243200,3
orqa,3,0,1380,0,1569038400,1581570000,3
Rolando_Cueva,0,3,0,3,1579237200,1579323600,3
jakejakejake86,0,3,0,-6,1590379200,1590465600,3
BP5025,0,3,0,4,1592107200,1593230400,3
Boiok,0,3,0,19,1549515600,1549602000,3
MB6,1,2,202,20,1566446400,1600488000,3
diamondsinmymouth,0,3,0,3,1608699600,1608699600,3
modestprofanity,0,3,0,26,1608613200,1608613200,3
bloodwolf28,0,3,0,54,1563940800,1584331200,3
GuiMenGre,1,2,12,5,1597118400,1597118400,3
rainbow_drab,0,3,0,23,1602820800,1608267600,3
apathyismymotto,0,3,0,21,1576386000,1585368000,3
picklespimp,0,3,0,12,1594440000,1594440000,3
heretogetpwned,0,3,0,94,1557288000,1572580800,3
Interceox,0,3,0,24,1557806400,1569297600,3
Devmurph18,0,3,0,3,1581310800,1581397200,3
Poltercon,0,3,0,-6,1554523200,1566360000,3
JohnGwynbleidd,1,2,43,4,1578027600,1582261200,3
skarbles,0,3,0,42,1578286800,1578286800,3
ProjectBadass-,0,3,0,0,1589515200,1589601600,3
zuzg,0,3,0,342,1605157200,1607230800,3
SatanMeekAndMild,0,3,0,38,1607490000,1607490000,3
7URB0,0,3,0,23,1587268800,1598760000,3
stuntaneous,0,3,0,3,1539835200,1605416400,3
Infinaut,0,3,0,10,1603771200,1603771200,3
macondo-yasnaya,1,2,24,12,1578632400,1578632400,3
OvechkinsYellowLaces,0,3,0,9,1573707600,1573707600,3
Stone_Bucket,0,3,0,13,1589083200,1607490000,3
ellyh2,0,3,0,179,1603512000,1603598400,3
zovahkin,0,3,0,-20,1600833600,1600833600,3
s1lav3,3,0,127,0,1558756800,1573621200,3
seekingpennys,0,3,0,12,1603857600,1609304400,3
Das_Ce_Ammer,0,3,0,133,1579064400,1598068800,3
Not_Michelle_Obama_,0,3,0,-2,1591243200,1591329600,3
silent_future678,0,3,0,54,1602993600,1604293200,3
mayonaise_cat,0,3,0,1,1605157200,1606712400,3
SullenArtist,0,3,0,137,1580965200,1601092800,3
_C22M_,0,3,0,0,1589601600,1589688000,3
frostyburns,0,3,0,8,1602907200,1605243600,3
snackery_binx,0,3,0,16,1591243200,1591329600,3
Soaliveinthe215,0,3,0,1,1595995200,1598673600,3
ulyssesphilemon,0,3,0,-4,1573966800,1573966800,3
ChantedFox,0,3,0,14,1578805200,1585281600,3
sawbonesromeo,0,3,0,1095,1607317200,1608613200,3
QueerPirate92,0,3,0,32,1548997200,1552276800,3
TWINBLADE98,0,3,0,44,1576731600,1606885200,3
ChortleLikeAMortal,0,3,0,27,1595908800,1595908800,3
HCCO,0,3,0,22,1604030400,1604293200,3
GinnyMorningstar,1,2,9,5,1609390800,1611896400,3
cairfrey,0,3,0,46,1582606800,1583726400,3
Drangustron,0,3,0,20,1611896400,1611982800,3
placemat24,0,3,0,77,1586404800,1599796800,3
ChandlerBiing,0,3,0,42,1575003600,1578286800,3
Kureina,0,3,0,3,1608526800,1608613200,3
bellabowie,0,3,0,29,1566446400,1566532800,3
HereToTalkAbtWrassln,1,2,100,28,1597118400,1597118400,3
couchfucker6669,3,0,66,0,1602043200,1608786000,3
IKenpai,1,2,36,3,1597723200,1601179200,3
miguel6971,0,3,0,-34,1573966800,1574312400,3
aFineMoose,0,3,0,-15,1596600000,1607490000,3
unimatrix_zer0,0,3,0,145,1571544000,1575608400,3
bouzenjishitsu,0,3,0,34,1577854800,1588651200,3
Vox__Umbra,0,3,0,14,1559707200,1565928000,3
mrcosbey,0,3,0,5,1602475200,1608267600,3
ihatecommunism724323,1,2,0,-14,1608786000,1608786000,3
zDraxi,0,3,0,7,1612069200,1612069200,3
SpikeyTaco,0,3,0,109,1584504000,1584590400,3
fullmaltalchemist,3,0,81,0,1435118400,1436155200,3
just_a_random_userid,1,2,16,14,1544763600,1597291200,3
Domini384,0,3,0,3,1585454400,1585713600,3
Foodcity,0,3,0,16,1564459200,1607144400,3
Zanderleigh,0,3,0,39,1574226000,1574226000,3
KFLOL,0,3,0,94,1563163200,1563854400,3
B00leybean,0,3,0,24,1574744400,1578459600,3
xlFLASHl,1,2,271,3,1572580800,1591243200,3
TheBathCave,0,3,0,19,1595304000,1605330000,3
Kemosabe0,1,2,60,10,1546923600,1550984400,3
ecerin,0,3,0,7,1581656400,1607576400,3
mrleroyster,0,3,0,8,1606712400,1607058000,3
UtterlyChop,1,2,54,4,1608008400,1608008400,3
kijanamtanashati,1,2,17,3,1605502800,1605589200,3
clitvacuum,0,3,0,16,1589860800,1589947200,3
Ricketysyntax,0,3,0,25,1607403600,1607403600,3
elbaivnon,0,3,0,122,1594094400,1594699200,3
TheMotte,0,3,0,193,1597118400,1599537600,3
AsleepAlarm,0,3,0,40,1590379200,1591416000,3
Itsohhereitis,0,3,0,30,1571371200,1581656400,3
GoodBot_BadBot,0,3,0,7,1515560400,1528862400,3
Sarcasm_Llama,0,3,0,20,1593316800,1593316800,3
APJMEX,0,3,0,6,1592712000,1596254400,3
4ierWaves,0,3,0,5,1609045200,1609131600,3
leafo777,1,2,110,25,1573448400,1575176400,3
Jdog131313,0,3,0,3,1561521600,1604379600,3
VikingRevenant,0,3,0,208,1577422800,1593662400,3
Francesdevries,0,3,0,-7,1605330000,1605416400,3
thatreallycoolguy,0,3,0,-21,1606280400,1606280400,3
PoopDick420ShitCock,1,2,7,30,1604898000,1606021200,3
LegitimateTed,0,3,0,27,1583125200,1583899200,3
TotemGenitor,0,3,0,10,1611810000,1611982800,3
webby53,0,3,0,-20,1579237200,1579410000,3
Sparememe,0,3,0,8,1606626000,1606798800,3
Kit_fox_foci,0,3,0,26,1600660800,1600660800,3
badnuub,0,3,0,32,1607403600,1608958800,3
Magnum_Gonada,0,3,0,2,1612069200,1612069200,3
rashmallow,0,3,0,83,1557979200,1597032000,3
L00KA,0,3,0,4,1596600000,1609131600,3
WeirdFruitOnAStick,0,3,0,7,1589860800,1609045200,3
W1nterKn1ght,0,3,0,48,1602734400,1606021200,3
LukeTheDuke26,0,3,0,17,1604379600,1607058000,3
TheisIsNhice,1,2,0,-6,1596859200,1596859200,3
QuarantineTheHumans,0,3,0,26,1558411200,1580101200,3
Mr_LCB,0,3,0,-9,1603512000,1603512000,3
Bubba421,0,3,0,-85,1576386000,1576386000,3
crabbybitchman,1,2,8,3,1598587200,1598673600,3
Lurdanjo,0,3,0,23,1596254400,1603339200,3
curiousCat999,0,3,0,18,1575176400,1582606800,3
____Orange____,0,3,0,1,1588824000,1605589200,3
Bloody_Insane,1,2,29,17,1597896000,1601092800,3
Palmar,0,3,0,4,1555387200,1555560000,3
Transfigured_Knight,0,3,0,125,1555905600,1559102400,3
x-eNzym,0,3,0,4,1584417600,1584417600,3
polite_scrawler,0,3,0,21,1601438400,1602388800,3
lizardbreath1736,0,3,0,17,1584936000,1585368000,3
Bellamii,1,2,237,16,1555041600,1558843200,3
zmbjebus,0,3,0,16,1593403200,1597809600,3
Fictionland,0,3,0,47,1591243200,1591243200,3
MapedMod,1,2,19,2,1577854800,1580274000,3
singeblanc,0,3,0,5,1453957200,1490932800,3
DoTheRightThing69,0,3,0,17,1585627200,1592884800,3
GauntletInMyPussPuss,0,3,0,4,1575522000,1575522000,3
chrissythefairy,0,3,0,45,1584417600,1607317200,3
ysselss,0,3,0,25,1597377600,1604898000,3
sixlounge,0,3,0,12,1571630400,1571716800,3
pro_beau,0,3,0,21,1589688000,1589688000,3
gangexcrement,0,3,0,-5,1584849600,1588996800,3
ChupanMiVerga,0,3,0,55,1603512000,1603684800,3
Alexander-the-II,0,3,0,40,1594180800,1595995200,3
thuglyfeyo,0,3,0,1,1585454400,1585454400,3
Agus152535455,0,3,0,7,1588996800,1588996800,3
throwaway27464829,0,3,0,19,1540094400,1543467600,3
TheMends,0,3,0,68,1592712000,1594699200,3
Nakkitus,2,1,162,2,1593230400,1603166400,3
aznbirdflu,0,3,0,22,1550552400,1552708800,3
Tyty__90,0,3,0,20,1601092800,1607058000,3
MittensUniversesBane,0,3,0,14,1564200000,1564545600,3
205049,0,3,0,18,1599710400,1600833600,3
RedditorOnReddit2,0,3,0,-21,1571112000,1571112000,3
saltonmyfish,0,3,0,15,1572062400,1578200400,3
LeratoNull,0,3,0,10,1567310400,1567310400,3
crazyladybutterfly,1,2,1,19,1538193600,1540612800,3
nickdanger3d,0,3,0,45,1557288000,1596254400,3
buffalocoinz,0,3,0,33,1606539600,1607058000,3
CanHeWrite,0,3,0,29,1593748800,1595390400,3
Necrocornicus,0,3,0,-4,1603512000,1606712400,3
kennieamarillo,0,3,0,49,1561089600,1561089600,3
OutWithTheNew,0,3,0,24,1577336400,1577336400,3
GlobTwo,0,3,0,7,1585454400,1585540800,3
thanksalex,0,3,0,5,1584676800,1584763200,3
borrowedtime12319999,0,3,0,10,1602734400,1607749200,3
BeigeOnNeonOrange,0,3,0,30,1581483600,1582002000,3
Quirky_Inflation,0,3,0,7,1604379600,1604379600,3
whatthebosh,0,3,0,62,1562817600,1565928000,3
profoundexperience,0,3,0,1,1587528000,1587528000,3
Taograd359,0,3,0,6,1560916800,1561003200,3
AngryBanana0,1,2,0,-4,1606626000,1606626000,3
GryfferinGirl,0,3,0,29,1596340800,1606885200,3
meatgrinder54,0,3,0,20,1572930000,1578459600,3
dolmiopopcap,1,2,1394,12,1576645200,1600833600,3
JulesBonnotGunClub,0,3,0,7,1547096400,1547182800,3
SummerBoi20XX,0,3,0,32,1611896400,1611896400,3
luvreddituser1321,1,2,15,7,1589774400,1595649600,3
Shockah92,0,3,0,99,1605934800,1608699600,3
TheOneTrueClockWorK,0,3,0,5,1585195200,1585195200,3
Luke5119,0,3,0,40,1573102800,1589860800,3
Ikaros9Deidalos6,0,3,0,23,1572930000,1574312400,3
ghostfire_io,0,3,0,7,1567483200,1570766400,3
Frenchslumber,1,2,479,27,1609218000,1611896400,3
HaziEnuf,0,3,0,49,1602388800,1606453200,3
osuplayer491,0,3,0,-13,1595131200,1595131200,3
Aquakingmess,0,3,0,6,1608267600,1608267600,3
tioomeow,0,3,0,11,1584331200,1590120000,3
HoboBardManiac,0,3,0,42,1587614400,1606971600,3
Misoriyu,0,3,0,25,1592625600,1593921600,3
watislyf999,1,2,3,24,1588478400,1594612800,3
ninja_tank25,0,3,0,10,1583384400,1594612800,3
Corrvusuvrroc,0,3,0,5,1598587200,1605589200,3
Sessionhead,0,3,0,1,1598846400,1603512000,3
HipsterWhoMissedOut,1,2,46,8,1604030400,1606280400,3
Klagaren,0,3,0,6,1604898000,1604984400,3
Specimen222,1,2,8,3,1567656000,1567742400,3
Lv_InSaNe_vL,0,3,0,-4,1585540800,1585627200,3
thisman,1,2,241,69,1573016400,1582002000,3
NovaKatalyst,0,3,0,8,1563249600,1603339200,3
SMGUTZ01,0,3,0,3,1601870400,1601870400,3
jonsmith1998,1,2,119,39,1594353600,1595304000,3
ShaunyBabe3,0,3,0,52,1578891600,1606885200,3
doomsday0099,1,2,49,9,1564545600,1588564800,3
Axelnobody,0,3,0,79,1593662400,1597982400,3
not_very_creative,0,3,0,46,1605589200,1608699600,3
bo0tzz,0,3,0,5,1578027600,1585800000,3
Birddaycake,0,3,0,9,1576299600,1606798800,3
decompsociety4us,0,3,0,0,1585454400,1585454400,3
My1stUsrnameWasTaken,0,3,0,21,1590465600,1590465600,3
throwawaywork04040,0,3,0,23,1569902400,1569988800,3
grumpybuttpirate,0,3,0,7,1593662400,1593662400,3
OhNoXo,0,3,0,21,1600228800,1601352000,3
_PRP,0,3,0,33,1563595200,1565409600,3
ItsKonway,0,3,0,44,1598673600,1603684800,3
wondermetoinifinity,0,3,0,4,1605589200,1605589200,3
Styckles,0,3,0,7,1604466000,1604466000,3
findingnew2021,0,3,0,3,1610686800,1611118800,3
theracewarhasbegun,1,2,3,6,1554782400,1563422400,3
Remy385,0,3,0,30,1573966800,1591848000,3
iAmTheChampignon,0,3,0,3,1608267600,1608354000,3
88boxturtle,0,3,0,255,1605934800,1605934800,3
latinacouponer,0,3,0,29,1604030400,1605330000,3
phoenixrbth,0,3,0,9,1591934400,1592020800,3
Laliving90,0,3,0,12,1574398800,1587528000,3
toastismost,0,3,0,25,1578286800,1592280000,3
TexRichman,0,3,0,51,1564977600,1573448400,3
cmVkZGl0,0,3,0,24,1598760000,1601524800,3
Apollo_Wolfe,0,3,0,6,1573362000,1573362000,3
MladenL,0,3,0,32,1568001600,1568001600,3
GhiathI,0,3,0,11,1598846400,1598846400,3
evil_agent_perry,1,2,107,26,1599451200,1600056000,3
aerospace_94,0,3,0,18,1571284800,1572753600,3
commiefairy,1,2,1151,19,1606626000,1609304400,3
coZZeh,0,3,0,-25,1601092800,1601179200,3
Pawneewafflesarelife,0,3,0,5,1595649600,1595649600,3
chiliringgamer16,0,3,0,22,1598500800,1602820800,3
ImageMirage,1,2,8,10,1608440400,1608440400,3
Siraphine,0,3,0,94,1606971600,1611810000,3
AttackOfTheBolts,0,3,0,-1,1584590400,1584590400,3
garaks_tailor,0,3,0,6,1598587200,1598587200,3
jahahaheinterne,0,3,0,0,1608699600,1608699600,3
Avallonsly,0,3,0,193,1596427200,1599105600,3
anacrusis000,0,3,0,39,1597723200,1598846400,3
eh_throwaway98,0,3,0,20,1583125200,1583470800,3
komodobitchking,0,3,0,185,1597636800,1600315200,3
Holts70,0,3,0,27,1584158400,1584158400,3
JenG-O,0,3,0,10,1605243600,1605762000,3
WaySheGoesBub,0,3,0,72,1596686400,1605070800,3
ShelbySootyBobo,0,3,0,5,1582347600,1582952400,3
captianbob,0,3,0,8,1585540800,1585540800,3
Witchyko,0,3,0,12,1587787200,1601784000,3
dankacademia,0,3,0,17,1590638400,1596340800,3
randomo_redditor,0,3,0,446,1596513600,1602388800,3
only1remains,2,1,64,9,1553745600,1589947200,3
HackManDan,0,3,0,23,1598932800,1599710400,3
Worldliness_Antique,3,0,8709,0,1607144400,1608526800,3
KaiBahamut,0,3,0,27,1570507200,1594612800,3
Etrigone,0,3,0,27,1596859200,1596859200,3
samueldubon,0,3,0,3,1600574400,1600574400,3
StaggerLee808,0,3,0,22,1603252800,1603339200,3
PurplePizzaPuffin,0,3,0,2,1593576000,1593662400,3
Stormcrow1776,0,3,0,-6,1600228800,1600228800,3
Dioapple,0,3,0,26,1606280400,1612069200,3
evansomondilove,0,3,0,1,1606107600,1606107600,3
Giratinalawyer,0,3,0,8,1601611200,1606453200,3
vikietheviking,0,3,0,3,1595563200,1595563200,3
cantcontrol12,0,3,0,65,1571803200,1571889600,3
Plappeye,0,3,0,12,1607662800,1607662800,3
banjobenny02,0,3,0,117,1596254400,1609045200,3
Slight0,0,3,0,-19,1597636800,1605157200,3
ShanghaiShootout,0,3,0,21,1572843600,1576731600,3
Hoi_ro,1,2,17,3,1600228800,1600228800,3
JackPoe,0,3,0,19,1600574400,1608354000,3
EWool,1,2,4,18,1606712400,1607144400,3
CH0AM_N0MSKY,0,3,0,31,1547614800,1548133200,3
rustymetal97,3,0,217,0,1602475200,1609131600,3
liquid42,0,3,0,121,1549256400,1607403600,3
happycat07,0,3,0,23,1601092800,1601352000,3
sardemliche,2,1,10,3,1544158800,1544158800,3
PrayerJuan,0,3,0,180,1601179200,1607317200,3
smallsnail89,0,3,0,53,1558238400,1607490000,3
hydroactiveturtle,0,3,0,16,1574312400,1575176400,3
Bila_Mauta,0,3,0,19,1593921600,1601438400,3
Accomplished_Two3379,1,2,6,4,1607490000,1607576400,3
Myik,0,3,0,16,1595390400,1595390400,3
FuckYouCuntAdmins8,0,3,0,20,1584763200,1584763200,3
bunkum89,0,3,0,-15,1607317200,1607317200,3
DrBokbagok,0,3,0,48,1609304400,1609390800,3
Terrince-Friend,1,2,13,7,1602129600,1602129600,3
theveganmarxist,0,3,0,226,1572843600,1575608400,3
I_love_asparagus,0,3,0,14,1607662800,1607749200,3
speedracer73,0,3,0,16,1602734400,1609304400,3
sheep-shape,0,3,0,674,1609131600,1609131600,3
FamiliarPassenger0,1,2,192,28,1582952400,1582952400,3
iatethefrog,0,3,0,15,1603857600,1606971600,3
_clairedelune,0,3,0,10,1582002000,1582693200,3
metamaoz,0,3,0,2,1550293200,1550293200,3
existenceispain888,0,3,0,26,1593057600,1600228800,3
Peeps469,0,3,0,13,1582434000,1606798800,3
awkward_3rd_ball,0,3,0,27,1607144400,1607403600,3
Doggslife,0,3,0,41,1590638400,1597204800,3
doobsicle,0,3,0,16,1608958800,1609045200,3
Dead5loth99,0,3,0,7,1583985600,1584244800,3
PurpleWishbone,0,3,0,6,1599624000,1608354000,3
KevlarArcher,0,3,0,4,1600747200,1600747200,3
GiGaBYTEme90,0,3,0,609,1608613200,1608958800,3
GuttaTrash,0,3,0,23,1605675600,1606712400,3
MechaSnacks,0,3,0,22,1601265600,1603857600,3
ComradeJason,1,2,0,-13,1567396800,1567396800,3
lonelybih,0,3,0,14,1569816000,1569816000,3
Gasoline_Dreams,0,3,0,-6,1602475200,1602475200,3
eddie_atleti,0,3,0,300,1591070400,1591156800,3
Liwi808,0,3,0,-44,1599624000,1599883200,3
Sensitive-literature,0,3,0,43,1583812800,1588910400,3
gregormendelacid,1,2,9,-6,1603684800,1603684800,3
saycheesecakeisalie,0,3,0,26,1548651600,1548651600,3
SJWitch,0,3,0,283,1573880400,1589428800,3
DeismAccountant,0,3,0,3,1574658000,1596945600,3
veganmuffin,0,3,0,19,1575522000,1575522000,3
KingoftheShadow,0,3,0,184,1579496400,1579496400,3
LithiumNick,0,3,0,58,1598932800,1600574400,3
maybealwaysyes,0,3,0,22,1606712400,1606798800,3
RelativeDish,1,2,64,30,1555905600,1555905600,3
HappyHesher,1,2,0,-4,1567483200,1598500800,3
_phony_,0,3,0,19,1578546000,1578546000,3
XxX_Colman_XxX,0,3,0,7,1605243600,1607317200,3
anonymoumoulous,0,3,0,7,1578546000,1587700800,3
tiisje,1,2,429,5,1579064400,1579237200,3
app257,0,3,0,23,1594612800,1607662800,3
FaeVal,0,3,0,15,1570507200,1572843600,3
_shuckle,0,3,0,-3,1607576400,1607662800,3
Anarcho_Humanist,0,3,0,5,1524974400,1548910800,3
Chick3nWheat,0,3,0,-7,1588651200,1588737600,3
GolemThe3rd,0,3,0,5,1582952400,1596168000,3
DamnBadSpin,0,3,0,14,1582347600,1582693200,3
17648750,0,3,0,42,1579755600,1579755600,3
Overtheflood,0,3,0,28,1554523200,1556078400,3
1tamal2tamales,1,2,9,6,1603425600,1605934800,3
SovietMcDonalds,0,3,0,67,1572667200,1578805200,3
hiphopnurse,0,3,0,0,1532577600,1532577600,3
Rthen,0,3,0,1,1571198400,1571284800,3
queer_artsy_kid,0,3,0,14,1583384400,1583899200,3
takyamamoto,0,3,0,21,1604293200,1608526800,3
BadLuckCharm1966,0,3,0,5,1585108800,1606626000,3
Weaversag2,0,3,0,34,1573534800,1575867600,3
Worlds_Dumbest_Nerd,0,3,0,3,1587182400,1587182400,3
deadmonkeyfetus,0,3,0,11,1607835600,1607835600,3
aguyinthecity,0,3,0,70,1591243200,1591329600,3
yourlefttoenail,1,2,11,2,1607662800,1607662800,3
HisNameWasBoner411,0,3,0,28,1596427200,1596600000,3
Xhuzestaan,1,2,115,2,1585281600,1585540800,3
ovenface2000,0,3,0,1,1595217600,1595304000,3
Nepalus,0,3,0,6,1603598400,1603598400,3
cordiallyinvited333,0,3,0,9,1582520400,1587355200,3
Muckl3t,0,3,0,29,1549515600,1603339200,3
CodexProfit,0,3,0,4,1603425600,1608008400,3
CHIEFXx,1,2,6,12,1571630400,1573102800,3
UrTwiN,0,3,0,2,1585454400,1592366400,3
So_Thats_Nice,0,3,0,31,1580014800,1600315200,3
Hazardish08,0,3,0,2,1611982800,1611982800,3
idontkillbees,0,3,0,6,1585195200,1605330000,3
Jens__rai,0,3,0,3,1596081600,1596168000,3
onAPieceOfToast,0,3,0,11,1574658000,1586404800,3
KhaineVulpana,0,3,0,6,1605157200,1608613200,3
hiddenViolets01610,0,3,0,4,1571976000,1574830800,3
afartnamedbob,0,3,0,47,1588305600,1593921600,3
CookHusbandThrowaway,0,3,0,31,1573189200,1573189200,3
mayhemkb,0,3,0,4,1562817600,1600920000,3
thatswhy42,0,3,0,-1,1593662400,1593662400,3
halfmonty,0,3,0,-5,1571112000,1571112000,3
thefourthhouse,0,3,0,91,1586491200,1606712400,3
dragonflyindividual,0,3,0,-2,1606194000,1606712400,3
gallaevent,3,0,439,0,1561348800,1561521600,3
MyWALife,0,3,0,149,1598414400,1601524800,3
orthros,0,3,0,5,1589169600,1600488000,3
harperdarper,0,3,0,554,1598068800,1608786000,3
SusieTheBastard,0,3,0,15,1585195200,1585195200,3
jolie178923-15423435,0,3,0,54,1560484800,1566360000,3
fuchkoughff1969,0,3,0,-3,1605243600,1605243600,3
FOR_DEMACIA,0,3,0,6,1609304400,1609304400,3
kriptostoner420,0,3,0,-8,1599364800,1600660800,3
borkedbox,0,3,0,11,1604379600,1604379600,3
KamonTV,0,3,0,4,1605243600,1607403600,3
The_Magic_Tortoise,0,3,0,6,1587355200,1608440400,3
Constant-Arugula993,0,3,0,4,1603598400,1603598400,3
RadioactiveCorndog,0,3,0,5,1598932800,1608267600,3
Dinesaur,0,3,0,17,1583384400,1585627200,3
RoboData1,0,3,0,12,1603425600,1603425600,3
fuckdjkhaled,0,3,0,40,1577941200,1577941200,3
limjeck,1,2,340,10,1580187600,1608008400,3
pl4m,1,2,1,17,1590984000,1598932800,3
lysergiccastle,0,3,0,15,1565755200,1565755200,3
DualCoder,0,3,0,17,1595390400,1595476800,3
shrptoothinthevalley,0,3,0,54,1555300800,1555387200,3
PopperChopper,0,3,0,12,1608354000,1608354000,3
taalleerling,0,3,0,14,1548910800,1594785600,3
wheres-my-rum,1,2,2696,65,1582779600,1582866000,3
kenshima15,0,3,0,-2,1602734400,1602734400,3
ImJacksThrowaway,1,2,5,3,1582866000,1597982400,3
Talzon70,0,3,0,5,1553227200,1553227200,3
tjgatward,0,3,0,19,1539921600,1539921600,3
sizzlecinema,0,3,0,6,1597982400,1599364800,3
BroserJ,0,3,0,-23,1606885200,1607144400,3
think50,0,3,0,0,1557979200,1557979200,3
Polaris2,0,3,0,75,1565668800,1565668800,3
Kwershal,0,3,0,13,1585454400,1585540800,3
trumpdump409,0,3,0,14,1601956800,1605589200,3
fuckschool_22,2,1,151,3,1557892800,1558152000,3
NURMeyend,0,3,0,22,1597032000,1597118400,3
Raventhornicorn,0,3,0,15,1575262800,1585108800,3
Phaedrug,0,3,0,12,1586836800,1603339200,3
CalmCarpenter5,0,3,0,6,1590379200,1590638400,3
PhoenixCycle,0,3,0,23,1588564800,1589515200,3
paradeqia,0,3,0,17,1596168000,1596168000,3
dlongbeach,0,3,0,31,1568692800,1569384000,3
ZestyZachy,0,3,0,15,1589428800,1593576000,3
DatSonicBoom,0,3,0,27,1571457600,1575781200,3
Throw_it_Away_867,0,3,0,13,1593576000,1593662400,3
Hello_pusheen,0,3,0,17,1608699600,1608699600,3
Mertkaykay,0,3,0,4,1579928400,1581051600,3
caffein8dnotopi8d,0,3,0,5,1590033600,1590033600,3
LickyBeckyTheLez,0,3,0,-25,1583211600,1583211600,3
Pordan_Jeterson,1,2,29,2,1594612800,1594612800,3
TheMiseryChick,0,3,0,7,1486098000,1560657600,3
falsemc,1,2,8,3,1576904400,1576904400,3
fauxcerebri,0,3,0,15,1606885200,1607576400,3
binbanbingbong,0,3,0,18,1606798800,1607403600,3
The7thNomad,0,3,0,29,1550293200,1551070800,3
AussieCollector,0,3,0,13,1606885200,1606885200,3
Badde00,0,3,0,5,1592798400,1607317200,3
aw-un,0,3,0,7,1582952400,1607835600,3
Dutcheaglesucker,1,2,16,8,1563249600,1563595200,3
WeEatCocks4Satan420,0,3,0,44,1607058000,1612155600,3
__jamien,0,3,0,53,1558152000,1563076800,3
tyvo,1,2,430,55,1575262800,1575262800,3
PizzaHegel,0,3,0,23,1568692800,1568692800,3
wootteri,0,3,0,12,1559016000,1607662800,3
bodiescasper,0,3,0,16,1558929600,1609131600,3
nonpartisanissue,0,3,0,59,1597550400,1597550400,3
takingastep,0,3,0,7,1551243600,1555646400,3
azirfury,0,3,0,17,1604293200,1605502800,3
AndrewG34,0,3,0,8,1611896400,1611896400,3
SizeableEvents,2,1,38,3,1576040400,1588046400,3
Extocin,0,3,0,10,1584676800,1584676800,3
fuckingportuguese,0,3,0,22,1594785600,1606798800,3
Weak-Stuff,1,2,47,16,1583125200,1583125200,3
StartupSensei,0,3,0,163,1595044800,1611982800,3
charlitstarlett,1,2,197,7,1540699200,1565323200,3
imcing9119,0,3,0,24,1585108800,1590033600,3
TooOldToTell,0,3,0,3,1590552000,1604116800,3
Luke20820,0,3,0,-4,1591329600,1591329600,3
Backstageplasma,0,3,0,41,1539662400,1539662400,3
SSJRapter,0,3,0,-2,1599019200,1601179200,3
throw_away6789998212,0,3,0,82,1586404800,1586404800,3
Supringsinglyawesome,0,3,0,-4,1560657600,1581224400,3
PM_ME_PHYS_PROBLEMS,0,3,0,17,1571544000,1591329600,3
Cthulhuonpcin144p,0,3,0,9,1559793600,1559793600,3
RockManDan,0,3,0,2,1606626000,1606626000,3
pecheckler,0,3,0,14,1593057600,1604984400,3
ArchmageIlmryn,0,3,0,12,1572753600,1572753600,3
Whateva67,0,3,0,22,1568347200,1568692800,3
morskieokooko,1,2,62,16,1566273600,1567915200,3
geomaster,0,3,0,-9,1603512000,1603598400,3
The-Snake-Room,0,3,0,8,1580014800,1584417600,3
mainstreetballer,0,3,0,3,1605934800,1605934800,3
Shaddaaaaaapp,0,3,0,80,1600747200,1600747200,3
elizabeth-hyse,1,2,704,85,1605762000,1605762000,3
Herman999999999,0,3,0,14,1603425600,1609218000,3
enjoythelive1,0,3,0,11,1609390800,1609390800,3
Either-Dream-3933,0,3,0,3,1600660800,1604203200,3
Revan0315,0,3,0,51,1598328000,1599537600,3
gregy521,0,3,0,43,1609045200,1609045200,3
DomSubThreesome,0,3,0,6,1589860800,1589860800,3
steampunkgibbon,0,3,0,-13,1598846400,1605502800,3
BossJohns,0,3,0,1,1593576000,1593662400,3
krabmonster,0,3,0,22,1556164800,1557460800,3
Arkhipovawa,0,3,0,38,1578286800,1578286800,3
frenchiebuilder,0,3,0,8,1569124800,1569211200,3
KikiSparklexx,0,3,0,29,1557115200,1603425600,3
Robby_the_Mook,1,2,17,9,1576558800,1593835200,3
Rorynne,0,3,0,14,1594180800,1603339200,3
Tiempos_Modernos,0,3,0,-9,1594094400,1608613200,3
Viki1999,0,3,0,61,1573102800,1583384400,3
TheLadderStabber,0,3,0,2,1554264000,1554264000,3
Diedwithacleanblade,0,3,0,4,1602820800,1608181200,3
AttackPug,0,3,0,33,1584590400,1585454400,3
novel1389,0,3,0,9,1566878400,1566878400,3
bussdownshawty,0,3,0,4,1597291200,1597377600,3
ildiv86,0,3,0,-1,1575608400,1575694800,3
leftstick,0,3,0,23,1607403600,1607403600,3
ilikecakemor,0,3,0,62,1598846400,1606021200,3
_atyourcervix,0,3,0,11,1580878800,1587355200,3
slyweazal,0,3,0,4,1605675600,1606366800,3
orgokthebashful,0,3,0,65,1607490000,1607490000,3
Lukeen41,0,3,0,-11,1594699200,1594699200,3
xchris_topher,0,3,0,11,1534478400,1572062400,3
FlimsyAmphibian,0,3,0,20,1564977600,1564977600,3
Tyropillar,0,3,0,7,1598932800,1598932800,3
Throwaway43248324328,0,3,0,7,1601179200,1601611200,3
mutualaidowl,0,3,0,16,1596427200,1596513600,3
Imkayak,0,3,0,21,1546578000,1589601600,3
gwillicoder,0,3,0,5,1608699600,1608699600,3
Lampanket,0,3,0,37,1598932800,1604203200,3
NINJAsDepression,0,3,0,4,1567483200,1567483200,3
bizzaro321,0,3,0,27,1575867600,1575954000,3
MrShrike,0,3,0,81,1598155200,1608181200,3
AtonalApe,0,3,0,26,1561176000,1606798800,3
OneHairyThrowaway,0,3,0,18,1578718800,1578718800,3
awnawkareninah,0,3,0,6,1611896400,1612155600,3
AdviceDanimals,0,3,0,16,1539921600,1539921600,3
Del_Castigator,0,3,0,10,1586836800,1586836800,3
Greenblanket24,0,3,0,11,1607490000,1609304400,3
AmericanIntelligence,0,3,0,3,1559016000,1559793600,3
Triquetra4715,0,3,0,2,1598932800,1600315200,3
tralfamadoran777,0,3,0,5,1608872400,1609218000,3
Petethecrane,0,3,0,26,1582088400,1606971600,3
jackson17767969,0,3,0,25,1562644800,1562644800,3
aloe-ha,1,2,482,16,1589515200,1600488000,3
MelonPrinceSui,0,3,0,29,1591156800,1591588800,3
muffinsandtomatoes,0,3,0,-16,1568001600,1568001600,3
CameFromFar,0,3,0,11,1611982800,1611982800,3
Spndash64,0,3,0,8,1570507200,1570507200,3
CommieSkullCrusher,0,3,0,-4,1571803200,1571803200,3
coltsfootballlb,0,3,0,13,1612069200,1612069200,3
DBH114,0,3,0,5,1585454400,1585454400,3
221gp,1,2,8,215,1573707600,1576213200,3
BackwardsHouse78,0,3,0,3,1612069200,1616212800,3
theprincessx,0,3,0,20,1606798800,1609477200,3
Sportsguy_44_45_,0,3,0,-2,1605243600,1606539600,3
dreamsynth,0,3,0,7,1600920000,1601006400,3
egg_princess,0,3,0,46,1596081600,1596081600,3
tomato_tickler,0,3,0,16,1556683200,1561435200,3
Frakshaw,0,3,0,62,1573102800,1604725200,3
mzk-mzk,0,3,0,-10,1585540800,1598846400,3
MarsReject,0,3,0,185,1559188800,1565755200,3
0saladin0,0,3,0,8,1599883200,1599883200,3
GreenTeaHG,0,3,0,9,1598932800,1599019200,3
Mista9000,0,3,0,7,1602129600,1607403600,3
mrdude86,0,3,0,9,1591329600,1596340800,3
Lord_Freak,0,3,0,71,1566446400,1566532800,3
9966123,1,2,105,-19,1596513600,1597204800,3
she_ded_again,0,3,0,38,1606539600,1607230800,3
mrsacapunta,0,3,0,13,1573362000,1587355200,3
yayapfool,0,3,0,228,1582606800,1582693200,3
GoodForYouLol,0,3,0,7,1604552400,1604552400,3
newbruhvv,0,3,0,11,1603512000,1603598400,3
HourlyAlbert,0,3,0,7,1566705600,1566705600,3
LushEnough,0,3,0,38,1573448400,1584504000,3
wawatertermemelonlon,0,3,0,13,1601352000,1606453200,3
Youredoingitwrongbro,0,3,0,32,1608786000,1611810000,3
moooooopg,0,3,0,405,1592884800,1592971200,3
Legionof1,0,3,0,10,1585454400,1585454400,3
Zaxa7,0,3,0,9,1603339200,1603944000,3
Alarmed-Peace-9662,0,3,0,6,1611810000,1612155600,3
Nationalist_Patriot,0,3,0,-12,1577336400,1577336400,3
LEERROOOOYYYYY,0,3,0,-8,1596686400,1596772800,3
SupremeGentleman92,0,3,0,27,1558584000,1559102400,3
acc_anarcho,2,1,18,2,1586664000,1586836800,3
raspberries-n-spitup,0,3,0,22,1576731600,1576731600,3
erth-werm,0,3,0,78,1609131600,1609218000,3
V1taNu0va,0,3,0,4,1606626000,1606626000,3
uhhokaysure,0,3,0,19,1543294800,1548046800,3
bedpost9000,0,3,0,-1,1607490000,1608094800,3
Unnecessary-Shouting,0,3,0,19,1585281600,1602993600,3
UncomfortableDunker,0,3,0,71,1597896000,1606107600,3
SleepyAsianOnAPlane,0,3,0,8,1601956800,1601956800,3
kasunder,0,3,0,10,1601265600,1601352000,3
Lillixjay,0,3,0,21,1582952400,1584244800,3
NarekNaro,0,3,0,-4,1591416000,1591416000,3
DukeOfGeek,0,3,0,28,1407211200,1584849600,3
Adon1kam,0,3,0,17,1579669200,1579669200,3
Dicky_McGeezaks,1,2,10,69,1593230400,1593316800,3
fleetwoodsmaack,1,2,4779,74,1597896000,1597896000,3
Octane_Au,0,3,0,46,1570420800,1572235200,3
GrkLifter,1,2,28,11,1571025600,1572930000,3
Raymond_K_Hessel2000,1,2,10,3,1594699200,1604466000,3
peregrine_nation,1,2,42,7,1567483200,1568088000,3
girlwhosaysfrick,2,1,463,2,1590638400,1605848400,3
Zenifold,0,3,0,5,1586145600,1586145600,3
eddiehizzle,0,3,0,5,1578891600,1606798800,3
Codered0289,0,3,0,21,1594785600,1611982800,3
The_Lifeless_Void,0,3,0,8,1612069200,1612155600,3
SonOfSparda1984,0,3,0,28,1609045200,1609045200,3
nadsulpia,0,3,0,15,1560916800,1594872000,3
ldeveraux,0,3,0,12,1607662800,1609131600,3
Kyrond,0,3,0,12,1612069200,1612069200,3
felixtha_cat,0,3,0,20,1568260800,1605157200,3
PeterTMC,1,2,15,18,1605502800,1608267600,3
arrowff,0,3,0,64,1598846400,1600056000,3
mostlygray,0,3,0,83,1574312400,1578891600,3
tk-bug,0,3,0,50,1584849600,1597982400,3
saidthefamiliar,0,3,0,20,1575867600,1577336400,3
lazyfucker67,0,3,0,3,1599019200,1609218000,3
knghydn,0,3,0,25,1602907200,1604898000,3
Seminaryruinslives,1,2,11,2,1554868800,1555646400,3
Thhppt,0,3,0,83,1600315200,1609304400,3
ElCuve,0,3,0,10,1599883200,1603512000,3
4114119321121225,0,3,0,80,1561521600,1573966800,3
koffeccinna,0,3,0,32,1602734400,1606366800,3
ScourgeMonki,0,3,0,13,1582693200,1583812800,3
Lady_Bread,0,3,0,42,1587441600,1598155200,3
firegecko5,0,3,0,47,1534219200,1536984000,3
here4thepuns,0,3,0,-25,1608440400,1609304400,3
Cee102,0,3,0,16,1568347200,1586404800,3
totebag2020,0,3,0,6,1581483600,1581483600,3
damnspider,0,3,0,29,1567828800,1589428800,3
DongDudeman,1,2,2,6,1606712400,1607662800,3
Apart-Profession4968,0,3,0,0,1609304400,1609390800,3
cumguzzlingstarfish,0,3,0,9,1608267600,1608267600,3
JustJoinAUnion,0,3,0,29,1595822400,1603771200,3
Blackboy117,0,3,0,-22,1586491200,1586491200,3
dasbodmeister,0,3,0,69,1578978000,1604466000,3
tremblingtadzio19,0,3,0,21,1568692800,1576126800,3
huewutm8,1,2,4672,81,1597032000,1597032000,3
alyoshathebear,1,2,274,18,1578459600,1589169600,3
entertainman,0,3,0,3,1585454400,1585454400,3
hollowedparrots,0,3,0,5,1582520400,1582520400,3
Shyartsy,0,3,0,24,1548565200,1548565200,3
Bamboo7ster,0,3,0,98,1587096000,1587096000,3
nickyobro,0,3,0,92,1584590400,1594612800,3
xXgreeneyesXx,0,3,0,5,1599537600,1608094800,3
biblesilvercorner,0,3,0,21,1570075200,1570075200,3
MadeYouLookFegit,0,3,0,23,1606798800,1606798800,3
PoshSpiceLC,0,3,0,10,1599796800,1600747200,3
Coryphaeus,1,2,14,11,1602043200,1608440400,3
Lets_Do_This_,0,3,0,-16,1589860800,1608094800,3
FungiVessle,0,3,0,7,1587268800,1600660800,3
dklaus1204,0,3,0,672,1589860800,1590552000,3
gotra5,0,3,0,9,1602129600,1602129600,3
BlPlN,0,3,0,12,1555819200,1568779200,3
wupdup,0,3,0,3,1603684800,1603684800,3
yexpensivepenver,0,3,0,2,1589515200,1589515200,3
Bibliophile_Writer,0,3,0,39,1596513600,1597118400,3
Aruthian,1,2,20,10,1597291200,1607403600,3
rbf_queen,0,3,0,51,1591675200,1598068800,3
boybray,0,3,0,28,1571284800,1585195200,3
harrisks,2,1,396,10,1598414400,1598587200,3
ivoryangel143,0,3,0,9,1611810000,1612155600,3
VillaIncognit0,0,3,0,27,1612069200,1612069200,3
Megapumpkin,0,3,0,12,1597118400,1598328000,3
livesinacabin,0,3,0,31,1605675600,1611982800,3
8spd20,0,3,0,62,1599019200,1605934800,3
elote42069,0,3,0,34,1591416000,1592193600,3
birdseyeview327,1,2,105,15,1583557200,1607835600,3
Fck7392,0,3,0,38,1604552400,1604552400,3
BushBakedBeanDeadDog,0,3,0,10,1552708800,1562990400,3
herdygerdyboobaloony,2,1,839,4,1602561600,1609045200,3
Ghost_Hound,0,3,0,13,1562990400,1606107600,3
drgnfly369,0,3,0,60,1597291200,1606626000,3
Mike_hawk5959,0,3,0,185,1596254400,1606021200,3
Psilocub,0,3,0,22,1584763200,1584763200,3
TheIncredibleHenry,0,3,0,33,1594180800,1604984400,3
Chilly-Bin,0,3,0,78,1578027600,1579150800,3
emmapirnay,1,2,13,5,1611896400,1611896400,3
PlurgeMcSplurge,0,3,0,10,1607922000,1611896400,3
musingsofmadman,0,3,0,37,1590033600,1596859200,3
happy8888999,0,3,0,6,1604030400,1606798800,3
Ambitious_Relief_151,0,3,0,-42,1601524800,1601524800,3
gardnerfreddie2,0,3,0,6,1573534800,1606885200,3
vegtoria,0,3,0,158,1603425600,1603512000,3
throwaway777982359,0,3,0,247,1565409600,1565668800,3
NaCLedPeanuts,0,3,0,6,1590379200,1590465600,3
simbimba,1,2,154,3,1594008000,1596081600,3
Virusbadmkay,0,3,0,-22,1585454400,1585454400,3
ja7ba,0,3,0,6,1605762000,1606539600,3
MidnightRider3000,0,3,0,4,1609045200,1609131600,3
sighhchedelic,0,3,0,30,1557720000,1557720000,3
Viridian_Crane,0,3,0,8,1595908800,1599278400,3
astroemi,0,3,0,41,1597809600,1609304400,3
Handyfoot_Legfingers,1,2,35,19,1596859200,1608094800,3
NevesyTriht1,1,2,89,10,1594526400,1605330000,3
ThusSpokeZarate,0,3,0,24,1551070800,1601870400,3
prefer-to-stay-anon,0,3,0,9,1603512000,1603598400,3
bluehood380,0,3,0,43,1556424000,1558324800,3
Cluckster_Fork,0,3,0,15,1603512000,1603857600,3
LegendMeadow,0,3,0,3,1579496400,1579582800,3
dontanswerit,1,2,11,5,1585713600,1593662400,3
Batedcow,1,2,44,2,1575694800,1585627200,3
mulcahey,1,2,50,1,1566878400,1595304000,3
Thiamaria,1,2,6,25,1602475200,1605502800,3
kunstricka,0,3,0,16,1599105600,1601524800,3
TheOnlyFox1235,0,3,0,4,1608354000,1608354000,3
SpaceOtterMafia,0,3,0,11,1608181200,1608181200,3
azathoth1919,0,3,0,19,1562040000,1562904000,3
Todayisthedaytoo,1,2,7,22,1562040000,1562558400,3
Glitchboy,0,3,0,6,1609131600,1609390800,3
oldspaceshipzion,0,3,0,6,1579755600,1579755600,3
fattermcgee,0,3,0,7,1585540800,1585540800,3
firstrevolutionary,0,3,0,11,1603598400,1603771200,3
Watershed787,0,3,0,17,1598328000,1598414400,3
WeylandYutani42,0,3,0,7,1595304000,1597723200,3
drunklematt,0,3,0,38,1589515200,1592280000,3
MrUnknownorNobody,1,2,7,2,1587441600,1588132800,3
SocialIntelligence,0,3,0,7,1590033600,1603512000,3
_justempty,0,3,0,20,1608094800,1608094800,3
blackadress,0,3,0,57,1584936000,1598587200,3
Ferninja,1,2,59,25,1573621200,1576213200,3
1-800-GANKS,0,3,0,-13,1598328000,1606366800,3
Conejto,0,3,0,23,1573362000,1579582800,3
InterestingPseudonym,0,3,0,12,1586145600,1586145600,3
VolantPastaLeviathan,0,3,0,10,1594353600,1594353600,3
RickyWinterborn2019,0,3,0,106,1609218000,1609218000,3
saltyboi18,0,3,0,7,1602129600,1602129600,3
doLSDdoDMT,0,3,0,-12,1594785600,1595304000,3
potatomari,1,2,9,3,1600056000,1600228800,3
blkplrbr,0,3,0,30,1577336400,1608613200,3
AugustaPrime,0,3,0,-16,1595390400,1595476800,3
HimikoHime,0,3,0,20,1605157200,1605157200,3
dowhathappens89,0,3,0,23,1574312400,1592798400,3
TeddyArgentum,0,3,0,12,1571803200,1571803200,3
Babylonbricky99,0,3,0,38,1598328000,1604379600,3
Turkin4tor,0,3,0,9,1588564800,1588737600,3
happycowgirl1920,1,2,80,2,1593576000,1593576000,3
courtneygoe,0,3,0,29,1585886400,1607403600,3
Hypnotoadmode,0,3,0,-43,1565755200,1565755200,3
VirgoByScorpio,2,1,195,6,1601092800,1602907200,3
Elegnan,0,3,0,7,1598241600,1608440400,3
ixora7,0,3,0,78,1585022400,1585022400,3
syubkook,1,2,16,5,1585800000,1607576400,3
DanBrandszy,0,3,0,26,1608354000,1611982800,3
kcidyccus,0,3,0,40,1572843600,1579928400,3
ApatheticDust,0,3,0,24,1608354000,1608354000,3
shotputlover,0,3,0,16,1572930000,1593835200,3
scotthallstandup,1,2,569,30,1583125200,1583125200,3
Realistic_Pass,0,3,0,12,1596600000,1600228800,3
randy24681012,0,3,0,20,1605848400,1611723600,3
Alysazombie,0,3,0,45,1604898000,1606885200,3
humorheals,0,3,0,74,1577163600,1582866000,3
CHXNBS,0,3,0,45,1582779600,1582779600,3
Dithyrab,0,3,0,20,1597464000,1597464000,3
Nocturne7280,0,3,0,72,1599883200,1607230800,3
nookie-monster,0,3,0,56,1558584000,1558670400,3
bakedbombshell,0,3,0,84,1606280400,1606453200,3
pinaconada,0,3,0,4,1608440400,1614574800,3
raeraerae171,0,3,0,28,1589256000,1595217600,3
Requiemf0radreamer,0,3,0,122,1589083200,1590724800,3
hindsyte,0,3,0,22,1584244800,1584244800,3
Athronas,0,3,0,13,1595217600,1605416400,3
Retrosmith,1,2,65,3,1581570000,1581570000,3
BocoCorwin,0,3,0,11,1580533200,1584244800,3
dxdydz_dV,0,3,0,45,1578459600,1599883200,3
MusiqueConcrete,0,3,0,30,1556856000,1559275200,3
MujerMaravilla93,0,3,0,10,1605848400,1608526800,3
OwnAdministration8,1,2,7,2,1596081600,1597204800,3
anonranting21,0,3,0,46,1592798400,1597809600,3
WilliamMcAdoo,1,2,12,2,1597636800,1597636800,3
PainalPleasures,0,3,0,-29,1602820800,1602820800,3
Krazykrzysz,2,1,95,40,1548910800,1553745600,3
SEILogistics,0,3,0,15,1592193600,1592884800,3
Misterganja420,1,2,6819,12,1605762000,1605848400,3
slurmpnurmp,0,3,0,89,1593921600,1608267600,3
SentientBowtie,0,3,0,135,1585886400,1597291200,3
SharkAttack29,0,3,0,3,1583557200,1597636800,3
padmasterjay,1,2,176,11,1605157200,1606798800,3
AliceHearthrow,0,3,0,17,1574571600,1589601600,3
TomCADK,0,3,0,114,1549515600,1556510400,3
FreyaWho8,0,3,0,51,1551416400,1552194000,3
PoisonErin,0,3,0,109,1586577600,1603425600,3
lightttpollution,0,3,0,21,1551934800,1552107600,3
throwaway178905,0,3,0,8,1585713600,1585800000,3
lucky_black_cats,0,3,0,9,1603425600,1608008400,3
Minimalism12,0,3,0,9,1592712000,1592712000,3
Materia_Thief,0,3,0,3,1577336400,1605589200,3
LarryMcBasketball,0,3,0,93,1591934400,1592539200,3
DannyPinn,0,3,0,115,1600228800,1608872400,3
immaheadawt,1,2,9019,874,1601179200,1601179200,3
Lolllamaworm,0,3,0,4,1589428800,1602648000,3
RaggedyGentleman,0,3,0,5,1588219200,1591070400,3
randominternetnormie,0,3,0,4,1580706000,1586836800,3
nefariosinsomniac,0,3,0,17,1606280400,1606453200,3
AndersFIST,0,3,0,8,1612069200,1612069200,3
porfiro,0,3,0,24,1574658000,1583384400,3
feelmedoyou,0,3,0,16,1568260800,1608526800,3
EndTimesRadio,0,3,0,11,1590811200,1599278400,3
TwistedTarzan,0,3,0,107,1598760000,1612155600,3
mechavolt,0,3,0,73,1592625600,1602820800,3
dacv393,1,2,17,73,1558670400,1603512000,3
quidpropron,1,2,32,2,1595649600,1595649600,3
TrevJohn502,0,3,0,10,1602043200,1603771200,3
Tanryu,0,3,0,48,1602820800,1603857600,3
some_guy_over_here,0,3,0,-10,1580533200,1580533200,3
ThisGoldAintFree,0,3,0,9,1588996800,1593057600,3
Sighion,0,3,0,-1,1599710400,1599710400,3
Shogun-Saul,1,2,12,7,1569470400,1569988800,3
Christophesus,0,3,0,10,1537848000,1537934400,3
yaeltheunicorn,1,2,20,15,1579755600,1582174800,3
PM_ME_SPICY_DECKS,0,3,0,6,1568692800,1611896400,3
Altoyedro89,0,3,0,13,1605243600,1605330000,3
camouflage_chemist,0,3,0,-40,1609390800,1609477200,3
TheRedmanCometh,0,3,0,3,1566360000,1566360000,3
dillpicklebelay,0,3,0,75,1582434000,1585627200,3
ChakkyP,0,3,0,14,1554436800,1554523200,3
banishedpaladin,2,1,142,6,1562299200,1562731200,3
curiousScientist1989,2,1,163,8,1568088000,1580360400,3
Netherspin,0,3,0,2,1573102800,1601179200,3
Semarc01,0,3,0,22,1553486400,1568088000,3
streetprize,0,3,0,13,1597032000,1597032000,3
ttblue,1,2,6,4,1539835200,1539921600,3
draconius_iris,0,3,0,20,1603252800,1603252800,3
PauloTheNattyCosta,0,3,0,-1,1598760000,1608699600,3
fastfoodforfuture,0,3,0,92,1593921600,1595131200,3
FlyingTaquitoBrother,0,3,0,3,1578632400,1578632400,3
LordTwillyDillydum,0,3,0,39,1602302400,1607230800,3
newgrounder,0,3,0,66,1571112000,1578459600,3
wenchslapper,0,3,0,7,1585627200,1585713600,3
amfool,1,2,57,5,1575954000,1576558800,3
TrueBlue98,0,3,0,5,1563336000,1563336000,3
ValuableJackfruit,1,2,0,-1,1547182800,1547182800,3
Gaydara,0,3,0,12,1555300800,1557028800,3
deathbybudgie,0,3,0,46,1607662800,1608440400,3
Marsmar-LordofMars,0,3,0,5,1575694800,1577595600,3
Sirsilentbob423,0,3,0,36,1568347200,1575349200,3
Snackys,0,3,0,1,1556683200,1607922000,3
TheKingOfMidgard,0,3,0,40,1583557200,1583643600,3
AbyssalPractitioner,0,3,0,62,1595390400,1595822400,3
AspiringSquadronaire,0,3,0,35,1605934800,1606626000,3
mr-uncertain,0,3,0,30,1605934800,1606366800,3
Lambdaformes,0,3,0,39,1605416400,1605416400,3
bkalldaybaybay,0,3,0,9,1593057600,1593144000,3
lotusQ,0,3,0,45,1575608400,1593403200,3
Deathcrush90,0,3,0,27,1598328000,1598328000,3
not_funny_just_mean,0,3,0,20,1567051200,1601524800,3
IMessedUp4,1,2,53,5,1608613200,1608613200,3
awhaling,0,3,0,9,1593835200,1602475200,3
itsagoodloop,0,3,0,15,1608526800,1609477200,3
Time_on_my_hands,0,3,0,28,1592539200,1606021200,3
HeyLookitMe,0,3,0,39,1566792000,1588824000,3
FriendlyLocalComrade,0,3,0,85,1611810000,1612242000,3
Scorpioprincess83,0,3,0,7,1568347200,1571198400,3
DerMetzgermeister99,1,2,11,2,1598932800,1599019200,3
shlamslam,2,1,1081,29,1585713600,1586232000,3
jewbacca207,2,1,93,9,1604898000,1607922000,3
WhiteRabbit-_-,0,3,0,9,1600574400,1600660800,3
Adv3ntur31SOutThere,0,3,0,5,1608008400,1608008400,3
BaselxD,0,3,0,29,1571457600,1589688000,3
Elroon502,1,2,25,9,1570420800,1583899200,3
Expensive_Moose,0,3,0,14,1586232000,1588651200,3
knorfit,1,2,496,36,1583298000,1596081600,3
discreet_baker,1,2,9,6,1603166400,1606366800,3
VoightKent,0,3,0,3,1597377600,1597982400,3
Derpifacation,0,3,0,38,1594267200,1594267200,3
JbearNV,0,3,0,15,1593748800,1593748800,3
pukegreenwithenvy,0,3,0,89,1555732800,1579410000,3
piecheatsteal,0,3,0,17,1560571200,1560657600,3
randommuses,0,3,0,2,1612069200,1612155600,3
ConventionalizedRuhr,1,2,43,3,1572321600,1572580800,3
Azcatl_iix,0,3,0,204,1607749200,1608786000,3
MrShaytoon,0,3,0,19,1594440000,1605589200,3
JamesBon21,0,3,0,-34,1564027200,1564027200,3
HorizontalTwo08,0,3,0,-4,1608699600,1608699600,3
CokeMyName,0,3,0,2,1606539600,1606626000,3
Fozes,0,3,0,25,1558584000,1601265600,3
Verdun82,0,3,0,10,1560830400,1604638800,3
JWSanchez,0,3,0,3,1590120000,1606626000,3
Rayuk01,0,3,0,13,1578027600,1580446800,3
JiGGeNNs,0,3,0,-10,1574571600,1574571600,3
ontanned,0,3,0,13,1595390400,1599883200,3
Phantomblujay,0,3,0,-3,1569729600,1569729600,3
iimhx2,1,2,24,7,1598241600,1598414400,3
x_pineapple_pizza_x,1,2,7,11,1608008400,1609045200,3
Crassard,0,3,0,32,1608440400,1608958800,3
herrwaldos,0,3,0,9,1605589200,1606107600,3
TVibes87,0,3,0,39,1598760000,1598760000,3
Yrvaa,0,3,0,12,1578373200,1584072000,3
Corp-Por,1,2,22,40,1578891600,1580101200,3
future_horizons,0,3,0,11,1595044800,1601956800,3
Mathemathematic,0,3,0,121,1587614400,1587700800,3
Bookislovakia,0,3,0,16,1597291200,1604898000,3
momofeveryone5,0,3,0,28,1589515200,1601352000,3
citysidhe,0,3,0,15,1570075200,1588824000,3
paradoxical_topology,0,3,0,19,1607662800,1611896400,3
ig-fantasticide,0,3,0,9,1580878800,1586318400,3
sirfray,1,2,364,3,1578373200,1578459600,3
Najanator717,0,3,0,15,1593835200,1593921600,3
Redditusername_123,2,1,87,1,1605589200,1607576400,3
JJMMio,0,3,0,4,1580533200,1580533200,3
Jerseyprophet,0,3,0,449,1606194000,1608526800,3
BulldenChoppahYus,0,3,0,4,1610859600,1610859600,3
Fzohseven,0,3,0,4,1598760000,1598760000,3
Emayess_PS4,1,2,313,13,1563508800,1581224400,3
afguspacequeen,0,3,0,10,1599364800,1609045200,3
zuul99,0,3,0,3,1573362000,1573448400,3
shy_replacement,0,3,0,34,1604203200,1604203200,3
p1x3lpush3r,1,2,39,3,1582174800,1582261200,3
IgNaNoMoUs,0,3,0,6,1443326400,1465444800,3
samfo56,0,3,0,64,1604725200,1609477200,3
Mr-Logic101,0,3,0,-3,1591243200,1609045200,3
Signature-Skitz,0,3,0,7,1582606800,1591675200,3
Scootakip,0,3,0,23,1567137600,1577422800,3
xboxeater,0,3,0,25,1595908800,1609477200,3
rbseit02,0,3,0,28,1602648000,1602734400,3
Ziggy319,0,3,0,11,1607230800,1607403600,3
ZombiesAmongUs,0,3,0,3,1604030400,1607230800,3
Phantaxein,0,3,0,49,1576386000,1606885200,3
MerpidtyMerp,1,2,437,22,1579410000,1579496400,3
GirthyEconomist,0,3,0,32,1580446800,1582693200,3
venusianpisces,1,2,66,9,1586404800,1586404800,3
demarmelade,0,3,0,130,1598587200,1600315200,3
C64__,0,3,0,19,1602302400,1603252800,3
Heraclituss,0,3,0,3,1597809600,1597809600,3
cosmiccat5758,1,2,5,2,1612069200,1612328400,3
amquelbettamin,0,3,0,4,1574053200,1574139600,3
Sassymewmew,0,3,0,3,1585454400,1585540800,3
chuckymack,0,3,0,46,1597550400,1603684800,3
GnarlyGn0rc,1,2,41,4,1570334400,1570593600,3
DarkwingDuckHunt,0,3,0,37,1605502800,1605589200,3
neverforgetdream,0,3,0,6,1545022800,1550898000,3
anspee,0,3,0,39,1589601600,1611982800,3
ALLCATZAREBEAUTIFUL,0,3,0,87,1601524800,1605589200,3
pm_me_4,0,3,0,5,1602734400,1602820800,3
lupaburner2k19,2,1,149,1,1578286800,1578373200,3
cptrambo,0,3,0,25,1608008400,1609390800,3
flippitydip,0,3,0,50,1534219200,1559188800,3
PutterwedgeYronwood,0,3,0,4,1608440400,1608440400,3
wegrownfolk,0,3,0,12,1589083200,1596254400,3
Korganos-moon,0,3,0,221,1606626000,1609218000,3
SuperDuperOtter,0,3,0,98,1575522000,1591416000,3
CorporateNoMore,1,2,39,10,1555560000,1555819200,3
High_Barron,0,3,0,38,1588046400,1588046400,3
DenebVegaAltair,0,3,0,15,1592884800,1605502800,3
broccolisprout,0,3,0,8,1601179200,1601265600,3
scarface2910,0,3,0,36,1602043200,1604030400,3
jkoolp86,0,3,0,-17,1597377600,1597377600,3
ChaosXKnight,0,3,0,1,1600142400,1602907200,3
comfortablynumb15,0,3,0,24,1571889600,1598673600,3
watwatwatwatwhat,0,3,0,5,1574398800,1578459600,3
black_pepper,0,3,0,5,1445486400,1540180800,3
Commander_Kind,0,3,0,17,1612069200,1612069200,3
A-Air-breather,0,3,0,9,1598932800,1604725200,3
respect_the_potato,0,3,0,36,1575090000,1580446800,3
zonnebloemetje,0,3,0,65,1554264000,1583211600,3
Jakesteroz,0,3,0,6,1599105600,1605675600,3
foxylady45567,1,2,28,25,1555473600,1599624000,3
mrtnightmare,0,3,0,3,1593316800,1593316800,3
jaywocker,1,2,24,7,1599451200,1599451200,3
edgewater15,0,3,0,28,1574830800,1579237200,3
gremlinguy,0,3,0,15,1536292800,1570420800,3
BulgarianNationalist,0,3,0,-24,1601265600,1601265600,3
MrCookies1234,2,1,121,13,1558497600,1568865600,3
devjohnson13,0,3,0,9,1602043200,1602043200,3
NoCoffeeNoThink,0,3,0,33,1599969600,1605243600,3
RabuDam,1,2,20,3,1557288000,1557374400,3
twinklestein,0,3,0,20,1562299200,1603684800,3
thedoctormo,0,3,0,15,1592798400,1592798400,3
PM_ME_BUTTHOLE_PIX,0,3,0,3,1611982800,1611982800,3
MasterPoetry1,0,3,0,3,1583557200,1583643600,3
PermanentRoundFile,0,3,0,62,1603598400,1608613200,3
5prcnt,1,2,2,-5,1569211200,1585368000,3
hfamiliaris,0,3,0,30,1572062400,1572753600,3
ItsADumbName,0,3,0,8,1605070800,1605070800,3
thewindinthewillows,0,3,0,28,1570334400,1570334400,3
ddh85,0,3,0,39,1571889600,1571889600,3
kissmyAsiel,0,3,0,102,1566187200,1566273600,3
Ohdibahby,0,3,0,35,1590638400,1597291200,3
UnderbiteKobe,0,3,0,27,1589515200,1589774400,3
MrRavenist,0,3,0,19,1605934800,1609390800,3
4Hugh2Mongus0,0,3,0,15,1593748800,1593835200,3
BlessThisBussy,0,3,0,3,1550293200,1550293200,3
Newblik,0,3,0,3,1558324800,1558324800,3
akholy,0,3,0,7,1578286800,1588564800,3
MisterTwo_O,0,3,0,-13,1595131200,1595217600,3
llcoolj92301,2,1,10,2,1611723600,1611982800,3
Benevoson,0,3,0,13,1601524800,1606626000,3
pepprish,1,2,69,6,1595908800,1595995200,3
LivewareIssue,0,3,0,36,1587009600,1588737600,3
DrDezmund,0,3,0,4,1582347600,1582347600,3
daou0782,0,3,0,18,1602475200,1607317200,3
killiskill,0,3,0,3,1576645200,1576645200,3
wezznco,0,3,0,0,1585540800,1585540800,3
SolDeusLuna,0,3,0,-23,1591416000,1594699200,3
GreyRatus,0,3,0,8,1600747200,1600747200,3
provinhdence,0,3,0,4,1585540800,1585540800,3
ziper1221,0,3,0,31,1539144000,1553140800,3
basmith0,0,3,0,11,1581656400,1598587200,3
Laureline1234,1,2,21,9,1602475200,1602475200,3
xnxkq,0,3,0,6,1602043200,1607576400,3
Lz_erk,0,3,0,22,1593662400,1597118400,3
profanesublimity,0,3,0,6,1585713600,1598673600,3
trinoniv,1,2,961,117,1598500800,1598500800,3
reality_is_weird,1,2,1,2,1600660800,1600660800,3
devin972010,1,2,107,4,1573621200,1611982800,3
FadedPariah,0,3,0,4,1606453200,1606539600,3
Klaumongtautalm,0,3,0,17,1597723200,1605243600,3
PepeTheConsultant,0,3,0,11,1593230400,1593230400,3
ETGQ,0,3,0,6,1576386000,1581570000,3
rattpack18,0,3,0,1,1609131600,1609131600,3
devisbeavis,0,3,0,18,1606366800,1607490000,3
clownbr33der,0,3,0,17,1568001600,1568433600,3
dying_skies,0,3,0,-10,1573707600,1574053200,3
Ok_Seaworthiness7408,0,3,0,58,1608699600,1608699600,3
UncleSlacky,0,3,0,41,1593316800,1604030400,3
Teardropivy25,0,3,0,14,1594699200,1594699200,3
maggieG42,0,3,0,5,1585972800,1586059200,3
Justpassinby1984,0,3,0,13,1606798800,1606798800,3
whyamihere189,1,2,1132,53,1608267600,1611723600,3
PMurNOODZ2me,0,3,0,3,1595649600,1595649600,3
tauriel81,0,3,0,2,1593316800,1598414400,3
Unlock17A,0,3,0,1,1572062400,1576645200,3
BurritoBoy11,0,3,0,96,1600574400,1600660800,3
lonelydad_,1,2,29,31,1553054400,1563249600,3
fallensoap1,0,3,0,9,1584590400,1604293200,3
VeryAwkwardCake,0,3,0,4,1559880000,1559966400,3
NtsParadize,0,3,0,-3,1589860800,1602734400,3
spock589,0,3,0,67,1563249600,1568347200,3
einfachschwimmen,0,3,0,18,1598846400,1598846400,3
nbroken,0,3,0,3,1605675600,1605675600,3
spoobydoo,0,3,0,5,1599019200,1599019200,3
failadin155,0,3,0,19,1574485200,1576472400,3
pwilla,0,3,0,31,1546405200,1566100800,3
LoL_is_pepega_BIA,0,3,0,9,1606453200,1606453200,3
TheViciousCandiru,0,3,0,5,1603080000,1607230800,3
halfgingerish,0,3,0,30,1608613200,1608786000,3
albwalb,1,2,14,10,1591934400,1591934400,3
oftencoffee,0,3,0,28,1548738000,1565668800,3
Duskwalde,0,3,0,4,1603598400,1603598400,3
keebsec,0,3,0,26,1611810000,1612069200,3
flylikeabanana,0,3,0,56,1585800000,1594008000,3
sowydso,0,3,0,57,1570939200,1607144400,3
enthreeoh,0,3,0,3,1604379600,1604379600,3
Demenster,0,3,0,5,1580187600,1582779600,3
AerThreepwood,0,3,0,33,1559707200,1572148800,3
KingViktorious,0,3,0,14,1605848400,1608267600,3
Kumagawa-,0,3,0,7,1578459600,1578459600,3
Newone1255,0,3,0,-19,1603512000,1603512000,3
Rachell10,0,3,0,13,1600142400,1600142400,3
Afccard,0,3,0,13,1581742800,1581742800,3
AstroQueen88,0,3,0,68,1570420800,1592452800,3
SubmarineStrong,0,3,0,3,1554177600,1554609600,3
Cannabisendorphins,0,3,0,6,1602648000,1602648000,3
thelastspike,0,3,0,13,1594440000,1607490000,3
CommandoLamb,0,3,0,18,1597464000,1597464000,3
cellophant,0,3,0,15,1421038800,1598846400,3
Whitemaleprivilage,0,3,0,12,1567396800,1580187600,3
MattChew1917,0,3,0,11,1599537600,1603944000,3
tugspanno,0,3,0,1,1576386000,1576558800,3
wuttang13,1,2,10,36,1580706000,1585368000,3
grain_d,0,3,0,7,1569988800,1570593600,3
circlesun22,0,3,0,17,1564545600,1612069200,3
moss344,0,3,0,-52,1566446400,1569384000,3
dapper_enboy,0,3,0,17,1562472000,1576558800,3
tonyrocks922,0,3,0,6,1605762000,1605762000,3
Naturwissenschaftler,1,2,156,13,1605589200,1607835600,3
DannyVxDx,1,2,11,3,1605157200,1605243600,3
DurianExecutioner,0,3,0,109,1551157200,1607576400,3
Yacksfilma,0,3,0,21,1592625600,1592625600,3
CryptoCrackLord,0,3,0,2,1609390800,1609390800,3
kallisto868,0,3,0,5,1600315200,1600315200,3
YerSenpai,1,2,51,62,1582088400,1582088400,3
ghosteagle,1,2,231,21,1596340800,1598846400,3
PashaBiceps_Bot,0,3,0,29,1572062400,1572148800,3
abillionguitars,1,2,3,5,1598068800,1598155200,3
Demyxtime13,0,3,0,41,1602475200,1602561600,3
inhonia,0,3,0,28,1577422800,1590638400,3
Inferno_Zyrack,0,3,0,5,1579237200,1608440400,3
KeepingTrack,0,3,0,-39,1603080000,1612155600,3
misstakukenihelvette,0,3,0,23,1590033600,1602129600,3
triggermethis,1,2,0,1,1477368000,1477368000,3
QuantumField,0,3,0,-4,1602475200,1602475200,3
JackdeAlltrades,0,3,0,203,1598328000,1606539600,3
CookieCrumbl,0,3,0,-1,1606021200,1606021200,3
whiterice_432,0,3,0,81,1598068800,1600315200,3
OviliskTwo,0,3,0,350,1608786000,1608786000,3
NotAnArea51Alien,1,2,420,18,1580619600,1594353600,3
kanilanana,0,3,0,48,1578891600,1578978000,3
mtd0123,0,3,0,13,1589169600,1589774400,3
Edge-Lord0000,0,3,0,7,1586750400,1611810000,3
Speng69,0,3,0,12,1574139600,1605157200,3
kiiyarayne,1,2,18,5,1551848400,1551934800,3
Fishlickin,0,3,0,6,1595217600,1595217600,3
Ryoukugan,0,3,0,4,1600315200,1603425600,3
GaymasterNacelle,0,3,0,0,1538193600,1538366400,3
Samsamsamadam,0,3,0,35,1598068800,1599019200,3
sambarguy,0,3,0,27,1602302400,1603598400,3
instability2,1,2,61,4,1570766400,1570852800,3
Ellis_was_hell,0,3,0,4,1604379600,1608872400,3
GucciManesTeeth47,0,3,0,-21,1608267600,1608267600,3
maschetoquevos,0,3,0,8,1607835600,1611810000,3
guilerms,0,3,0,11,1604116800,1607403600,3
Mycocide,0,3,0,55,1572235200,1594094400,3
Fat_Dolphin,0,3,0,6,1580014800,1583470800,3
twinpines85,0,3,0,40,1546146000,1554523200,3
exoholland,1,2,16,99,1549083600,1607317200,3
shiddabrik,0,3,0,33,1572667200,1579323600,3
kuributt,0,3,0,6,1585886400,1598932800,3
Aesthetically,0,3,0,38,1569988800,1584072000,3
elementop,0,3,0,43,1589515200,1609218000,3
M0RALVigilance,0,3,0,25,1576731600,1585454400,3
700KMF,0,3,0,2,1604725200,1604725200,3
SemperBavaria,0,3,0,10,1612069200,1612069200,3
puffyfluffy12,1,2,1022,13,1600228800,1600228800,3
ldkdjeon,0,3,0,12,1575176400,1575176400,3
ALegendInHisOwnMind,0,3,0,43,1565668800,1571803200,3
wonderZoom,0,3,0,5,1592712000,1592712000,3
Martian_MuadDib,0,3,0,2,1603598400,1603857600,3
arnthorsnaer,0,3,0,3,1605589200,1605589200,3
Taurmin,0,3,0,11,1608699600,1608699600,3
loosh63,0,3,0,39,1577768400,1581829200,3
Myaseline,0,3,0,172,1593835200,1599451200,3
SiliconDon,0,3,0,15,1547010000,1547010000,3
LeWhitestKnight,2,1,30,2,1606712400,1608354000,3
NovelWindow0,0,3,0,1,1591848000,1591934400,3
sallymboo_,0,3,0,73,1599710400,1600747200,3
LifeWithLenny_W,3,0,299,0,1563940800,1567742400,3
MrGreggle,0,3,0,-29,1588824000,1590120000,3
paxtimus,0,3,0,42,1596600000,1596686400,3
newthrowaway111111,0,3,0,0,1585454400,1585540800,3
Flamezo,0,3,0,15,1595131200,1595649600,3
nursecomanche,0,3,0,76,1605416400,1605416400,3
ballsandbayonets,0,3,0,19,1611896400,1611982800,3
chrisdalott9000,0,3,0,16,1572062400,1597896000,3
Triple-Deke,0,3,0,2,1585540800,1585540800,3
Fitchywanklebottom,1,2,17,18,1589860800,1609304400,3
CringeName,0,3,0,82,1598414400,1608958800,3
Anthro_the_Hutt,1,2,12,10,1577163600,1585108800,3
consistentincomplete,0,3,0,15,1589947200,1589947200,3
Blasted_Awake,0,3,0,-6,1602734400,1607317200,3
gerbil_jammer,0,3,0,23,1579064400,1579150800,3
zClarkinator,1,2,62,21,1558152000,1558238400,3
fourlogs,0,3,0,5,1571716800,1576213200,3
noothersinvolved,0,3,0,3,1571544000,1571889600,3
Unknockable,0,3,0,-7,1551589200,1551934800,3
fuyukihana,0,3,0,16,1583125200,1584763200,3
tous_die_yuyan,1,2,2084,376,1600228800,1605934800,3
punchoutlanddragons,1,2,55,11,1593057600,1595304000,3
iwhonixx,0,3,0,3,1585540800,1585627200,3
pato-perdido,0,3,0,24,1594872000,1608872400,3
erickgramajo,0,3,0,-8,1586923200,1606021200,3
wiwoo,0,3,0,4,1471233600,1520658000,3
TheDutchin,0,3,0,28,1587960000,1587960000,3
WitchyDragon,0,3,0,70,1578027600,1582088400,3
DanGrieur,0,3,0,24,1553054400,1566360000,3
Fawxhox,1,2,111,11,1581397200,1581397200,3
XKeyscore666,0,3,0,8,1612155600,1612155600,3
S_J_Cleric,0,3,0,9,1595217600,1611637200,3
GingerRoot96,1,2,18,15,1581742800,1582779600,3
majorpsych1,0,3,0,133,1600228800,1611896400,3
CantCSharp,0,3,0,6,1564113600,1564113600,3
ha5htaq,0,3,0,42,1599624000,1602043200,3
Xevamir,1,2,83,56,1598673600,1608699600,3
gothiccboi,0,3,0,11,1606107600,1606107600,3
ratwacky29,3,0,15,0,1501214400,1501214400,3
gresh88,0,3,0,17,1537070400,1554523200,3
emanresuwoods,0,3,0,17,1600833600,1606885200,3
kpsi355,0,3,0,9,1573534800,1603598400,3
T1MM3RMAN,0,3,0,6,1612155600,1612155600,3
SooFloBro,0,3,0,0,1555905600,1557979200,3
burn_bean,0,3,0,5,1552881600,1552881600,3
0ZenoNexus0,0,3,0,20,1572321600,1575003600,3
Greenmushroom23,0,3,0,234,1589947200,1602129600,3
Call_Me_Ryan,0,3,0,-10,1609131600,1609131600,3
Dr_Crow_Dick,0,3,0,2,1548824400,1554004800,3
keepthemomentum,0,3,0,10,1605848400,1609131600,3
djdjdbdksmsnsxnfrdkd,0,3,0,-13,1547182800,1547182800,3
cherrybombdotcommie,0,3,0,8,1604293200,1607576400,3
bodmarley,0,3,0,1,1566619200,1566705600,3
embracebecoming,0,3,0,8,1581570000,1581570000,3
Pitou-sGuts,0,3,0,158,1570852800,1592798400,3
TurboAnus,0,3,0,38,1577336400,1577336400,3
Loud_Lion,1,2,20,12,1579323600,1579323600,3
metlotter,0,3,0,90,1609218000,1609304400,3
Uuuuuii,0,3,0,90,1591502400,1605502800,3
thekid1420,0,3,0,31,1571976000,1575262800,3
PM_ME_UR_GRUNDLE,0,3,0,4,1596600000,1597118400,3
TheAprilStarr,0,3,0,3,1572930000,1575435600,3
Intelligent-Product6,0,3,0,3,1612587600,1612587600,3
TheZombieJC,0,3,0,14,1584244800,1584331200,3
yikes153,0,3,0,15,1592280000,1608613200,3
jason14331,3,0,301,0,1604379600,1604898000,3
davidmlewisjr,0,3,0,7,1589256000,1589256000,3
fakin-_it,0,3,0,14,1579237200,1580446800,3
Investigate311,0,3,0,63,1602388800,1604984400,3
ModestAndroid,0,3,0,41,1593403200,1597550400,3
Tkeleth,0,3,0,23,1597723200,1604030400,3
cdubb28,0,3,0,7,1598846400,1598846400,3
sleepyecho,0,3,0,17,1603339200,1604379600,3
froghaxx,0,3,0,11,1568001600,1571803200,3
llahsraMhanoJ,1,2,11,6,1598155200,1598414400,3
tillie_jayne,0,3,0,7,1603598400,1603684800,3
Efflights6,0,3,0,4,1568606400,1576213200,3
GlassPrunes,0,3,0,6,1608181200,1608958800,3
Patticusatticus,0,3,0,50,1572930000,1575176400,3
SatanicJesus69,0,3,0,6,1589515200,1590465600,3
phantasmagoriaintwo,0,3,0,7,1604379600,1605848400,3
0Spryth0,0,3,0,30,1599969600,1606626000,3
SenorPoontang,0,3,0,-11,1583899200,1583899200,3
Whalemage,1,2,4,5,1575435600,1576904400,3
IAmAHat_AMAA,0,3,0,20,1573966800,1585540800,3
TheSpaceRonin,0,3,0,9,1609304400,1609304400,3
diarrheamudslide,0,3,0,5,1589860800,1604379600,3
Thencewasit,0,3,0,7,1571112000,1582088400,3
has-some-questions,0,3,0,22,1596859200,1609131600,3
SweetDickyWillie,0,3,0,8,1591934400,1594872000,3
CampingPlayer,0,3,0,8,1612155600,1612846800,3
Snowhatguy909,0,3,0,11,1571630400,1578286800,3
StationVisual,0,3,0,87,1601611200,1606712400,3
Strength-InThe-Loins,0,3,0,4,1572843600,1576213200,3
Sweetredpot,0,3,0,18,1581915600,1601956800,3
bigandmessy,1,2,41,4,1597896000,1597896000,3
zjd0114,0,3,0,-11,1571112000,1571112000,3
bluntmesilly,0,3,0,6,1588219200,1603512000,3
gweneveer,0,3,0,187,1577422800,1578978000,3
BeaArthursBae,0,3,0,15,1598673600,1599796800,3
International_Fee588,0,3,0,5,1597896000,1601611200,3
timeslider,1,2,67,165,1594526400,1597291200,3
Thoughtbuffet,0,3,0,23,1593748800,1593835200,3
nonptat,0,3,0,-5,1577509200,1577509200,3
yarn-ball,0,3,0,38,1607490000,1607490000,3
Onthegluesince82,0,3,0,6,1547528400,1550379600,3
Maelis,0,3,0,13,1599796800,1609045200,3
r0ssk0,0,3,0,2,1570248000,1570248000,3
Tavia_Melody,0,3,0,12,1579237200,1587182400,3
kmast6969,0,3,0,-24,1606539600,1606539600,3
rubot78,0,3,0,15,1605330000,1612069200,3
regularidiot666,0,3,0,24,1598846400,1605416400,3
Nawhililianloakolani,0,3,0,26,1581483600,1581483600,3
Top-Currency,0,3,0,10,1603598400,1603598400,3
postscarcityindigo,0,3,0,209,1607490000,1607576400,3
Moradopls,1,2,15,7,1577336400,1607835600,3
officialNickMullen,0,3,0,3,1585540800,1585540800,3
SwiftScoutTeemo,0,3,0,17,1578805200,1578805200,3
2_old_2B_clever,0,3,0,8,1598155200,1598414400,3
thepredictableone,0,3,0,3,1613106000,1613106000,3
codyofficial,0,3,0,18,1602388800,1612069200,3
teknobable,0,3,0,20,1601179200,1608786000,3
trynaimprove88,1,2,164,3,1609304400,1609390800,3
Alexandersaywhat,1,2,7,3,1606107600,1606107600,3
IHEARTCOCAINE,0,3,0,-14,1555905600,1557547200,3
Far_Scientist_5082,0,3,0,27,1599364800,1600833600,3
guavaberries3,2,1,37,1,1597896000,1611464400,3
yslvibes,0,3,0,19,1596859200,1599019200,3
sinesenraged,0,3,0,31,1599278400,1599537600,3
bag_o_knobs,1,2,40,11,1581915600,1594094400,3
CoolGuySauron,0,3,0,7,1589169600,1609131600,3
CaptainObvious_1,0,3,0,-13,1606280400,1606366800,3
manifesto18,0,3,0,49,1565668800,1572408000,3
_______walrus,0,3,0,15,1584763200,1605502800,3
Charming_Anxiety,0,3,0,20,1597377600,1597550400,3
zaphod4th,0,3,0,-2,1594440000,1607662800,3
quinnilius,0,3,0,34,1586059200,1591761600,3
cloudy_frost,0,3,0,16,1597118400,1601956800,3
AWKIFinFolds,0,3,0,18,1594785600,1599192000,3
sml09,0,3,0,42,1591675200,1603425600,3
darkmeowl25,0,3,0,22,1589169600,1597118400,3
elven_treachery,0,3,0,31,1575954000,1588046400,3
agent_tater_twat,0,3,0,101,1605589200,1606194000,3
ilikecaketoomuch,0,3,0,349,1577941200,1577941200,3
ButchTheKitty,0,3,0,15,1589169600,1589169600,3
billFoldDog,0,3,0,10,1595304000,1595304000,3
strangebru,0,3,0,8,1585022400,1608267600,3
tonguetiedturtle000,0,3,0,8,1603512000,1605675600,3
ChocolateMilkyWay,1,2,428,9,1535428800,1555732800,3
lucky20041,0,3,0,2,1593576000,1593662400,3
froggman79,0,3,0,16,1561348800,1578978000,3
LutherLuffeigh,1,2,107,10,1570161600,1570248000,3
sugarholicsheep,0,3,0,18,1599537600,1604898000,3
Locko_O,0,3,0,20,1571803200,1573016400,3
babytaradactyl,0,3,0,2,1608008400,1608008400,3
TheSpiritOfTheVale,0,3,0,-2,1600747200,1600747200,3
33649,0,3,0,9,1595995200,1599019200,3
SuprmeGodEmporer,0,3,0,1,1584244800,1606626000,3
Im_da_machine,0,3,0,120,1574571600,1576645200,3
dokkodo_bubby,0,3,0,-14,1576904400,1576904400,3
xtra86,0,3,0,107,1605934800,1608872400,3
stee_stee_,0,3,0,28,1594353600,1594440000,3
FrostyTrain8,1,2,30,4,1560657600,1603339200,3
Marshalllipe,0,3,0,35,1559188800,1581829200,3
Princeberry,0,3,0,26,1571803200,1571803200,3
XR425,0,3,0,3,1587441600,1587441600,3
specterofautism,0,3,0,44,1555905600,1557547200,3
KuehnRemarks1,0,3,0,-10,1606798800,1606798800,3
platosLittleSister,0,3,0,7,1553572800,1553572800,3
Skylinens,0,3,0,19,1568606400,1608958800,3
Workfree,0,3,0,13,1584936000,1585022400,3
radicalfloristx,0,3,0,24,1590206400,1609131600,3
HonestlyMediocre0,0,3,0,7,1606626000,1606626000,3
richem0nt,0,3,0,10,1605070800,1605070800,3
Queenhotsnakes,0,3,0,45,1587441600,1587441600,3
aaronblue342,0,3,0,29,1595217600,1595736000,3
So-D-Pressed,1,2,11,7,1584504000,1584504000,3
afreaukid,1,2,137,10,1598068800,1607922000,3
smoothsofa,0,3,0,139,1607490000,1607749200,3
skyerippa,0,3,0,59,1594958400,1603512000,3
Chinfusang,0,3,0,11,1607576400,1612155600,3
OurSaviourMechaJesus,0,3,0,3,1572235200,1572408000,3
wethail,0,3,0,9,1599710400,1599710400,3
357fallingspring,0,3,0,20,1600747200,1600747200,3
havingfun89,0,3,0,21,1574571600,1579064400,3
rose-girl94,0,3,0,4,1601265600,1605070800,3
mariners2o6,0,3,0,46,1608354000,1609477200,3
LiquidxDreams,0,3,0,5,1572235200,1584417600,3
Pecorino_Giovani,0,3,0,0,1562990400,1563076800,3
makemeking706,0,3,0,37,1602734400,1602734400,3
Metaethic,1,2,74,4,1600228800,1600228800,3
IcyPirate1221,0,3,0,83,1574053200,1575781200,3
Vitis_Vinifera,0,3,0,8,1580533200,1580706000,3
Durchbeisser,0,3,0,23,1594353600,1598846400,3
Snuggs_,0,3,0,11,1567224000,1612069200,3
SowingSalt,0,3,0,6,1556078400,1556078400,3
klivessss,1,2,6,9,1605070800,1606712400,3
therealnikkidarling,1,2,349,20,1601006400,1602561600,3
ryanhindleynjpw,0,3,0,6,1600142400,1600228800,3
urkweenkayla,0,3,0,71,1577854800,1582520400,3
cooldadmemes,0,3,0,17,1563768000,1580274000,3
MojitoBlue,0,3,0,-3,1578632400,1578632400,3
razor_sharp_pivots,0,3,0,24,1580792400,1590638400,3
Stormtech5,0,3,0,63,1571457600,1576904400,3
The___Repeater,0,3,0,38,1590638400,1592366400,3
brageevjen,0,3,0,1,1568088000,1568088000,3
sgarg2,1,2,1,3,1601870400,1601956800,3
TetraThiaFulvalene,0,3,0,6,1582434000,1582434000,3
_-__-__-__-__-_-_-__,0,3,0,30,1603512000,1603512000,3
Trucktober,0,3,0,10,1601092800,1607749200,3
anarchistcraisins,0,3,0,3,1601265600,1601265600,3
Shajenko,0,3,0,17,1560312000,1563768000,3
xmassindecember,2,1,100,36,1551934800,1576472400,3
StreetCartoonist,0,3,0,78,1576818000,1585454400,3
PhilMcGraw,0,3,0,7,1577422800,1577509200,3
Radcat96,0,3,0,83,1593316800,1594526400,3
dela617,0,3,0,-14,1584676800,1584763200,3
DNayli,0,3,0,-10,1600747200,1601092800,3
inukaglover666,0,3,0,33,1593489600,1607662800,3
truethompson,0,3,0,16,1541304000,1552708800,3
402915,0,3,0,11,1576645200,1583384400,3
MOU3ER,0,3,0,20,1574744400,1574830800,3
Vinyltube,0,3,0,35,1589860800,1599624000,3
SatansSwingingDick,0,3,0,-2,1607835600,1607835600,3
ineednothing04,0,3,0,16,1602388800,1603425600,3
DuskTheVikingWolf,1,2,978,9,1582261200,1590206400,3
sa5m_i_am,0,3,0,3,1584590400,1584590400,3
SPEAKEA5Y,2,1,1012,8,1565150400,1565409600,3
Admiral_Wiki,1,2,15,4,1591070400,1591070400,3
balkanibex,0,3,0,-13,1578718800,1578805200,3
sponge3465,0,3,0,-17,1603771200,1603771200,3
WaskeepatThendre,0,3,0,-8,1573275600,1573275600,3
randsomac,0,3,0,52,1554955200,1555128000,3
livinglitch,0,3,0,8,1604984400,1604984400,3
Johnololo1,0,3,0,10,1588305600,1588305600,3
Gamer3111,0,3,0,101,1601438400,1602734400,3
marshal_mellow,0,3,0,23,1599624000,1599710400,3
Drackar39,0,3,0,41,1591502400,1601524800,3
koginam,0,3,0,29,1601524800,1606971600,3
Sir_Insanity,0,3,0,82,1570852800,1572667200,3
StickmanEG,0,3,0,11,1576904400,1584158400,3
baraptherapper,0,3,0,9,1605589200,1607230800,3
cgriff32,0,3,0,2,1591243200,1591243200,3
Giraff3,0,3,0,5,1566014400,1608181200,3
Zumbard,0,3,0,18,1587182400,1587441600,3
Ripplefx1,0,3,0,90,1604725200,1604725200,3
Krexius,2,1,318,5,1565496000,1582779600,3
Xelzit,0,3,0,1,1572062400,1604379600,3
mrmariekondo,0,3,0,24,1569643200,1580274000,3
Glorax1214,0,3,0,32,1582434000,1583470800,3
nanotech23,0,3,0,8,1578632400,1578632400,3
FloatOldGoat,0,3,0,35,1578546000,1581915600,3
MustCOOM,0,3,0,-10,1606712400,1606798800,3
mr__churchill,0,3,0,69,1603684800,1604203200,3
ColdaxOfficial,0,3,0,4,1577163600,1577163600,3
Seba_Swans,1,2,49,-10,1567051200,1568692800,3
johnjohnson2020,1,2,4,3,1572930000,1576126800,3
YamZyBoi,0,3,0,38,1596945600,1598328000,3
-everyoneisgaybutme-,0,3,0,6,1608181200,1608613200,3
username_13,0,3,0,9,1599537600,1601956800,3
aestheticcowboy,0,3,0,7,1601179200,1601179200,3
thedudeslater,0,3,0,19,1588651200,1588651200,3
TheJumpingBulldog,0,3,0,25,1598328000,1598328000,3
popop213,1,2,28,13,1597204800,1607317200,3
jaxqatch,0,3,0,80,1570939200,1570939200,3
floatingdandelion,0,3,0,17,1567483200,1567569600,3
holmiez,0,3,0,10,1601092800,1609304400,3
ostrofci,0,3,0,4,1606539600,1606539600,3
flower_of_the_desert,0,3,0,96,1598500800,1598673600,3
somethingInTheMiddle,0,3,0,30,1568779200,1578459600,3
human2084,0,3,0,55,1584504000,1587960000,3
BadW3rds,0,3,0,2,1591243200,1594008000,3
All_Mods_Eat_Poop,0,3,0,37,1569297600,1569988800,3
oh2Shea,0,3,0,36,1599537600,1608354000,3
candace_owens_gw_acc,0,3,0,76,1586404800,1597896000,3
PeculiarlyMature,0,3,0,40,1598673600,1599019200,3
PacoVelobs,0,3,0,21,1578373200,1608958800,3
kakatoru,0,3,0,-6,1577509200,1577509200,3
RealNeilPeart,0,3,0,68,1595390400,1595390400,3
funerealfeghoot,1,2,114,89,1572580800,1602993600,3
bobbylabamba,0,3,0,4,1599537600,1606885200,3
ltkettch16,0,3,0,101,1581224400,1581915600,3
Kconn04,1,2,22,25,1584590400,1607230800,3
mrpinbert,0,3,0,11,1562126400,1585022400,3
huazanim,0,3,0,24,1590897600,1593144000,3
PoshDiggory,0,3,0,5,1592107200,1594612800,3
Baintball333,0,3,0,0,1598846400,1598932800,3
Mr_Jackpotz,0,3,0,38,1601006400,1604725200,3
edamameTuba,0,3,0,14,1603512000,1603512000,3
KawaiiCheezii,1,2,39,18,1596686400,1596772800,3
tails99,0,3,0,-41,1586232000,1586232000,3
DaCrazyDude1,1,2,628,9,1559880000,1575349200,3
Alpha3031,0,3,0,38,1599019200,1599019200,3
pineapplesforevers,0,3,0,112,1566878400,1572494400,3
HobbiesJay,0,3,0,52,1605589200,1605675600,3
IloveGliese581c,0,3,0,59,1593662400,1594526400,3
jaxon-k,1,2,152,23,1608958800,1609045200,3
Edmondc1,0,3,0,13,1609218000,1609218000,3
tecmm7,0,3,0,60,1592798400,1592798400,3
XanderTheChef,0,3,0,48,1593576000,1599192000,3
DLKTK,0,3,0,264,1562644800,1568692800,3
CCHTweaked,1,2,21,11,1595822400,1602475200,3
Devi1s-Advocate,0,3,0,2,1582779600,1611896400,3
SBF1001,0,3,0,16,1597464000,1597464000,3
Robert_u,0,3,0,8,1552276800,1552536000,3
priezusV2,0,3,0,91,1573275600,1573275600,3
-Philologian,0,3,0,95,1603425600,1607230800,3
InternetApprentice,0,3,0,14,1581829200,1581829200,3
J-Fr-sIUE-67-2112,0,3,0,44,1608008400,1608008400,3
daraghlol,0,3,0,10,1579150800,1608094800,3
4dSffSd4,0,3,0,130,1576558800,1596772800,3
VapesOnAPlane,0,3,0,5,1547355600,1547442000,3
TheElfStrangler,1,2,4,4,1585195200,1585368000,3
malachiconstantjrjr,0,3,0,263,1599278400,1600228800,3
jonmatifa,0,3,0,43,1578459600,1582088400,3
Longtime_Lurker5,0,3,0,35,1574830800,1591243200,3
DVB135,0,3,0,3,1612069200,1612069200,3
drhugs,0,3,0,3,1548738000,1572408000,3
65923466,0,3,0,18,1588996800,1596254400,3
vertigopenguin,0,3,0,10,1581397200,1597032000,3
Take_On_Will,0,3,0,19,1606366800,1606712400,3
stub-ur-toe,0,3,0,12,1605934800,1608699600,3
Goblingnarr,0,3,0,24,1571716800,1591934400,3
cdmedici,0,3,0,80,1569124800,1571803200,3
ProfessionalRoom,0,3,0,28,1576299600,1584244800,3
norx123,0,3,0,-133,1604811600,1608699600,3
The_Archagent,0,3,0,37,1560398400,1562817600,3
Unlimited_Bacon,0,3,0,55,1600315200,1600401600,3
logatwork,1,2,78,25,1574658000,1602216000,3
tres_ecstuffuan,0,3,0,14,1576818000,1583125200,3
DrummeeX09,0,3,0,34,1556424000,1591502400,3
qedx,0,3,0,9,1433649600,1476590400,3
Ckck96,0,3,0,30,1600228800,1608354000,3
seduceitall,0,3,0,-4,1574830800,1574830800,3
delinquent-lil-bitch,0,3,0,9,1605502800,1609045200,3
againstmethod,0,3,0,7,1596772800,1602820800,3
PirateDaveZOMG,0,3,0,16,1560657600,1573534800,3
Aezzil,0,3,0,6,1605502800,1609477200,3
thatmoongurl,0,3,0,11,1608094800,1609218000,3
waxxiefrog,1,2,241,48,1574312400,1588737600,3
Thatomeglekid,1,2,45,6,1598587200,1598673600,3
PreparedCampaigner,0,3,0,20,1593057600,1595822400,3
juliusceasermu,0,3,0,-14,1594008000,1594094400,3
appetiteforecstacy,1,2,33,12,1594353600,1596686400,3
hey-im-potioneer,0,3,0,440,1608786000,1608786000,3
vazeline200,0,3,0,22,1609304400,1609304400,3
shahnwsyed,0,3,0,-47,1608440400,1608440400,3
Writer_A,0,3,0,20,1564113600,1603512000,3
TheJeagle,0,3,0,7,1589515200,1589688000,3
scarlit,0,3,0,13,1597896000,1597896000,3
ShiftlesShapeshifter,0,3,0,45,1595649600,1602648000,3
ggemiinii,1,2,210,24,1606712400,1606798800,3
Enemist,0,3,0,352,1587441600,1599537600,3
Babayaga20000,0,3,0,3,1572408000,1582779600,3
Dylan_Quest,2,1,451,16,1605502800,1609477200,3
DavidDoch,1,2,0,-17,1566964800,1566964800,3
TheAtticGoblin,0,3,0,15,1606798800,1607749200,3
milesxvincent,1,2,100,4,1576126800,1581915600,3
Clear-Tangerine,0,3,0,-10,1590465600,1603080000,3
m2005905,0,3,0,4,1584331200,1605243600,3
D0D,0,3,0,-13,1603512000,1603512000,3
Sexysandwitch94,0,3,0,-30,1567051200,1571544000,3
IcarusIscariot,1,2,62,21,1579582800,1598328000,3
Salamqnder,0,3,0,37,1583899200,1584331200,3
VirginiaVelociraptor,0,3,0,42,1608354000,1608354000,3
TheApricotCavalier,0,3,0,9,1600574400,1603512000,3
TheArtomix,0,3,0,15,1578373200,1581397200,3
Garinn,0,3,0,-7,1599019200,1599105600,3
Inthegreyistheanswer,0,3,0,32,1596254400,1598414400,3
ColderClimbs,0,3,0,2,1577595600,1577595600,3
ihavenogenderama,0,3,0,6,1572321600,1572408000,3
nonexistant-fae,1,2,14,3,1612069200,1612069200,3
19TheCrimsonKing69,0,3,0,71,1593921600,1593921600,3
Louie8229,0,3,0,30,1586404800,1586664000,3
NonReality,0,3,0,23,1583812800,1595649600,3
Julmat1,0,3,0,41,1592539200,1611810000,3
praisebetothedeepone,0,3,0,-12,1586404800,1586664000,3
Caelios,0,3,0,10,1606626000,1606626000,3
badpeaches,0,3,0,162,1582002000,1582002000,3
fahrenheitisretarded,0,3,0,-4,1606885200,1607835600,3
RyanKaleb,2,1,936,28,1577941200,1604725200,3
8thEarth,0,3,0,17,1567569600,1568001600,3
Uberrees,0,3,0,33,1550466000,1560744000,3
iphan4tic,0,3,0,6,1571284800,1608699600,3
AnimaApocalypse,0,3,0,21,1608181200,1608440400,3
policeblocker,0,3,0,7,1594094400,1596081600,3
Garrotxa,0,3,0,2,1556596800,1556596800,3
rockaroni,0,3,0,38,1597118400,1597118400,3
roseadaer,0,3,0,9,1589688000,1589688000,3
VapedScoops,0,3,0,19,1575435600,1576126800,3
dank3o3,1,2,16,2,1609131600,1609131600,3
Icecreamforcrows,0,3,0,30,1598328000,1603512000,3
AlanMooresWizrdBeard,0,3,0,137,1584072000,1605070800,3
Cali_Val,0,3,0,16,1577336400,1601956800,3
ihcorex,0,3,0,54,1577854800,1603684800,3
babydance1234,0,3,0,12,1606626000,1607576400,3
WriterBWmc,0,3,0,16,1598155200,1598241600,3
bongobills,0,3,0,27,1512018000,1612069200,3
PrayTheThrowAway0001,2,1,503,1,1555905600,1561521600,3
danarchist,0,3,0,4,1606798800,1606798800,3
Felinius,0,3,0,13,1540180800,1561521600,3
Da_Rabbit_Hammer,0,3,0,3,1608958800,1609304400,3
CTANKEP47,3,0,200,0,1592280000,1592625600,3
mrmatteh,0,3,0,53,1608526800,1608613200,3
timmieseh,0,3,0,23,1581915600,1583985600,3
ArchertheDegenerate,1,2,64,2,1578286800,1578373200,3
stylesm11,0,3,0,-12,1576213200,1592452800,3
TheyGunnedMeDown,0,3,0,-12,1575176400,1575176400,3
dappledleaves46,1,2,11,13,1607576400,1607576400,3
livinginpeckham,0,3,0,6,1606194000,1606971600,3
dagrin666,0,3,0,70,1595304000,1603512000,3
Deadguy888,0,3,0,38,1602129600,1602129600,3
warmplace,0,3,0,3,1581483600,1581483600,3
flower_goblin,0,3,0,27,1597464000,1598328000,3
dudeonrails,0,3,0,12,1605330000,1605330000,3
MarvelSoyBoy420,0,3,0,20,1585540800,1585540800,3
FootballBusy,0,3,0,16,1607576400,1607576400,3
ramatheson,0,3,0,15,1573362000,1577854800,3
Aide_This,0,3,0,17,1597982400,1608267600,3
imbdbd,0,3,0,7,1605675600,1612069200,3
mae4n,0,3,0,59,1580187600,1583812800,3
Shwaposoup,0,3,0,-14,1602302400,1603512000,3
snek_goes_HISS,0,3,0,12,1589169600,1596772800,3
Dracolocutor,0,3,0,16,1594440000,1605675600,3
Chaoticpsychosis,0,3,0,78,1606626000,1607835600,3
goldpinkkay,0,3,0,5,1597118400,1597118400,3
kciddeah,2,1,40,3,1594785600,1595908800,3
JayJayChrome1994,0,3,0,36,1587009600,1587009600,3
PyrrhicDefeatist,0,3,0,78,1596945600,1608181200,3
meme_war_lord,1,2,59,6,1586664000,1588305600,3
Suspicious_Poon,0,3,0,-59,1609218000,1609304400,3
Mistress-Elswyth,0,3,0,10,1596254400,1596859200,3
ThePartyDog,0,3,0,33,1561953600,1569902400,3
DeeDeeDancer,0,3,0,19,1558584000,1582261200,3
zekkdez,0,3,0,34,1558411200,1559102400,3
mikeeppi,0,3,0,189,1599105600,1599105600,3
Dancing_Israeli420,0,3,0,5,1607662800,1608526800,3
browbraway,1,2,50,11,1570075200,1570075200,3
SuperPwnerGuy,0,3,0,-144,1584936000,1584936000,3
DaemonCRO,0,3,0,-2,1584244800,1584244800,3
mr_bostonian,0,3,0,3,1609218000,1609218000,3
WhistlingDead,0,3,0,7,1594353600,1594353600,3
Vnecktrev09,0,3,0,19,1605934800,1609477200,3
SuperNanoCat,0,3,0,151,1594353600,1604984400,3
yesmydog,0,3,0,27,1570507200,1598500800,3
Priezus,0,3,0,73,1557720000,1560657600,3
Vexusr,2,1,1006,36,1545195600,1598846400,3
GarbageOfCesspool,0,3,0,53,1594267200,1598846400,3
PM_ME_YOUR_DEAD_KIDS,0,3,0,7,1565841600,1565928000,3
9inchestoobig,0,3,0,213,1595563200,1595563200,3
Crabulous_,0,3,0,20,1557115200,1557201600,3
Legendary_Bibo,0,3,0,7,1594785600,1611982800,3
MrFake_Name,0,3,0,28,1550811600,1588305600,3
opheliaonthelake,1,2,1681,25,1600920000,1600920000,3
wkk3211,0,3,0,-2,1581224400,1581224400,3
Mug-o-tea,0,3,0,14,1588651200,1607576400,3
ChildofChaos,0,3,0,-25,1580706000,1581310800,3
potatodogz,0,3,0,6,1598673600,1601870400,3
OddtheWise,0,3,0,10,1583812800,1596513600,3
VoidNode,0,3,0,72,1580792400,1580792400,3
kyohanson,0,3,0,16,1605934800,1607144400,3
IPreferSoluitude,0,3,0,51,1578114000,1578200400,3
erinaceinaeValet,0,3,0,11,1605762000,1605762000,3
AB-1987,0,3,0,21,1569643200,1569643200,3
tlrmatt,0,3,0,1,1576645200,1576731600,3
Longjumping-Rush672,1,2,0,2,1607317200,1607317200,3
BobTPAFL,0,3,0,-63,1572494400,1572580800,3
bardo0,1,2,12,14,1583125200,1595476800,3
These-Chef1513,0,3,0,3,1605934800,1607662800,3
gothshit,0,3,0,13,1574917200,1585886400,3
Womec,0,3,0,4,1606626000,1606626000,3
everynameistaken43,1,2,12,5,1607576400,1607576400,3
ggggggggggggggggggkj,0,3,0,42,1578459600,1584158400,3
twenge,1,2,23,7,1533182400,1533268800,3
KaliLineaux,0,3,0,5,1573966800,1573966800,3
You_Artistic,0,3,0,18,1604466000,1605157200,3
Bantanomo_Bay,0,3,0,5,1582088400,1584676800,3
thereallifechibi,0,3,0,8,1548478800,1583985600,3
betacapsuletroy,0,3,0,28,1582779600,1606712400,3
bencherra,2,1,806,21,1578891600,1603684800,3
PrincesaMetapod,0,3,0,35,1573362000,1602043200,3
vilk_,0,3,0,6,1567742400,1606280400,3
Avivabitches,0,3,0,17,1597809600,1597809600,3
Chellz93,2,1,0,1,1578805200,1600574400,3
Stickyjarg,0,3,0,0,1607835600,1608786000,3
opalfruit91,0,3,0,17,1608699600,1608872400,3
mr-tony-stark,0,3,0,17,1562212800,1593835200,3
Spectacularity,0,3,0,40,1593662400,1606885200,3
loudog40,0,3,0,12,1540440000,1589342400,3
spice_weasel,0,3,0,19,1574312400,1574312400,3
ChRo1989,0,3,0,27,1594094400,1601092800,3
mojojb,0,3,0,16,1597723200,1607749200,3
yhl3051,2,1,132,1,1602561600,1602820800,3
NormalRedditorISwear,0,3,0,230,1608958800,1611810000,3
mandaraffe,0,3,0,10,1606280400,1608699600,3
plib2020,0,3,0,28,1600660800,1600660800,3
thryncita,0,3,0,23,1607662800,1608958800,3
radon860,1,2,8,45,1552449600,1552449600,3
no_haduken,0,3,0,29,1562212800,1570593600,3
anon25783,0,3,0,3,1582693200,1582693200,3
Neckbeards_goneweild,1,2,59,8,1596427200,1596427200,3
RightiesArentHuman,0,3,0,116,1609218000,1609304400,3
Vishnuprasad-v,1,2,119,29,1564804800,1564804800,3
jeIIan1s9,0,3,0,4,1593144000,1594699200,3
scrappymap,1,2,676,0,1598932800,1603684800,3
asd21123,0,3,0,3,1607662800,1607835600,3
finleymemedaddy,0,3,0,17,1582606800,1606798800,3
rootyb,0,3,0,16,1561867200,1569038400,3
Boring-Object7039,0,3,0,39,1598673600,1598673600,3
digitalb34rd,0,3,0,17,1557028800,1558843200,3
seasaltandvinager,0,3,0,23,1592193600,1609304400,3
grammatiker,0,3,0,30,1576213200,1604811600,3
sparklinglavawater,0,3,0,15,1549602000,1567310400,3
stayxcurious,0,3,0,87,1586664000,1589860800,3
Chipperz,1,2,14,44,1590724800,1598328000,3
Kerbal27,1,2,209,18,1572753600,1575435600,3
nothingzisisrealz,0,3,0,25,1562644800,1563249600,3
liquidsyphon,0,3,0,4,1600660800,1600747200,3
millionwordsofcrap,0,3,0,26,1575349200,1607922000,3
MagicMigsXXL,0,3,0,45,1560312000,1568952000,3
tarantula320,0,3,0,60,1603166400,1608008400,3
boybombs,0,3,0,30,1562731200,1569124800,3
Xerces29,0,3,0,3,1608699600,1608786000,3
Mr-Incredible-,0,3,0,14,1601697600,1601870400,3
amishantharaxx,0,3,0,12,1598068800,1599969600,3
tricxs,0,3,0,6,1539921600,1540180800,3
luisl1994,0,3,0,-2,1572930000,1579064400,3
thehoesmaketheman,0,3,0,-10,1608267600,1608267600,3
JerryOverton,0,3,0,6,1605243600,1605243600,3
nicolauz,0,3,0,14,1590552000,1590552000,3
SubRecommender,0,3,0,61,1561780800,1600401600,3
splatterjacks,0,3,0,8,1598155200,1603598400,3
RebelMountainman,0,3,0,1,1605589200,1608354000,3
valoigib,0,3,0,5,1570766400,1602907200,3
A-Boy-and-his-Bean,0,3,0,3,1603252800,1603339200,3
bradleyggg,0,3,0,21,1592452800,1595563200,3
JJ_Smells,0,3,0,3,1601524800,1606539600,3
antonio_cool,0,3,0,-19,1608613200,1608613200,3
Major-Woolley,0,3,0,9,1568779200,1600228800,3
Eleftourasa,0,3,0,8,1580792400,1599019200,3
DoublePumpForLife,1,2,579,20,1575435600,1598328000,3
Dantai,0,3,0,4,1606021200,1606021200,3
Shadow-of-Deity,0,3,0,4,1605589200,1605589200,3
DJ-Slickstop,0,3,0,9,1580878800,1581310800,3
HappyGazelle,0,3,0,56,1570248000,1570939200,3
elevator7,0,3,0,18,1597377600,1598500800,3
AquaL1te,1,2,33,5,1602043200,1602475200,3
TemptingScape,1,2,26,8,1589601600,1589601600,3
zerrschaftsheiten,2,1,1,1,1596945600,1602216000,3
constancespry6791,0,3,0,192,1596340800,1596340800,3
_Junic_,0,3,0,10,1603339200,1603944000,3
throwworkaway475,0,3,0,17,1594267200,1596427200,3
believeINCHRIS,0,3,0,18,1582174800,1584417600,3
BusSlight1094,0,3,0,8,1607576400,1607576400,3
Redshoe9,0,3,0,250,1587268800,1600574400,3
Luckyfella4,0,3,0,45,1602388800,1602475200,3
vRobbie17,0,3,0,3,1602129600,1602129600,3
fragile_cedar,0,3,0,24,1573275600,1592280000,3
area51alienbaby,0,3,0,6,1570161600,1570161600,3
hamsterz1,0,3,0,24,1601265600,1602734400,3
breathingabitharder,0,3,0,131,1605416400,1606194000,3
LexyCalliope,0,3,0,100,1603512000,1609218000,3
piratepete7,1,2,350,32,1568174400,1568260800,3
amtett,0,3,0,38,1605848400,1609131600,3
Mellow_Maniac,0,3,0,3,1573880400,1573880400,3
Habib_Zozad,0,3,0,40,1600574400,1601524800,3
Wiwiweb,0,3,0,72,1611896400,1611982800,3
DGRedditToo,0,3,0,86,1593576000,1593662400,3
saintpetejackboy,1,2,913,7,1556251200,1569816000,3
Shinjitsu-,0,3,0,26,1585195200,1591416000,3
PM_ME_YOUR_COVID-19,0,3,0,173,1598241600,1602648000,3
woobird44,0,3,0,115,1570507200,1606626000,3
Thumbs0fDestiny,0,3,0,3,1603339200,1611896400,3
crawldad82,0,3,0,-1,1571025600,1571025600,3
-cub-,0,3,0,-9,1573966800,1573966800,3
Spookyrabbit,0,3,0,15,1609045200,1609045200,3
westward2002,0,3,0,47,1580101200,1602561600,3
nerdboxmktg,0,3,0,10,1579755600,1583899200,3
Key_Coffee4941,0,3,0,5,1611637200,1611982800,3
tomasthemossy,2,1,106,1,1602302400,1606971600,3
VonMillerQBKiller,0,3,0,3,1578805200,1579323600,3
Azoonux,0,3,0,-1,1611982800,1612069200,3
SpreadItLikeTheHerp,0,3,0,4,1548738000,1556078400,3
donald12998,0,3,0,4,1582779600,1597636800,3
DeltaAvacyn6248,0,3,0,46,1605157200,1605589200,3
buttertoastmmm,0,3,0,30,1601438400,1601438400,3
PM_CUPS_OF_TEA,0,3,0,10,1550379600,1586836800,3
Descartavel84,0,3,0,11,1575867600,1575954000,3
leahlikesweed,1,2,34,11,1587614400,1589169600,3
JellyBellyWow,0,3,0,14,1576645200,1576645200,3
Curlycorpse,0,3,0,22,1572148800,1572753600,3
Allemanator,1,2,72,19,1579755600,1579755600,3
Thooor1,1,2,10,1,1569038400,1569124800,3
Castle_112,0,3,0,24,1601697600,1608440400,3
AnxiousGreg,0,3,0,16,1583298000,1588046400,3
frizface,0,3,0,12,1590465600,1604379600,3
PopularFault,0,3,0,31,1569816000,1588564800,3
A_Bear_Called_Barry,0,3,0,17,1580101200,1581570000,3
WinRaRz,0,3,0,9,1572408000,1573189200,3
shaolinPWNstyle,0,3,0,9,1572843600,1589601600,3
kepler__186f,0,3,0,3,1606366800,1607490000,3
arto26,0,3,0,3,1615867200,1615867200,3
proudpansexualplant,0,3,0,294,1592280000,1605762000,3
the_fox_hunter,0,3,0,1,1593230400,1593316800,3
JustAnother_Jess,0,3,0,69,1559880000,1561521600,3
amxha,0,3,0,30,1574053200,1574830800,3
PowerfulSneeze,0,3,0,25,1579755600,1579755600,3
redyeppit,0,3,0,3,1609390800,1610514000,3
gork496,0,3,0,19,1602129600,1602129600,3
elfonite,0,3,0,20,1548824400,1603512000,3
Spare_a_quarter,0,3,0,8,1563422400,1563595200,3
haw35ome,0,3,0,9,1583643600,1586836800,3
burf2500,0,3,0,6,1606885200,1606971600,3
macroweasel,0,3,0,6,1582779600,1582779600,3
Bearmay33,0,3,0,-7,1587355200,1587355200,3
LordoftheNetherlands,0,3,0,125,1557720000,1570593600,3
ep311,0,3,0,21,1572148800,1587960000,3
speakless_listenmore,0,3,0,17,1594872000,1598846400,3
LoftyGoat,0,3,0,3,1584158400,1602907200,3
Tyler99910,0,3,0,18,1607230800,1608786000,3
Phaea,0,3,0,13,1591502400,1591588800,3
SiaSara,0,3,0,4,1597204800,1604203200,3
oridjinal,0,3,0,5,1603598400,1603598400,3
StarLuma,1,2,13,2,1556596800,1573102800,3
GovWarzenegger,0,3,0,10,1574053200,1578373200,3
deadite_on_reddit,0,3,0,-8,1611896400,1611896400,3
Monsieur_Triporteur,0,3,0,17,1607662800,1612069200,3
MikeTheImpaler,0,3,0,59,1608008400,1608181200,3
DangerDutrow,0,3,0,-27,1567483200,1567483200,3
StephenNolansTits,0,3,0,17,1605675600,1606366800,3
capitol_pasta,2,1,48,1,1605157200,1605157200,3
ezzay,0,3,0,64,1600660800,1608440400,3
squeezemyhand,1,2,48,3,1576040400,1606539600,3
BlackVeganGirl,0,3,0,18,1573016400,1592452800,3
dissociatingtossaway,1,2,48,2,1609390800,1609563600,3
Prairiepinecone,0,3,0,11,1603598400,1603598400,3
DakDuck,0,3,0,10,1598328000,1598414400,3
Null_Voider,0,3,0,42,1594180800,1607922000,3
nicholiss,0,3,0,15,1567569600,1567569600,3
PM_ME_YOUR_MANDOLINS,0,3,0,14,1582779600,1582779600,3
El-Mooo,0,3,0,7,1573189200,1604811600,3
Slothalotta,0,3,0,38,1565928000,1574053200,3
meiapessoa,0,3,0,13,1556942400,1557028800,3
freewilly696,0,3,0,38,1560571200,1560571200,3
Gooberto-Sanchez,0,3,0,-4,1611896400,1612846800,3
inga_mendes,0,3,0,4,1595822400,1596772800,3
bianxrv,0,3,0,35,1597723200,1611896400,3
Charle_65,0,3,0,19,1593403200,1607490000,3
TheUberEvil,0,3,0,11,1591243200,1604811600,3
dalehitchy,1,2,180,12,1594008000,1594008000,3
Somniatora,0,3,0,48,1608008400,1612328400,3
FBIsmostmonitored,2,1,457,52,1597032000,1599883200,3
brighteyes142,2,1,147,4,1546491600,1547355600,3
iloveouterspace,0,3,0,4,1608354000,1608354000,3
termiAurthur,0,3,0,14,1609218000,1611896400,3
snowandsorrow,1,2,18,45,1595217600,1595304000,3
newmacbookpro,0,3,0,97,1560657600,1583726400,3
brook1888,0,3,0,83,1593662400,1598068800,3
MyOfficeAlt,0,3,0,12,1609218000,1609304400,3
Mr_pessimister,0,3,0,-29,1592884800,1594008000,3
HamLizard,0,3,0,6,1605934800,1609390800,3
imbackmods,0,3,0,-16,1602993600,1602993600,3
SIRenes0072,1,2,4,4,1580101200,1580101200,3
meisnick,0,3,0,16,1589860800,1607662800,3
Jazzminejoker,1,2,37,6,1567828800,1569124800,3
StayBlazed306,0,3,0,23,1603771200,1608440400,3
broughtonline,1,2,239,3,1604811600,1608008400,3
vonpoppm,0,3,0,11,1591243200,1591329600,3
_seangp,0,3,0,7,1548651600,1576299600,3
AustinAuranymph,0,3,0,41,1599019200,1606366800,3
_Stewie_Griffin,0,3,0,2,1611982800,1611982800,3
Putsismahcckin,0,3,0,6,1583298000,1592280000,3
bingobango415,0,3,0,14,1611896400,1611896400,3
karlpiranha,0,3,0,7,1607576400,1608699600,3
razenha,0,3,0,-30,1572235200,1575608400,3
ReIiLeK,0,3,0,13,1600315200,1606626000,3
thisismySFWprofile,0,3,0,11,1597118400,1597204800,3
DezZzampano,0,3,0,11,1588824000,1588824000,3
AllofaSuddenStory,0,3,0,7,1584763200,1592625600,3
ahug1597,0,3,0,65,1592884800,1598673600,3
sampaggregator,3,0,755,0,1575608400,1597032000,3
Lalgoli,0,3,0,273,1602993600,1604379600,3
MasterK911,0,3,0,-35,1601265600,1601265600,3
Sil5286,0,3,0,22,1607835600,1611982800,3
allen_hernandez1,1,2,19,4,1602216000,1608958800,3
BillyTheSillygoat,1,2,13,2,1575262800,1575262800,3
ssorbom,0,3,0,-3,1603166400,1603252800,3
NerdyDadGuy1981,0,3,0,10,1609304400,1609390800,3
mushypushy,1,2,0,7,1558843200,1558843200,3
pmgirl,0,3,0,64,1584158400,1585627200,3
DutchessM,0,3,0,16,1581570000,1581570000,3
WebKoala,0,3,0,-11,1561521600,1561953600,3
SameGuy37,0,3,0,-2,1584763200,1608786000,3
wubbalubbazubzub,0,3,0,29,1598587200,1606021200,3
OptimisticCrossbow,0,3,0,25,1605762000,1606021200,3
shafinm,0,3,0,3,1600660800,1600660800,3
XM202AFRO,0,3,0,5,1585886400,1587700800,3
NepowGlungusIII,0,3,0,3,1576386000,1576472400,3
Brilliant_Bank,0,3,0,102,1574744400,1602907200,3
Icmedia,0,3,0,8,1608872400,1609390800,3
manslam,1,2,10,8,1584417600,1584504000,3
NES87,0,3,0,45,1608094800,1608094800,3
bigquayle,1,2,14,3,1551934800,1552021200,3
Pikatoise,0,3,0,41,1582606800,1592107200,3
blacksmithwolf,0,3,0,95,1584244800,1584244800,3
DrEnrique,0,3,0,21,1557806400,1562644800,3
MeetTheTwinAndreBen,0,3,0,52,1585022400,1607576400,3
Waifuwigi,0,3,0,19,1605330000,1605416400,3
jobelenus,0,3,0,7,1435723200,1436155200,3
lwllnbrndn,0,3,0,-16,1589947200,1589947200,3
Elena1684,0,3,0,7,1601179200,1601870400,3
bolle_ohne_klingel,0,3,0,56,1560571200,1569297600,3
Roddy117,0,3,0,-33,1601870400,1608354000,3
DuckyChuk,0,3,0,-3,1587873600,1587960000,3
DFLOYD70,0,3,0,15,1553054400,1572930000,3
larryboii_,0,3,0,-18,1579496400,1579842000,3
kayayem,0,3,0,15,1574571600,1577941200,3
Ecstasyapathy,0,3,0,11,1593835200,1608267600,3
SirRobinRanAwayAway,0,3,0,63,1607835600,1609390800,3
skwuchiethrostoomf,0,3,0,60,1605243600,1608181200,3
KeiPirate5,0,3,0,74,1583298000,1592280000,3
leighjen2,0,3,0,-12,1596254400,1596254400,3
ghostingfortacos,0,3,0,35,1572235200,1572235200,3
mysicksadartworld,1,2,12,4,1591156800,1591243200,3
CJFresh,0,3,0,113,1565668800,1567137600,3
_Porb,0,3,0,42,1554955200,1609218000,3
dajoker711,1,2,7,5,1551675600,1553572800,3
crossfit_is_stupid,0,3,0,25,1576213200,1583812800,3
fulltime-sagittarius,0,3,0,63,1548392400,1559275200,3
just_be_a_human,0,3,0,16,1540612800,1540612800,3
99power,0,3,0,6,1589947200,1591588800,3
Cinammon-Sprinkler,0,3,0,3,1591416000,1608094800,3
tosernameschescksout,0,3,0,41,1576386000,1608958800,3
BANG-JP,0,3,0,33,1561262400,1591329600,3
efnPeej,0,3,0,16,1595304000,1595476800,3
nocringyintro,0,3,0,-20,1568520000,1568606400,3
id-entity,0,3,0,7,1594353600,1594872000,3
TheOnlyFreed,1,2,17,4,1539057600,1539144000,3
cburke82,0,3,0,41,1577336400,1601179200,3
lexaquin,0,3,0,19,1572321600,1605589200,3
arose_20,0,3,0,10,1588910400,1593662400,3
MatthewSerinity,0,3,0,64,1567483200,1576558800,3
NoRiskNoReturn,0,3,0,20,1602820800,1603857600,3
throwaway6142019,1,2,56,10,1560657600,1560657600,3
t0_0l,0,3,0,52,1565409600,1569556800,3
SNAilFrOlIc,1,2,10,4,1605416400,1605416400,3
99995,0,3,0,9,1605157200,1611896400,3
Pucabunny,0,3,0,24,1584504000,1584504000,3
bigbura,0,3,0,33,1560571200,1603425600,3
gamebuster,0,3,0,-3,1601697600,1601784000,3
Goblicon,0,3,0,0,1591243200,1602216000,3
Thegiantclaw42069,0,3,0,2,1607576400,1607576400,3
MaldiwlehlakiepiFLAP,0,3,0,57,1579928400,1580101200,3
kingoftheridge,0,3,0,-17,1553054400,1554523200,3
DoItAgain24601,1,2,7,3,1608181200,1608181200,3
trollmaster5000,0,3,0,7,1572580800,1601265600,3
Real_Jeff_Bezos,0,3,0,371,1571630400,1571976000,3
TheLiberalLogician,3,0,401,0,1608354000,1609390800,3
seno76,0,3,0,19,1568260800,1576645200,3
SPDTalon,0,3,0,123,1602475200,1603080000,3
DabYourTroublesAway,0,3,0,8,1606107600,1606280400,3
nickrempel,2,1,36,28,1562644800,1578027600,3
millennialfalcon360,1,2,56,9,1594008000,1608440400,3
Renlywinsthethrone,0,3,0,40,1571544000,1589428800,3
Stillemere,0,3,0,11,1574571600,1578373200,3
siamocontenti,1,2,21,7,1602216000,1602216000,3
masoudloveskimberly,1,2,12,8,1595649600,1595649600,3
Muffinkingprime,0,3,0,3,1594094400,1605243600,3
Money4Nothing2000,0,3,0,-2,1582779600,1608613200,3
zonkerson,0,3,0,25,1574053200,1585886400,3
20body20,0,3,0,37,1603684800,1604984400,3
rbohl,0,3,0,7,1581224400,1603598400,3
dank_bass,0,3,0,14,1607749200,1607835600,3
tigreye007,2,1,52,2,1599278400,1606194000,3
virgilsescape,0,3,0,-2,1606280400,1608354000,3
BeccaaCat,0,3,0,38,1572930000,1573707600,3
holykamina,0,3,0,60,1601611200,1607835600,3
legoyodaiamtruly,0,3,0,1,1585108800,1607230800,3
Dokurushi,0,3,0,1,1599019200,1599019200,3
a_rad_gast,0,3,0,98,1592539200,1602302400,3
Coventide,0,3,0,11,1611810000,1611810000,3
FlavioLikesToDrum,0,3,0,127,1597809600,1603684800,3
DJKent,0,3,0,7,1604116800,1604203200,3
robfloyd,0,3,0,3,1559275200,1559275200,3
AnotherRedditLurker_,0,3,0,27,1559966400,1561608000,3
-_MaxWell_-,0,3,0,22,1596686400,1596686400,3
bananastandmgmt,0,3,0,28,1608786000,1608786000,3
mrmotey01,2,1,56,7,1601524800,1606107600,3
NemoTheLostOne,0,3,0,6,1603857600,1609304400,3
prijindal,0,3,0,12,1591329600,1599278400,3
Dezzillion,0,3,0,-45,1607922000,1607922000,3
BlackSkullWolf,1,2,15,4,1568001600,1568001600,3
ydoeyetri,0,3,0,9,1592193600,1603425600,3
JohnnyRelentless,0,3,0,11,1591588800,1608786000,3
Drek311,0,3,0,9,1585972800,1585972800,3
wantonviolins,0,3,0,68,1591675200,1593316800,3
LotoSage,0,3,0,62,1572843600,1579150800,3
kyosanshugi,0,3,0,11,1588996800,1588996800,3
toway27483926,0,3,0,7,1604116800,1604811600,3
BoredasUsual88,0,3,0,58,1603771200,1612155600,3
JMoxon569,0,3,0,-11,1608699600,1608872400,3
noganetpasion,0,3,0,-18,1585454400,1585454400,3
Nuckfiggers321,0,3,0,-7,1600228800,1600315200,3
meat_tunnel,0,3,0,4,1603512000,1603512000,3
Fun-Ad-9016,0,3,0,7,1611982800,1612069200,3
mysticalchimp,1,2,103,17,1557028800,1606712400,3
IWantABeautifulWoman,0,3,0,9,1596772800,1602648000,3
ghost6898,0,3,0,13,1596340800,1598241600,3
Ethel-,0,3,0,16,1579496400,1579582800,3
hrsspls,0,3,0,13,1600488000,1612846800,3
dickpasty,0,3,0,57,1606280400,1607576400,3
SensibleGoat,0,3,0,8,1597377600,1597377600,3
Destithen,0,3,0,28,1571371200,1603512000,3
Kpopluvr94,0,3,0,7,1571630400,1574139600,3
fatalityforever1,0,3,0,16,1594872000,1596600000,3
thisisntgoingwell12,0,3,0,-146,1579410000,1579410000,3
edman436,0,3,0,11,1603684800,1608786000,3
BubbleGuts01,0,3,0,139,1588392000,1595044800,3
macdeth,0,3,0,6,1584244800,1606107600,3
WaterUnderwaterWater,2,1,21,2,1595044800,1596081600,3
bauqodn,0,3,0,5,1599796800,1599796800,3
boothgremlin,0,3,0,31,1598673600,1599192000,3
UniverseCatalyzed,0,3,0,-4,1594267200,1595390400,3
AlexHowe24,0,3,0,4,1550552400,1608786000,3
ComprehensiveAd4021,0,3,0,3,1606626000,1606626000,3
robococknballs,0,3,0,21,1576126800,1578027600,3
Mytzlplk,1,2,26,8,1559275200,1563249600,3
stressernotafighter,1,2,21,2,1604638800,1604811600,3
Easleyaspie,0,3,0,15,1597896000,1597896000,3
readdidd,0,3,0,1,1608526800,1608526800,3
BAF-2876,0,3,0,139,1556251200,1559620800,3
Novodmitrovsk,1,2,213,4,1597291200,1600315200,3
JRPG_CHI,0,3,0,34,1565668800,1566532800,3
VirgoVibez,0,3,0,10,1594267200,1608440400,3
bsbbtnh,0,3,0,6,1606971600,1606971600,3
alwayssunnyinphilly1,0,3,0,48,1573275600,1573275600,3
christheprince1610,0,3,0,75,1575781200,1585800000,3
Caskerville,0,3,0,74,1605675600,1607490000,3
diamund223,1,2,13,10,1607317200,1609131600,3
Drudicta,0,3,0,12,1593835200,1593921600,3
petertel123,0,3,0,10,1599537600,1599537600,3
pharma_phreak,0,3,0,3,1589083200,1598673600,3
Doctor_Satan_,0,3,0,243,1592193600,1596686400,3
LowCarbs,0,3,0,9,1553227200,1597032000,3
TheGreyMarshmallow,0,3,0,-7,1582434000,1582866000,3
12money95,0,3,0,6,1603339200,1608786000,3
colossalwreckemail,1,2,34,4,1600228800,1600228800,3
crazy727king,0,3,0,3,1572235200,1572321600,3
Specialist_Company_7,0,3,0,53,1603598400,1611896400,3
olivo000,1,2,1,3,1594353600,1597550400,3
achatina,0,3,0,24,1589342400,1602993600,3
Sick-Nurse,0,3,0,24,1588305600,1598500800,3
Soggy_Stuff9318,1,2,4,3,1606280400,1606280400,3
jaysin26,0,3,0,10,1607058000,1608440400,3
g3danken,0,3,0,3,1575608400,1575608400,3
A_LIFE,0,3,0,33,1582434000,1607144400,3
Autoradiograph,0,3,0,-7,1603339200,1607922000,3
anton5009,0,3,0,0,1606539600,1606626000,3
Sethorion,0,3,0,4,1594872000,1594958400,3
puresemantics,0,3,0,14,1600056000,1607317200,3
reallydude_666,1,2,17,5,1603252800,1603339200,3
meowstash321,1,2,6,14,1583384400,1588737600,3
toastytal,0,3,0,12,1568606400,1568692800,3
Glennsof,0,3,0,17,1595822400,1604379600,3
dedwomanwalking,1,2,12,5,1580446800,1580446800,3
MediocreJerk,0,3,0,0,1584504000,1596254400,3
pinkfrosteddoughnut,0,3,0,-11,1603512000,1603512000,3
WhatnotSoforth,0,3,0,7,1600142400,1607144400,3
Lock798,0,3,0,8,1582693200,1585540800,3
Jaredlong,0,3,0,13,1608181200,1608267600,3
dukec,0,3,0,27,1605589200,1607317200,3
YaThisIsBigBrainTime,0,3,0,35,1604984400,1604984400,3
Cobyp999,0,3,0,0,1602648000,1602648000,3
bobsyouruncle_666,0,3,0,6,1606798800,1606798800,3
CentripetalSideEye,0,3,0,48,1554004800,1599278400,3
Xdude199,0,3,0,19,1587009600,1605934800,3
Kooshikoo,0,3,0,7,1575349200,1594872000,3
boris_keys,0,3,0,71,1606539600,1606626000,3
tunahands316,1,2,321,19,1597118400,1604898000,3
Catthew-Mahogany,0,3,0,5,1592798400,1592798400,3
Totally_Cubular,0,3,0,-1,1571976000,1572062400,3
dragon731,0,3,0,31,1604030400,1604116800,3
PapuJohn,0,3,0,82,1606626000,1609390800,3
EthanTorez,1,2,13,2,1497240000,1497758400,3
kitelooper,0,3,0,6,1556942400,1556942400,3
sandjogger05,0,3,0,-6,1606626000,1607317200,3
Duckwithers,0,3,0,5,1605848400,1606021200,3
Necessary-History,0,3,0,4,1608094800,1608094800,3
AffectionateFudge9,0,3,0,17,1544936400,1544936400,3
DEERROBOT,0,3,0,11,1594872000,1612155600,3
BlasterPhase,0,3,0,12,1584331200,1601956800,3
llStev,0,3,0,23,1594353600,1608354000,3
Mragftw,0,3,0,54,1603512000,1605848400,3
vin_b,0,3,0,13,1572667200,1608872400,3
SolveDidentity,0,3,0,28,1606366800,1606971600,3
YouRockCancelDat,0,3,0,7,1607835600,1608613200,3
allthatglitterz7,1,2,62,23,1574571600,1574658000,3
GBenRN,0,3,0,-6,1582952400,1584676800,3
ComradeCatfud,0,3,0,36,1574398800,1575781200,3
nobodyinparticul4r,1,2,4,6,1605416400,1605416400,3
ilovemycuddlebunny,1,2,5,159,1606539600,1608181200,3
mrcrabs6464,1,2,7,4,1602648000,1602648000,3
Mrmrsa2,0,3,0,4,1592798400,1592798400,3
NeilDegrasse-PhatAss,0,3,0,60,1573534800,1605070800,3
favoritesound,0,3,0,19,1598587200,1609131600,3
troe_uhwai_account,0,3,0,-16,1568088000,1568088000,3
ThirdPersonRecording,0,3,0,4,1593748800,1593748800,3
BatgirlOfTarth,0,3,0,9,1607490000,1607662800,3
MugiwaraJinbe,1,2,33,357,1599537600,1600833600,3
scramtek,0,3,0,12,1429848000,1431921600,3
Turboguy555,0,3,0,89,1575781200,1586059200,3
LaochCailiuil,0,3,0,3,1561348800,1562126400,3
Ancalagon523,0,3,0,6,1595304000,1608354000,3
EUjimblemyjimmies,0,3,0,21,1572494400,1587182400,3
Rasputin20,0,3,0,234,1598760000,1598846400,3
MaliaXOXO,0,3,0,4,1602734400,1617595200,3
NoopLocke,0,3,0,50,1558497600,1559016000,3
BeneathTheSassafras,0,3,0,14,1603598400,1611810000,3
farmanimalinacubicle,1,2,6,2,1573102800,1573102800,3
countthemiles08,3,0,1958,0,1565496000,1576904400,3
Graciousemployee,1,2,24,17,1591675200,1591675200,3
analEVPsession,0,3,0,4,1587614400,1587700800,3
apsa9076,0,3,0,-8,1608613200,1609131600,3
dumbest_name,0,3,0,9,1558497600,1565064000,3
ChipotleMayocide,0,3,0,2,1550293200,1550293200,3
Puzzleheaded_Truth20,1,2,6,4,1605070800,1605157200,3
JimmyTheGinger,1,2,17,5,1605243600,1609131600,3
Zurg0Thrax,0,3,0,1,1565236800,1565236800,3
DeepestFire,0,3,0,3,1572235200,1572235200,3
hfusidsnak,0,3,0,9,1603512000,1605070800,3
JimQ_official,1,2,73,4,1605157200,1605762000,3
KingKrusador,0,3,0,27,1608008400,1608094800,3
The_Cocoanuts,0,3,0,4,1547701200,1551157200,3
Ungr8fulMillennial,1,2,2,2,1552363200,1552363200,3
Munchies4Crunchies,0,3,0,19,1608526800,1609650000,3
Goldiero,0,3,0,-8,1589601600,1608354000,3
fakeprewarbook,0,3,0,110,1571630400,1589083200,3
silppurikeke,0,3,0,10,1603080000,1604030400,3
masterchiyf,0,3,0,-34,1577509200,1577509200,3
Perfect600,0,3,0,4,1612069200,1612069200,3
PastelPreacher,0,3,0,4,1559707200,1559707200,3
km777p,0,3,0,4,1582002000,1584676800,3
ashstorm91,1,2,76,9,1582606800,1582606800,3
EnemyOfTyranny,0,3,0,57,1576472400,1576472400,3
billybobthongton,0,3,0,6,1556596800,1556596800,3
ButtfuckChampion_,0,3,0,6,1579150800,1579150800,3
NotYourAverageLifta,0,3,0,-60,1612155600,1612155600,3
TisFullOfHope,0,3,0,44,1592884800,1608181200,3
BraemnBoechm,0,3,0,11,1576213200,1588651200,3
stir_friday,0,3,0,4,1543381200,1543381200,3
avaritze,0,3,0,93,1587268800,1591675200,3
guhnner,0,3,0,44,1593057600,1594440000,3
Noollon,0,3,0,78,1591502400,1603512000,3
Jumbojet777,0,3,0,13,1609045200,1609045200,3
skootnu,0,3,0,11,1589083200,1600488000,3
hockeyboi22,0,3,0,9,1597896000,1600660800,3
wilsonh915,0,3,0,89,1586404800,1601438400,3
zingtea,0,3,0,6,1577941200,1581570000,3
PerfectTangelo,0,3,0,-19,1599019200,1601697600,3
newacc0untwhod1s,0,3,0,17,1587182400,1587700800,3
Anatoli667,0,3,0,-13,1567224000,1567224000,3
Weetoes92,0,3,0,19,1604984400,1604984400,3
bitchsaidwhaaat,0,3,0,9,1585454400,1585454400,3
eathesequal,0,3,0,-181,1600315200,1600315200,3
Chris12edfield,0,3,0,6,1568260800,1568606400,3
bigeasy-,0,3,0,0,1581224400,1581224400,3
pepepeoepepepeoeoe,0,3,0,38,1593489600,1598414400,3
fulloffantasies,0,3,0,9,1603080000,1603080000,3
hydraulic2,0,3,0,76,1544763600,1552021200,3
rohan_himself,0,3,0,16,1607662800,1607662800,3
isaezraa,0,3,0,30,1567051200,1587614400,3
believe_in_yaselfPLS,1,2,71,4,1598673600,1598673600,3
Not_Reddit,0,3,0,4,1589515200,1609045200,3
AdnenP,0,3,0,-4,1595649600,1595649600,3
nihilistplant,0,3,0,18,1584158400,1606280400,3
siliconmalley,0,3,0,100,1592366400,1592452800,3
InvisibleEar,0,3,0,3,1583557200,1591416000,3
dutchguy555,0,3,0,29,1578978000,1583038800,3
Jabaggs,3,0,31,0,1605157200,1606626000,3
blackholealpha99,0,3,0,112,1576126800,1602475200,3
tennesseewaltz,0,3,0,13,1606798800,1609045200,3
TangerineForeign9004,0,3,0,4,1600142400,1600142400,3
toosig513,0,3,0,-48,1588824000,1588824000,3
IwishIdidntlikemath,0,3,0,21,1594267200,1605589200,3
marlboroman69,0,3,0,25,1585108800,1585368000,3
benedwards1972,0,3,0,4,1583643600,1583643600,3
AphonicGod,0,3,0,155,1607317200,1608094800,3
bloodsong77,0,3,0,25,1560657600,1575954000,3
WendigoTwo,0,3,0,15,1607230800,1608786000,3
Evilyn-GenderSmasher,0,3,0,45,1587614400,1592193600,3
chelc2284,1,2,322,48,1579064400,1579064400,3
MoldyGas,0,3,0,29,1580014800,1580014800,3
ClutchHunter,0,3,0,20,1564027200,1593230400,3
dataless01,0,3,0,68,1592884800,1607490000,3
BobertCanada,1,2,7,1,1599019200,1599192000,3
csteele98,1,2,2,3,1559016000,1559102400,3
Echos_myron123,1,2,132,34,1546837200,1567569600,3
LordHaveMercyKilling,0,3,0,12,1606194000,1606194000,3
Plague_wars,0,3,0,231,1587614400,1600056000,3
AllyisntFair,0,3,0,5,1598932800,1613192400,3
Sonderosity,0,3,0,19,1568952000,1609304400,3
Tidsdilatation,0,3,0,14,1577163600,1606798800,3
99redba11ons,0,3,0,19,1582606800,1590638400,3
littlepersephone,0,3,0,32,1580101200,1580101200,3
dutsi,0,3,0,7,1563076800,1570852800,3
Max_Insanity,0,3,0,67,1603684800,1608354000,3
GypsyWoman82,0,3,0,28,1581656400,1581742800,3
chokkochill,0,3,0,17,1592280000,1592280000,3
adumcheesler,0,3,0,4,1607317200,1607317200,3
elcoco13,0,3,0,-3,1602129600,1602216000,3
AntoineGGG,0,3,0,6,1603512000,1603684800,3
PenguinLover9000,0,3,0,5,1611982800,1611982800,3
keybomon,0,3,0,38,1600228800,1600315200,3
pappatharappa,0,3,0,3,1571889600,1571889600,3
GreyIggy0719,0,3,0,203,1581224400,1604898000,3
sexy_syzygy,0,3,0,30,1577941200,1577941200,3
1004v,1,2,12,8,1605762000,1608181200,3
eloquent_petrichor,0,3,0,3,1586404800,1586404800,3
cheezyshrimp93,0,3,0,9,1556596800,1562385600,3
fati-abd,0,3,0,6,1586059200,1605502800,3
psychedelicize,1,2,77,23,1566360000,1578114000,3
Cory123125,0,3,0,25,1584417600,1593230400,3
birdsy-purplefish,0,3,0,3,1541998800,1542430800,3
TheBrianTV,0,3,0,26,1602388800,1606539600,3
flizargnark,0,3,0,23,1603425600,1603425600,3
EponymousBosh,0,3,0,216,1555300800,1565323200,3
MrAlagos,0,3,0,14,1592712000,1593576000,3
TheGladeRunner,0,3,0,12,1602648000,1603771200,3
beevibe,0,3,0,15,1574830800,1594612800,3
shuynt,0,3,0,25,1556078400,1556078400,3
Padawanbater,1,2,10,30,1597809600,1598328000,3
Hungry_Culture,0,3,0,12,1595390400,1604466000,3
RealDovahkiin,0,3,0,2,1567483200,1567569600,3
R3lativityEmc2,0,3,0,8,1565841600,1565928000,3
ConsumerDeath,0,3,0,6,1607922000,1608786000,3
chidoputogordo,1,2,14,3,1583038800,1590120000,3
sgtpeppers508,0,3,0,43,1562385600,1584504000,3
Irey_West,0,3,0,6,1611982800,1612155600,3
lilalbis,0,3,0,15,1573534800,1573534800,3
crelp,0,3,0,5,1568865600,1608613200,3
Zulban,0,3,0,11,1478754000,1490068800,3
NightmareIncarnate,0,3,0,16,1581656400,1606194000,3
triad1996,1,2,618,56,1546318800,1546318800,3
Darcyboop,0,3,0,11,1600747200,1600747200,3
programmingMoose,0,3,0,11,1607230800,1607835600,3
LD50_irony,1,2,7525,60,1605243600,1608181200,3
Awh153,0,3,0,58,1594008000,1594008000,3
Adulations,0,3,0,457,1597896000,1600574400,3
stachldrat,0,3,0,20,1571371200,1608267600,3
Elizabitch4848,0,3,0,19,1565064000,1602043200,3
OarsandRowlocks,0,3,0,4,1594353600,1605502800,3
Ptitsuisse97,0,3,0,10,1592366400,1592452800,3
GetToDaChoppa97,0,3,0,5,1573189200,1573707600,3
Michael_DN,0,3,0,6,1590638400,1605589200,3
Poet_of_Legends,0,3,0,-15,1599969600,1600142400,3
peruytu,0,3,0,5,1567310400,1567310400,3
bardolomaios2g,0,3,0,300,1608699600,1608958800,3
Ratsach,0,3,0,3,1601784000,1601870400,3
JudyWilde143,0,3,0,4,1605848400,1606885200,3
tired_so_tired,0,3,0,6,1589342400,1589342400,3
Seamen-Schmuckatelli,0,3,0,-8,1587873600,1594180800,3
hamberder-muderer,1,2,100,13,1606194000,1606194000,3
PeopleCallMeSimon,0,3,0,19,1605589200,1605675600,3
TheAardvarkKingdom,0,3,0,2,1569816000,1569816000,3
Yog-Sothawethome,0,3,0,16,1582952400,1594094400,3
pap3rw8,0,3,0,8,1568001600,1568001600,3
Climhazzard73,0,3,0,7,1596686400,1597550400,3
WhatsGoodBWood,0,3,0,22,1597464000,1606107600,3
whowantstoknow,1,2,12,12,1559448000,1596859200,3
Yourhyperbolemirror,0,3,0,25,1590120000,1590120000,3
elucator,0,3,0,111,1566273600,1588478400,3
Hipponomics,0,3,0,3,1571198400,1571284800,3
Lightningsage2,0,3,0,9,1595044800,1600315200,3
tyrus_bongo,0,3,0,16,1575262800,1606021200,3
Eugene-Dabs,0,3,0,26,1591934400,1592712000,3
throwawayaccountoops,1,2,233,12,1581656400,1581656400,3
Pierre_Alex,0,3,0,-5,1585540800,1608699600,3
BigManPicks,0,3,0,7,1602043200,1602129600,3
Throwawayaccount0602,1,2,7,3,1600401600,1600401600,3
PonerBenis,0,3,0,10,1581742800,1581742800,3
AVeryImportantMan,1,2,82,27,1583812800,1586491200,3
greenrun99,0,3,0,5,1574744400,1574744400,3
skullhorse22,0,3,0,80,1558497600,1593489600,3
RedJamie,0,3,0,15,1600747200,1606885200,3
Braydox,0,3,0,1,1578373200,1606626000,3
Mad_Aeric,0,3,0,10,1596945600,1596945600,3
Useless_Nobody56,1,2,27,6,1593316800,1593662400,3
Diogenes_GodOfQuads,0,3,0,6,1578891600,1588564800,3
NavicularFossa,1,2,21,8,1576472400,1582088400,3
YanovStation,0,3,0,43,1598500800,1598500800,3
soemeoqnetoleanowan2,0,3,0,7,1599451200,1599451200,3
Hotascurry,0,3,0,43,1579842000,1595908800,3
SleazyJusticeWarrior,1,2,107,8,1574226000,1574312400,3
TheAutomatorML,0,3,0,-58,1577336400,1577336400,3
Kutvlieg,0,3,0,28,1605762000,1608094800,3
Marin_55,0,3,0,79,1595217600,1597809600,3
peas_and_hominy,0,3,0,4,1590984000,1608094800,3
FartHeadTony,0,3,0,5,1608872400,1608872400,3
tess_whatamess,1,2,27,11,1604898000,1604898000,3
lostcorass,0,3,0,9,1571112000,1602302400,3
pedrop1985,0,3,0,6,1585886400,1585972800,3
01binary,0,3,0,5,1591329600,1591329600,3
pm_me_younique,1,2,21,3,1586404800,1586664000,3
Swiink,0,3,0,6,1605502800,1608958800,3
Oatmeal_or_Porridge,1,2,12,23,1607576400,1611810000,3
THC_Induced,0,3,0,31,1596772800,1606712400,3
MyNameIsWinston,0,3,0,125,1579064400,1579064400,3
cerenjules,1,2,11,7,1595304000,1598760000,3
pond_with_ducks,0,3,0,9,1603598400,1604116800,3
bigboss_3238,0,3,0,4,1554955200,1608526800,3
t1234556,0,3,0,21,1575781200,1578805200,3
VaultBoy3,0,3,0,31,1604030400,1608181200,3
black_blot,0,3,0,10,1559102400,1575954000,3
MorriganSavage,1,2,8,6,1562472000,1568260800,3
MediocreHolocaust,0,3,0,40,1569902400,1574571600,3
KorbinMorrow,1,2,16,16,1575608400,1577163600,3
the_next_cheesus,0,3,0,113,1541304000,1608699600,3
heero2077,0,3,0,11,1575954000,1592107200,3
stevjorbs,0,3,0,19,1606539600,1606885200,3
Loki-Gwynbleidd,1,2,161,3,1611982800,1612069200,3
wes205,0,3,0,22,1597636800,1601179200,3
Orsonius2,0,3,0,7,1538020800,1576645200,3
enuo,0,3,0,9,1600660800,1600660800,3
Alh840001,0,3,0,9,1590379200,1607835600,3
chrisduder,0,3,0,36,1592884800,1593748800,3
Catgirl-pocalypse,0,3,0,16,1584936000,1595476800,3
lilykayce,0,3,0,78,1601179200,1601697600,3
SlickWiggler,0,3,0,57,1574830800,1580360400,3
enbiroment,0,3,0,6,1555819200,1555819200,3
ChloeB42,0,3,0,22,1581224400,1583470800,3
ErikTheRed19,0,3,0,21,1604466000,1606712400,3
itinerantzymurgist,0,3,0,38,1582693200,1584936000,3
TiV3,0,3,0,4,1458187200,1503892800,3
jivoochi,2,1,51,1,1589342400,1599192000,3
AnotherGit,0,3,0,-6,1566187200,1566273600,3
Whiprust,0,3,0,27,1603512000,1603512000,3
mindyamushies,0,3,0,6,1609390800,1609477200,3
HycAMoment,0,3,0,4,1578373200,1599624000,3
san475,0,3,0,11,1606539600,1606626000,3
fuckwork865,1,2,35,31,1572930000,1572930000,3
fig_art,1,2,74,14,1601784000,1601784000,3
tatteddiamond,0,3,0,196,1593403200,1593403200,3
poponio,0,3,0,12,1583985600,1598760000,3
whimsyNena,0,3,0,51,1582520400,1582520400,3
CountDoppelbock,0,3,0,38,1608786000,1608786000,3
pooshkii,0,3,0,3,1601697600,1606626000,3
Gambino225,1,2,1754,103,1603598400,1606626000,3
crystalbaron,1,2,9,10,1611810000,1611896400,3
811HEFE,0,3,0,5,1585454400,1603598400,3
mrmudzi,0,3,0,4,1595736000,1595736000,3
lonely-arab-guy,0,3,0,42,1597809600,1607922000,3
RandomMandarin,0,3,0,37,1601524800,1607403600,3
my_way_or_die,0,3,0,62,1592193600,1592280000,3
xi545,0,3,0,5,1603684800,1605070800,3
LusoAustralian,0,3,0,1,1571630400,1571716800,3
Jelly_Cleaver,0,3,0,28,1577768400,1604811600,3
Nutritious_breakfast,0,3,0,96,1592452800,1594440000,3
bored40,0,3,0,36,1575608400,1583384400,3
boolers,0,3,0,21,1603598400,1605243600,3
graymuse,0,3,0,106,1599451200,1599624000,3
MyR3dditAcc0unt,0,3,0,37,1582952400,1599537600,3
bluestar2011,0,3,0,14,1605243600,1608613200,3
whistleridge,0,3,0,17,1607662800,1607662800,3
lolligagger3000,0,3,0,10,1554955200,1557979200,3
dastardlycustard,0,3,0,44,1596945600,1603771200,3
Naw207,0,3,0,7,1580187600,1595131200,3
BenzoClaymore,0,3,0,1,1577163600,1579842000,3
loves_cereal,1,2,1082,72,1568606400,1568606400,3
hiliikkkusss,0,3,0,36,1601438400,1605243600,3
PullOutGodMega,0,3,0,20,1594180800,1594180800,3
GoldenRetreevee,1,2,43,2,1606194000,1606366800,3
Holgrin,0,3,0,41,1559966400,1560052800,3
uma_caruma,0,3,0,27,1577336400,1580792400,3
GoroAketchup,0,3,0,40,1576645200,1593230400,3
FrustratedLogician,0,3,0,3,1601697600,1601697600,3
GiftedContractor,0,3,0,5,1600142400,1600228800,3
Galexio,0,3,0,270,1609304400,1609304400,3
Potkrokin,0,3,0,-13,1607576400,1607576400,3
that-one-guy-youknow,0,3,0,9,1561780800,1561780800,3
pollywantsheroin,1,2,109,5,1602388800,1602475200,3
GoodRedd,0,3,0,14,1588651200,1595995200,3
aaqucnaona,0,3,0,8,1570075200,1576213200,3
Roos534,0,3,0,13,1554350400,1612155600,3
Invelix,0,3,0,5,1608094800,1611982800,3
Crizpywaffle,0,3,0,90,1578286800,1580619600,3
Gamesurfer,0,3,0,14,1550293200,1550293200,3
Angeleno88,0,3,0,96,1594008000,1607922000,3
thicksurprise,0,3,0,56,1600228800,1601524800,3
duggtodeath,0,3,0,13,1564459200,1589947200,3
AllHailTheCeilingCat,0,3,0,8,1569988800,1581570000,3
giorgiopadano,0,3,0,51,1600056000,1608181200,3
omar_4902,0,3,0,5,1599796800,1599796800,3
MaximoLovely,0,3,0,64,1605416400,1611982800,3
PM_ME_YOUR_REPO,0,3,0,14,1594872000,1604116800,3
showerclub,0,3,0,301,1594267200,1606712400,3
markarious,0,3,0,57,1585713600,1591588800,3
Pube_lius,0,3,0,-8,1612155600,1612155600,3
fuckwhatyahurd,0,3,0,41,1608354000,1608354000,3
notchillturtle,2,1,647,3,1552536000,1555646400,3
TheLostArchangel,1,2,6,4,1594353600,1594353600,3
pongo1231,0,3,0,176,1567569600,1572148800,3
astrangerstill,0,3,0,-2,1567569600,1567915200,3
EvolutionaryLens,0,3,0,58,1601352000,1609390800,3
asstral_4486,0,3,0,37,1539662400,1557460800,3
sitpagrue,0,3,0,30,1572408000,1580619600,3
kalystia1983,0,3,0,9,1600833600,1600833600,3
Swish18,0,3,0,0,1608181200,1608267600,3
Blazanov,0,3,0,21,1594353600,1596081600,3
Garm27,0,3,0,11,1582088400,1584331200,3
User_Name13,1,2,6,2,1567569600,1571112000,3
Signorito,1,2,8,5,1577768400,1604984400,3
Walican132,0,3,0,36,1566964800,1570766400,3
Avitosh,0,3,0,55,1585368000,1605330000,3
SilverStryfe,0,3,0,21,1574571600,1609304400,3
z_h1996,1,2,137,6,1599451200,1599537600,3
EatTheRichIsPraxis,0,3,0,157,1601092800,1603684800,3
throwawaylol12344321,1,2,0,2,1611637200,1611637200,3
DarthInvictus,0,3,0,36,1599278400,1604984400,3
bangbangahah,0,3,0,-14,1604293200,1608440400,3
everyteendrama,1,2,16,14,1592625600,1592625600,3
kynoid,1,2,85,6,1593403200,1600660800,3
BillionaireChowder,0,3,0,22,1594699200,1595476800,3
jackville07,1,2,36,19,1570075200,1570075200,3
Countdunne,0,3,0,116,1609131600,1609218000,3
sedaition,0,3,0,27,1552363200,1609045200,3
Abandonsmint,0,3,0,40,1574571600,1574571600,3
NeptuneAndCherry,0,3,0,38,1596686400,1599796800,3
NoBluey,0,3,0,21,1584936000,1607317200,3
C1-10PTHX1138,2,1,31,2,1611896400,1611982800,3
daft_strawberry,0,3,0,6,1604811600,1604811600,3
will404soon,1,2,119,2,1593748800,1594008000,3
The_Andrew_1987,0,3,0,20,1567828800,1602907200,3
whiskydiq,0,3,0,2,1601265600,1607922000,3
Casinopreacher_69,0,3,0,5,1591761600,1591848000,3
BrokenEggcat,0,3,0,34,1601956800,1606798800,3
SenatorPineapple,0,3,0,195,1575262800,1589688000,3
littlesallymae,0,3,0,5,1605330000,1605675600,3
fanartaltmanfartsalt,0,3,0,16,1604984400,1607490000,3
firedog32,1,2,28,3,1598500800,1608094800,3
actuallymuseishen,0,3,0,-25,1599796800,1599883200,3
majarian,0,3,0,27,1596772800,1611982800,3
MishapMike,0,3,0,15,1602475200,1602561600,3
ibringulove,1,2,28,3,1600920000,1603512000,3
beanandrachel,1,2,10,31,1585195200,1585368000,3
indirectdelete,0,3,0,22,1599796800,1602388800,3
DoomGoober,0,3,0,51,1603512000,1603598400,3
freddyfernando,0,3,0,12,1541912400,1541912400,3
Akton,1,2,3,17,1567656000,1568088000,3
psychedelic_fuzz_Man,0,3,0,28,1611982800,1612069200,3
some_random_chick,0,3,0,25,1595995200,1596600000,3
bearddeliciousbi,0,3,0,43,1575262800,1577422800,3
quarantinemyasshole,0,3,0,13,1591243200,1604379600,3
DidYouReallySayTh4t,0,3,0,-15,1584244800,1584244800,3
AstralFinish,0,3,0,61,1540008000,1543381200,3
airforceproud96,0,3,0,5,1607662800,1607662800,3
kumaku,0,3,0,30,1602475200,1606971600,3
oneoldfarmer,0,3,0,14,1611723600,1611810000,3
perfectbarrel,0,3,0,5,1605070800,1606107600,3
EchoGamer16,2,1,270,1,1577768400,1580619600,3
isleeptoolate,0,3,0,24,1602475200,1602734400,3
The-all-seeing-why,0,3,0,4,1596254400,1639026000,3
IHateMyHandle,0,3,0,80,1597982400,1598068800,3
gumbo11211,0,3,0,33,1563249600,1582952400,3
OrangeRealname,0,3,0,7,1574917200,1585454400,3
JehovahBruh,0,3,0,7,1604030400,1612155600,3
HalfysReddit,0,3,0,117,1595390400,1602734400,3
Bottombottoms,0,3,0,76,1602648000,1606021200,3
cupcakem8,2,1,52,3,1607749200,1608267600,3
WhyDoIKeepFalling,0,3,0,21,1568347200,1585800000,3
aNewlifeReborn,0,3,0,14,1589601600,1589601600,3
GodAwfulSiegePlayer,0,3,0,57,1557288000,1573275600,3
vanbrunts,1,2,23,10,1574917200,1577422800,3
DurrutiDuck91,0,3,0,6,1568347200,1570334400,3
jamboknees,0,3,0,14,1608958800,1608958800,3
Amaya_Vulpecula,0,3,0,3,1603512000,1603512000,3
Placeholder0485,0,3,0,29,1564113600,1576126800,3
bebaebae,0,3,0,22,1598587200,1598846400,3
hmz-x,0,3,0,208,1588478400,1590120000,3
kmalevich,0,3,0,42,1603684800,1603684800,3
rebuildthedeathstar,1,2,23,7,1557201600,1569211200,3
curious13129,0,3,0,0,1585454400,1585540800,3
Remarkable_Tea5412,0,3,0,271,1611896400,1611982800,3
brightside21,1,2,15,16,1594267200,1597723200,3
jellyfeeesh,0,3,0,36,1576645200,1576818000,3
International_Side95,0,3,0,4,1607317200,1607317200,3
ZachN12,0,3,0,9,1595563200,1605416400,3
canIbeMichael,0,3,0,-2,1585454400,1585540800,3
interrobangin_,0,3,0,7,1570075200,1573534800,3
Deadsil3nt,0,3,0,54,1598328000,1602993600,3
borbistheworb,1,2,8,23,1579410000,1580533200,3
Unicornsandwhich,0,3,0,12,1607144400,1608354000,3
mastodon_juan,1,2,12,52,1592020800,1602820800,3
mywhataguythatgaston,0,3,0,12,1582002000,1589774400,3
Count_Morrel,0,3,0,24,1599451200,1603598400,3
tubatemplar,0,3,0,8,1605934800,1605934800,3
spyke42,2,1,106,2,1583812800,1589515200,3
Quzyotto,0,3,0,-14,1605502800,1605502800,3
YourOwnBiggestFan,1,2,181,11,1590465600,1590465600,3
X_phuzZ-_-nutZ_X,0,3,0,103,1599019200,1607576400,3
McUserton,0,3,0,42,1603339200,1605330000,3
ColonParentheses,0,3,0,70,1600833600,1600833600,3
winstoncray,0,3,0,-36,1579928400,1580101200,3
rofladl,0,3,0,53,1559880000,1571803200,3
johnskylighter,0,3,0,14,1596600000,1599364800,3
vemenist,0,3,0,99,1607922000,1608008400,3
donttayzondaymebro,0,3,0,-24,1582088400,1583038800,3
nutella__fiend,0,3,0,37,1609218000,1609390800,3
BigSpicyMeatball,0,3,0,57,1580360400,1596513600,3
Flaky_Watch,0,3,0,87,1595649600,1603080000,3
Danoindigo,0,3,0,24,1606712400,1606712400,3
redisanokaycolor,0,3,0,10,1576213200,1582520400,3
Faerielight,0,3,0,8,1599537600,1606885200,3
sgtzach,0,3,0,9,1604379600,1604466000,3
tnbizkit,0,3,0,33,1592193600,1593662400,3
Cantdrownafish,0,3,0,112,1585454400,1589860800,3
confident_arrogance,0,3,0,1,1607403600,1607403600,3
WorkSucksAWholeLot,3,0,81,0,1551762000,1557288000,3
arkartas,0,3,0,92,1571284800,1571371200,3
Jdmisra81,1,2,52,203,1585540800,1607403600,3
FailedSociopath,0,3,0,36,1603512000,1603512000,3
elegiac_bloom,0,3,0,5,1608526800,1608526800,3
shifty313,0,3,0,5,1570420800,1606885200,3
MassiveSwingingCock,2,1,92,13,1575349200,1582434000,3
ConnerOcean,1,2,32,10,1597809600,1597809600,3
AtemporalVellichoria,0,3,0,5,1434254400,1434340800,3
Sniperking187,0,3,0,44,1594785600,1602302400,3
cyanideshawty,1,2,7,4,1575262800,1575349200,3
sergiokujo,0,3,0,85,1608267600,1609218000,3
IndependantVoter,0,3,0,-2,1584763200,1584763200,3
RingWraith75,0,3,0,20,1586836800,1607317200,3
MyKo101,1,2,10,27,1577422800,1577422800,3
nipplefucker3100,0,3,0,3,1569384000,1569384000,3
DarthBaconStrip,1,2,52,955,1582606800,1584504000,3
alexLAD,0,3,0,7,1599105600,1608181200,3
FashyFemboi,0,3,0,-94,1609390800,1609477200,3
wilhelm-cruel,0,3,0,5,1573016400,1573016400,3
MonsterHipster,0,3,0,55,1590033600,1590033600,3
yoooo12347,0,3,0,7,1597291200,1597291200,3
jableshables,0,3,0,7,1576731600,1576731600,3
xxpen15mightierxx,0,3,0,26,1605330000,1606021200,3
ItsOldHickory,0,3,0,-3,1586750400,1586836800,3
wynmill,1,2,19,4,1556424000,1556510400,3
howtodothisone,0,3,0,-40,1576386000,1576472400,3
a_cosmic_psycho,2,1,15,2,1549861200,1566446400,3
karyo1000,0,3,0,10,1608613200,1608699600,3
awahohmyyes,1,2,22,29,1587960000,1595563200,3
BJHanssen,0,3,0,3,1452315600,1452488400,3
mtpeart,0,3,0,4,1598500800,1598500800,3
lysergic_hermit,0,3,0,57,1608181200,1609045200,3
XieLong,1,2,99,0,1548738000,1563076800,3
VastVorpalVoid,0,3,0,15,1603771200,1603771200,3
Malgioglio,0,3,0,-39,1592366400,1592452800,3
corner,0,3,0,3,1606626000,1606626000,3
MetalBeastt,0,3,0,3,1591243200,1591243200,3
cshermyo,0,3,0,12,1573448400,1579237200,3
Gonzo565,0,3,0,283,1587182400,1587182400,3
pm_me_all_th_puppers,0,3,0,32,1598846400,1608613200,3
brightladdy,0,3,0,9,1604811600,1611637200,3
marrow_monkey,0,3,0,27,1576386000,1577077200,3
ehhhhhhhhhhhhplease,0,3,0,18,1575435600,1575435600,3
endCIV_,0,3,0,43,1559707200,1567051200,3
muntal,0,3,0,26,1592366400,1606021200,3
SheepInTheBox26,1,2,22,3,1578373200,1578459600,3
Cafte,0,3,0,41,1576386000,1576386000,3
Myquil-Wylsun,0,3,0,48,1583211600,1586664000,3
BubblyAttitude1,0,3,0,8,1555819200,1555905600,3
Teeheepants2,0,3,0,15,1574226000,1575003600,3
prlol,0,3,0,10,1593835200,1608181200,3
bocelot,0,3,0,26,1606194000,1607662800,3
applewithme,0,3,0,94,1579323600,1587960000,3
queer_bird,0,3,0,14,1595822400,1608094800,3
Rulifaxen,2,1,429,18,1571889600,1608181200,3
J_D_I,0,3,0,6,1594526400,1594872000,3
GigaSuper,0,3,0,-1,1559016000,1559102400,3
HVP2019,0,3,0,7,1603512000,1603598400,3
logan-is-a-drawer,1,2,27,22,1567224000,1569038400,3
prettylittleliongirl,1,2,5,5,1555560000,1583985600,3
LibreHelene,0,3,0,26,1572408000,1594353600,3
gassy_clown,0,3,0,3,1607835600,1607922000,3
ducati1011,0,3,0,5,1585540800,1600660800,3
JonnyCharming,0,3,0,7,1597982400,1601956800,3
redbaskets87,0,3,0,6,1599624000,1604638800,3
The_LeBron_James,0,3,0,9,1572667200,1574053200,3
meanwhileinvermont,0,3,0,2,1603684800,1609131600,3
Thefrogmandingo,0,3,0,2,1608267600,1609390800,3
why_worry_oh_wait,1,2,20,-8,1601006400,1601611200,3
Resident8495,0,3,0,144,1599710400,1605934800,3
RoseOfSharonCassidy,0,3,0,98,1564200000,1606453200,3
1aur,1,2,67,10,1577854800,1577941200,3
RedAshes_,0,3,0,34,1606712400,1606712400,3
peteypete78,0,3,0,9,1601265600,1601265600,3
janeshep,1,2,52,49,1567051200,1602648000,3
erotomanias,0,3,0,5,1597118400,1608699600,3
abruptcontriveddingo,0,3,0,15,1607317200,1609390800,3
Maddiecattie,0,3,0,5,1546750800,1546750800,3
dangerdad1,0,3,0,69,1601265600,1601265600,3
Xypherius,0,3,0,68,1585281600,1585368000,3
goddessofentropy,0,3,0,51,1569816000,1601265600,3
kannilainen,1,2,4,0,1593748800,1600574400,3
scuffedtrihardcx,0,3,0,-5,1574571600,1574571600,3
linderlouwho,0,3,0,23,1589860800,1594785600,3
ghstrprtn,0,3,0,18,1554264000,1566446400,3
ResidentialConcierge,0,3,0,-32,1597636800,1598587200,3
kirkbadaz,1,2,86,9,1590120000,1601956800,3
Amnoon,1,2,10,25,1561608000,1567396800,3
jonnyboy897,0,3,0,6,1607922000,1607922000,3
RoyGeraldBillevue,0,3,0,4,1594612800,1595822400,3
Tyler_Diaz,1,2,5,2,1580619600,1580619600,3
hitlerdick420,0,3,0,8,1562040000,1582088400,3
player-piano,0,3,0,23,1557288000,1565150400,3
the-guz,0,3,0,50,1603425600,1605848400,3
thedamnwolves,0,3,0,41,1567569600,1567656000,3
wildorchidveins,0,3,0,26,1592539200,1593921600,3
KyuuMobile,0,3,0,14,1569816000,1578805200,3
brokenrapier,0,3,0,127,1562817600,1568779200,3
mojobytes,0,3,0,31,1598155200,1598155200,3
tristan_rc,0,3,0,9,1602734400,1606885200,3
jkruse05,0,3,0,13,1605070800,1605070800,3
beanyboi030,1,2,8005,13,1608872400,1608958800,3
jbeezy2345,0,3,0,39,1580706000,1588564800,3
Warwolf5,0,3,0,290,1564459200,1569384000,3
prplCar0t,3,0,105,0,1595563200,1600660800,3
CallMeAnanda,0,3,0,-3,1584763200,1584849600,3
riadfodig,0,3,0,-2,1600574400,1600574400,3
danyisill,0,3,0,9,1548046800,1555214400,3
fiddy2014,0,3,0,4,1572930000,1589947200,3
Babydarlinghoneychan,0,3,0,114,1555128000,1581915600,3
organicperson,0,3,0,50,1593748800,1594353600,3
DamnCarlSucks,0,3,0,8,1585627200,1608958800,3
Badgernomics,0,3,0,47,1583125200,1609131600,3
Tchn339,0,3,0,139,1592280000,1604898000,3
Nonfictsean,0,3,0,-26,1571371200,1571716800,3
NotAnAcademicAvocado,0,3,0,17,1598760000,1598760000,3
Ollie-OllieOxenfree,0,3,0,37,1591243200,1591243200,3
FullHealthCosplay,0,3,0,4,1604379600,1604379600,3
mintsponge,0,3,0,72,1539921600,1544245200,3
D-Ursuul,0,3,0,5,1588910400,1588910400,3
SubatomicKitten,0,3,0,19,1600660800,1607922000,3
palpatine66,0,3,0,45,1578286800,1588046400,3
mattleo,0,3,0,17,1596081600,1596081600,3
Wed0x,0,3,0,-11,1566014400,1566014400,3
treasonousGOP,0,3,0,30,1582261200,1582261200,3
iamanautodidact2,0,3,0,31,1612069200,1612069200,3
fartyfanny,0,3,0,25,1567656000,1570334400,3
Squidiculus,0,3,0,58,1580101200,1602648000,3
balmycarrot,0,3,0,59,1572930000,1589428800,3
Swvfd626,0,3,0,52,1611810000,1611810000,3
blondiecommie,0,3,0,105,1574398800,1606885200,3
recmajkemi,2,1,756,28,1602388800,1608354000,3
frigidbarrell,0,3,0,90,1550466000,1603425600,3
Aloiveah,0,3,0,13,1607490000,1607576400,3
bobd0l3,0,3,0,-4,1585022400,1591329600,3
frgnld,0,3,0,17,1549256400,1549256400,3
house_of_many_fuks,0,3,0,93,1593057600,1601265600,3
newthrowaway86,2,1,25,1,1577854800,1580706000,3
PuffinOnAFuente,0,3,0,17,1572148800,1572148800,3
astral-dwarf,0,3,0,50,1589860800,1608872400,3
akulagr,0,3,0,34,1596427200,1601092800,3
Burnout2KForever,0,3,0,22,1579755600,1598932800,3
Shot_Policy_4110,0,3,0,52,1607317200,1607317200,3
Zebrakiller,0,3,0,-38,1574744400,1574744400,3
Samurott,0,3,0,17,1602129600,1602129600,3
RhinoJacket,0,3,0,4,1601352000,1602216000,3
Mergo99,0,3,0,3,1589860800,1589947200,3
madein1981,0,3,0,15,1565668800,1567828800,3
strangerisyou,0,3,0,7,1597118400,1598846400,3
Saucy_Salmon,0,3,0,4,1582866000,1608526800,3
fullmetalmaker,0,3,0,31,1602388800,1602820800,3
Equilibrium132,0,3,0,21,1570075200,1571889600,3
xandertarot,0,3,0,6,1586318400,1605589200,3
SephirothYggdrasil,0,3,0,26,1604030400,1608181200,3
redheadedalex,0,3,0,8,1556769600,1564027200,3
throwaway117296,1,2,62,5,1604898000,1604984400,3
KevlarUnicorn,0,3,0,20,1606021200,1608958800,3
ElGrandeRojo2018,0,3,0,11,1554264000,1559620800,3
Miston375,0,3,0,30,1579755600,1579755600,3
Magnetgarden,0,3,0,115,1561348800,1597550400,3
sockywocky,0,3,0,4,1600056000,1600056000,3
Bobbysw0rld,0,3,0,4,1591934400,1612155600,3
MTADO,0,3,0,11,1582779600,1587355200,3
WhyAyala,0,3,0,-1,1553918400,1553918400,3
LeothiAkaRM,0,3,0,73,1561435200,1604379600,3
nyannian,0,3,0,32,1582779600,1598414400,3
chaoticchica,0,3,0,12,1594353600,1594353600,3
LngWait,0,3,0,31,1597809600,1607144400,3
nacruza,0,3,0,24,1571284800,1583557200,3
Exceleration_Station,0,3,0,0,1605416400,1605502800,3
jimsongibby,0,3,0,15,1578027600,1582088400,3
kittywerk,0,3,0,5,1597377600,1597377600,3
PURPLEDONGOFTHANOS,0,3,0,-2,1562731200,1562731200,3
HotGirlOnProxy,0,3,0,7,1563681600,1572667200,3
RevenantThyamis,0,3,0,36,1582520400,1588392000,3
FacetiousBeard,0,3,0,56,1596686400,1606798800,3
nodiso,0,3,0,7,1604379600,1604379600,3
geeves_007,0,3,0,49,1568260800,1608440400,3
oeilofpajaro,0,3,0,15,1602302400,1602302400,3
lenaqueen90,1,2,21,5,1601352000,1601352000,3
PiXLANIMATIONS,0,3,0,3,1637643600,1637643600,3
RetroNewDave,2,1,31,3,1594440000,1596600000,3
Karnami,1,2,14,33,1581742800,1582434000,3
Alex-Cour-de-Lion,0,3,0,24,1608958800,1609045200,3
ZakPgames,0,3,0,6,1572930000,1588564800,3
XMED,0,3,0,16,1594353600,1602216000,3
Galivanting,0,3,0,-2,1559880000,1590897600,3
TurboTime68,0,3,0,12,1559361600,1559534400,3
neutrino46,0,3,0,6,1573189200,1582088400,3
the_stove,0,3,0,-5,1573016400,1573102800,3
wallstdebts,0,3,0,2,1568001600,1597464000,3
EchotheGiant,0,3,0,8,1582952400,1598846400,3
HellStoneBats,0,3,0,29,1605243600,1607403600,3
Lynndonia,0,3,0,20,1606885200,1606885200,3
kun_tee_chops,0,3,0,13,1555041600,1557201600,3
tiredbeebuddy,1,2,163,8,1552449600,1552536000,3
rhyanin,0,3,0,19,1602216000,1606107600,3
para_blox,0,3,0,32,1580446800,1601265600,3
HeavenIsClosedForMe,0,3,0,14,1578632400,1583643600,3
acid_minnelli,0,3,0,8,1594094400,1598932800,3
Daniellamb,0,3,0,11,1583470800,1583470800,3
kaesylvri,0,3,0,16,1602734400,1606107600,3
qadm,0,3,0,36,1572494400,1572494400,3
catgirl_apocalypse,0,3,0,20,1563249600,1563249600,3
SerotoninSyndrome666,0,3,0,32,1611810000,1611810000,3
guerrillaactiontoe,0,3,0,14,1582088400,1583470800,3
Lord_of_Sporks,0,3,0,25,1547096400,1555041600,3
HumanParkingCones,0,3,0,15,1550293200,1567569600,3
Pinko_Bastard,0,3,0,4,1577422800,1577509200,3
BlueNets,0,3,0,24,1598414400,1604293200,3
redditusersmostlysuc,0,3,0,-4,1608267600,1609822800,3
CommunistSnail,0,3,0,4,1584158400,1609045200,3
TheGoldenTeacher420,0,3,0,6,1606021200,1606021200,3
sarahACA,0,3,0,49,1576818000,1601524800,3
slef-arminggrenade,1,2,7,1,1608613200,1608613200,3
PM_ME_EXOTIC_CHEESES,0,3,0,422,1587355200,1587441600,3
5bigtoes,0,3,0,-3,1585454400,1585454400,3
alstraka,0,3,0,54,1598673600,1598846400,3
Graemett,0,3,0,62,1573621200,1573621200,3
rapid66,0,3,0,5,1600747200,1600747200,3
StillShmoney,1,2,47,10,1606021200,1606107600,3
KingofGames37,0,3,0,-5,1550293200,1550293200,3
Willow3001,0,3,0,27,1607230800,1607230800,3
daddymaci,2,1,4366,6,1576213200,1611810000,3
JonnySoegen,0,3,0,3,1572930000,1578373200,3
colonel80,0,3,0,3,1601092800,1601179200,3
theoreticalpigeon,0,3,0,-5,1575781200,1575781200,3
Hasll,0,3,0,19,1559102400,1598587200,3
wc8991,3,0,484,0,1563940800,1583812800,3
bman23433,0,3,0,5,1608872400,1608872400,3
corvusmonedula,0,3,0,102,1587096000,1587182400,3
BillGoob,1,2,13,2,1576818000,1578114000,3
KoeiNL,0,3,0,45,1605589200,1605589200,3
dandy2293,0,3,0,22,1571976000,1594008000,3
lovepussyandstuff,0,3,0,15,1546491600,1567656000,3
MasterlessMan333,0,3,0,36,1581397200,1581397200,3
Doomwaffle,0,3,0,25,1560139200,1569816000,3
stillblue839,0,3,0,11,1581397200,1592193600,3
ScarredWolf1,0,3,0,-48,1587528000,1588132800,3
cygnet_ring,1,2,79,89,1594872000,1594958400,3
DefectiveNation,0,3,0,15,1583557200,1607835600,3
Khumbolawo,0,3,0,9,1599796800,1608440400,3
gford333,0,3,0,43,1572408000,1608699600,3
HRHKingEdwardIX,0,3,0,48,1578286800,1578286800,3
skymaredreamseek,0,3,0,20,1592280000,1596340800,3
jkj199390,1,2,679,90,1601870400,1601870400,3
Jcorb,0,3,0,-5,1585454400,1585540800,3
Lorfall,0,3,0,-59,1589342400,1596859200,3
Kalbex,0,3,0,6,1600142400,1600142400,3
bbqandchilli,0,3,0,30,1571716800,1572667200,3
MarthaMacGuyver,0,3,0,35,1591243200,1596340800,3
ZaggRukk,0,3,0,4,1594699200,1606366800,3
broken_geist,0,3,0,65,1607749200,1608699600,3
Grim-Reality,0,3,0,460,1597636800,1598846400,3
DoNotMicrow8ve,0,3,0,84,1598673600,1598673600,3
lulpwned,0,3,0,14,1605157200,1608440400,3
cfuw,1,2,23,2,1582434000,1582520400,3
not-the-pizza-driver,0,3,0,6,1605157200,1608267600,3
unpaidRedditModlol,0,3,0,-4,1599537600,1599537600,3
scatman410a,1,2,165,71,1560312000,1568865600,3
gingergoblin,0,3,0,27,1573448400,1575867600,3
plinkplink90,0,3,0,128,1586923200,1604725200,3
Plasmacamel,0,3,0,4,1574485200,1577941200,3
BlackTeacups,1,2,10,2,1562644800,1563681600,3
KROPOTKINLIKESTRAINS,0,3,0,82,1575349200,1594872000,3
Messerjocke666,0,3,0,5,1604203200,1604725200,3
Butter_Meister,1,2,127,8,1558065600,1581224400,3
1BruteSquad1,0,3,0,3,1606021200,1608354000,3
Worsfold83,0,3,0,8,1578373200,1600574400,3
mob_world,0,3,0,120,1562990400,1571457600,3
DrShankax,0,3,0,120,1599969600,1602388800,3
Papaverpalpitations,0,3,0,5,1602216000,1607662800,3
Bob_Loblaw16,0,3,0,1,1593662400,1606971600,3
avocadowinner,0,3,0,5,1548651600,1568347200,3
redactionrecalled,0,3,0,17,1570939200,1572667200,3
jeaves2020,0,3,0,3,1591243200,1591329600,3
ReallyBigBoots,1,2,19,10,1560398400,1560398400,3
CityLimitsPK,1,2,7,4,1482037200,1482037200,3
Catbarf1409,0,3,0,10,1601179200,1601179200,3
SixtyCyclesLBC,0,3,0,19,1551589200,1553227200,3
Unreliable_Source,0,3,0,7,1598846400,1598846400,3
Bdc87,0,3,0,33,1553140800,1554523200,3
Sudoaptgetanarchy,1,2,51,33,1572062400,1572148800,3
AlarmingDot,0,3,0,19,1605589200,1606539600,3
Cuttlefist,1,2,7,-1,1566360000,1573362000,3
kimmy9042,0,3,0,49,1593576000,1595908800,3
BetaGater,0,3,0,8,1600833600,1600833600,3
MustLovePunk,0,3,0,6,1603598400,1603598400,3
rydo-higgins,1,2,36,2,1553227200,1561435200,3
irrelevantswag,1,2,22,14,1565409600,1566532800,3
S1mplejax,0,3,0,116,1603080000,1607403600,3
P00gs1,0,3,0,3,1578978000,1591243200,3
No-Ad666,0,3,0,122,1605243600,1609045200,3
ashitakablues,3,0,850,0,1602129600,1607576400,3
TrumpWasABadPOTUS,0,3,0,50,1605157200,1605848400,3
ethicalhamjimmies,0,3,0,64,1592798400,1605934800,3
lightsolgr,0,3,0,11,1596081600,1602388800,3
sqrtoiler,0,3,0,16,1585022400,1585022400,3
Bridgetthemidget,0,3,0,19,1595476800,1598068800,3
eternus,1,2,13,5,1571630400,1593057600,3
KnowledgeisImpotence,0,3,0,19,1604379600,1607403600,3
xPain666,0,3,0,-12,1594699200,1594785600,3
squirrl4prez,0,3,0,18,1612069200,1612069200,3
LifeIsPainOnlyPain,0,3,0,19,1547355600,1553140800,3
the_hucumber,0,3,0,19,1594353600,1604293200,3
koolkidspec,0,3,0,6,1571630400,1571716800,3
Nalivai,0,3,0,3,1571630400,1571716800,3
pteridoid,0,3,0,3,1591243200,1591243200,3
Deathcrow,0,3,0,122,1572494400,1574917200,3
homebyeleven,2,1,16,3,1578459600,1581483600,3
nocoolnicknamesorry,1,2,58,5,1578027600,1578459600,3
Coontang_,0,3,0,-110,1592625600,1592625600,3
aarnalthea,0,3,0,37,1579323600,1580533200,3
cottagecow,2,1,14714,29,1601784000,1604203200,3
SnooKiwis2161,0,3,0,18,1599537600,1599537600,3
levetzki,0,3,0,6,1611896400,1611896400,3
Griffwashere,0,3,0,19,1552107600,1552194000,3
josiesaro,0,3,0,530,1597809600,1599278400,3
jacktorrancestoner,0,3,0,1,1611982800,1611982800,3
mofosyne,0,3,0,4,1582779600,1604898000,3
scruffy_77,0,3,0,4,1598500800,1598500800,3
notnormal4,0,3,0,14,1597809600,1597896000,3
candleelit,0,3,0,5,1595822400,1601524800,3
bernyzilla,0,3,0,3,1573621200,1599364800,3
itsthematrixdood,0,3,0,3,1570248000,1570334400,3
stealwing33,0,3,0,8,1591156800,1591156800,3
FullFaithandCredit,0,3,0,22,1566360000,1594353600,3
Fakjbf,0,3,0,9,1568952000,1575435600,3
paythemandamnit,0,3,0,10,1577941200,1589601600,3
smashsouls,0,3,0,-191,1606366800,1609218000,3
Case2600,2,1,100,1,1550379600,1601784000,3
apugsthrowaway,0,3,0,76,1577509200,1584763200,3
twothirtyintheam,0,3,0,6,1602388800,1608613200,3
shawn_efil,0,3,0,13,1565496000,1565582400,3
dstrausser83,0,3,0,-34,1573102800,1574312400,3
LongEmotion6703,0,3,0,9,1605934800,1607576400,3
MetalicP,2,1,146,3,1594699200,1597204800,3
Vexling,0,3,0,5,1597204800,1597204800,3
Freebiesaregreat,0,3,0,26,1589342400,1596859200,3
Lowfuji,0,3,0,6,1591848000,1591848000,3
rad4jud,0,3,0,-5,1570334400,1570420800,3
BeesToTheFace,0,3,0,8,1600660800,1605416400,3
holdeno,0,3,0,72,1605589200,1606885200,3
URL0C4LST0N3R,0,3,0,9,1607317200,1612069200,3
Latraell,0,3,0,4,1611810000,1611810000,3
Incitatus_,0,3,0,21,1573448400,1573448400,3
Rody365,2,1,15,1,1555560000,1587441600,3
skekze,0,3,0,24,1541998800,1608613200,3
Conclavicus,0,3,0,43,1608613200,1608699600,3
rion-is-real,0,3,0,7,1592107200,1592107200,3
holdmy_imgoingin,1,2,5,2,1608008400,1608181200,3
Drenghel,1,2,41,4,1584158400,1598932800,3
mythofdob,0,3,0,5,1589860800,1589860800,3
Fywsm,0,3,0,5,1575176400,1575176400,3
Blasphoumy69,1,2,0,-1,1609477200,1609477200,3
strange_relative,0,3,0,188,1554264000,1561608000,3
inhoue_orihime,0,3,0,21,1605934800,1608267600,3
NotTryingToBeHated,1,2,34,12,1595908800,1595908800,3
DyingMisfit,0,3,0,-130,1604116800,1604116800,3
squeezeonein,0,3,0,64,1562299200,1574744400,3
GoblinX7,2,1,2099,2,1582434000,1587355200,3
consumesportsball,1,2,36,17,1559620800,1559620800,3
bmw42091,0,3,0,-3,1608699600,1609477200,3
peepeeskillz,0,3,0,52,1547096400,1563336000,3
Glitch5450,0,3,0,-13,1606712400,1606798800,3
babymoominnn,0,3,0,4,1596859200,1596859200,3
QueenMedina,1,2,186,35,1581397200,1586923200,3
errmaz,0,3,0,28,1579410000,1603684800,3
MarzyMartian,0,3,0,-46,1599710400,1605502800,3
ZA44,0,3,0,1,1550293200,1550293200,3
Modeine,0,3,0,26,1597377600,1597377600,3
thirdeyebrown_666,0,3,0,-62,1600747200,1600747200,3
HobBosHoss,0,3,0,8,1575349200,1601438400,3
ComputerBuild1,0,3,0,6,1584676800,1585108800,3
Storytellerjack,0,3,0,5,1598500800,1599278400,3
nothingifeelnothing,0,3,0,117,1605157200,1605243600,3
Mohliboyyye,0,3,0,4,1586059200,1586059200,3
197328645,0,3,0,0,1571112000,1571198400,3
wellfuckmylife666,0,3,0,125,1602561600,1602993600,3
NickCagey,0,3,0,5,1554350400,1554350400,3
wandalorian,1,2,85,22,1605243600,1606453200,3
Acceptable-Fudge9000,0,3,0,9,1597896000,1597982400,3
06AC,0,3,0,3,1590811200,1599537600,3
7MCMXC,0,3,0,4,1606366800,1608267600,3
ncgunny,0,3,0,-4,1571889600,1571889600,3
tylerisgriffith,0,3,0,64,1596772800,1601870400,3
therealwheeze,0,3,0,8,1558497600,1580706000,3
mark0bravo,0,3,0,24,1593230400,1594267200,3
WhaTheHeckle,0,3,0,3,1589428800,1594008000,3
PositivityOnly15,0,3,0,2,1607749200,1607749200,3
TheHumbleTomato,0,3,0,25,1595131200,1595217600,3
KatiTheMatey,0,3,0,33,1579064400,1579669200,3
dogssuck9,0,3,0,0,1593403200,1593403200,3
qpjakewaggqp,0,3,0,7,1585454400,1585454400,3
weasle865,0,3,0,-20,1576299600,1576299600,3
Jack_Haywood,0,3,0,17,1588305600,1604203200,3
s0ma_c0ma,0,3,0,3,1573102800,1573189200,3
beegreen,0,3,0,4,1596859200,1596859200,3
ES345Boy,0,3,0,46,1573707600,1573794000,3
starrpamph,0,3,0,76,1577854800,1598241600,3
phalseprofits,1,2,21,18,1597204800,1602734400,3
ensembletogether,0,3,0,21,1600574400,1601784000,3
helloagainlilfriend,0,3,0,4,1558324800,1559448000,3
cutestram,1,2,47,9,1604984400,1605243600,3
puppydogparty,0,3,0,70,1611723600,1611896400,3
OzBurger,0,3,0,41,1598241600,1598328000,3
vegemouse,0,3,0,16,1570766400,1579842000,3
Napagogue,0,3,0,11,1601438400,1601438400,3
boobatronz,0,3,0,15,1550466000,1551934800,3
CaptainsLincolnLog,0,3,0,-6,1589860800,1589860800,3
imsaneinthebrain,0,3,0,39,1557979200,1560744000,3
theusernameIhavepick,0,3,0,9,1537416000,1537588800,3
DankMemesRealDreams,0,3,0,15,1467691200,1481259600,3
Jupiters,0,3,0,14,1596772800,1599796800,3
Dane1211,0,3,0,33,1580446800,1594872000,3
mfsocialist,0,3,0,30,1583298000,1592539200,3
Rethious,0,3,0,2,1579323600,1590120000,3
CptIshmael,0,3,0,12,1609304400,1609304400,3
Neverhadsauerkraut,0,3,0,11,1607662800,1612155600,3
Biggie39,0,3,0,17,1578027600,1585281600,3
Ascerta,0,3,0,-68,1606453200,1606712400,3
reddmuni,0,3,0,21,1579755600,1580014800,3
ChewbaccasStylist,0,3,0,-1,1583899200,1583985600,3
cumnuri83,0,3,0,217,1608613200,1608613200,3
Thought_Ladder,0,3,0,8,1602820800,1602820800,3
Vitefish,0,3,0,31,1605589200,1605762000,3
HumanRevo,0,3,0,145,1598068800,1602734400,3
puppycatliason,1,2,24,26,1573621200,1573621200,3
OceansJenny,1,2,0,10,1601784000,1605330000,3
johnrealname,0,3,0,7,1562644800,1589256000,3
siccoblue,0,3,0,321,1608786000,1608786000,3
wildlymedioxre,0,3,0,4,1590033600,1590033600,3
quietboy3,0,3,0,23,1595476800,1598500800,3
jeremybeau,0,3,0,25,1565064000,1567569600,3
choosewisely564,0,3,0,-2,1608267600,1611982800,3
raventth5984,0,3,0,24,1607317200,1608008400,3
Jagel-Spy,0,3,0,6,1572321600,1572321600,3
thatc0braguy,0,3,0,9,1588478400,1600833600,3
ExpertOdin,0,3,0,15,1606885200,1606885200,3
nolangainsborough,0,3,0,9,1585281600,1585281600,3
darknessofchrist,0,3,0,5,1591329600,1591329600,3
chaoz2030,0,3,0,42,1606626000,1606885200,3
WantOutStopDigging,0,3,0,3,1601524800,1601524800,3
Funkyldj,0,3,0,0,1573966800,1573966800,3
romeoh0tel,0,3,0,108,1583125200,1606366800,3
Thezanatosh,1,2,11,6,1561435200,1561521600,3
PrlsonMike,0,3,0,18,1596340800,1603339200,3
slackbladerered,0,3,0,7,1567828800,1569038400,3
MadNinja77,0,3,0,28,1573794000,1573880400,3
deanmachine22,0,3,0,16,1573102800,1573448400,3
gpnemtb,1,2,44,20,1594440000,1608354000,3
kingtevo,3,0,1,0,1561608000,1564459200,3
aonghasan,0,3,0,135,1585022400,1601524800,3
Not_Paid_Just_Intern,0,3,0,24,1594440000,1605934800,3
Once_a_Fool,0,3,0,31,1559102400,1596254400,3
PsychologicalChart9,0,3,0,14,1611896400,1611982800,3
DavidCRolandCPL,0,3,0,9,1585108800,1585108800,3
Hyundi,0,3,0,37,1607490000,1607490000,3
PM_me_opossum_pics,0,3,0,61,1571976000,1612069200,3
WritingWithSpears,0,3,0,2,1574830800,1585368000,3
therealcherry,0,3,0,4,1579410000,1591416000,3
squiddy555,0,3,0,32,1603425600,1609218000,3
42Ubiquitous,0,3,0,11,1574312400,1574312400,3
TessHKM,0,3,0,3,1578805200,1589601600,3
audiored,1,2,38,8,1431835200,1598587200,3
Shrimpy_McWaddles,0,3,0,11,1585454400,1585454400,3
huey_cobra,0,3,0,34,1578546000,1597464000,3
PineAppleisbad46,0,3,0,1,1603512000,1603598400,3
SilentTea,1,2,35,2,1576818000,1576904400,3
insearchofansw3r,0,3,0,-58,1596686400,1608699600,3
jonthehippie,0,3,0,8,1596168000,1596168000,3
Maxtsi,0,3,0,-12,1579669200,1586491200,3
MC_Cookies,0,3,0,53,1588305600,1605675600,3
AHighFifth,0,3,0,65,1605330000,1606539600,3
Bishop-78,0,3,0,62,1579410000,1592366400,3
BeerHippo,0,3,0,20,1597723200,1602129600,3
Railered,0,3,0,-1,1583985600,1584072000,3
CrazyCarl1986,0,3,0,6,1572148800,1572148800,3
CaterpillarHookah,0,3,0,24,1603512000,1603512000,3
Aceroris,0,3,0,28,1562385600,1586318400,3
ApistoAfishianado,0,3,0,-27,1598328000,1598500800,3
ilikeboba-,1,2,120,12,1606798800,1606798800,3
DragonWolfZen,0,3,0,116,1549515600,1550725200,3
parametrek,0,3,0,5,1605243600,1608267600,3
slayer531,0,3,0,121,1566360000,1579323600,3
floortroll,0,3,0,14,1569384000,1571025600,3
TimbuckTato,0,3,0,25,1601956800,1601956800,3
Rarezuuzuu,0,3,0,27,1609477200,1609477200,3
truenorthrookie,0,3,0,11,1546578000,1546837200,3
55sycamore,1,2,224,17,1552021200,1580878800,3
YOUAREHERE-,1,2,13,4,1555992000,1555992000,3
kazyfake,0,3,0,199,1577854800,1605157200,3
summer_dreem,0,3,0,8,1597550400,1598587200,3
Juuliath00,1,2,3537,13,1581051600,1583211600,3
undreamedgore,0,3,0,4,1546405200,1546491600,3
nate0068,0,3,0,20,1608526800,1608526800,3
Shitballs1,0,3,0,-9,1584763200,1584763200,3
Akagikin,0,3,0,13,1571457600,1599451200,3
Sall876,1,2,0,1,1574398800,1574398800,3
Olaf4586,1,2,206,10,1583985600,1605157200,3
UnevenGlow,0,3,0,7,1607317200,1609218000,3
slickflicker,0,3,0,13,1557892800,1557979200,3
Seno900,0,3,0,48,1567656000,1603339200,3
ComradeNed,0,3,0,58,1592712000,1597809600,3
njester025,0,3,0,22,1600401600,1602820800,3
pheromonekvlt,0,3,0,14,1577336400,1577336400,3
tuumorboy,1,2,9,8,1575522000,1575522000,3
MetaphoricalKidney,0,3,0,103,1574571600,1580101200,3
lollitakey,0,3,0,24,1578891600,1605243600,3
Paulintoparis,0,3,0,23,1599796800,1605243600,3
danieljamesgillen,0,3,0,-20,1541044800,1541044800,3
satanic_slaughter,0,3,0,9,1594353600,1594526400,3
sunnybunny12692,0,3,0,8,1608267600,1611896400,3
GandhiMSF,0,3,0,6,1598328000,1599019200,3
mud_chicken,1,2,11,10,1576386000,1582952400,3
ThatBritishGuy577,0,3,0,7,1571889600,1605934800,3
Ndubuisi_Okeh,0,3,0,2,1558065600,1559966400,3
netanyahu4eva,0,3,0,48,1595822400,1596859200,3
BelugaBunker,0,3,0,-2,1593662400,1601179200,3
EldestPort,0,3,0,39,1605157200,1605848400,3
TheTroubledChild,0,3,0,24,1550206800,1558497600,3
SocialJusticeLich,1,2,0,19,1583557200,1603080000,3
ThrowAway666xD,1,2,476,8,1582779600,1605589200,3
chxrly_,1,2,650,19,1599451200,1599537600,3
marshmellian,0,3,0,121,1600574400,1600660800,3
masterminder,0,3,0,61,1552107600,1581138000,3
gschaina,0,3,0,3,1598328000,1598328000,3
corneridea,0,3,0,50,1584763200,1608699600,3
The_Answer_Is_42__,0,3,0,22,1555992000,1559534400,3
hopeelizabethgil,1,2,19,7,1602734400,1602734400,3
Phanatic899,0,3,0,9,1541566800,1545541200,3
deitpep,0,3,0,3,1585886400,1585886400,3
wherewhyhowwhen,0,3,0,6,1599883200,1606194000,3
justaverage,0,3,0,54,1611982800,1612069200,3
Vast-Silver,0,3,0,10,1594699200,1608613200,3
MercurialFreeze,0,3,0,-2,1611896400,1611896400,3
PomegranatePrincess8,0,3,0,70,1595390400,1595476800,3
Dmarek02,0,3,0,16,1606798800,1607144400,3
LBJsPNS,0,3,0,7,1567137600,1593835200,3
between3and20spaces,0,3,0,5,1602648000,1602648000,3
oslozombie,0,3,0,5,1578027600,1584936000,3
SpunKDH,0,3,0,5,1604898000,1604898000,3
SupremeSaleem,2,1,382,4,1572148800,1608267600,3
Skeet_skeet_my_NEET,0,3,0,11,1577336400,1577336400,3
SasquatchCooking,0,3,0,9,1584676800,1595995200,3
carbondiscord,0,3,0,85,1588392000,1588564800,3
estridgepete,1,2,223,24,1585800000,1596254400,3
Mgeegs,0,3,0,17,1588392000,1604811600,3
semispectral,0,3,0,32,1602907200,1602907200,3
Aquil_the_dog,0,3,0,9,1572843600,1572843600,3
patricktranq,0,3,0,60,1601352000,1608267600,3
yourAverageN00b,0,3,0,4,1601352000,1601352000,3
Coloradio-Engineer,0,3,0,7,1573448400,1583812800,3
Sweet_Any,0,3,0,11,1609390800,1609390800,3
LukeNew,0,3,0,3,1595649600,1609045200,3
joe579003,0,3,0,3,1581224400,1581224400,3
ThisNameIsNotCeative,0,3,0,-39,1596686400,1596686400,3
purplekrab,0,3,0,12,1596772800,1605243600,3
Draech,0,3,0,332,1576299600,1603771200,3
proletarium,0,3,0,82,1547874000,1549256400,3
LauraTFem,0,3,0,64,1579150800,1579496400,3
Akalazoo,0,3,0,3,1594353600,1594440000,3
carlyleprick,0,3,0,12,1603166400,1603166400,3
Beachesandy,0,3,0,12,1607230800,1608181200,3
magyrswarming,0,3,0,9,1581483600,1581483600,3
Thomas-the-Tankie,0,3,0,23,1561521600,1561608000,3
misha_the_homeless,0,3,0,39,1579237200,1587355200,3
dick_me_daddy_oWo,0,3,0,28,1571284800,1586836800,3
subeam,0,3,0,15,1585886400,1604725200,3
rudduman,0,3,0,14,1572753600,1607230800,3
bonkheight,0,3,0,13,1561694400,1607230800,3
vvwvwwvw,0,3,0,39,1578200400,1602734400,3
hoanganh22,1,2,14,9,1583125200,1602648000,3
thebloo2,0,3,0,24,1586318400,1588996800,3
ThePathForwardYT,3,0,17,0,1587009600,1587528000,3
thermobear,0,3,0,-29,1609218000,1609218000,3
Weneeddietbleach,0,3,0,15,1584763200,1605502800,3
MatUphotographic,0,3,0,5,1572321600,1572408000,3
BruceLeeDragon,0,3,0,31,1609390800,1609390800,3
pepperjack999,0,3,0,1,1612069200,1612069200,3
radenthefridge,0,3,0,-5,1582779600,1582779600,3
TonyBong,0,3,0,23,1585627200,1605675600,3
MDemel,0,3,0,1,1585454400,1585540800,3
Nuch_Horris,1,2,15,11,1585454400,1595304000,3
meowtasticly,0,3,0,62,1593835200,1599019200,3
TheYakkingWakko,0,3,0,39,1578546000,1585972800,3
jujumber,0,3,0,10,1606366800,1608440400,3
einz_goobit,1,2,0,1,1556596800,1556596800,3
Denzel_Currys_Rice,0,3,0,46,1607922000,1608440400,3
TheRealShmowzow,0,3,0,5,1585108800,1588046400,3
allysony_joy,1,2,81,5,1604116800,1607749200,3
oasisreverie,0,3,0,16,1598155200,1602475200,3
nutcase-man,0,3,0,33,1574053200,1598241600,3
Dpryll94,1,2,22,5,1598673600,1598760000,3
BushDidSixtyNine11,0,3,0,-13,1581310800,1591243200,3
SDMAJESTY,0,3,0,24,1608526800,1609304400,3
Projecterone,0,3,0,24,1557633600,1557633600,3
givememyhatback,0,3,0,8,1598500800,1598500800,3
dddaaadddd,0,3,0,-25,1577682000,1577682000,3
Nimthiriel,0,3,0,9,1601352000,1601352000,3
John-McCue,0,3,0,13,1599537600,1606885200,3
honklersheros,0,3,0,-26,1600228800,1609477200,3
Tuckersbrother,0,3,0,25,1578891600,1578891600,3
pandaholic23,0,3,0,61,1577163600,1577163600,3
danhoeg,0,3,0,37,1567137600,1567137600,3
carclain,0,3,0,96,1575781200,1580792400,3
Katatoniczka,0,3,0,10,1605157200,1605589200,3
malnourishedfarts,0,3,0,2,1588305600,1593316800,3
TrumpTrainMechanic,0,3,0,-4,1580274000,1580274000,3
caramelsloth,0,3,0,9,1572408000,1581310800,3
peloncin,1,2,68,35,1580706000,1612155600,3
SilverBeast2,0,3,0,38,1559620800,1562644800,3
HonorMyBeetus,0,3,0,-3,1562731200,1562731200,3
monkeyamongmen,0,3,0,8,1605070800,1605070800,3
spacemanSparrow,1,2,6,7,1587355200,1608786000,3
throw822away1,0,3,0,7,1602475200,1602475200,3
Eviladhesive,0,3,0,40,1549429200,1599364800,3
Justreadsomeshit,0,3,0,19,1608872400,1609218000,3
i_use_3_seashells,0,3,0,4,1594353600,1594353600,3
Doogswilliam,0,3,0,6,1568952000,1598673600,3
R264Awesome,1,2,0,0,1589688000,1589688000,3
OnkelWormsley,0,3,0,5,1574658000,1577163600,3
Phernaside,1,2,52,6,1596600000,1608181200,3
jXian,0,3,0,83,1585022400,1585195200,3
EggToast4Days,1,2,24,8,1588737600,1589256000,3
Procrastinista_423,0,3,0,10,1593230400,1602043200,3
TheCraftBrew,0,3,0,12,1584763200,1603512000,3
SamanthaMunroe,0,3,0,4,1602907200,1602907200,3
bigmoneykirky,1,2,53,12,1595649600,1596254400,3
orthecreedence,0,3,0,18,1601956800,1606194000,3
SignHereCo,1,2,456,26,1575349200,1577595600,3
djvolta,0,3,0,6,1603425600,1607662800,3
CorrectAddress,0,3,0,15,1593316800,1598932800,3
Fuzzson,0,3,0,28,1586664000,1594872000,3
TeslaModelE,1,2,39,54,1602907200,1607403600,3
celticsfan114,0,3,0,10,1586404800,1588737600,3
PM_ME_DEADPEOPLE,0,3,0,7,1597118400,1611982800,3
HashClasher,0,3,0,-4,1599969600,1600488000,3
SapperHammer,0,3,0,12,1584590400,1600660800,3
Sadlyacat,0,3,0,6,1597118400,1597118400,3
Confident_Basket8694,0,3,0,15,1612069200,1612155600,3
supposedlyitsme,0,3,0,15,1607576400,1608958800,3
nxqv,0,3,0,4,1565582400,1606626000,3
forking_shortballs,0,3,0,4,1595995200,1595995200,3
OPBeard,0,3,0,13,1568174400,1584936000,3
PlagueCrafter,0,3,0,16,1579064400,1579064400,3
Swaggerudoo,0,3,0,4,1606107600,1608872400,3
crono220,0,3,0,11,1569988800,1583211600,3
JonathanSourdough,0,3,0,8,1605848400,1608786000,3
lightning_po,0,3,0,17,1601784000,1608958800,3
arowz1,0,3,0,35,1567569600,1572408000,3
MariaCN,3,0,216,0,1584072000,1588132800,3
SundayDiscovery,2,1,12,0,1598932800,1605762000,3
PrivateRedditUser224,0,3,0,6,1591329600,1591329600,3
Lynette713,0,3,0,346,1565496000,1588737600,3
gaywhatwhat,0,3,0,13,1599796800,1599796800,3
ProbablyAR0b0t,0,3,0,2,1576126800,1576126800,3
Loptional,0,3,0,14,1565755200,1565755200,3
hejmate,0,3,0,9,1591502400,1603425600,3
Jeolleo,0,3,0,6,1553486400,1553486400,3
dreams1919,0,3,0,4,1598846400,1598846400,3
huxley00,0,3,0,9,1584763200,1610686800,3
WarDecterFM,0,3,0,42,1577854800,1604466000,3
angelomike,0,3,0,7,1589860800,1604293200,3
ConscienceFree,1,2,9,4,1601697600,1601697600,3
morbidiosyncratic,0,3,0,340,1549602000,1611896400,3
starrfish100,0,3,0,7,1599105600,1600920000,3
LordAronsworth,1,2,125,80,1560398400,1576472400,3
Esduh2,0,3,0,53,1608786000,1608872400,3
Garbeg,0,3,0,5,1583211600,1608526800,3
Ser_Salty,0,3,0,5,1580101200,1612069200,3
throwaway7789778,0,3,0,4,1605502800,1605589200,3
Sacredgun,0,3,0,1,1597204800,1597291200,3
Strongfatguy,0,3,0,23,1587009600,1588392000,3
WontLieToYou,0,3,0,3,1551416400,1574398800,3
stevenjd,0,3,0,5,1586923200,1586923200,3
jeffsal,0,3,0,23,1594699200,1600056000,3
StolenCamaro,0,3,0,158,1602043200,1604379600,3
HooliganNamedStyx,0,3,0,11,1585022400,1603512000,3
gr0uchfac3,0,3,0,40,1602561600,1608267600,3
froufur,0,3,0,52,1603512000,1603857600,3
DanielThePizza,0,3,0,11,1585454400,1585627200,3
ahskateskate,0,3,0,4,1605762000,1605762000,3
itchy136,0,3,0,-7,1579064400,1591329600,3
BreninLlwyd7,0,3,0,-7,1608267600,1608267600,3
aqt4u2c,0,3,0,71,1594008000,1600574400,3
GDoe5,0,3,0,9,1609218000,1609218000,3
Mozared,0,3,0,252,1605070800,1608267600,3
xenodevale,0,3,0,41,1598068800,1600142400,3
2ouble3spresso,0,3,0,9,1603944000,1604984400,3
TheNebulousMind,0,3,0,14,1596686400,1597636800,3
Anthfack109,0,3,0,14,1608958800,1609477200,3
DigitalGhostie,0,3,0,50,1606280400,1607144400,3
angrybab00n,0,3,0,9,1580014800,1589428800,3
BBR0DR1GUEZ,0,3,0,39,1578286800,1608094800,3
doctor0fJournalism,0,3,0,4,1595131200,1600228800,3
scotian-surfer,0,3,0,93,1589601600,1590033600,3
SuperPancake27,0,3,0,30,1561348800,1588737600,3
benevenstancian0,0,3,0,95,1600142400,1608786000,3
ginger_spits,0,3,0,41,1584676800,1607576400,3
PredatorsScar,1,2,44,4,1568260800,1603771200,3
Dick_Dousche,1,2,14,6,1539921600,1541217600,3
Groilers,0,3,0,4,1574658000,1594267200,3
not_bad_really,0,3,0,21,1572148800,1575262800,3
lite951,0,3,0,-2,1587441600,1587441600,3
PhoenixRising519,0,3,0,4,1570852800,1575954000,3
dixadik,0,3,0,3,1559448000,1586318400,3
ShibasInSuits,0,3,0,10,1566532800,1568433600,3
poopcasso,0,3,0,-66,1600660800,1600660800,3
variousothergits,0,3,0,13,1592107200,1599019200,3
thisbitchisgayyeet,0,3,0,46,1554868800,1567224000,3
ferrellhamster,0,3,0,58,1607749200,1609131600,3
teriyakininja7,0,3,0,160,1570593600,1573966800,3
Eric_Fapton,0,3,0,15,1583470800,1583470800,3
NamityName,0,3,0,0,1582693200,1595217600,3
wetblockz,1,2,9,7,1599278400,1599278400,3
tc65681,0,3,0,21,1606194000,1608267600,3
Mudpie106,0,3,0,5,1548651600,1548738000,3
phantom-009,0,3,0,19,1578200400,1596859200,3
scarfacecokehead,0,3,0,9,1546491600,1546750800,3
GeneDalefield,0,3,0,9,1583211600,1584417600,3
araninha,1,2,53,11,1566792000,1566792000,3
heathmon1856,0,3,0,11,1582002000,1591329600,3
GarbageChemistry,1,2,0,5,1602648000,1603512000,3
mistervirtue,0,3,0,27,1593576000,1599105600,3
zublits,0,3,0,57,1605848400,1607576400,3
jaspersgroove,0,3,0,12,1602475200,1605416400,3
DaddysTears,0,3,0,99,1603684800,1603857600,3
howard_deans_scream,0,3,0,25,1575262800,1579928400,3
thisidntpunny,0,3,0,11,1571025600,1571025600,3
haydini,0,3,0,47,1583812800,1583812800,3
Previous_Stranger,0,3,0,88,1581915600,1586404800,3
Gaminggod1997reddit,0,3,0,83,1605934800,1608267600,3
SoleSoulSeoul,0,3,0,22,1578373200,1588824000,3
hokiecmo,0,3,0,29,1555905600,1578027600,3
alarumba,0,3,0,44,1589601600,1598760000,3
LadyHelpish,2,1,198,4,1578286800,1580187600,3
shy_vy,1,2,1327,9,1554177600,1554264000,3
UnstrirringCoffee,0,3,0,133,1598155200,1603598400,3
axlrs,0,3,0,7,1568001600,1574398800,3
CriztianS,0,3,0,0,1591243200,1591243200,3
Lurkwurst,0,3,0,48,1595217600,1608440400,3
thisismy9-11,0,3,0,7,1580446800,1587355200,3
soji5,0,3,0,10,1591675200,1591675200,3
SanctimoniousApe,0,3,0,27,1565928000,1592193600,3
UpInTheTreehouse,0,3,0,47,1589860800,1599796800,3
NamasteVibes,0,3,0,34,1573880400,1574485200,3
SwagOnABudget,0,3,0,-64,1576386000,1576386000,3
2suck,1,2,67,16,1555473600,1557720000,3
Repyro,0,3,0,69,1577422800,1603512000,3
DarKbaldness,0,3,0,-9,1603512000,1603512000,3
dovanic,0,3,0,19,1595822400,1602475200,3
Status_Flux,0,3,0,7,1572148800,1579064400,3
opmdreamz,0,3,0,6,1582779600,1582779600,3
KillerFan,0,3,0,12,1592712000,1607317200,3
vodkamutinis,0,3,0,33,1599710400,1604379600,3
wineandeggs,0,3,0,8,1606280400,1608786000,3
TheChurchOfDonovan,0,3,0,-17,1582261200,1585972800,3
carrieberry,0,3,0,35,1582779600,1591243200,3
D0GMEAT007,0,3,0,3,1593576000,1597118400,3
Newspaupert,0,3,0,23,1586923200,1587182400,3
jack-face,0,3,0,5,1587528000,1596686400,3
L1amas,0,3,0,18,1589860800,1598241600,3
Fenastus,0,3,0,9,1578114000,1605243600,3
m3lin0e,0,3,0,18,1596772800,1597550400,3
Desirsar,0,3,0,4,1606107600,1606107600,3
kugrond,0,3,0,15,1586923200,1605502800,3
neela47,3,0,209,0,1588651200,1590033600,3
MikesSoftCider,0,3,0,16,1585454400,1585454400,3
davidthealpha,0,3,0,40,1598414400,1598414400,3
cestcho,0,3,0,20,1576558800,1586059200,3
TopperHrly,0,3,0,129,1571112000,1604116800,3
scruffyminds,0,3,0,52,1573707600,1591502400,3
MrRabbit7,0,3,0,45,1562040000,1579237200,3
Chipp_in,1,2,20,5,1555300800,1555992000,3
12345678952,1,2,27,3,1581224400,1581310800,3
EatonMicucci,1,2,0,1,1593403200,1593403200,3
absurdmephisto,0,3,0,105,1581224400,1590465600,3
bossnas88,0,3,0,-29,1599537600,1599537600,3
KarmaGrey,0,3,0,46,1583038800,1594958400,3
schizo_costume,0,3,0,34,1563768000,1563768000,3
WineBunny,0,3,0,15,1600315200,1605675600,3
TragasaurusRex,0,3,0,4,1583211600,1592020800,3
emPtysp4ce,0,3,0,28,1565668800,1584504000,3
TA-PSTGuy,0,3,0,13,1576904400,1598760000,3
__shrimpdick__,0,3,0,100,1607749200,1607749200,3
Marlza,0,3,0,17,1595217600,1595217600,3
Eliot0,0,3,0,73,1596168000,1596168000,3
survivalist626,0,3,0,69,1594958400,1595044800,3
Kristo145,0,3,0,-22,1576386000,1576386000,3
jilsander,0,3,0,50,1548392400,1564372800,3
CSynus235,0,3,0,1,1573707600,1574053200,3
GnosticWeebdom,0,3,0,-7,1589169600,1589256000,3
dffadng,0,3,0,19,1607576400,1608181200,3
bijoudarling,0,3,0,94,1575176400,1590638400,3
EquiliMario,0,3,0,21,1572235200,1572235200,3
mde132,0,3,0,187,1557633600,1559880000,3
HughJamerican,0,3,0,4,1565150400,1565150400,3
Roku6Kaemon,0,3,0,6,1585454400,1585454400,3
dedhoarse,1,2,10,47,1580187600,1592712000,3
Bike1894,0,3,0,-19,1591675200,1591675200,3
Fuckpeople2,1,2,11,4,1595649600,1595736000,3
0_o_0_o_0,0,3,0,5,1486702800,1497412800,3
HeadMembership,0,3,0,36,1592625600,1605502800,3
sciencefiction97,0,3,0,9,1581915600,1608354000,3
yannage_damage,0,3,0,-1,1608267600,1608267600,3
comet_sauce,0,3,0,188,1600920000,1606453200,3
911ChickenMan,0,3,0,4,1595217600,1608872400,3
mleonm57,0,3,0,6,1575954000,1576040400,3
MurderFloof,0,3,0,8,1603598400,1603684800,3
ralusek,0,3,0,0,1568088000,1568088000,3
Deus_Payne,0,3,0,18,1602129600,1602216000,3
Im_le_tired,0,3,0,-121,1584504000,1584504000,3
butterspreader,0,3,0,19,1567051200,1574658000,3
Jimicoy,0,3,0,17,1594267200,1598414400,3
jackoftradesnh,0,3,0,14,1608267600,1612069200,3
BJJJourney,0,3,0,1,1605589200,1605589200,3
steveneguy,0,3,0,124,1603684800,1609131600,3
natturalsenses,0,3,0,15,1581397200,1581397200,3
Cade_Connelly_13,0,3,0,18,1571803200,1572843600,3
TempestofBenares,0,3,0,19,1582520400,1596772800,3
goawayeli,0,3,0,18,1571544000,1576990800,3
hoophooper,1,2,13,2,1564459200,1564718400,3
Whohadtheswineflu,0,3,0,25,1606712400,1606712400,3
Riov,0,3,0,15,1597377600,1605243600,3
JJSwagger,0,3,0,144,1601784000,1605848400,3
shebangal,0,3,0,-148,1599364800,1599364800,3
GinchAnon,0,3,0,2,1589860800,1589860800,3
Flamewolf50,0,3,0,7,1594785600,1594785600,3
nocaptain11,0,3,0,624,1599883200,1604116800,3
IceMcFried,0,3,0,-8,1589774400,1589774400,3
MrKnopfler,0,3,0,44,1566187200,1604898000,3
tkuiper,0,3,0,9,1597204800,1597204800,3
NoSalt,0,3,0,-23,1591156800,1606539600,3
Cloud_floater,1,2,43,4,1609218000,1609218000,3
SIeepCap,0,3,0,22,1593662400,1608526800,3
anthrax_ripple,0,3,0,18,1603857600,1606280400,3
freelanceispoverty,0,3,0,49,1586059200,1588737600,3
Im_S4m,1,2,22,15,1606626000,1607317200,3
KobeBeatJesus,0,3,0,14,1598760000,1598760000,3
PeanutButter__,0,3,0,68,1581829200,1586059200,3
srkdummy3,0,3,0,11,1560916800,1569211200,3
poohbear98_,0,3,0,8,1591243200,1596772800,3
would92,0,3,0,37,1578373200,1580014800,3
Wretched_Form,0,3,0,30,1580792400,1580878800,3
WholePea2,0,3,0,3,1598414400,1600315200,3
dustv1n,0,3,0,26,1578805200,1579582800,3
CBDrew,1,2,921,244,1574658000,1574658000,3
ellgor94,2,1,101,24,1596600000,1602734400,3
OttoOnTheFlippside,0,3,0,21,1593057600,1598500800,3
AceyRenegade,0,3,0,75,1577077200,1579755600,3
surfingpikachu11,0,3,0,10,1584072000,1591329600,3
josh_shit,0,3,0,4,1590724800,1590724800,3
HalfSoul30,0,3,0,49,1603512000,1603598400,3
ElCaliforniano,0,3,0,11,1570075200,1574398800,3
baelzebob,0,3,0,10,1571112000,1571284800,3
6ixBeast,0,3,0,34,1573880400,1576558800,3
sparnart,0,3,0,19,1603684800,1603684800,3
RainyDayBirbs,0,3,0,42,1604030400,1607922000,3
LaterallyHitler,0,3,0,4,1588392000,1588392000,3
thequeenoflimbs,0,3,0,5,1599105600,1609218000,3
BuyShitYouDontNeed,0,3,0,8,1602648000,1602734400,3
Bacta_Junkie,0,3,0,42,1564804800,1564804800,3
simonbleu,0,3,0,-3,1571025600,1571025600,3
TheOnlyOneWhoKnows,0,3,0,11,1605675600,1605675600,3
noobmaster69He,0,3,0,3,1606626000,1611982800,3
Seakawn,0,3,0,13,1591243200,1591243200,3
ManOnTheWorld,0,3,0,27,1594612800,1594612800,3
ughughugh333,0,3,0,25,1554868800,1556078400,3
Ruin_It_For_Everyone,0,3,0,19,1606280400,1606280400,3
kraft_doubles,1,2,30,57,1598673600,1602907200,3
FuriouslyFaded,0,3,0,-52,1587787200,1587873600,3
Brilliant_Ad8845,3,0,3,0,1608872400,1609131600,3
Themembers93,0,3,0,-21,1577509200,1605934800,3
elizadi,2,1,338,38,1582002000,1605330000,3
the_sky_god15,0,3,0,27,1555992000,1607662800,3
Aenema_,0,3,0,42,1558584000,1573275600,3
General_lee12,0,3,0,74,1601956800,1608958800,3
ArcadeStallman,0,3,0,31,1577941200,1580274000,3
cr2502stroke,0,3,0,6,1596686400,1596686400,3
Jster422,0,3,0,31,1574571600,1574658000,3
haho3278,0,3,0,20,1597291200,1599537600,3
2FAatemybaby,0,3,0,5,1590033600,1601179200,3
littleoldteeth,0,3,0,-6,1551848400,1551934800,3
sleepingredneck,0,3,0,10,1580533200,1580533200,3
TripplerX,0,3,0,3,1607922000,1607922000,3
syringistic,0,3,0,-10,1606539600,1606626000,3
WyrmHero1944,0,3,0,23,1589601600,1593403200,3
BigCharlie-,0,3,0,2,1591329600,1591675200,3
SaltySamoyed,0,3,0,13,1594872000,1594872000,3
Scubabooba,0,3,0,17,1571371200,1571457600,3
Daxsmooth,0,3,0,34,1598068800,1607317200,3
Toast_On_The_RUN,0,3,0,13,1609131600,1609131600,3
butt_quack,0,3,0,102,1576126800,1576213200,3
Unlikely-Marzipan,0,3,0,8,1593662400,1594008000,3
somniphera,0,3,0,39,1593921600,1606021200,3
nathanguitarman,0,3,0,3,1607230800,1607230800,3
Ser901,0,3,0,159,1609218000,1609390800,3
imVERYhighrightnow,0,3,0,35,1584072000,1584072000,3
Bright_Side_Of_Lyfe,1,2,37,350,1603512000,1603684800,3
Smoke_Toothpaste,0,3,0,-4,1603512000,1603598400,3
EarlyBuilding5,0,3,0,4,1596513600,1596513600,3
emmy9622,0,3,0,5,1573621200,1580014800,3
Crusty_Nostrils,0,3,0,8,1575694800,1575781200,3
thnderbolt,0,3,0,70,1593230400,1605157200,3
madhattergm,0,3,0,5,1601697600,1601784000,3
CageAndBale,0,3,0,2,1612242000,1612242000,3
UnlikelyBeautiful,1,2,7,4,1581829200,1581829200,3
throwaway698008135,1,2,16,23,1612069200,1612069200,3
psychocycler,0,3,0,34,1611982800,1611982800,3
captfitz,0,3,0,-12,1577854800,1577854800,3
donnydg25,0,3,0,6,1576386000,1576386000,3
Protocosmo,0,3,0,29,1606539600,1608613200,3
Sploovy,1,2,39,26,1591156800,1596600000,3
TheAlchemist2,0,3,0,13,1585540800,1596168000,3
JackTheLantern,0,3,0,14,1609218000,1609218000,3
cervidaes,0,3,0,31,1580792400,1586491200,3
bandanahybrid,0,3,0,20,1607662800,1608267600,3
GottIstTot,0,3,0,34,1591243200,1591243200,3
ChillRedditMom,0,3,0,173,1578027600,1585540800,3
KartinMrause,0,3,0,4,1592366400,1608526800,3
cant_read_this,0,3,0,23,1592280000,1607922000,3
samisbond,0,3,0,38,1599883200,1602820800,3
Iconoclast674,0,3,0,-17,1605330000,1605330000,3
TempAccountJustTemp,1,2,112,234,1595736000,1598068800,3
bastardoflightening,0,3,0,5,1606971600,1608699600,3
Meryl_Strep_Throat,1,2,5,4,1599624000,1599624000,3
plantitas,0,3,0,11,1592971200,1592971200,3
bearlioz_,0,3,0,112,1608008400,1608008400,3
Bufster72,0,3,0,100,1607749200,1607835600,3
Velicopher,0,3,0,40,1554523200,1554523200,3
qwasy_,0,3,0,25,1585195200,1589169600,3
chebeckeren,0,3,0,12,1592452800,1596859200,3
mvalen122,0,3,0,4,1565496000,1565668800,3
TheBlackCostanza,0,3,0,38,1564459200,1569988800,3
Streiger108,0,3,0,50,1607576400,1607922000,3
unflavored,0,3,0,25,1593057600,1606366800,3
alana181,0,3,0,3,1594612800,1594612800,3
AnativeTakistani,1,2,40,60,1588737600,1589860800,3
Withinmyrange,0,3,0,-30,1605243600,1605243600,3
LegendOfJeff,0,3,0,16,1603684800,1606712400,3
VerbistaOxoniensis,0,3,0,207,1602302400,1602302400,3
galaxychildxo,0,3,0,34,1592280000,1598155200,3
Fagarito,1,2,98,10,1597896000,1597982400,3
NOTanormie70421,0,3,0,-41,1604030400,1604030400,3
Sarah_Fishcakes,0,3,0,55,1590033600,1599105600,3
Lm0y,0,3,0,13,1552276800,1566964800,3
WesternBruv,0,3,0,17,1595563200,1595563200,3
blorpitude,0,3,0,11,1563249600,1573102800,3
Simpl3xion,0,3,0,70,1582779600,1589601600,3
EggSafe,0,3,0,9,1598846400,1598846400,3
carefreedom17,1,2,21,11,1560830400,1604030400,3
uberpirate,0,3,0,62,1550811600,1587355200,3
bronzemerald,2,1,145,1,1603598400,1604116800,3
jmart762,0,3,0,4,1576645200,1576645200,3
Gosleepbaby,0,3,0,11,1588305600,1588305600,3
3L3M3NT4LP4ND4,1,2,8,2,1598673600,1598760000,3
concrete_floors,0,3,0,30,1579150800,1580360400,3
EnvironmentalPear215,1,2,1,2,1602216000,1602216000,3
slammerbar,0,3,0,3,1607835600,1607835600,3
MrBobski,0,3,0,1,1600401600,1606712400,3
sneakpeekbot,0,3,0,3,1514091600,1540180800,3
Mayonegg420,0,3,0,5,1593057600,1595908800,3
1gramweed2gramskief,0,3,0,538,1585454400,1585454400,3
Motor_Ad283,0,3,0,14,1606280400,1606971600,3
avergo,0,3,0,5,1574312400,1574312400,3
monstermud,0,3,0,30,1600747200,1608699600,3
ScarlettLooks,0,3,0,5,1576904400,1588564800,3
MieSelph,0,3,0,39,1599192000,1611896400,3
Dazencobalt17,0,3,0,7,1604293200,1605675600,3
Kietay,0,3,0,2,1592107200,1597636800,3
UltimateJuicyMemes,0,3,0,-2,1551243600,1551330000,3
HawaiianPluto,0,3,0,1,1584763200,1606626000,3
cheezie_toastie,0,3,0,158,1586404800,1588392000,3
MistookenFor,1,2,81,9,1601179200,1605243600,3
seg321,0,3,0,-38,1600747200,1600747200,3
evening_emerald,2,1,26,9,1601870400,1609304400,3
monchoochoo,0,3,0,11,1605848400,1606107600,3
qoqrqu,0,3,0,16,1585454400,1585454400,3
real_BP,0,3,0,-36,1598846400,1600401600,3
Dazzling_Rhubarb,1,2,10,5,1586923200,1586923200,3
myparentswillbeproud,1,2,10,15,1581051600,1589169600,3
Exo-2,1,2,81,3,1571976000,1609218000,3
SEPPUCR0W,0,3,0,9,1595217600,1595217600,3
Hemicore,1,2,262,13,1578459600,1578546000,3
pettytite,0,3,0,17,1580706000,1582347600,3
traleonester,0,3,0,20,1607662800,1607662800,3
galen_wright,0,3,0,3,1576645200,1576990800,3
espressmo,0,3,0,38,1594267200,1601870400,3
Craigbrand97,1,2,29,8,1548651600,1548651600,3
amsterdamnitall,0,3,0,49,1578200400,1595390400,3
DangerActiveRobots,0,3,0,13,1608094800,1608181200,3
firstdropof,0,3,0,7,1601524800,1605675600,3
mrbigrooster69,1,2,65,1,1570680000,1570680000,3
twister726,0,3,0,14,1537502400,1538539200,3
murdermymeat,0,3,0,7,1570161600,1599624000,3
Lamnent,0,3,0,34,1605330000,1611896400,3
XerxesthePersian,0,3,0,4,1556596800,1557547200,3
SexOffenderDead,1,2,4,4,1603684800,1604293200,3
ImCheesuz,0,3,0,18,1596600000,1599796800,3
bellahelvete,0,3,0,11,1581051600,1598587200,3
604-Guy,0,3,0,68,1583211600,1587182400,3
8ace40,0,3,0,31,1550638800,1576386000,3
Balthazar-247365,0,3,0,-36,1573016400,1573016400,3
Pink131980,0,3,0,50,1601179200,1606280400,3
Vikhus,0,3,0,56,1552107600,1555992000,3
peterisfrosty1,1,2,356,4,1567828800,1585454400,3
tellywatching,0,3,0,30,1574830800,1588737600,3
TheCuriousPsychonaut,1,2,16,12,1559620800,1559620800,3
Mowza2k2,0,3,0,10,1582779600,1582779600,3
quangli,0,3,0,16,1577422800,1607835600,3
lespaul1973,1,2,17,6,1599537600,1599796800,3
Psychomadeye,0,3,0,2,1599105600,1599278400,3
catetheway,0,3,0,12,1587787200,1588824000,3
Thatfilthytigger,0,3,0,9,1592971200,1592971200,3
WI_Norske,0,3,0,29,1587096000,1605675600,3
mycatsnameisroger,1,2,2,12,1607490000,1609218000,3
nivenredux,0,3,0,2,1594353600,1594353600,3
Red217,0,3,0,65,1596859200,1596859200,3
curelom_herder,1,2,44,44,1569297600,1590465600,3
I-am-Jacksmirking,1,2,6,2,1597377600,1597464000,3
tuedeluedicus,0,3,0,6,1587441600,1587441600,3
ComradeChaosCat,0,3,0,23,1593835200,1593835200,3
foreigncircle,0,3,0,-11,1571544000,1571630400,3
thezombiekiller14,0,3,0,18,1577509200,1606798800,3
dooBeCS,0,3,0,121,1592798400,1604379600,3
Rodic87,0,3,0,6,1554264000,1594440000,3
easyworthit,1,2,556,11,1594958400,1598846400,3
pandru001,0,3,0,29,1598328000,1605157200,3
PurposelessPenguin,1,2,69,3,1585454400,1585540800,3
reluctantpeon,1,2,28,11,1554350400,1554523200,3
E-Plurbis-DumbDumb,0,3,0,84,1569297600,1589774400,3
SandrineJade,0,3,0,15,1555992000,1560139200,3
deka413,0,3,0,21,1561348800,1569902400,3
just_pank,0,3,0,87,1587528000,1591070400,3
wormglow,0,3,0,31,1598328000,1598500800,3
bitter_candi,0,3,0,180,1562990400,1596513600,3
Orgidee,0,3,0,-73,1609045200,1609045200,3
Bee_Hummingbird,0,3,0,70,1598673600,1604466000,3
TheBarsenthor,0,3,0,43,1604030400,1604030400,3
whippey,0,3,0,3,1569211200,1595736000,3
Altrightcommie1,0,3,0,3,1585281600,1585627200,3
mrgeebs17,0,3,0,28,1584763200,1604293200,3
andho_m,0,3,0,9,1605416400,1605416400,3
ExpertgamerHB,0,3,0,13,1595736000,1597204800,3
goldboy3343,0,3,0,11,1529726400,1532577600,3
LeotheVGC,0,3,0,5,1599883200,1607576400,3
Bard-of-All-Trades,1,2,225,6,1605502800,1605502800,3
mattyomama,0,3,0,24,1606280400,1607576400,3
elfballs,0,3,0,33,1591675200,1592884800,3
LVII,0,3,0,434,1591243200,1591329600,3
BadDogSexyMister,0,3,0,34,1569297600,1569297600,3
mickymouse150,1,2,0,-6,1592798400,1592798400,3
VincentImpellitteri,0,3,0,58,1537848000,1547874000,3
whaddup_chickenbutt,0,3,0,40,1592452800,1593057600,3
msf455,0,3,0,15,1556769600,1565755200,3
a_kato,0,3,0,4,1608613200,1608613200,3
step1,0,3,0,10,1579669200,1579669200,3
TGlucifer,0,3,0,36,1600660800,1600920000,3
anomisk,1,2,115,3,1571284800,1572494400,3
eappy,0,3,0,-4,1607576400,1607576400,3
concocted_reality,0,3,0,32,1606712400,1606798800,3
PreschoolBoole,0,3,0,6,1607317200,1608267600,3
Nv1sioned,0,3,0,-15,1578805200,1584936000,3
DrBucket,0,3,0,3,1591502400,1606712400,3
LordShesho,0,3,0,41,1585454400,1585454400,3
Vonte958,0,3,0,20,1573362000,1574398800,3
mintyapricot,0,3,0,16,1606626000,1606626000,3
burny65,0,3,0,-4,1571112000,1571112000,3
blackop987,2,1,481,447,1593403200,1596427200,3
odizzlefizzle,1,2,14,4,1602648000,1602648000,3
Avmvb5,1,2,89,25,1593921600,1597032000,3
MPPlumber,0,3,0,37,1594267200,1600574400,3
b_buster118,0,3,0,13,1579842000,1587355200,3
splatterhead,0,3,0,84,1593662400,1598846400,3
xXFilesXx420,0,3,0,10,1612155600,1612242000,3
dazedconfusedev,0,3,0,11,1593748800,1607662800,3
KaydGameplay,0,3,0,7,1596513600,1596600000,3
DaddyD265,0,3,0,3,1599796800,1605589200,3
DrilldoBaggins2,2,1,1303,1,1581483600,1606798800,3
kingalex90,0,3,0,15,1596859200,1609390800,3
hadapurpura,0,3,0,8,1550379600,1550379600,3
Nevatis,0,3,0,19,1576472400,1607835600,3
Eternal2401,0,3,0,110,1588564800,1602216000,3
CultEscaped,0,3,0,12,1576126800,1581224400,3
ShakaZulu44,0,3,0,83,1585540800,1586664000,3
StumbleBee42,0,3,0,30,1574744400,1578546000,3
Samlikesreddit13,0,3,0,20,1594180800,1594872000,3
loner589,1,2,0,0,1573448400,1573448400,3
Gertrude37,0,3,0,15,1555905600,1555992000,3
petaline555,1,2,16,10,1534478400,1534651200,3
DankCannabinoids,0,3,0,3,1598328000,1598414400,3
sorry_wasntlistening,0,3,0,15,1454389200,1566878400,3
HistoryDogs,0,3,0,8,1607662800,1607749200,3
Inqubate,1,2,71,49,1608958800,1609304400,3
CheseWeezle,0,3,0,5,1598760000,1603598400,3
Ethical_Hunter,0,3,0,2,1581310800,1581397200,3
Braydentbaron,0,3,0,7,1587614400,1588132800,3
cisco_frost,0,3,0,21,1566360000,1605675600,3
Skeletal_Flowers,0,3,0,24,1596859200,1601352000,3
TelonTusk,0,3,0,16,1579150800,1579150800,3
Shezmu4798,1,2,18,4,1555300800,1555300800,3
the-aleph-and-i,0,3,0,29,1585627200,1585627200,3
tortoisekitty,0,3,0,5,1595044800,1595044800,3
Worldly-Librarian-49,1,2,5,10,1604203200,1604203200,3
gigipotemkin,1,2,3169,91,1605157200,1605157200,3
buttonsf,0,3,0,3,1584158400,1584158400,3
PatGar004,0,3,0,10,1572235200,1608526800,3
Momoring,0,3,0,16,1607662800,1608008400,3
brewski5niner,0,3,0,77,1604116800,1609131600,3
Trix_Rabbit,0,3,0,21,1611896400,1611982800,3
itsybitsyblitzkrieg,0,3,0,13,1598241600,1609390800,3
peyopi88,0,3,0,37,1572408000,1572843600,3
someotherkindofstone,0,3,0,11,1577854800,1609390800,3
sinsinsalabim,0,3,0,5,1595908800,1595908800,3
hploy,0,3,0,52,1576990800,1589169600,3
Radamanthos,0,3,0,29,1560139200,1560139200,3
forest_faunus_,1,2,66,9,1578978000,1578978000,3
MissRadi,1,2,523,3,1605589200,1608526800,3
beee-l,0,3,0,8,1569124800,1569124800,3
kitambi,0,3,0,10,1572321600,1578718800,3
name_is_Zai,0,3,0,7,1594785600,1594785600,3
nat2r,0,3,0,0,1585454400,1609304400,3
trex_on_cocaine,0,3,0,3,1582779600,1589947200,3
mjt5689,0,3,0,4,1600747200,1600747200,3
Coadster16,0,3,0,83,1555387200,1592366400,3
Major_Assholes,0,3,0,86,1585022400,1585022400,3
Flyawaylittlemonkey,0,3,0,23,1604030400,1609304400,3
PhishIndependent,0,3,0,-4,1606885200,1606885200,3
tmdjeon,0,3,0,24,1590552000,1595736000,3
jackmorgue,0,3,0,22,1608094800,1608440400,3
crypticfreak,0,3,0,113,1605934800,1606021200,3
Dan35oz,0,3,0,7,1521691200,1538539200,3
prprr,0,3,0,98,1580101200,1580274000,3
pub811,0,3,0,-15,1607662800,1607662800,3
cambo_,1,2,102,9,1535428800,1535515200,3
BadLuckBen,0,3,0,22,1606539600,1606539600,3
Elemor_,2,1,80,3,1578718800,1583985600,3
JASONJACKSON1948,0,3,0,24,1605243600,1606626000,3
Smoore0902,1,2,20,14,1604293200,1604379600,3
distractedtora,0,3,0,19,1575349200,1575349200,3
ellaisobel1,0,3,0,19,1573275600,1582261200,3
_ferk_,0,3,0,17,1583125200,1583298000,3
Nedgurlin,0,3,0,8,1578459600,1587182400,3
Door_rooD,1,2,0,-4,1583125200,1583125200,3
tmm1999,0,3,0,30,1594872000,1594872000,3
pig_smart,0,3,0,1,1572148800,1573016400,3
Ctrlaltbunk,0,3,0,7,1611982800,1611982800,3
cfsg,1,2,957,28,1548997200,1581138000,3
sixteenmiles,0,3,0,16,1575954000,1593921600,3
USER-NUMBER-,0,3,0,8,1602993600,1603080000,3
Shalashaskaska,0,3,0,88,1602129600,1603512000,3
Knorkebork,0,3,0,25,1568779200,1572494400,3
CyberStr,0,3,0,64,1591243200,1608008400,3
jacksonadamsa,2,1,28,1,1601265600,1601611200,3
AlekziaBlue,0,3,0,28,1600228800,1608267600,3
tirrramisu,1,2,269,46,1591502400,1596600000,3
-cosmic_dust-,0,3,0,40,1560312000,1562040000,3
sakchaser666,0,3,0,5,1599019200,1605330000,3
QueenofMars321,3,0,329,0,1606021200,1606539600,3
D3M4NNU,1,2,4,6,1594180800,1599019200,3
nesta_es,3,0,1126,0,1606971600,1607230800,3
Coltbjorn,1,2,221,36,1578200400,1578286800,3
Huda_Jama_Boom_Room,0,3,0,13,1609131600,1609304400,3
DessertWitch,0,3,0,61,1604984400,1607317200,3
gl00pp,0,3,0,7,1570939200,1609045200,3
TheKingsDM,1,2,35,4,1583298000,1584590400,3
emerald-stone,0,3,0,13,1594440000,1594440000,3
Spicypancake701,1,2,23,3,1603684800,1605502800,3
SimianControl,0,3,0,21,1593748800,1593748800,3
Exkallibur12,0,3,0,115,1606453200,1611810000,3
flaplikebjrd,0,3,0,1,1598846400,1605848400,3
ShitFacedSteve,0,3,0,77,1572580800,1572753600,3
russiantroIIbot,0,3,0,90,1589774400,1601179200,3
YourOldPalBendy,0,3,0,35,1600488000,1600660800,3
silentloler,0,3,0,5,1593662400,1608267600,3
thatlldopigthatlldo7,1,2,13,2,1557460800,1557547200,3
curtisbrownturtis,0,3,0,17,1606194000,1608872400,3
ChristopherMcLucas,0,3,0,88,1602129600,1607317200,3
Katmfoley111,0,3,0,14,1605934800,1607230800,3
mycology,0,3,0,24,1589947200,1590120000,3
johnnyb4llgame,0,3,0,10,1571889600,1607490000,3
Sciencemusk,0,3,0,6,1603512000,1603512000,3
20Wizard,0,3,0,25,1582779600,1591156800,3
forcejitsu,0,3,0,3,1576990800,1576990800,3
Secondary0965,0,3,0,15,1591848000,1595649600,3
yourmomz69420,0,3,0,128,1603166400,1603166400,3
Lodcraft,0,3,0,11,1602388800,1606194000,3
apalmer12,1,2,25,10,1608267600,1608267600,3
PotassiumLover3k,0,3,0,0,1598500800,1598500800,3
bratbarn,0,3,0,12,1605934800,1611982800,3
bryoneill11,0,3,0,-14,1562644800,1585454400,3
gotugoin,0,3,0,-1,1580360400,1608526800,3
buustamon,0,3,0,45,1598155200,1601956800,3
Bornthisweigh,0,3,0,27,1578718800,1578718800,3
DM_ME_YOUR_NUTSACK,0,3,0,7,1564977600,1564977600,3
focused8888,0,3,0,8,1569729600,1569902400,3
Cootiefish,0,3,0,15,1561435200,1598241600,3
Danjour,0,3,0,53,1606626000,1608699600,3
GMD463,0,3,0,3,1585886400,1585886400,3
paltrimi,0,3,0,9,1598414400,1600833600,3
llIlIIllIlllIIIlIIll,0,3,0,3,1603512000,1603512000,3
theangeryemacsshibe,0,3,0,0,1550898000,1564804800,3
skyyurufox,2,1,3991,31,1584504000,1584504000,3
NeonGamblor,0,3,0,-33,1585454400,1598932800,3
Al5xrocks,1,2,50,3,1604466000,1605070800,3
chrundle_tha_grate,0,3,0,7,1573275600,1574658000,3
ndu867,0,3,0,-13,1601179200,1601179200,3
PM_ME_UR_LOON_PICS,0,3,0,3,1539835200,1540008000,3
Substantial_Quote,0,3,0,13,1585454400,1585454400,3
ass_soon_as_possible,0,3,0,5,1604898000,1604898000,3
DJNerateFUCK,1,2,335,247,1575522000,1575522000,3
VarietiesOfStupid,0,3,0,25,1583384400,1586404800,3
marmotorman,0,3,0,15,1560312000,1560312000,3
leafofgrass,0,3,0,3,1579410000,1579410000,3
Sweet_Insanity,0,3,0,7,1587096000,1594094400,3
todaytrip,0,3,0,38,1607230800,1607576400,3
tarais,0,3,0,43,1591761600,1607317200,3
misanthroptimistic,0,3,0,-22,1602820800,1602820800,3
EllaL3,1,2,140,29,1601956800,1602043200,3
Rattacino,0,3,0,5,1595476800,1599710400,3
polski_zubr,1,2,34,15,1577336400,1577336400,3
loluthoughthe,0,3,0,-28,1576386000,1576386000,3
2018GTTT,0,3,0,7,1608267600,1609131600,3
moon-dust-xxx,0,3,0,23,1606626000,1609563600,3
Dramatic_Economist_4,0,3,0,48,1604466000,1608267600,3
IfItsOKWithYou,0,3,0,58,1546578000,1569470400,3
brucetwarzen,0,3,0,2,1568347200,1601524800,3
legeof008,0,3,0,2,1608267600,1608440400,3
Hobo_on_a_Stick,0,3,0,68,1560398400,1563768000,3
YingYangEnigma,0,3,0,32,1578373200,1596859200,3
Bouric87,0,3,0,3,1586836800,1605589200,3
seppo420gringo,1,2,34,17,1554350400,1554955200,3
cleverone11,0,3,0,0,1556596800,1556596800,3
IHaveLargeBalls,0,3,0,1,1585454400,1585454400,3
anas-khokho,0,3,0,22,1585195200,1586491200,3
thissucks09,0,3,0,16,1589774400,1596859200,3
LadyofLakes,0,3,0,35,1561780800,1576645200,3
bbkp15,0,3,0,11,1595390400,1595476800,3
LordSnips,1,2,27,17,1599883200,1600142400,3
Smellylildoggo,0,3,0,3,1611205200,1611205200,3
Drfoxi,0,3,0,9,1595217600,1595908800,3
chineseandscottish,0,3,0,31,1587787200,1590465600,3
snusboi,0,3,0,-10,1607835600,1607835600,3
badandbolshie,0,3,0,33,1607403600,1607403600,3
OrientalOpal,0,3,0,38,1605589200,1612155600,3
bertrandite,0,3,0,57,1574398800,1577250000,3
KennyFulgencio,0,3,0,22,1585022400,1599710400,3
OuroCEO,2,1,19,2,1582866000,1583125200,3
sarahannety,0,3,0,11,1587009600,1590552000,3
onlyredditwasteland,0,3,0,33,1583557200,1583726400,3
Zeshan_M,0,3,0,-11,1605502800,1608699600,3
Azsun77677,0,3,0,7,1578891600,1602302400,3
Autonomisty,1,2,3,39,1580274000,1588392000,3
Cautzan,0,3,0,8,1576386000,1576386000,3
RedShirtwaist,0,3,0,14,1586404800,1586404800,3
W_McAvoy,0,3,0,9,1596859200,1597377600,3
SerHung,0,3,0,21,1607230800,1607576400,3
generalmelchit,2,1,799,5,1582088400,1606885200,3
ira4,0,3,0,6,1591243200,1591243200,3
vixcurse,0,3,0,17,1590292800,1591502400,3
stevestoneky,0,3,0,31,1570075200,1572408000,3
whenthemoonatethesun,0,3,0,3,1597204800,1597204800,3
NelsonChunder,0,3,0,262,1597032000,1606626000,3
oss542,0,3,0,3,1564632000,1564632000,3
YakSquad,0,3,0,179,1577336400,1607662800,3
Bricklayering,0,3,0,16,1592971200,1592971200,3
inherpinkgarage,1,2,66,8,1588392000,1604379600,3
MissChampy,0,3,0,19,1573621200,1578459600,3
eye_of_iapetus,0,3,0,14,1508212800,1560830400,3
OurDudeOfSorrows,0,3,0,15,1588564800,1597032000,3
uncom4table,0,3,0,21,1572580800,1572580800,3
pink_nationals,3,0,127,0,1596513600,1598932800,3
LadyLohse,0,3,0,26,1598155200,1608786000,3
Dijiwolf1975,0,3,0,48,1596600000,1597809600,3
AelitaBelpois,0,3,0,23,1567656000,1567656000,3
SlickStyle,0,3,0,9,1569124800,1569124800,3
CoconutCowgirl,0,3,0,3,1586577600,1586664000,3
NewRyanMan,0,3,0,8,1593662400,1593748800,3
Adramel3ch,0,3,0,18,1556683200,1564113600,3
ProfColdheart,0,3,0,56,1589601600,1590379200,3
CycloneGhostAlpha,1,2,234,18,1593403200,1593403200,3
--vera--,0,3,0,0,1585454400,1585540800,3
skeksab,0,3,0,29,1579842000,1581051600,3
sign_on_the_window,0,3,0,38,1579237200,1585713600,3
Whiskey-Rose,0,3,0,137,1583211600,1587960000,3
DismalDiscount,0,3,0,501,1574485200,1578027600,3
TrinnyXXX,0,3,0,29,1591329600,1606971600,3
cdsce,0,3,0,15,1607490000,1607490000,3
Luwe95,0,3,0,4,1605502800,1611896400,3
alphadicks0,0,3,0,2,1596600000,1600833600,3
River0001,0,3,0,55,1593057600,1605848400,3
DryRubRibs_,0,3,0,30,1603598400,1603684800,3
smorgasbordofgayness,0,3,0,17,1583298000,1605934800,3
pttm12,0,3,0,47,1576990800,1581310800,3
Vslacha,0,3,0,60,1584763200,1584763200,3
raid555,0,3,0,5,1596859200,1608786000,3
LuKasih,0,3,0,54,1605070800,1607317200,3
GroovyGroovster,0,3,0,3,1602993600,1603080000,3
jhooksandpucks,0,3,0,7,1585454400,1585454400,3
taauji,0,3,0,13,1546232400,1546318800,3
respecttheflannel,0,3,0,11,1606626000,1606712400,3
Hohenheim_of_Shadow,0,3,0,37,1605243600,1605243600,3
psydack,0,3,0,52,1562644800,1562644800,3
sm4cc,0,3,0,-1,1557892800,1557892800,3
CaroDeCrembles,0,3,0,15,1602129600,1609045200,3
IDrinkYourSoyMilk,1,2,0,-8,1580014800,1580014800,3
Splundercrunk,0,3,0,-3,1593316800,1598846400,3
WednesdaysEye,0,3,0,11,1575176400,1576472400,3
hi_ma_friendz,1,2,21,6,1569297600,1597377600,3
Whiteliesmatter1,0,3,0,-5,1611810000,1611810000,3
ZQubit,0,3,0,47,1611896400,1612069200,3
Peak_late,0,3,0,-2,1605070800,1605157200,3
cirifoba,0,3,0,4,1568865600,1576472400,3
rookiespinster,0,3,0,7,1579150800,1580965200,3
Stevealot,1,2,1,7,1604984400,1607230800,3
grahnen,0,3,0,23,1597896000,1599278400,3
franksastroworld,2,1,351,4,1597636800,1605157200,3
Mtaylor0812_,0,3,0,41,1549342800,1567569600,3
A-COM,0,3,0,27,1583812800,1597636800,3
chadbot01,0,3,0,32,1605330000,1607662800,3
ScreamingHippy,0,3,0,8,1594699200,1595736000,3
sub1ime,0,3,0,4,1585454400,1612069200,3
DestroyThem,0,3,0,22,1589515200,1608958800,3
Suugondese,0,3,0,3,1594785600,1594785600,3
MrJayFizz,0,3,0,5,1594699200,1597377600,3
SallyNoMer,0,3,0,23,1602734400,1605330000,3
thicc__midget,0,3,0,83,1584590400,1584590400,3
Lolo_the_pirate,0,3,0,26,1607144400,1608786000,3
DoesntLiketoRespond,0,3,0,60,1591156800,1599537600,3
ElectricCreep1967,0,3,0,10,1597809600,1601870400,3
sagittariuscraig,1,2,18,16,1602993600,1602993600,3
dnpp123,0,3,0,3,1600574400,1600574400,3
SilentCornflakes,0,3,0,18,1596081600,1596168000,3
IcecreamWindow,0,3,0,51,1559620800,1591502400,3
Kawaii_PotatoUwU,0,3,0,15,1587009600,1587096000,3
Armand28,0,3,0,-21,1571025600,1600660800,3
shisu001,0,3,0,29,1597982400,1605157200,3
Gekkido,0,3,0,14,1599796800,1603512000,3
latte_overdose,0,3,0,12,1562558400,1570766400,3
Dubandubs,0,3,0,15,1579150800,1601956800,3
guccimeemaw,1,2,8,10,1608094800,1608094800,3
mitchbequiet,1,2,365,45,1593489600,1593489600,3
friedrichbojangles,0,3,0,47,1576990800,1584936000,3
Cry6a6y6,0,3,0,245,1599019200,1603512000,3
Kaliilac,1,2,45,12,1593748800,1593835200,3
LuckyTheLynx,0,3,0,6,1582693200,1596340800,3
MedicinalCum,0,3,0,78,1582347600,1589256000,3
more863-also,0,3,0,-64,1608181200,1608181200,3
triple_skyfall,0,3,0,15,1582779600,1596427200,3
frugalaccount23,0,3,0,-8,1597291200,1597377600,3
SteveBuscemiHasEyes,0,3,0,44,1582088400,1582088400,3
scrovak,0,3,0,3,1572235200,1572321600,3
ParticularInflation4,0,3,0,30,1582952400,1583038800,3
OneOf_ManyHumans,0,3,0,14,1606453200,1606539600,3
mark1nhu,0,3,0,8,1600488000,1603512000,3
breathofthemild420,0,3,0,26,1583726400,1583899200,3
antonivs,0,3,0,31,1541912400,1566187200,3
ElBiscuit,0,3,0,27,1572148800,1572148800,3
hoarding_insanity,1,2,15,2,1568001600,1568174400,3
ComradeKits24,0,3,0,20,1572667200,1577941200,3
MrEctomy,0,3,0,-75,1607922000,1607922000,3
IGGEL,0,3,0,57,1523592000,1584504000,3
spottedredfish,0,3,0,19,1565409600,1566792000,3
WyrdThoughts,0,3,0,63,1547528400,1607058000,3
Bricks_and_Birds,0,3,0,5,1591243200,1604898000,3
wretchedryan,3,0,338,0,1585368000,1608699600,3
YU_AKI,0,3,0,20,1606366800,1606798800,3
Gannicusisamal,0,3,0,12,1603425600,1606712400,3
ResistTrumpism,3,0,42,0,1599710400,1602734400,3
mynamenotavailable,3,0,2382,0,1569816000,1576645200,3
MentionItAllAndy,0,3,0,4,1569988800,1569988800,3
Joeman106,0,3,0,5,1593748800,1605243600,3
anonymous_anxiety,1,2,31,146,1608354000,1608440400,3
otterfailz,0,3,0,5,1592020800,1592020800,3
hamgrey,0,3,0,9,1606712400,1606712400,3
throwaway1093483,1,2,73,19,1604466000,1604552400,3
rhade333,0,3,0,-6,1609304400,1609304400,3
xAsilos,0,3,0,4,1605502800,1605502800,3
lyckeekat,2,1,6886,26,1594699200,1596772800,3
S_DLB,0,3,0,16,1583211600,1597377600,3
dunderheid17,0,3,0,-6,1601956800,1601956800,3
pokap91,0,3,0,3,1571284800,1578891600,3
thesameboringperson,0,3,0,182,1611896400,1611896400,3
shhsandwich,0,3,0,31,1568692800,1603598400,3
akaSomebody,0,3,0,0,1603684800,1606712400,3
iwantnews1,0,3,0,50,1583038800,1592971200,3
CharizardThough,2,1,117,3,1563768000,1582088400,3
LumpyBoobAttitude,0,3,0,15,1576126800,1576386000,3
Throwaway145226755,1,2,2,2,1596945600,1596945600,3
burntbagelbandit,1,2,109,87,1601179200,1601179200,3
DC38x,0,3,0,32,1580274000,1585454400,3
richhcirrich,0,3,0,16,1592452800,1597636800,3
gride9000,0,3,0,63,1573621200,1573880400,3
thatfishyyguy,0,3,0,14,1569470400,1569988800,3
bluepuddings,0,3,0,6,1599278400,1608786000,3
twunting,0,3,0,-9,1605502800,1605502800,3
Gelatinoussquamish,2,1,115,27,1575694800,1577595600,3
chaosgirl93,0,3,0,24,1572321600,1576472400,3
LaskoLad,0,3,0,23,1607317200,1607317200,3
Waba1abadubdub,0,3,0,5,1590897600,1607835600,3
ohstarrynight,1,2,11,4,1572148800,1588305600,3
llamaguy420,3,0,260,0,1584676800,1611982800,3
frippilin,0,3,0,23,1553486400,1553486400,3
Squawkers77,0,3,0,5,1575954000,1575954000,3
MongooseDog85,1,2,26,28,1556769600,1594699200,3
THErealROFLCOPTER,0,2,0,10,1569038400,1572667200,2
mjquinn1,0,2,0,21,1587355200,1587355200,2
TeamRedundancyTeam,0,2,0,3,1609045200,1609045200,2
Peeky_Rules,0,2,0,4,1605675600,1605848400,2
mr_steal_yo_round,0,2,0,2,1612155600,1612155600,2
lanzo-,1,1,13,4,1608267600,1608267600,2
skiller215,0,2,0,21,1581397200,1606107600,2
jdolla604,0,2,0,29,1590033600,1590552000,2
SavouryPlains,0,2,0,3,1580533200,1609131600,2
hulk235,0,2,0,5,1575954000,1575954000,2
vauntedtrader,0,2,0,11,1594872000,1596772800,2
TheStateIsImmoral,0,2,0,-97,1580706000,1580706000,2
XysidheQueen,0,2,0,12,1573707600,1573707600,2
Dune17k,0,2,0,9,1557460800,1557460800,2
beholdersi,0,2,0,4,1600660800,1600747200,2
venusinscorpio1,0,2,0,3,1614488400,1614574800,2
noon_nous,0,2,0,5,1585627200,1602043200,2
Stunts23,0,2,0,20,1566878400,1569988800,2
innocentrrose,0,2,0,7,1600747200,1600920000,2
NoBeRon79,0,2,0,4,1583899200,1583899200,2
FractexMoozix,0,2,0,6,1605589200,1605675600,2
elijahmcdade,0,2,0,2,1605070800,1605070800,2
Onesight360,0,2,0,0,1578373200,1578459600,2
higgins271,0,2,0,5,1592712000,1592712000,2
throwawayjustsayhay,0,2,0,3,1599451200,1599451200,2
heegos,0,2,0,156,1605416400,1609390800,2
burtzev,2,0,19,0,1494648000,1565496000,2
sjm293,0,2,0,15,1604898000,1604898000,2
COPELAHAMA,0,2,0,10,1600920000,1602302400,2
mano1990,0,2,0,3,1600488000,1605934800,2
lessdecidable,0,2,0,20,1549688400,1569038400,2
Misscuudi,0,2,0,25,1570766400,1585195200,2
mtnlady,0,2,0,31,1591243200,1594872000,2
ameck16,0,2,0,12,1609045200,1609045200,2
Asheleyinl2,0,2,0,3,1585627200,1589860800,2
GonzoBalls69,0,2,0,46,1579928400,1598068800,2
weeniehutjr420,0,2,0,24,1576645200,1586404800,2
mypseudonymyoyoyo,0,2,0,16,1602475200,1605762000,2
sos291,0,2,0,20,1591416000,1591416000,2
Usukidoll,0,2,0,6,1589947200,1590379200,2
LuxNocte,0,2,0,25,1608526800,1608526800,2
scoreboy69,0,2,0,7,1585108800,1585108800,2
Oberon_Swanson,0,2,0,10,1574398800,1584244800,2
gus2155,1,1,20,3,1612155600,1612155600,2
letthemeatkitsch,0,2,0,13,1586923200,1587528000,2
nathenitalian,0,2,0,4,1584676800,1584676800,2
sulkee,0,2,0,11,1606280400,1606280400,2
Blackrollychair,0,2,0,13,1569988800,1573966800,2
nml003,1,1,21,3,1568260800,1568347200,2
chelseaannehubble,0,2,0,63,1547182800,1551848400,2
RoseyOneOne,0,2,0,-2,1586836800,1603598400,2
DonnaHightower,0,2,0,2,1587528000,1587528000,2
Gissal,0,2,0,3,1557288000,1557979200,2
darkstaride,0,2,0,42,1580965200,1580965200,2
pibble22,0,2,0,3,1589947200,1603857600,2
Sirliamtron,0,2,0,2,1572062400,1572062400,2
cynoclast,0,2,0,11,1583985600,1605934800,2
leapbitch,0,2,0,20,1599105600,1600574400,2
NickAlmighty,0,2,0,15,1579755600,1579928400,2
infallibledegenerate,0,2,0,17,1583899200,1583899200,2
Superpigmen,0,2,0,24,1602216000,1605848400,2
CToxin,0,2,0,10,1606539600,1606539600,2
Elubatela,0,2,0,23,1605762000,1605848400,2
IrishGamer3,0,2,0,3,1572667200,1572667200,2
KongoOtto,0,2,0,0,1582174800,1608872400,2
BluntNarwhal,0,2,0,32,1573016400,1602043200,2
Bananaface96,1,1,80,2,1601352000,1601438400,2
ibayibay1,0,2,0,49,1568347200,1572753600,2
hribayz2,0,2,0,28,1585886400,1585886400,2
bleeblorb,0,2,0,3,1611982800,1611982800,2
QuizzicalWombat,0,2,0,4,1581310800,1607835600,2
CozmicBean,0,2,0,9,1602734400,1609045200,2
ventscalmes,0,2,0,20,1565409600,1565409600,2
shitlord_god,0,2,0,2,1591848000,1599364800,2
foxx_ghost,0,2,0,4,1578978000,1585627200,2
JadeFalcon777,0,2,0,6,1550552400,1550552400,2
NATOuk,0,2,0,31,1605848400,1605848400,2
dat_grue,0,2,0,3,1589774400,1607662800,2
EntrepreneurCool9543,0,2,0,1,1599019200,1599019200,2
ijhopethefuckyoudo,0,2,0,12,1607317200,1607317200,2
Plasros,0,2,0,26,1602475200,1608094800,2
Bored_Gaining,0,2,0,54,1607230800,1607230800,2
mentalhealthrowaway9,0,2,0,-33,1589860800,1589860800,2
morichunike,2,0,47,0,1526875200,1526875200,2
girlywish,0,2,0,6,1574398800,1578978000,2
useryeyeye,0,2,0,37,1604379600,1604379600,2
ornatagrey,0,2,0,15,1594785600,1608699600,2
blahgle,0,2,0,8,1598846400,1603080000,2
Brodhisativa,0,2,0,12,1587700800,1587700800,2
joshrmacd,0,2,0,35,1573448400,1573534800,2
ChopinCJ,0,2,0,2,1603339200,1603339200,2
UUorW,0,2,0,15,1560139200,1570507200,2
Matthew-Barnett,0,2,0,4,1548478800,1548478800,2
jerseyjdog,0,2,0,5,1561694400,1567742400,2
DeaconOrlov,0,2,0,25,1589515200,1589515200,2
AlrightButNo,0,2,0,18,1541566800,1541653200,2
crownedprophet,0,2,0,22,1598241600,1601956800,2
bonobopaniscus,2,0,1138,0,1559361600,1562126400,2
aygxw,0,2,0,48,1546578000,1546750800,2
ArabianPeninsula,0,2,0,-8,1603512000,1603512000,2
Dumbprof,0,2,0,12,1594699200,1598414400,2
thejesustrolley,0,2,0,50,1573448400,1573621200,2
BusterCall4,0,2,0,11,1588996800,1588996800,2
fuckwork5435,0,2,0,40,1569988800,1570075200,2
randomikron,0,2,0,7,1601524800,1603684800,2
brownsugarandsalt,0,2,0,10,1562990400,1571803200,2
Garden_Hermit_Fan,1,1,12,3,1609131600,1609131600,2
Sharkictus,0,2,0,41,1599019200,1599192000,2
MixedGender,1,1,13,1,1594612800,1594612800,2
Artichoke19,0,2,0,11,1548738000,1572843600,2
zman419,1,1,10,3,1599537600,1599537600,2
thecakefashionista,0,2,0,7,1600660800,1601265600,2
CodeineKrazy,0,2,0,3,1576990800,1589688000,2
healthy-gal,0,2,0,6,1604030400,1604116800,2
GracefulRaven,0,2,0,4,1580446800,1580533200,2
hotelactual777,0,2,0,42,1607576400,1607662800,2
xoxota99,0,2,0,6,1590638400,1594872000,2
oleg-py,0,2,0,11,1596513600,1599278400,2
Spicy-N-Sassy,0,2,0,138,1598587200,1600574400,2
ChickenNoodleSloop,0,2,0,8,1605589200,1605589200,2
HelenEk7,0,2,0,4,1605589200,1605589200,2
fwl3,0,2,0,2,1553140800,1560744000,2
hisslux,0,2,0,4,1565496000,1571198400,2
BillCosbysMixolgist,0,2,0,33,1609477200,1609477200,2
garrypig,0,2,0,16,1567310400,1571803200,2
Rowbot19,0,2,0,4,1574312400,1574398800,2
Mvanwalks421,0,2,0,0,1582779600,1606885200,2
dumboracula,0,2,0,-10,1599019200,1599019200,2
Airdorno,0,2,0,7,1608526800,1608526800,2
airforcefairy,0,2,0,4,1547528400,1600142400,2
username_entropy,0,2,0,26,1580706000,1580706000,2
cjsdaman101,0,2,0,2,1590033600,1590033600,2
deeendnamtoe,0,2,0,21,1606194000,1606194000,2
Dejan05,0,2,0,15,1609477200,1609477200,2
knuggles_da_empanada,0,2,0,28,1591243200,1608267600,2
OneTonWantonWonton,0,2,0,10,1573621200,1573621200,2
edeslayer,1,1,12,9,1604725200,1604725200,2
Jm_215,0,2,0,2,1585454400,1585454400,2
exuviaa,2,0,406,0,1550379600,1550984400,2
jayrock_was_changing,0,2,0,11,1577509200,1577509200,2
sirfirewolfe,1,1,1489,2,1591588800,1593316800,2
greenolivesandgarlic,0,2,0,2,1595649600,1597723200,2
BloodlustROFLNIFE,0,2,0,11,1604379600,1604466000,2
jonathanfs,1,1,223,49,1583384400,1584417600,2
vaultdweller6666,0,2,0,20,1605416400,1608958800,2
BillNyesHugePenis,0,2,0,8,1602043200,1609218000,2
bitchinbaja,0,2,0,6,1562212800,1565409600,2
richiehustle,0,2,0,2,1635652800,1635652800,2
MyNameIshmael,0,2,0,0,1573966800,1574571600,2
no-code,0,2,0,8,1604379600,1606539600,2
porkisbeef,0,2,0,4,1606021200,1606366800,2
Winterstille17,0,2,0,1,1603857600,1603857600,2
TheNinjaChicken,0,2,0,8,1588910400,1606712400,2
rarijack4prez,0,2,0,4,1592020800,1594353600,2
irofirelord,0,2,0,15,1583211600,1607144400,2
InsanityRoach,0,2,0,15,1607403600,1607490000,2
identicaltheft,1,1,59,9,1606021200,1606798800,2
pewpewhitguy,0,2,0,30,1602129600,1602129600,2
The_Sly_Trooper,0,2,0,4,1584244800,1601524800,2
Cymry_Cymraeg,0,2,0,74,1585713600,1598241600,2
Raccoon_JS,0,2,0,36,1566878400,1589860800,2
cary730,0,2,0,4,1577336400,1591329600,2
nint_love,0,2,0,6,1589860800,1589860800,2
Darwin-Charles,0,2,0,155,1602302400,1602302400,2
Jdsudz,0,2,0,24,1606712400,1606712400,2
Ok_Lemon1635,0,2,0,2,1608786000,1609477200,2
wrik01131992,0,2,0,3,1601265600,1601352000,2
NoMoreNicksLeft,0,2,0,6,1604984400,1604984400,2
uglyswan101,0,2,0,3,1602475200,1602475200,2
dragonyeuw,0,2,0,20,1579582800,1579842000,2
Crispy95,0,2,0,13,1564632000,1564632000,2
howamistillwiping,0,2,0,50,1606885200,1606885200,2
systemacaido,1,1,3,1,1576126800,1600488000,2
Blought,0,2,0,53,1602043200,1604030400,2
TraceAbility89,0,2,0,3,1591329600,1591329600,2
VladMartel,0,2,0,9,1589860800,1593662400,2
Denissssss,0,2,0,2,1608786000,1608786000,2
Inquisitor_Whitemane,0,2,0,3,1542776400,1556683200,2
SecretScorekeeper,0,2,0,16,1511154000,1511154000,2
chloesmiddlefinger,0,2,0,18,1581051600,1605934800,2
Quitthatgrit,0,2,0,2,1606366800,1606366800,2
yzykid27,0,2,0,10,1581310800,1581310800,2
fivepoundparrot,0,2,0,12,1562731200,1564372800,2
nakedv35,0,2,0,5,1598241600,1599278400,2
avrsn,0,2,0,-1,1605330000,1605934800,2
random_aces27,0,2,0,383,1582606800,1582779600,2
KimberlyLippington,0,2,0,16,1565755200,1574571600,2
gonzothegreat13,0,2,0,6,1599105600,1600660800,2
courtneylovesbutthol,0,2,0,-54,1573362000,1573362000,2
veszar,0,2,0,16,1568260800,1576558800,2
teelop,0,2,0,27,1554436800,1576386000,2
Jomii_D,0,2,0,3,1537070400,1537156800,2
Wreckwitness,0,2,0,7,1585108800,1585195200,2
PM-Your-Tiny-Tits,0,2,0,14,1587614400,1588651200,2
amc3631,0,2,0,10,1594440000,1599192000,2
Tchamp30,1,1,35,398,1602475200,1604466000,2
ManicTypist,0,2,0,4,1564804800,1582002000,2
VermiciousKnidzz,0,2,0,7,1607576400,1607835600,2
TheBeanDog,0,2,0,8,1565409600,1567569600,2
AnAtypicalAutistic,0,2,0,-2,1608613200,1608699600,2
i_eat_babies__,1,1,646,1,1583899200,1584331200,2
Morpheus_the_God,0,2,0,3,1608613200,1608613200,2
namesRhard1,0,2,0,5,1586491200,1591934400,2
shrine,0,2,0,12,1545195600,1545195600,2
popcorncolonel,0,2,0,9,1606021200,1606107600,2
TheGuyThatSaysMoist,0,2,0,3,1607922000,1607922000,2
gumpgrab,0,2,0,12,1570593600,1570593600,2
FinishYourLunch,0,2,0,47,1611896400,1611982800,2
booboo8706,0,2,0,19,1606798800,1606798800,2
DreysunTheOne,0,2,0,2,1600056000,1604030400,2
Daktush,0,2,0,-1,1591156800,1591329600,2
psychopythonmetrist,0,2,0,5,1611896400,1611896400,2
spoonacc,0,2,0,14,1577077200,1577941200,2
Iminhere3000,0,2,0,11,1595131200,1600228800,2
journalingfilesystem,0,2,0,2,1602648000,1602734400,2
WrongAnswer88,1,1,10,1,1602561600,1602561600,2
KingfisherClaws,0,2,0,9,1572321600,1572321600,2
CSIBNX,0,2,0,7,1570075200,1570075200,2
EmmaTheRobot,0,2,0,16,1563681600,1563768000,2
HazyPeanut,0,2,0,3,1607317200,1607922000,2
tubularical,0,2,0,12,1582088400,1585454400,2
bomdango,0,2,0,4,1601006400,1601179200,2
SuggestedPigeon,0,2,0,25,1581483600,1587441600,2
DoctorMedkit,0,2,0,-1,1606539600,1606626000,2
brightneonmoons,0,2,0,10,1575867600,1587268800,2
ellWatully,0,2,0,14,1601524800,1611723600,2
finallyfree1,0,2,0,3,1590033600,1590033600,2
freediverx01,0,2,0,7,1581483600,1581483600,2
Comrade_Vodka,0,2,0,2,1593748800,1593748800,2
thedrkace,1,1,18,2,1588737600,1588824000,2
Rhaifa,0,2,0,65,1568520000,1587009600,2
Afrotopia,0,2,0,-39,1587787200,1588737600,2
theoriginalt2m,1,1,42,1,1601352000,1606626000,2
djburokas,0,2,0,14,1582952400,1583384400,2
throwaway_11252020-,0,2,0,5,1606366800,1606366800,2
Drkstrm9,0,2,0,18,1590638400,1592107200,2
jahronimo,0,2,0,67,1596600000,1596600000,2
daemein,2,0,4,0,1599796800,1603425600,2
kaybee915,0,2,0,12,1591502400,1606712400,2
sendsomedickpix,0,2,0,73,1595131200,1608267600,2
MrMusicMaster,0,2,0,12,1611810000,1611810000,2
Cornwallis,0,2,0,15,1553486400,1580965200,2
WrongTequila,0,2,0,4,1576818000,1576818000,2
luingar2,0,2,0,33,1601784000,1606366800,2
carrotsinajar,0,2,0,15,1601179200,1601179200,2
Keystone_Heavy1,0,2,0,-12,1607662800,1607662800,2
wildteddies,2,0,3,0,1579928400,1582088400,2
Interesting_Package,0,2,0,34,1580446800,1600228800,2
IamstraightIswear,0,2,0,2,1533700800,1542085200,2
jlovinn,0,2,0,47,1562472000,1562472000,2
cdjohn24,0,2,0,-13,1572494400,1579064400,2
Foreign_mask,0,2,0,6,1575694800,1575694800,2
Pahka1947,0,2,0,9,1552708800,1552708800,2
samhouston69,0,2,0,16,1609304400,1609304400,2
YourMomoness,1,1,46,4,1572843600,1574917200,2
Nevertrumper1978,0,2,0,-3,1581224400,1581224400,2
notagangsta,0,2,0,19,1593662400,1597636800,2
kryonex,0,2,0,24,1606885200,1606971600,2
lawble,0,2,0,7,1606539600,1606539600,2
wurstomat,1,1,22,7,1552449600,1552449600,2
ScorseseTheGoat86,1,1,51,4,1594699200,1599624000,2
unlimiteddrip,0,2,0,10,1608354000,1608526800,2
wing3d,0,2,0,10,1603512000,1603512000,2
BullpenCatcher,0,2,0,3,1585454400,1585454400,2
Atoonix,0,2,0,16,1561780800,1561780800,2
PurpleAstronomerr,0,2,0,549,1603339200,1603512000,2
kadean14,0,2,0,-24,1584763200,1584849600,2
RedRaiderTravis,0,2,0,8,1564027200,1564113600,2
Pipes32,0,2,0,32,1599624000,1599624000,2
Speedhabit,0,2,0,-5,1567569600,1598760000,2
cooljazzboi,0,2,0,4,1571803200,1574053200,2
RealHot_RealSteel,0,2,0,17,1612069200,1612069200,2
LysergicUnicorn,1,1,52,1,1589688000,1590292800,2
Zerbiedose,0,2,0,-11,1574658000,1574658000,2
Drynwyn,0,2,0,57,1597118400,1597809600,2
daoistic,0,2,0,9,1563249600,1563249600,2
Dash83,0,2,0,10,1578373200,1578373200,2
bikesub,0,2,0,5,1594353600,1594440000,2
Hitlers_Gas_Bill,0,2,0,10,1548910800,1565755200,2
CatsFantastic,0,2,0,15,1546578000,1547528400,2
SpacePanther17,0,2,0,16,1552708800,1554264000,2
Crossbon3s,2,0,230,0,1592798400,1594785600,2
DoctorMckay202,0,2,0,3,1599883200,1599883200,2
Mobile_Memory,0,2,0,-2,1599019200,1599105600,2
Double-Let8318,2,0,125,0,1594180800,1596254400,2
Danbobway,0,2,0,10,1560744000,1560744000,2
Kitchen_Elevator,0,2,0,3,1589688000,1589688000,2
texicali37,0,2,0,1,1585454400,1587528000,2
ZyglroxOfficial,0,2,0,74,1591675200,1597377600,2
velvetdrips,0,2,0,16,1596945600,1607662800,2
JJHobbitsis,1,1,12,6,1606366800,1606366800,2
stinkylilboy97,0,2,0,13,1591243200,1591243200,2
ShelbySplatterpunk,0,2,0,14,1603339200,1603339200,2
AbuzeME,0,2,0,24,1605934800,1605934800,2
BrokenAlien,0,2,0,17,1556942400,1557028800,2
vendilion,0,2,0,38,1599710400,1599710400,2
gdmfr,0,2,0,11,1590120000,1590120000,2
distortedsymbol,0,2,0,3,1607576400,1607662800,2
awksaw,0,2,0,35,1580619600,1580965200,2
Butterbeard1,0,2,0,4,1577422800,1581397200,2
omartheduck,0,2,0,3,1580792400,1580792400,2
puppypoet,0,2,0,10,1598587200,1598587200,2
sunmkd91,0,2,0,2,1637470800,1637470800,2
dogs_are_cool123,0,2,0,11,1579150800,1580792400,2
GlobbityGlook,0,2,0,5,1604984400,1605157200,2
d_bo,0,2,0,7,1595649600,1600574400,2
pppmaryj,0,2,0,367,1601611200,1601611200,2
ianthemoff,0,2,0,-1,1584763200,1584763200,2
HOWLINGVAGABON,0,2,0,436,1602129600,1603425600,2
kelsey0309,0,2,0,7,1560484800,1560484800,2
throwawayowowowoowow,0,2,0,10,1576472400,1577163600,2
nauseypete,0,2,0,22,1607403600,1607576400,2
Deeptrance83,0,2,0,13,1603598400,1603598400,2
noodlecat4,0,2,0,10,1591934400,1593403200,2
jrbarber85,0,2,0,9,1602993600,1609304400,2
amposa,0,2,0,13,1605070800,1605070800,2
polishneverdies,0,2,0,5,1603684800,1607317200,2
will103,0,2,0,11,1576645200,1576645200,2
shockedpikachu123,0,2,0,53,1586836800,1586836800,2
FoxVeridian,0,2,0,9,1595476800,1599796800,2
surfvvax,0,2,0,4,1593662400,1593662400,2
mollie128,0,2,0,12,1591675200,1604466000,2
Zeltron2020,0,2,0,4,1608526800,1608526800,2
wordsworthn34,1,1,244,6,1602648000,1602648000,2
artsydapper,0,2,0,9,1594440000,1599451200,2
CardboardGristle,0,2,0,3,1603857600,1604466000,2
BrokeBrooker,0,2,0,2,1607576400,1607662800,2
doogleonion,0,2,0,2,1567224000,1567224000,2
Sraktai,0,2,0,3,1595044800,1595131200,2
H1ghlund3r,0,2,0,8,1591156800,1594353600,2
Virdon,0,2,0,2,1594872000,1594872000,2
JillianV,0,2,0,4,1588651200,1591243200,2
DejfCold,0,2,0,-6,1554523200,1554523200,2
DotaDadPudge,0,2,0,-4,1597982400,1604811600,2
mikeydblock,0,2,0,12,1543381200,1544418000,2
assailer10,0,2,0,2,1584676800,1584676800,2
HitlersPenisPump,0,2,0,2,1587009600,1592798400,2
mp90,0,2,0,5,1609045200,1609045200,2
Belt_Substantial,1,1,7287,1,1603598400,1603598400,2
myum,0,2,0,12,1583038800,1584072000,2
Boxpuffle,0,2,0,2,1573794000,1573794000,2
chessplayer798,0,2,0,16,1594612800,1594612800,2
FutureComplaint,0,2,0,6,1571630400,1571630400,2
emofleabagbitch,1,1,4,2,1602216000,1602561600,2
grabacactus,0,2,0,191,1604030400,1604030400,2
BullSprigington,0,2,0,-1,1594008000,1604379600,2
inklingPro1980,0,2,0,4,1550552400,1550552400,2
SarryPeas,0,2,0,5,1584158400,1605675600,2
justicedtrsf,0,2,0,30,1604984400,1607317200,2
theomegageneration,0,2,0,8,1573707600,1573707600,2
ganondorf_is_clutch,0,2,0,34,1607662800,1609477200,2
NEREVAR117,0,2,0,13,1606539600,1606539600,2
Icecat1239,0,2,0,2,1585454400,1585454400,2
depressedchic_exe,0,2,0,3,1605675600,1606626000,2
spotila7,0,2,0,25,1579150800,1579150800,2
LondonZrath,0,2,0,2,1583643600,1583643600,2
hellahallowhallo,0,2,0,5,1566187200,1576904400,2
deeeeeeeeeereeeeeeee,0,2,0,-6,1578114000,1578114000,2
mrsmelanieowen,0,2,0,6,1566360000,1574139600,2
guiltyremnantcig,1,1,111,20,1605157200,1605157200,2
khan_of_xiyu,0,2,0,32,1593489600,1594440000,2
AbbrevTranslatorBot,0,2,0,0,1605848400,1605848400,2
palepeachh,0,2,0,20,1553918400,1553918400,2
loox1490,0,2,0,-3,1576558800,1584244800,2
That1guyuknow16,0,2,0,30,1584676800,1607576400,2
Snacheezerisesup,0,2,0,9,1591156800,1591329600,2
Lonelywaits,0,2,0,7,1592280000,1598155200,2
peachy901,0,2,0,67,1540958400,1568088000,2
advthjudarv,0,2,0,118,1608699600,1608699600,2
quacks_echo,1,1,314,20,1560657600,1561521600,2
NotRalfHutter,0,2,0,17,1581051600,1581051600,2
IGrowMarijuanaNow,0,2,0,5,1589947200,1606366800,2
tnavelerriemanresu,0,2,0,16,1567569600,1567569600,2
karenfromfinance_,0,2,0,10,1593230400,1593230400,2
SonHero,0,2,0,27,1545627600,1551589200,2
wemadethemachine,0,2,0,15,1581310800,1581310800,2
-PaperbackWriter-,0,2,0,6,1592884800,1592884800,2
riokd,1,1,14,1,1605762000,1605934800,2
tiamat_487,0,2,0,231,1601697600,1603252800,2
__merdock379__,0,2,0,58,1598673600,1600315200,2
mpolo76,2,0,31,0,1601870400,1603252800,2
okfinejustletsgo,0,2,0,7,1591934400,1594008000,2
SnakeModule,0,2,0,37,1571025600,1581570000,2
_that_dam_baka_,0,2,0,2,1610859600,1610859600,2
SurprisingJack,1,1,265,1,1603512000,1603598400,2
DangKilla,0,2,0,-5,1584763200,1584763200,2
supermassiveanus,0,2,0,-16,1560830400,1560830400,2
AhMajesty,0,2,0,3,1561780800,1574053200,2
ReginaldvonPossumIV,0,2,0,8,1605070800,1606107600,2
pandora_monsoon,1,1,58,5,1607403600,1608786000,2
Bingo7779,0,2,0,10,1602648000,1606885200,2
IdonthaveanIP,0,2,0,3,1634788800,1634788800,2
DixQwerty,2,0,17,0,1601870400,1606107600,2
pezewuziz,0,2,0,5,1589947200,1595822400,2
kultureisrandy,0,2,0,16,1584849600,1584849600,2
alcoholicfurby,0,2,0,109,1580792400,1580792400,2
thorrentacc,0,2,0,2,1580619600,1580619600,2
Yebbo,0,2,0,17,1514091600,1514350800,2
Lemonic_Tutor,0,2,0,106,1595822400,1596340800,2
fgggrgtrgthh,0,2,0,11,1565323200,1572667200,2
ThisIsSevenOfSwords,0,2,0,33,1573966800,1593662400,2
ArquivistaTara,0,2,0,6,1587528000,1589169600,2
HomelessLives_Matter,0,2,0,9,1603598400,1603684800,2
Garlic-Butter-Fly,0,2,0,147,1592020800,1607662800,2
Smug010,0,2,0,20,1598500800,1598587200,2
HenryHenderson,0,2,0,3,1579064400,1582088400,2
matergallina,0,2,0,94,1587355200,1587441600,2
BrickofPeace,1,1,0,-5,1609390800,1609390800,2
eleitl,1,1,16,1,1583985600,1611810000,2
AcidPhazzze,0,2,0,6,1566446400,1573966800,2
TheRealMicrowaveSafe,0,2,0,27,1586404800,1586491200,2
belugabeach,0,2,0,62,1577768400,1580792400,2
dr-robotnick,0,2,0,5,1583726400,1583726400,2
throwaway28149,0,2,0,3,1603598400,1603598400,2
_MoDoc,0,2,0,8,1612069200,1612069200,2
Stage3GuildNavigat0r,0,2,0,53,1579755600,1580360400,2
frickhead69,0,2,0,8,1594526400,1594526400,2
xEman26x,0,2,0,11,1588305600,1608872400,2
firestorm713,0,2,0,9,1597032000,1597291200,2
B1naryB0t,0,2,0,25,1608872400,1609218000,2
HooHooHooisers,0,2,0,41,1608008400,1608008400,2
kimjongunleakednudes,0,2,0,4,1599192000,1599192000,2
bearstomach,0,2,0,134,1588996800,1588996800,2
justshower,0,2,0,4,1592366400,1592452800,2
adhdenhanced,0,2,0,8,1603512000,1603857600,2
dirtpaws,0,2,0,4,1608094800,1608786000,2
kemites,0,2,0,9,1557288000,1557547200,2
nandryshak,0,2,0,50,1574398800,1575435600,2
Credible_Cognition,0,2,0,-2,1607662800,1607662800,2
Dr_Jahko,0,2,0,5,1576126800,1576213200,2
proglysergic,0,2,0,2,1606021200,1606021200,2
b-khaldun,1,1,30,2,1582606800,1588305600,2
Acommie,0,2,0,7,1567224000,1567224000,2
champagnepolarbear,0,2,0,4,1612414800,1612414800,2
Simply_Cosmic,0,2,0,1,1578200400,1578978000,2
human_salamander12,1,1,11,5,1607058000,1607058000,2
Lupardan,0,2,0,17,1583985600,1608786000,2
likemyhashtag,0,2,0,28,1576645200,1604030400,2
hugh_abbott,0,2,0,3,1566964800,1566964800,2
supremacyisfoolish,0,2,0,3,1605589200,1607835600,2
Deadpool_MM,0,2,0,7,1570420800,1570420800,2
quickso,0,2,0,95,1595563200,1603339200,2
rystaman,0,2,0,11,1600660800,1600747200,2
truepopoon,0,2,0,8,1594440000,1595217600,2
MoldyRadicchio,0,2,0,18,1584504000,1584504000,2
amethystinthedark,0,2,0,7,1580360400,1581051600,2
meinname2,0,2,0,2,1608008400,1611810000,2
TheWither031,0,2,0,6,1562212800,1562212800,2
real_dea,0,2,0,-7,1589169600,1589169600,2
LoveNowAndForever,0,2,0,57,1580187600,1580533200,2
Happy-nobody,0,2,0,18,1585022400,1599883200,2
Fantuhm,0,2,0,1,1608872400,1608872400,2
UseAnarchismUnbound,0,2,0,-1,1579323600,1579410000,2
Anger_Machine,0,2,0,8,1602216000,1603684800,2
mattyag,0,2,0,23,1599537600,1603598400,2
atillathefun201,0,2,0,5,1608181200,1608440400,2
Seven-Force,0,2,0,20,1549256400,1569729600,2
Theneler,0,2,0,2,1589860800,1589860800,2
ExtensivePatience,0,2,0,6,1574312400,1607662800,2
PM_ME_UR_WATAMALONES,0,2,0,6,1593057600,1603771200,2
OtherPlayers,0,2,0,40,1580360400,1601352000,2
KittyGal0re,1,1,21,2,1600660800,1600747200,2
mainlyupsetbyhumans,0,2,0,5,1603512000,1603598400,2
The_Beer_Guy,0,2,0,0,1572148800,1572148800,2
Neuchacho,0,2,0,14,1591243200,1591243200,2
MayKinBaykin,0,2,0,47,1594267200,1608181200,2
ReadyTheGuillotine,0,2,0,5,1604725200,1605157200,2
TrofimS,0,2,0,2,1612069200,1612069200,2
Gabskiwii,1,1,2,2,1600401600,1600488000,2
DJCyberman,0,2,0,3,1608699600,1608699600,2
roaddogsupreme,1,1,16,2,1584676800,1585108800,2
legendnox,0,2,0,24,1594353600,1600574400,2
Standard_Permission8,0,2,0,5,1608440400,1608526800,2
antpile11,0,2,0,8,1605762000,1605762000,2
throwawayjimesjon,0,2,0,5,1608354000,1608354000,2
Buwski,0,2,0,33,1602129600,1605070800,2
Dragoseraker,0,2,0,11,1593835200,1593835200,2
BenjaminTW1,0,2,0,63,1574398800,1608181200,2
Otipemisiwak,0,2,0,11,1547096400,1547096400,2
danni_darko,1,1,0,3,1578718800,1579928400,2
haenger,0,2,0,2,1601870400,1601870400,2
I_am_ur_daddy,1,1,62,15,1591156800,1591156800,2
WPB_Mod,0,2,0,6,1598587200,1598846400,2
El-Tigre1337,1,1,91,3,1574053200,1574139600,2
Blackinmind,0,2,0,14,1566187200,1572843600,2
lyaxia,0,2,0,12,1605416400,1605416400,2
DelusionsOfGranduer,0,2,0,3,1555387200,1555473600,2
donotjerge,0,2,0,9,1605675600,1608440400,2
Outundaboutlier,0,2,0,17,1575522000,1581397200,2
drunkbusdriver,0,2,0,-47,1605934800,1605934800,2
urutapu,0,2,0,6,1588046400,1588219200,2
t-stu2,0,2,0,-1,1602216000,1602216000,2
Camais,1,1,54,7,1584590400,1586404800,2
bblade2008,0,2,0,9,1594440000,1594785600,2
euclideanvector,0,2,0,8,1578978000,1578978000,2
verygoodyesyes-_-,1,1,49,1,1608267600,1608354000,2
headgirl,0,2,0,44,1597032000,1597032000,2
olBBS,0,2,0,58,1595476800,1595476800,2
ValkyrieInValhalla,0,2,0,4,1597204800,1611982800,2
annualgoat,0,2,0,7,1599019200,1599019200,2
Dragoness42,0,2,0,9,1603598400,1603598400,2
felixfff,0,2,0,-2,1442894400,1442894400,2
CommodorePerson,0,2,0,2,1607317200,1608699600,2
Barky21,0,2,0,15,1598846400,1598846400,2
fobmanx,0,2,0,16,1603684800,1608699600,2
travelsonic,0,2,0,5,1596600000,1596772800,2
BitMan20,1,1,56,2,1567483200,1567569600,2
TrotskyStan,0,2,0,21,1568260800,1569211200,2
teabagabeartrap,0,2,0,7,1540180800,1540958400,2
FutureFreaksMeowt,0,2,0,29,1578114000,1578114000,2
alexmosesharris,2,0,560,0,1555041600,1558065600,2
HatRemov3r,0,2,0,-5,1605762000,1608440400,2
LEVII777,0,2,0,0,1564891200,1564977600,2
left_tiddy,0,2,0,10,1606107600,1606107600,2
Ender825,0,2,0,2,1601870400,1611810000,2
jubilant_dubilant,0,2,0,3,1608267600,1608267600,2
Pepsimans-Cocksleeve,0,2,0,19,1608008400,1612069200,2
jawnzoo,0,2,0,4,1599624000,1599710400,2
PRINCE-KRAZIE,0,2,0,3,1593662400,1596340800,2
enbyfish,1,1,25,10,1576645200,1576645200,2
wsims4,0,2,0,13,1602907200,1602907200,2
JackRuu,2,0,44,0,1478232000,1478232000,2
jakereyn22,0,2,0,2,1563163200,1563163200,2
Avi_King88,0,2,0,36,1592107200,1608786000,2
Prince-In-Purple,0,2,0,4,1600920000,1600920000,2
MXIIA,1,1,58,2,1600574400,1601611200,2
Manibe8,0,2,0,36,1572753600,1573448400,2
SC487,0,2,0,-11,1589342400,1589342400,2
10bandtotal,0,2,0,24,1561089600,1594699200,2
equestrienneM,0,2,0,22,1567051200,1578027600,2
Boarina,0,2,0,48,1601956800,1608181200,2
VerySmartBoi,0,2,0,7,1594526400,1594526400,2
free_range_tofu,0,2,0,10,1607835600,1607835600,2
intNx,0,2,0,7,1590120000,1590120000,2
Jackthechief2,0,2,0,-10,1608267600,1608267600,2
form_an_opinion,0,2,0,9,1603512000,1603512000,2
desquibnt,0,2,0,3,1605589200,1606539600,2
PaulRuddsJeans,1,1,7,22,1559188800,1559188800,2
IWantToGiverupper,0,2,0,2,1601524800,1601784000,2
lisarulesandusuck,0,2,0,16,1591329600,1603425600,2
Al_Nor_Mar,0,2,0,2,1604466000,1604466000,2
ChubbiestLamb6,0,2,0,108,1591416000,1591416000,2
tittrucker,0,2,0,6,1592193600,1592280000,2
DusanTadic,0,2,0,1,1604638800,1604638800,2
IntelligentCod3,0,2,0,8,1601870400,1611723600,2
DancesWithRaptors,0,2,0,22,1573966800,1606539600,2
CaptainHazama,0,2,0,31,1605934800,1606539600,2
treehugger100,0,2,0,3,1597032000,1597032000,2
critically_damped,0,2,0,23,1604030400,1604984400,2
AmpaMicakane,0,2,0,7,1573621200,1573621200,2
ThatCrazyTonkGuy,0,2,0,2,1608267600,1608267600,2
eusociality,0,2,0,15,1568088000,1573189200,2
utkaereng,0,2,0,1,1589860800,1589860800,2
icecreambefore,0,2,0,2,1557979200,1559880000,2
tossanothaone2me,0,2,0,62,1604293200,1604293200,2
usrevenge,0,2,0,10,1603252800,1605502800,2
foolish_me,0,2,0,40,1596168000,1603598400,2
BrewTheDeck,0,2,0,2,1594353600,1594353600,2
aspiring_geek83,0,2,0,3,1602302400,1602302400,2
cozyqueen420,0,2,0,8,1607662800,1607749200,2
drugmaker07,0,2,0,1,1588910400,1588910400,2
FrancoTorres2019,1,1,19,2,1590638400,1590638400,2
solarsailor353,0,2,0,3,1584158400,1584590400,2
PieleenWhiff,0,2,0,22,1575608400,1591675200,2
herbisthewerd,0,2,0,6,1571630400,1571630400,2
Seff-bone,0,2,0,6,1601438400,1601870400,2
Greeenieweeenie,0,2,0,20,1579755600,1599451200,2
W1n3t0n,0,2,0,-9,1590379200,1590379200,2
Sweaty-Bumblebee4055,0,2,0,4,1603512000,1604811600,2
longknives,0,2,0,15,1600228800,1601524800,2
HawtyQuail,2,0,66,0,1603166400,1605243600,2
LiveFree_OrDie603,0,2,0,25,1560571200,1560657600,2
HonestCarpet,0,2,0,-18,1591934400,1593489600,2
JDude13,0,2,0,20,1572843600,1598068800,2
mp9936,0,2,0,2,1594872000,1595044800,2
ACBorgia,0,2,0,20,1599624000,1599624000,2
stellolocks,0,2,0,9,1594440000,1596427200,2
_0123456,0,2,0,6,1585454400,1585454400,2
Queasy-Cauliflower-6,0,2,0,11,1608613200,1608613200,2
HillariousRodham,0,2,0,7,1607490000,1608008400,2
qquestionable,0,2,0,66,1608181200,1611982800,2
dnwlnri,0,2,0,3,1576213200,1576213200,2
LudwigVanHalen,0,2,0,52,1607317200,1608872400,2
Cerxi,0,2,0,6,1575781200,1577854800,2
flashnash,0,2,0,-11,1592971200,1592971200,2
Doza93,0,2,0,11,1607662800,1607749200,2
illwill_lbc83,0,2,0,86,1585454400,1585454400,2
hrafnkat,0,2,0,11,1585886400,1585886400,2
ultratunaman,0,2,0,20,1575003600,1577336400,2
LordAnon5703,0,2,0,-4,1598587200,1602734400,2
mj371,1,1,23,4,1585454400,1585454400,2
eklatea,1,1,21,1,1594699200,1601352000,2
Whargarblle,0,2,0,27,1607490000,1607490000,2
steelymouthtrout,0,2,0,7,1603598400,1603598400,2
MindIsTheFearKiller,0,2,0,25,1600660800,1600660800,2
Doc-J,0,2,0,6,1597377600,1599192000,2
signal-insect,0,2,0,23,1607144400,1608008400,2
Royceunion1024,0,2,0,5,1562299200,1562299200,2
BasicWhiteHorse,0,2,0,11,1597291200,1602993600,2
Dwihgt,1,1,18383,4,1581138000,1581138000,2
Moe_Syzlak_,0,2,0,7,1605589200,1605675600,2
Antiworkthrowaway,1,1,26,4,1562126400,1562126400,2
DJBeachCops,0,2,0,28,1592798400,1595476800,2
Kanshan,0,2,0,14,1592193600,1592971200,2
Vyolle,0,2,0,53,1575435600,1600056000,2
bigberthaboy,0,2,0,7,1548219600,1549342800,2
steezymcdiss,0,2,0,28,1588651200,1588651200,2
DeltaPositionReady,0,2,0,6,1608354000,1608872400,2
harmonyouwish,0,2,0,2,1609995600,1609995600,2
Inquiryplzhelp,0,2,0,22,1600488000,1601870400,2
albdjakajab,0,2,0,0,1611982800,1611982800,2
piano248,0,2,0,3,1612242000,1612328400,2
weed-boy520,0,2,0,4,1587960000,1590292800,2
adinfinitum,0,2,0,6,1565323200,1582261200,2
Trick_Acanthisitta58,0,2,0,12,1609131600,1609131600,2
sm0lshit,0,2,0,11,1579410000,1580965200,2
johndoesall,0,2,0,19,1596600000,1596600000,2
iFunnyPrince,0,2,0,3,1564977600,1564977600,2
MekkaGodzilla,0,2,0,3,1592280000,1593316800,2
SleepyforPresident,0,2,0,56,1585022400,1585022400,2
leidakar,0,2,0,18,1569038400,1569038400,2
Dewt2,2,0,238,0,1594872000,1595822400,2
MyTeaIsMighty,0,2,0,9,1582779600,1600660800,2
Shensai,0,2,0,2,1582088400,1582088400,2
Haramune,2,0,3476,0,1594353600,1600056000,2
bikemikeasaurus,0,2,0,32,1577422800,1585627200,2
ninetiesnostalgic,0,2,0,3,1608526800,1608526800,2
EthanNewb,0,2,0,3,1569470400,1569470400,2
Threeoptions123,0,2,0,5,1604898000,1605070800,2
Bruised_Penguin,0,2,0,34,1585108800,1585108800,2
OhMyGloob,0,2,0,2,1567310400,1567483200,2
sweet_puck,0,2,0,54,1579237200,1580965200,2
IGotPIPed,0,2,0,11,1605675600,1605675600,2
bugbladderbeast,0,2,0,34,1597550400,1598241600,2
shook_not_shaken,0,2,0,3,1599710400,1599710400,2
m_ahman,1,1,22,4,1591675200,1591675200,2
Solell,0,2,0,2,1608613200,1608613200,2
HereToSmileAtYou,0,2,0,19,1585022400,1585022400,2
redditaccount127,0,2,0,5,1605934800,1612501200,2
journeyManCredenza,0,2,0,10,1572235200,1573362000,2
Whole_Wonderful,1,1,10029,1,1604466000,1604466000,2
_night_cat,0,2,0,6,1603512000,1603512000,2
Victor187,0,2,0,8,1597636800,1598414400,2
EntropyFighter,0,2,0,3,1589860800,1589860800,2
Dirtyfingerteemo,0,2,0,4,1579064400,1591243200,2
UncoolOcean,0,2,0,7,1578978000,1584676800,2
dagumet117,0,2,0,8,1592280000,1592280000,2
_TYFSM,0,2,0,10,1609390800,1611810000,2
CommuFisto,0,2,0,5,1583726400,1583726400,2
thekinetickid,0,2,0,0,1591243200,1592798400,2
machammp,0,2,0,5,1593144000,1593230400,2
Chrisisc00l,0,2,0,-2,1596859200,1597636800,2
1y251251251225,0,2,0,12,1582088400,1582088400,2
figfriend,0,2,0,225,1607317200,1607403600,2
Revverb,0,2,0,8,1572667200,1572667200,2
ChristopherByte,0,2,0,11,1552363200,1552622400,2
Demnchi,0,2,0,6,1606021200,1607662800,2
_bexcalibur,0,2,0,55,1608872400,1608872400,2
educatedEconomist,0,2,0,22,1584763200,1584763200,2
kingkalypso,0,2,0,11,1600228800,1600228800,2
nicduus,0,2,0,6,1589601600,1589688000,2
Oyasumi_Aqua,0,2,0,41,1561348800,1561435200,2
fakeshaf,0,2,0,3,1604116800,1604116800,2
darkbyrd,0,2,0,3,1575954000,1576040400,2
NPC186,0,2,0,12,1597377600,1597896000,2
STLBluesLGB,0,2,0,-30,1590379200,1590379200,2
Zombiellen,0,2,0,2,1567396800,1567396800,2
awenonian,0,2,0,15,1599019200,1599019200,2
latestagememealism,0,2,0,4,1593316800,1593489600,2
mackenzi_x,0,2,0,-7,1592452800,1592539200,2
DeNiroPacino,0,2,0,6,1607576400,1608699600,2
justletmehaveausernm,1,1,8,3,1576818000,1584676800,2
HannukahPajamas,0,2,0,6,1581742800,1582002000,2
100percentthisisit,0,2,0,6,1605589200,1605589200,2
Shocky1384,0,2,0,-2,1603512000,1603598400,2
metagnathous,0,2,0,16,1587355200,1588392000,2
inesko,0,2,0,1,1599019200,1600488000,2
JabronSalami,0,2,0,7,1600920000,1600920000,2
magicfultonride,0,2,0,21,1603512000,1603512000,2
Gumball1122,0,2,0,27,1599796800,1599796800,2
HiThereIAmLame,0,2,0,35,1608094800,1608181200,2
Puffycheeses,0,2,0,34,1589515200,1589515200,2
MathTheUsername,0,2,0,18,1573534800,1573534800,2
k_whole,0,2,0,5,1573102800,1573102800,2
comptejete,0,2,0,3,1571976000,1581051600,2
player398732429,0,2,0,16,1600660800,1605157200,2
redderhunt,0,2,0,4,1607403600,1608613200,2
SGNick,0,2,0,43,1581915600,1581915600,2
lowrads,0,2,0,6,1581829200,1603512000,2
Ima_White_Guy,0,2,0,-2,1573102800,1573102800,2
MuddyFilter,0,2,0,1,1578373200,1581051600,2
RoboCowboy,0,2,0,13,1578286800,1580446800,2
She_is_Cheese,0,2,0,14,1560484800,1563940800,2
UndoingMonkey,0,2,0,2,1601870400,1611810000,2
kexavah558ask,0,2,0,3,1576818000,1580878800,2
Cofet,0,2,0,-19,1578373200,1578373200,2
Chudwaffles,0,2,0,22,1571716800,1571716800,2
PosadismIsInevitable,0,2,0,20,1596513600,1598068800,2
shrinkydink00,0,2,0,4,1582779600,1582866000,2
nbrown1589,0,2,0,5,1555387200,1555387200,2
sox3502us,0,2,0,18,1599364800,1599796800,2
radtads,0,2,0,3,1581742800,1581742800,2
elppaenip,0,2,0,97,1577422800,1577422800,2
dreadymama314,0,2,0,2,1607317200,1607317200,2
Eliravenx,0,2,0,25,1590984000,1593748800,2
liliagrace37,0,2,0,8,1574658000,1578286800,2
drainage_holes,0,2,0,63,1582866000,1588305600,2
M3KVII,0,2,0,4,1571371200,1571371200,2
lowerextremity,0,2,0,15,1540612800,1541480400,2
blueshirts16,1,1,218,2,1599105600,1608958800,2
chippy-special,0,2,0,5,1593057600,1593057600,2
krw268,0,2,0,26,1583125200,1590984000,2
thepeopleschoice666,0,2,0,22,1602216000,1604898000,2
turtlewhisperer23,0,2,0,1,1605848400,1605848400,2
LetsLive97,0,2,0,54,1609131600,1609131600,2
heinsbjk,0,2,0,2,1611982800,1612069200,2
Annjul666,0,2,0,92,1607144400,1608526800,2
DefTotallyNotForPorn,0,2,0,19,1606798800,1606798800,2
ForeverInBlackJeans,0,2,0,3,1604030400,1604552400,2
Harambiz,0,2,0,13,1556251200,1573448400,2
arbolitoloco,0,2,0,2,1603944000,1603944000,2
jenjosephine94,1,1,803,3,1574658000,1576645200,2
gburgwardt,0,2,0,-2,1588564800,1588564800,2
CruisinThroughFatvil,0,2,0,2,1608094800,1608094800,2
promisinganthesis,1,1,53,3,1607749200,1607749200,2
MrMathbot,0,2,0,5,1589342400,1609045200,2
fakeaccount113,0,2,0,2,1605589200,1605589200,2
Black_Koopa_Bro,0,2,0,2,1598760000,1600315200,2
StefTakka,0,2,0,3,1596600000,1609045200,2
jlovesit1,0,2,0,44,1598414400,1598414400,2
crazyinsane65,0,2,0,2,1601524800,1601697600,2
ThomasThaWankEngine,0,2,0,-7,1569988800,1589688000,2
ritrm,0,2,0,9,1569988800,1569988800,2
TehUnderachievers,1,1,14,11,1588737600,1599105600,2
TacoBellionaire,0,2,0,-18,1571803200,1571889600,2
leiladobadoba,0,2,0,105,1575349200,1575349200,2
Cristian888,0,2,0,12,1606539600,1606626000,2
Leift_Clike,0,2,0,8,1551502800,1551502800,2
KomboloiWielder,0,2,0,20,1594872000,1595563200,2
ursois,0,2,0,15,1599019200,1599019200,2
throwieBovvie,0,2,0,27,1565582400,1565582400,2
bex231,0,2,0,5,1589342400,1589428800,2
whatidoatworkmon2fri,0,2,0,3,1577077200,1578718800,2
freakyslob,0,2,0,4,1602734400,1605848400,2
Theminutenewt,0,2,0,11,1569124800,1569124800,2
TrendingBot,2,0,121,0,1580360400,1584504000,2
Whiteowl-25,0,2,0,4,1608786000,1608786000,2
314cake,0,2,0,3,1607835600,1609045200,2
ElderSkyrim,0,2,0,2,1602216000,1602216000,2
ubiMOSH,0,2,0,14,1592798400,1597291200,2
sebuq,1,1,2,1,1601352000,1607576400,2
cornyhornblower,0,2,0,-4,1591416000,1591416000,2
canarky,0,2,0,3,1589256000,1590033600,2
RichardShotglassIII,0,2,0,22,1580360400,1589947200,2
ancaaremere,2,0,690,0,1584504000,1587787200,2
PunktualPenguin,0,2,0,5,1560744000,1560744000,2
I_Lust_Commy_Mommy,0,2,0,2,1584244800,1584417600,2
Constant_Link1940,0,2,0,4,1608181200,1608526800,2
stoffwaffle,0,2,0,99,1573880400,1574053200,2
andoooooo,0,2,0,-28,1607922000,1607922000,2
PM_ME_MY_REAL_MOM,0,2,0,19,1603512000,1603512000,2
HeinzGGuderian,0,2,0,15,1597291200,1605330000,2
godandgoddess,0,2,0,44,1582779600,1598068800,2
padawantologist,0,2,0,9,1607749200,1607749200,2
theNickydog,0,2,0,1,1587009600,1609304400,2
TheFlabbs,0,2,0,6,1597636800,1599883200,2
OxygenMafia,0,2,0,8,1603684800,1606626000,2
plolp1234567890,1,1,0,2,1465099200,1465444800,2
NissanSkylineGT-R,0,2,0,3,1564804800,1564804800,2
2717192619192,0,2,0,9,1574658000,1598500800,2
Gasnax,0,2,0,2,1615438800,1615438800,2
Cosbos_Bos,0,2,0,12,1566360000,1566446400,2
Mysterious-Ad-9030,0,2,0,3,1603684800,1603684800,2
supersammy00,0,2,0,39,1612155600,1612155600,2
NeomarxistZoomDweeby,0,2,0,7,1579323600,1579410000,2
progressivememetics,0,2,0,25,1595649600,1595736000,2
A_Topical_Username,0,2,0,2,1606021200,1606107600,2
VoidHog,0,2,0,-13,1576386000,1576386000,2
HarmenKrusemeijer,0,2,0,-28,1581138000,1581570000,2
Apprehensive-Talk540,0,2,0,26,1611810000,1611896400,2
DrMowz,0,2,0,42,1607922000,1608440400,2
glittergangsterr,0,2,0,12,1600574400,1602129600,2
MrKitteh,0,2,0,3,1587182400,1588996800,2
laughing_behemoth,0,2,0,6,1596600000,1596686400,2
h2ohful,1,1,18,1,1568433600,1568606400,2
CarolusMagnus_Frank,0,2,0,15,1596254400,1596254400,2
SuicideIsSoSexyRrrrr,0,2,0,6,1609563600,1609563600,2
himaximusscumlordus,0,2,0,-5,1605502800,1605502800,2
EcoTimeEater,0,2,0,6,1551934800,1563336000,2
erinemeraldlove,0,2,0,5,1574139600,1574226000,2
ColdOnTheFold,0,2,0,3,1606712400,1606798800,2
litolic,0,2,0,3,1573534800,1588132800,2
SpectreOfCommunism,0,2,0,42,1579755600,1587873600,2
An_Unruly_Mob,0,2,0,-9,1548565200,1563854400,2
thedumbestdeer,0,2,0,10,1569988800,1582779600,2
Jomah2,0,2,0,6,1551762000,1551848400,2
akamejka,0,2,0,7,1573102800,1579669200,2
Kuhlermaster,0,2,0,13,1578027600,1602907200,2
2020isajoke,0,2,0,4,1608440400,1608699600,2
101_lurking_101,0,2,0,33,1584504000,1584590400,2
ExcellentSmith,0,2,0,15,1606971600,1606971600,2
TheWithdrawn,0,2,0,37,1572148800,1572667200,2
calciumpotass,0,2,0,14,1556337600,1556337600,2
exoticbatmeat,0,2,0,2,1589860800,1591156800,2
internal_truth,0,2,0,-4,1592971200,1593057600,2
Oknatora,0,2,0,-1,1585454400,1585454400,2
Uniquitous,0,2,0,3,1583812800,1588910400,2
Executioner3018,0,2,0,6,1608699600,1608699600,2
theboxman154,0,2,0,78,1608958800,1609304400,2
EddyBot,0,2,0,13,1597982400,1608958800,2
Spookydennys,1,1,211,11,1576731600,1576818000,2
shadowskill11,0,2,0,2,1604293200,1606626000,2
Seabiscuitsmonkey,0,2,0,8,1582347600,1582434000,2
comradecleave,0,2,0,17,1578978000,1583726400,2
heimda11,0,2,0,8,1598328000,1601092800,2
GalacticCats,0,2,0,79,1584244800,1589428800,2
balllllhfjdjdj,0,2,0,11,1601352000,1601438400,2
LokiiVegas,0,2,0,1,1606539600,1607403600,2
GraceAndMayhem,0,2,0,3,1544504400,1544504400,2
malomia,0,2,0,43,1600142400,1600142400,2
PlusUltra__,0,2,0,10,1599537600,1599537600,2
foxyvolumnia,1,1,435,9,1582693200,1582693200,2
Standard-Ad-6213,0,2,0,12,1602734400,1611896400,2
somaalchemy,1,1,3,1,1590033600,1590206400,2
OhioanRunner,0,2,0,59,1574917200,1574917200,2
Colzach,0,2,0,15,1588564800,1589860800,2
snorelando,0,2,0,167,1603425600,1603512000,2
kmrandom,0,2,0,19,1580014800,1587700800,2
thepotatoman23,0,2,0,80,1582693200,1593230400,2
SheepSpace9,1,1,40,1,1556337600,1556337600,2
Financingmylife,1,1,0,2,1607490000,1607576400,2
CaseyTheCreator,0,2,0,11,1592193600,1601179200,2
BorkfortheBORKGod,0,2,0,44,1578459600,1589601600,2
Glorfon,0,2,0,3,1607490000,1607490000,2
stealing_thunder,0,2,0,17,1575435600,1575435600,2
a_random_npc123,0,2,0,5,1562385600,1562385600,2
minutebreadtube,0,2,0,9,1602216000,1602216000,2
JL5887,0,2,0,5,1546664400,1550552400,2
HenryCavillsBigTits,0,2,0,13,1600142400,1600401600,2
ilikecats1007,0,2,0,17,1597896000,1609218000,2
Osric250,0,2,0,6,1603512000,1603598400,2
Penguin335,0,2,0,15,1594440000,1596859200,2
soccerskyman,0,2,0,8,1582261200,1582261200,2
kenblocksdaughter,0,2,0,5,1592712000,1593921600,2
sharezea,0,2,0,8,1593489600,1607317200,2
couldnothinkof1,1,1,0,-4,1606885200,1606885200,2
AwkwardLoner99,0,2,0,4,1590206400,1590292800,2
kgbnick,0,2,0,16,1598241600,1599192000,2
StephMujan,0,2,0,2,1573362000,1579323600,2
WaggishCape,1,1,131,9,1578027600,1578027600,2
ModernLOCKE,0,2,0,1,1578373200,1589515200,2
lo-li-ta,0,2,0,14,1580533200,1582779600,2
closeknittattoos,0,2,0,28,1597809600,1597809600,2
BuraisonFujii,0,2,0,1,1571803200,1571803200,2
ShaneIsAtWork,0,2,0,58,1583812800,1583812800,2
QuestItem,0,2,0,2,1589342400,1593576000,2
abbystraaalt,0,2,0,4,1597636800,1598932800,2
empress_tesla,0,2,0,8,1591675200,1591675200,2
2randy,0,2,0,6,1579410000,1607835600,2
thatsgoodposture,0,2,0,8,1464667200,1465272000,2
mahonrig,0,2,0,33,1589256000,1589256000,2
foreverthrowaway7887,0,2,0,5,1571976000,1572062400,2
ScantilyCladDad69,0,2,0,65,1606366800,1606366800,2
TheNo1pencil,0,2,0,5,1569384000,1569470400,2
KenRoy312,0,2,0,11,1560571200,1560657600,2
Bjorn_Suicide,0,2,0,7,1608094800,1608094800,2
SoftGas,0,2,0,13,1585454400,1585454400,2
marahsnai,0,2,0,11,1598500800,1598500800,2
Cawnor_,0,2,0,14,1569643200,1569729600,2
Lurker8886,0,2,0,20,1594008000,1594180800,2
lost_souls_club,0,2,0,6,1573102800,1575954000,2
Suffolk1970,0,2,0,14,1603598400,1606712400,2
Valdearg20,0,2,0,-1,1605070800,1605070800,2
imimagination,0,2,0,7,1580533200,1580533200,2
dRaidon,0,2,0,1,1597636800,1598155200,2
strawbopankek,0,2,0,50,1604203200,1609131600,2
DubsNoScrubs,1,1,17,5,1595736000,1595736000,2
Lurkersbane,0,2,0,3,1604811600,1608526800,2
ppapperclipp,0,2,0,5,1606539600,1606626000,2
BenjaminTalam,0,2,0,14,1585454400,1585454400,2
winter457,1,1,1313,3,1547874000,1557460800,2
JimEasy,0,2,0,5,1605157200,1605157200,2
nameislessimportant,0,2,0,16,1608440400,1608526800,2
flipside4cp,0,2,0,2,1549170000,1558152000,2
VideoLeoj,0,2,0,6,1583125200,1583125200,2
RainbowDarter,0,2,0,219,1553486400,1600056000,2
TheGuidanceCounseler,0,2,0,39,1594612800,1597464000,2
wildwestprincess,0,2,0,16,1551502800,1551502800,2
Sadistek,0,2,0,8,1608613200,1608613200,2
whatablunderfullife,0,2,0,-4,1608267600,1608354000,2
3rdGenChickenChaser,0,2,0,5,1570939200,1572494400,2
AWDe85TSi,0,2,0,5,1602993600,1606453200,2
AStrayUh,0,2,0,7,1581224400,1581224400,2
MostProbablyPetra,0,2,0,12,1599192000,1601438400,2
KingN56,0,2,0,4,1585800000,1585800000,2
drkarlsov,0,2,0,5,1597896000,1598587200,2
ExistentialCrisis97,2,0,81,0,1565496000,1566878400,2
dynamicthoughts,0,2,0,49,1545714000,1545714000,2
evilmunkey8,0,2,0,593,1602043200,1602043200,2
potatoskinned,0,2,0,90,1555905600,1555905600,2
FlatEarthWizard,0,2,0,11,1579064400,1585454400,2
JeanLuc_Richard,0,2,0,5,1592020800,1608958800,2
solidstate25,0,2,0,4,1603684800,1603684800,2
xviNEXUSivx,0,2,0,8,1599105600,1602475200,2
pileopoop,0,2,0,10,1598155200,1606971600,2
Rhys3333,0,2,0,2,1603512000,1603598400,2
Yougbear_ColoradoG74,0,2,0,-10,1607749200,1607749200,2
Difficult_Ad_9392,0,2,0,3,1604203200,1611810000,2
marukisnee,2,0,19,0,1526875200,1526875200,2
meatbeatmagritte,0,2,0,13,1581051600,1581051600,2
BathoundKappa007,0,2,0,2,1554177600,1554177600,2
Natuur1911,0,2,0,33,1582002000,1582002000,2
kidkipp,0,2,0,2,1603512000,1603598400,2
HerzogAndDafoe,0,2,0,72,1561089600,1561089600,2
HouseDowningVicodin,0,2,0,2,1612069200,1612069200,2
MammothDimension,0,2,0,3,1603512000,1611896400,2
erik4life,0,2,0,2,1619150400,1619150400,2
ontogeny1,0,2,0,15,1576213200,1582088400,2
Reggiebones92,0,2,0,6,1607490000,1607490000,2
mouldar,0,2,0,5,1607835600,1608872400,2
MyOtherAccount8719,2,0,153,0,1598414400,1601092800,2
WebAPI,0,2,0,4,1561780800,1561780800,2
ComputerPants,1,1,64,6,1584504000,1584504000,2
Mrs_Plague,0,2,0,18,1603512000,1603598400,2
SoyTempeh,0,2,0,5,1607576400,1607749200,2
123treeship,1,1,16,13,1591156800,1594526400,2
bgol111,0,2,0,2,1561003200,1562040000,2
cartmichael,1,1,11,1,1526529600,1526702400,2
duxrdown,0,2,0,-4,1551243600,1551416400,2
wellmacsgay,1,1,492,20,1549342800,1549429200,2
bluew200,0,2,0,0,1586232000,1586232000,2
Laughingboy14,1,1,240,1,1562644800,1562731200,2
RichBitchDress,0,2,0,11,1596600000,1596600000,2
Lucktanker,0,2,0,14,1598846400,1601784000,2
DDestro36,0,2,0,10,1580706000,1580706000,2
carfniex,0,2,0,3,1582088400,1589860800,2
Doctor_Swag,0,2,0,10,1611896400,1611896400,2
Sasquatch97,0,2,0,4,1600228800,1602129600,2
queerblackrose,0,2,0,41,1567224000,1569124800,2
A-Grey-World,0,2,0,5,1603598400,1605157200,2
TBDF12,0,2,0,28,1581570000,1581570000,2
356789yvn0wyhue6b,0,2,0,25,1608786000,1608786000,2
FlyingJib,0,2,0,17,1602648000,1602734400,2
youknow99,0,2,0,3,1603512000,1603598400,2
deathismyhedge,0,2,0,12,1594872000,1594872000,2
Dennidude,0,2,0,8,1551848400,1551848400,2
hcaz1113,0,2,0,2,1601524800,1608526800,2
Nizzlebomb,0,2,0,-1,1589860800,1589860800,2
W15H77,0,2,0,20,1604725200,1606885200,2
habb,0,2,0,4,1606626000,1606626000,2
Beingabummer,0,2,0,9,1569124800,1569124800,2
ChefBoredAreWe,0,2,0,32,1604725200,1605762000,2
aaaaji,0,2,0,-20,1583557200,1584244800,2
mickymouse106,1,1,0,-1,1603252800,1603252800,2
MerlinTheBDSMWizard,0,2,0,1,1584763200,1584763200,2
DoomCultSupremacy,0,2,0,29,1555992000,1555992000,2
permanentlytemporary,0,2,0,6,1594094400,1594440000,2
lunakiss_,0,2,0,8,1607922000,1607922000,2
-ich-bin-a-btch-,0,2,0,24,1585886400,1585972800,2
posadismgangang,0,2,0,3,1579755600,1579755600,2
burtalert,0,2,0,59,1605502800,1605502800,2
chief313,0,2,0,25,1604984400,1605070800,2
LookingForVheissu,0,2,0,6,1603512000,1603512000,2
ZipperZapZap,0,2,0,8,1599451200,1600747200,2
aBeaSTWiTHiNMe,0,2,0,10,1603252800,1606021200,2
blargghonkk,0,2,0,11,1594440000,1595390400,2
Balancedmanx178,0,2,0,2,1611982800,1611982800,2
ninjacouch132,0,2,0,2,1573189200,1573275600,2
little-red-turtle,0,2,0,2,1589947200,1589947200,2
thegovwantsussubdued,0,2,0,2,1595649600,1595649600,2
Green-Moon,0,2,0,0,1595822400,1595822400,2
IWONTHEMONEY,0,2,0,16,1571630400,1571630400,2
that1dyke,0,2,0,24,1566360000,1578978000,2
Urfavorganiccheeto,0,2,0,18,1593662400,1593662400,2
Browhytfamihere,0,2,0,2,1643086800,1643086800,2
speakinginparticles,1,1,243,9,1569643200,1569643200,2
vavaspoon,0,2,0,-9,1612069200,1612069200,2
viperfide,0,2,0,3,1591329600,1591329600,2
CJShort,0,2,0,148,1607230800,1607230800,2
TheSaint7,0,2,0,-16,1579410000,1579410000,2
loveofthegame1,0,2,0,-6,1587268800,1591502400,2
CircuitMa,0,2,0,49,1611982800,1611982800,2
giraffaclops,0,2,0,36,1597032000,1608786000,2
Da1sycha1n,0,2,0,11,1611896400,1611982800,2
Burritothedog,0,2,0,3,1565755200,1583643600,2
bippy33,0,2,0,8,1584072000,1584072000,2
mopthebass,0,2,0,12,1578373200,1578373200,2
vindaloopdeloop,0,2,0,6,1564545600,1565150400,2
bigboygamer,0,2,0,2,1589947200,1589947200,2
BlueMyLoad69,0,2,0,14,1578805200,1578805200,2
not-a-Shrek,1,1,170,17,1603598400,1603598400,2
851216135,0,2,0,9,1592884800,1605762000,2
randomuser-384,2,0,745,0,1600401600,1603512000,2
astrocactus14,0,2,0,12,1573794000,1573966800,2
Zade-Agor,0,2,0,41,1561867200,1562817600,2
AlectheLad,0,2,0,6,1599192000,1600228800,2
TheOneWhoMixes,0,2,0,4,1585022400,1600660800,2
MindHermit,0,2,0,5,1596168000,1596254400,2
Red_Apple_Pie,0,2,0,10,1611810000,1611982800,2
Dunotuansr,0,2,0,6,1606539600,1606626000,2
Succinate_dehydrogen,0,2,0,5,1594094400,1608786000,2
juhotuho10,1,1,2,1,1600747200,1607662800,2
Taco-twednesday,0,2,0,0,1588046400,1611982800,2
SpecialT9,0,2,0,46,1576904400,1602993600,2
senorsnrub,0,2,0,14,1578632400,1597636800,2
silverflower1998,2,0,130,0,1598414400,1606885200,2
SirGander,0,2,0,9,1570420800,1572494400,2
Osskyw2,0,2,0,-3,1591243200,1591243200,2
_IA_Renzor,0,2,0,20,1606539600,1606539600,2
Jermaine_Cole788,0,2,0,91,1556856000,1571889600,2
wazerpp,0,2,0,4,1576990800,1577077200,2
JonestheB0nes,1,1,16,1,1553140800,1553227200,2
return2ozma,0,2,0,10,1585454400,1585454400,2
theBAANman,1,1,6,3,1578286800,1598328000,2
tacobellmakesmebleed,1,1,123,13,1589688000,1589688000,2
jdmjoe89,0,2,0,3,1603684800,1607317200,2
babebibobuv,0,2,0,3,1596427200,1596427200,2
jurgenstempler,0,2,0,2,1585540800,1585627200,2
0drag,0,2,0,3,1612155600,1612155600,2
ccxx34718,0,2,0,10,1601524800,1601524800,2
grassdancejetta,0,2,0,3,1599364800,1601265600,2
RedditorMan2020,1,1,0,0,1608958800,1608958800,2
Johnnymonny1991,0,2,0,274,1605070800,1609131600,2
OnyxPhoenix,0,2,0,16,1605416400,1608008400,2
thwgrandpigeon,0,2,0,22,1601870400,1601870400,2
soomprimal,0,2,0,1,1603512000,1603684800,2
bradlan1994,0,2,0,39,1606280400,1606280400,2
Tyrus,0,2,0,15,1564632000,1605502800,2
lazysundayaesthetic,0,2,0,11,1593921600,1594008000,2
Vaginuh,0,2,0,4,1608008400,1608008400,2
directorschultz,0,2,0,8,1608958800,1609045200,2
Chestnut529,0,2,0,11,1599364800,1599364800,2
IceColdMilkshakeSalt,0,2,0,17,1589169600,1604203200,2
Ottomottomotto,0,2,0,3,1581742800,1582002000,2
206curlygurlie,0,2,0,7,1559275200,1563508800,2
boring_old_dad,0,2,0,4,1593057600,1599192000,2
BlakeSurfing,0,2,0,42,1577422800,1597464000,2
Milkythefawn,0,2,0,42,1607662800,1607749200,2
ADHDcUK,0,2,0,2,1572408000,1576645200,2
aetheralcosmos,0,2,0,9,1563076800,1563076800,2
MyStageName,0,2,0,18,1609304400,1609304400,2
andrewchch,0,2,0,33,1603080000,1606453200,2
FragrantWarthog3,0,2,0,15,1594440000,1598846400,2
caseclosedmagician,0,2,0,2,1585540800,1585800000,2
Tiptoad,0,2,0,-8,1609218000,1609218000,2
austrianbst_09,0,2,0,-33,1558497600,1570507200,2
DavosHanich,0,2,0,31,1580101200,1580101200,2
420bigbro69,0,2,0,2,1603512000,1606626000,2
katanon,0,2,0,14,1607317200,1608958800,2
Fuck_ODriscolls,0,2,0,133,1608354000,1608354000,2
AGuyCalledMe,0,2,0,5,1602302400,1602907200,2
PapaJueJue_,0,2,0,2,1590897600,1590897600,2
MegaScizzor,0,2,0,14,1579669200,1584849600,2
amadsonruns,0,2,0,-14,1557892800,1557979200,2
yaugturay,0,2,0,9,1574658000,1576558800,2
Llamia,0,2,0,14,1585454400,1585454400,2
KevinDurantsBurner18,0,2,0,-6,1548219600,1548219600,2
SmallTownMinds,0,2,0,8,1588478400,1608008400,2
terserterseness,0,2,0,69,1572843600,1572930000,2
DriedUpSquid,0,2,0,4,1605330000,1605330000,2
fatalikos,0,2,0,2,1573534800,1573621200,2
ardads,2,0,3,0,1412568000,1461297600,2
descendingangel87,0,2,0,59,1578373200,1578373200,2
PSY-BORGGG,1,1,20,1,1588996800,1608267600,2
55x25,0,2,0,30,1578200400,1578200400,2
mckills,1,1,12,3,1575349200,1603857600,2
AudioElevator,0,2,0,20,1582261200,1598328000,2
Njsamora,0,2,0,12,1571976000,1571976000,2
Drunk_Wombat,0,2,0,51,1581138000,1581138000,2
skullyturtle,0,2,0,24,1604898000,1607490000,2
actualhumanwaste,0,2,0,35,1571198400,1571198400,2
Odbody_AS2,1,1,201,20,1570334400,1570334400,2
tw-0161,0,2,0,0,1598932800,1599192000,2
BCSteve,0,2,0,76,1582088400,1583470800,2
TicStackToe,0,2,0,-2,1572062400,1572062400,2
ceoinboxnaira,2,0,2,0,1581915600,1582174800,2
spo0okymulder,0,2,0,7,1552881600,1552881600,2
flippydude,0,2,0,18,1581224400,1581224400,2
arcrealist,0,2,0,2,1589947200,1589947200,2
nigelegan,1,1,3,2,1598932800,1601870400,2
AZgratefulAllman,0,2,0,2,1585454400,1585454400,2
MarsupialRage,0,2,0,35,1587528000,1587528000,2
musicnews360,2,0,3,0,1598587200,1598760000,2
Steampunck,0,2,0,9,1595822400,1595908800,2
m1chl,0,2,0,6,1583557200,1588996800,2
magnumwang,1,1,14,3,1584504000,1584504000,2
legend0102,1,1,36,3,1612069200,1612069200,2
Idyllistic,2,0,154,0,1595390400,1602648000,2
SizzleFrazz,0,2,0,12,1568865600,1568865600,2
wkd_cpl,0,2,0,508,1589860800,1589860800,2
mynutsarebigger,0,2,0,121,1568865600,1569211200,2
getmeoffthisplanet9,0,2,0,3,1602475200,1602561600,2
616mushroomcloud,0,2,0,2,1573621200,1573621200,2
Redsmallboy,0,2,0,2,1600056000,1608872400,2
isetsblessings,0,2,0,20,1555214400,1578286800,2
Unhung_Zero,0,2,0,13,1588737600,1588737600,2
Ktmktmktm,0,2,0,-6,1584763200,1585368000,2
OneBestWayFoo,0,2,0,2,1577941200,1577941200,2
Meowerinae,0,2,0,5,1604116800,1607317200,2
Environmental_Tip875,0,2,0,71,1601870400,1602129600,2
jennnotgin10,0,2,0,11,1606194000,1608699600,2
thisisfakedecent,0,2,0,17,1589860800,1589947200,2
maexx80,1,1,9,1,1582779600,1582779600,2
YoSoyBadBoricua,1,1,15,1,1579755600,1604379600,2
Much_Difference,0,2,0,23,1585454400,1603512000,2
EdwardElric69,0,2,0,2,1605762000,1605762000,2
Dontgiveaclam,0,2,0,14,1600056000,1600401600,2
_Dead_Memes_,0,2,0,2,1603512000,1603512000,2
AmIKrumpingNow,0,2,0,8,1598932800,1599883200,2
ColonelKex,1,1,87,1,1596859200,1596945600,2
CZILLROY,0,2,0,58,1594440000,1602129600,2
emsok_dewe,0,2,0,13,1608958800,1608958800,2
zyko1309,0,2,0,22,1597032000,1601438400,2
realizdk,0,2,0,22,1587096000,1587182400,2
kahurangi,0,2,0,42,1578286800,1584244800,2
nosubsnoprefs,0,2,0,25,1611896400,1611896400,2
PositiveBoobs,0,2,0,8,1575435600,1578200400,2
eagle999,1,1,8,65,1585108800,1592798400,2
awkwardlettuce,1,1,580,6,1554091200,1594180800,2
cHuch_23_12,0,2,0,5,1573534800,1573534800,2
PhantomLobotomy,1,1,0,1,1608267600,1608267600,2
AnxietyLion,0,2,0,18,1562126400,1564632000,2
mirabella8,0,2,0,19,1606798800,1606885200,2
yugogrl2000,0,2,0,10,1567310400,1596254400,2
zedaycee,0,2,0,-3,1599019200,1599019200,2
felixmeister,0,2,0,27,1609045200,1609045200,2
SupremeCourt955,1,1,63,7,1597291200,1597377600,2
restingheart88,0,2,0,6,1558152000,1583384400,2
handcraftedcandy,0,2,0,85,1605330000,1606021200,2
Styx3791,0,2,0,2,1608267600,1608267600,2
RottingAway90,0,2,0,12,1606626000,1606626000,2
HUUGE_Slamma,0,2,0,3,1600228800,1601006400,2
Palmuu,0,2,0,10,1606885200,1606885200,2
bobbyvision9000,0,2,0,96,1591243200,1602820800,2
EveAndTheSnake,0,2,0,3,1596686400,1596859200,2
zodiac707,0,2,0,6,1562040000,1562040000,2
supacresatbest,0,2,0,2,1585281600,1589947200,2
a_piginacage,0,2,0,-6,1593057600,1593057600,2
redsenior,0,2,0,0,1567310400,1567310400,2
dagremlin,0,2,0,22,1580014800,1582347600,2
ughifeellikealoser,0,2,0,5,1600574400,1611550800,2
KelbyMoon,0,2,0,25,1596427200,1608699600,2
Composer-Budget,0,2,0,5,1612155600,1612242000,2
404_Dude,0,2,0,12,1606971600,1607403600,2
rokman,0,2,0,2,1606626000,1606626000,2
dynamoJaff,0,2,0,-2,1568865600,1568865600,2
Kensuki,0,2,0,5,1553659200,1553659200,2
Closeted_EXmuslim,1,1,25,1,1596859200,1597723200,2
reesees_piecees,0,2,0,81,1595736000,1595908800,2
CowboyXuliver,0,2,0,26,1588996800,1588996800,2
AkiraSanjito,0,2,0,8,1559275200,1559275200,2
Thor1noak,0,2,0,1,1575349200,1581570000,2
kekwillsit830,0,2,0,3,1600488000,1600488000,2
TheGoodVibesFairy,0,2,0,4,1607490000,1607490000,2
LotusFlower83,0,2,0,41,1583125200,1583125200,2
chemicalsam,0,2,0,18,1608613200,1608786000,2
BeardedFencer,0,2,0,104,1569124800,1569124800,2
Kingu_rx,0,2,0,14,1606885200,1606971600,2
cinamelayu,0,2,0,4,1559707200,1559707200,2
Frosted_Anything,0,2,0,2,1575262800,1575262800,2
JkJeans,0,2,0,11,1585022400,1603512000,2
0wnzorPwnz0r,0,2,0,-33,1608440400,1608440400,2
FoundYourDonkey,1,1,4103,22,1580792400,1580792400,2
udreif,0,2,0,50,1596254400,1596254400,2
Campusliquor,0,2,0,169,1584590400,1593057600,2
thebigautismo,0,2,0,57,1591502400,1601697600,2
whiteriot413,0,2,0,24,1590033600,1590033600,2
aerlenbach,1,1,14,6,1550293200,1550293200,2
FeralSparky,0,2,0,6,1606971600,1606971600,2
Frost_Karl,0,2,0,-8,1587355200,1587441600,2
SuperCucumber,0,2,0,11,1603512000,1603512000,2
MikeWillTerminate,0,2,0,2,1572321600,1580360400,2
-Interested-,0,2,0,6,1603598400,1603598400,2
OneScrubbyBoi,0,2,0,7,1596859200,1596859200,2
nsloth,0,2,0,6,1597636800,1597723200,2
tregenius,0,2,0,47,1562558400,1562558400,2
ammery,0,2,0,2,1589169600,1594612800,2
Pottingshire,0,2,0,43,1599019200,1608526800,2
anyiki,1,1,28,5,1581570000,1581570000,2
hWhatDo,0,2,0,15,1588651200,1588651200,2
Francolini,0,2,0,11,1600315200,1607576400,2
PollenInara,0,2,0,4,1601352000,1601352000,2
CaptainJay2013,0,2,0,35,1606626000,1607058000,2
aboumine,0,2,0,3,1574312400,1574312400,2
wEbKiNz_FaN_xOxO,0,2,0,0,1554523200,1569211200,2
Helpmehelpus_789,0,2,0,3,1581483600,1581483600,2
flcn_96,0,2,0,4,1602561600,1604811600,2
ZlLF,0,2,0,12,1595390400,1596254400,2
B7ueBeard,1,1,152,1,1599019200,1599105600,2
senseik,0,2,0,21,1605070800,1607144400,2
GruntyBadgeHog,0,2,0,34,1559102400,1559188800,2
confronted666,0,2,0,-12,1587268800,1587268800,2
dionysus2098,0,2,0,42,1598760000,1600315200,2
Starnois,0,2,0,18,1578286800,1593057600,2
dadddyku,0,2,0,2,1555905600,1555905600,2
Curious_triangle,0,2,0,5,1603080000,1603166400,2
OldSnacks,0,2,0,22,1576904400,1577077200,2
ilovemetatertot,1,1,844,33,1601179200,1601179200,2
Ume_chan,0,2,0,7,1572930000,1573016400,2
zack189,0,2,0,14,1597982400,1600228800,2
redsand69,0,2,0,-12,1585022400,1597291200,2
rad-boy,0,2,0,4,1595476800,1599969600,2
NurseMRSA,0,2,0,12,1600315200,1600315200,2
india_aj,0,2,0,5,1541739600,1541739600,2
tressloosaf,0,2,0,3,1593144000,1593144000,2
ChampionshipDiligent,0,2,0,6,1597118400,1597204800,2
Paso1129,0,2,0,6,1588996800,1590033600,2
_Dew_it_,0,2,0,7,1599796800,1600315200,2
MariaCadenzavnaEve,0,2,0,9,1591329600,1592107200,2
Asstastic_1,0,2,0,-3,1585108800,1585108800,2
somedood567,0,2,0,1,1584158400,1584158400,2
Culteredpman25,0,2,0,2,1600747200,1606971600,2
Alternative-Bat8637,0,2,0,10,1601006400,1603771200,2
witheredj8,0,2,0,9,1605589200,1607662800,2
siraliases,0,2,0,7,1607576400,1607662800,2
electrickumquat,0,2,0,23,1585454400,1585454400,2
beenawakeforawhile,0,2,0,54,1596513600,1598414400,2
bluebird173,0,2,0,3,1566446400,1577422800,2
MrShoe321,0,2,0,3,1592452800,1606021200,2
Staarlord,0,2,0,9,1605416400,1605416400,2
beerbeardsbears,0,2,0,3,1578373200,1578373200,2
iLikeHorse3,0,2,0,57,1596859200,1596859200,2
MrKerbinator23,0,2,0,5,1593835200,1603425600,2
drnknPrincess,1,1,17,4,1589860800,1589860800,2
AMarriedSpartan,0,2,0,10,1577422800,1577509200,2
Originalhommequifume,0,2,0,25,1598932800,1598932800,2
MikeyMikeDee,0,2,0,30,1569988800,1569988800,2
The_Electric_Slide,0,2,0,27,1566273600,1566273600,2
GallowsPoles,1,1,43,1,1573794000,1580878800,2
throwaway00s,0,2,0,4,1603684800,1603684800,2
Jedi_Coffee_Maker,0,2,0,6,1606107600,1609477200,2
Ms_Arden,0,2,0,8,1604293200,1604293200,2
Jupiterpie792,0,2,0,2,1603425600,1603512000,2
AhmostFr,0,2,0,40,1582693200,1587960000,2
savvy_1111,0,2,0,9,1591761600,1591848000,2
noot-noooot,0,2,0,18,1604379600,1608786000,2
Procrastinate_Panda,0,2,0,13,1593835200,1593835200,2
asmith1776,0,2,0,2,1590984000,1605070800,2
Ulvkrig,0,2,0,16,1582606800,1583211600,2
food_is_crack,0,2,0,4,1554350400,1554350400,2
Loaded_Slugs,0,2,0,12,1603512000,1603598400,2
AlexKNT,0,2,0,91,1607230800,1607576400,2
ramseyj,1,1,31,2,1598500800,1598500800,2
derMilchUndSaftMann,0,2,0,10,1572930000,1573189200,2
xXxOwO_an_thr_UwUxXx,0,2,0,32,1572667200,1573016400,2
zeoranger,0,2,0,10,1582520400,1603339200,2
yachtking1,0,2,0,-37,1589601600,1597550400,2
bootmii,0,2,0,2,1583211600,1583211600,2
aWHOLEcheesepizza,0,2,0,2,1598414400,1608872400,2
mgillespie18,0,2,0,2,1588305600,1602648000,2
itsnotafakeaccount,0,2,0,52,1565755200,1567051200,2
emiel1741,0,2,0,6,1608958800,1608958800,2
booboobradley,2,0,14,0,1598846400,1599537600,2
3bbAndF1ow1,0,2,0,6,1605157200,1607576400,2
Panaka,0,2,0,30,1581138000,1581138000,2
jazzy0649,1,1,28,10,1551589200,1551589200,2
Vapechef,0,2,0,2,1573621200,1573621200,2
undercoverpunk,1,1,162,1,1560830400,1562212800,2
Shoe-in,0,2,0,4,1558670400,1558670400,2
badat_reddit,0,2,0,21,1554091200,1554091200,2
Ryan_Faith,0,2,0,-7,1606885200,1606885200,2
Kinggold9000,0,2,0,4,1606712400,1606712400,2
Epichawks,0,2,0,9,1606366800,1606366800,2
ioshiraibae,0,2,0,9,1603512000,1603512000,2
Pandelicia,0,2,0,30,1557460800,1568952000,2
davyjoneses,1,1,192,11,1607662800,1607662800,2
uther_stormcloak,0,2,0,18,1569816000,1569816000,2
Cheesysocks,0,2,0,3,1550293200,1550293200,2
ARimapirate,0,2,0,5,1605070800,1605157200,2
ResidentOwl6,0,2,0,17,1608613200,1608613200,2
monamikonami,0,2,0,7,1603512000,1603512000,2
nivalis01,0,2,0,-24,1598587200,1605330000,2
Qwertish,0,2,0,10,1570420800,1595822400,2
vvyiie,0,2,0,34,1587268800,1605416400,2
Anife89,0,2,0,7,1573275600,1573448400,2
Hamburger-Queefs,0,2,0,4,1575262800,1587182400,2
Broton42069,0,2,0,19,1583470800,1584676800,2
mazzylove,0,2,0,5,1609304400,1611982800,2
greenyashiro,0,2,0,2,1567483200,1567569600,2
queenofhydration,1,1,32,1,1604379600,1604379600,2
bashfulfae,0,2,0,9,1606885200,1607058000,2
sweetFLUFFYpanda,2,0,328,0,1603080000,1607835600,2
whatsmyaltagain,1,1,50,25,1566273600,1572930000,2
Spidersinthegarden,0,2,0,2,1603512000,1603512000,2
not_a_toad,0,2,0,11,1531195200,1542430800,2
monjatrix,1,1,10,8,1589428800,1589428800,2
revengeorlove,0,2,0,3,1557374400,1557374400,2
dlibutti,0,2,0,36,1576645200,1580965200,2
tempogod,0,2,0,8,1606194000,1608526800,2
badgergooch,0,2,0,80,1560398400,1560398400,2
Used-Addendum-4349,1,1,0,-3,1599364800,1599364800,2
chockoballs,0,2,0,2,1584331200,1599710400,2
ms3074mas,0,2,0,16,1599105600,1602734400,2
JFL500,0,2,0,-4,1607576400,1622433600,2
peted1233,0,2,0,5,1584849600,1584849600,2
LazySparrows,0,2,0,6,1608786000,1609045200,2
M4xP0w3r_,0,2,0,2,1560657600,1575435600,2
itchinmyhead,0,2,0,8,1587960000,1605330000,2
TisIFrienchiestFry,0,2,0,3,1606366800,1609045200,2
Extension_Complex_83,1,1,0,-1,1604898000,1604898000,2
infamous4chanhacker,0,2,0,10,1557460800,1557460800,2
Primuri,0,2,0,18,1591588800,1591588800,2
blurryrhombus,1,1,60,2,1575694800,1599624000,2
LostRobotMusic,0,2,0,7,1605589200,1605589200,2
derpyven,0,2,0,10,1585454400,1585454400,2
fuck_bootstrap,0,2,0,4,1556510400,1558584000,2
periwinkleseas_,0,2,0,4,1601611200,1606366800,2
September_October,0,2,0,2,1569470400,1569470400,2
tanokkosworld,0,2,0,15,1592366400,1597032000,2
MangoCharade,0,2,0,5,1611982800,1611982800,2
xmrfistr,0,2,0,2,1593576000,1593576000,2
Espumma,0,2,0,6,1607403600,1611982800,2
Arabica_ThrowAway,0,2,0,11,1560312000,1560484800,2
Bhulveign,0,2,0,75,1591675200,1603944000,2
kay_bizzle,0,2,0,3,1607922000,1609045200,2
mclairy,0,2,0,117,1597291200,1598760000,2
yeodeco2001,1,1,6,1,1452661200,1453093200,2
primacoderina,0,2,0,11,1597896000,1597896000,2
Dazmorg,0,2,0,20,1554264000,1562731200,2
IClappedAlienCheeks,0,2,0,1,1608354000,1608354000,2
EarthBear,0,2,0,42,1560830400,1560830400,2
dankfor20,1,1,17,15,1586232000,1595390400,2
405freeway,2,0,70,0,1597464000,1608181200,2
scepticallyminded,0,2,0,29,1570161600,1582434000,2
Mortenick,0,2,0,42,1552708800,1553140800,2
Paula_Schultz237,0,2,0,3,1539921600,1540008000,2
louderstill,0,2,0,98,1584504000,1597809600,2
pinko1329,0,2,0,30,1596081600,1600833600,2
Nostalgicsaiyan,0,2,0,94,1588564800,1611982800,2
R1S4,0,2,0,-15,1583899200,1583899200,2
themagiciansrabbit,0,2,0,29,1548910800,1550293200,2
Edward_Loyola,0,2,0,-21,1601438400,1601524800,2
BlandSlamwich,0,2,0,7,1606798800,1606798800,2
HomerPimpson304,0,2,0,-49,1575349200,1581656400,2
Lord_Fluffykins,0,2,0,10,1609218000,1609390800,2
MostModestPersonEVER,0,2,0,28,1598500800,1602993600,2
LeonShiryu,0,2,0,5,1599105600,1599105600,2
hellreborn,0,2,0,45,1607749200,1607749200,2
grinninglikeadevil,0,2,0,4,1578373200,1584331200,2
Jan8created,0,2,0,5,1599105600,1601006400,2
clothespinkingpin,0,2,0,6,1596859200,1600574400,2
itsjustfuckingreddit,0,2,0,31,1595908800,1597809600,2
Rsoccer17,0,2,0,60,1596168000,1607144400,2
olivesnolives,0,2,0,8,1604030400,1606366800,2
i_dentify_as_an_emo,0,2,0,3,1600315200,1600315200,2
smells-like-updog24,0,2,0,9,1601956800,1606021200,2
Resolvable,0,2,0,6,1593316800,1593316800,2
chelseafc13,0,2,0,4,1609650000,1609650000,2
sapphicbitches,0,2,0,33,1603339200,1603339200,2
polymathintj,0,2,0,23,1602648000,1604984400,2
TheSpagheeter,0,2,0,2,1600315200,1608008400,2
HugeJoke,0,2,0,2,1606366800,1606453200,2
muffinzgalore,0,2,0,23,1598587200,1605848400,2
use_your_imagination,0,2,0,1,1604379600,1605157200,2
adognameddave,0,2,0,12,1604293200,1608354000,2
_Empty-R_,0,2,0,3,1606107600,1607835600,2
Kleens_The_Impure,0,2,0,7,1595304000,1595304000,2
Furrynote,0,2,0,-1,1577422800,1577422800,2
rsinc666,0,2,0,55,1581829200,1583211600,2
oisteink,0,2,0,-12,1562385600,1562385600,2
floppy-oreo,0,2,0,3,1595476800,1595476800,2
allouette16,0,2,0,4,1584676800,1600747200,2
hongkongdongshlong,0,2,0,-1,1606366800,1606366800,2
trugbee1203,0,2,0,15,1591243200,1591243200,2
Whisdeth,0,2,0,11,1577854800,1577854800,2
arbo34,1,1,59,9,1587096000,1587096000,2
Vonovix,0,2,0,31,1608008400,1608786000,2
thisisafluke,0,2,0,3,1608008400,1608008400,2
manfishgoat,0,2,0,4,1598155200,1608267600,2
Cbuur,0,2,0,3,1608872400,1608872400,2
tuxedocat80,0,2,0,6,1581224400,1593921600,2
hutxhy,0,2,0,7,1578200400,1589515200,2
coderedninja,0,2,0,4,1589083200,1589083200,2
mulith123,0,2,0,18,1599019200,1599019200,2
UnholyPants,0,2,0,35,1600747200,1600747200,2
murphski8,0,2,0,45,1563336000,1608526800,2
amygrindhaus,0,2,0,12,1603944000,1603944000,2
RobbieAnalog,0,2,0,24,1565668800,1565668800,2
gogetterheffer,0,2,0,2,1546750800,1546750800,2
AenFi,0,2,0,11,1550293200,1550293200,2
lattegirl04,0,2,0,2,1606021200,1606021200,2
Coyote-Carcass,0,2,0,16,1601006400,1601006400,2
themanus,0,2,0,7,1585022400,1585022400,2
CuckLotion,0,2,0,0,1578978000,1578978000,2
Katodd12340,0,2,0,3,1586577600,1586577600,2
bloodyagent2589,0,2,0,11,1586836800,1606626000,2
iytrix,0,2,0,31,1580965200,1592798400,2
Adelphe,1,1,118,1,1560398400,1560398400,2
information2Dnation,0,2,0,8,1570939200,1571284800,2
AttackFriend,0,2,0,3,1600833600,1600920000,2
killerpenguin74,0,2,0,110,1592625600,1592625600,2
DarthVaders_blaster,0,2,0,7,1609131600,1609390800,2
Y_Martinaise,0,2,0,5,1606021200,1606021200,2
Amauril_the_SpaceCat,0,2,0,24,1606021200,1606021200,2
rolfcm106,0,2,0,3,1592107200,1605070800,2
freshdystopia,0,2,0,3,1582693200,1605070800,2
DarthReznor96,0,2,0,67,1588219200,1590206400,2
imcoolifyourcool,2,0,24,0,1563076800,1563336000,2
billyjef,0,2,0,11,1571112000,1572843600,2
MaxedOutApe,0,2,0,-23,1599624000,1599624000,2
Double_Nekker,0,2,0,-2,1607835600,1607835600,2
SimplyQuid,0,2,0,18,1602129600,1602129600,2
warningcontentshot,1,1,37,2,1595304000,1612155600,2
defnotDino,0,2,0,2,1588305600,1608872400,2
Henchman20,0,2,0,2,1594872000,1601092800,2
Isengrine,0,2,0,17,1580446800,1587355200,2
imatworksorry,1,1,15,1,1578805200,1578805200,2
nightrogen,0,2,0,25,1606280400,1606798800,2
myfaceisfalling,0,2,0,6,1601611200,1605243600,2
Stargazer1186,1,1,11,4,1568952000,1569556800,2
want-to-say-this,0,2,0,7,1594353600,1594353600,2
Lumivarjo,0,2,0,2,1603425600,1603425600,2
Meryule,0,2,0,45,1581051600,1581310800,2
AmazingMrJason,0,2,0,6,1593230400,1601352000,2
Connect_Zucchini366,0,2,0,3,1600574400,1602820800,2
ehenning1537,0,2,0,16,1572843600,1586836800,2
kataraangz,0,2,0,13,1580792400,1593144000,2
DIY-lobotomy,1,1,7,1,1606626000,1612069200,2
Athabasco,1,1,311,21,1604725200,1607230800,2
Halofagoodtime1980,0,2,0,1,1599883200,1599883200,2
hawkdriver60,0,2,0,23,1609218000,1609477200,2
rsvp_to_life,0,2,0,8,1596945600,1603512000,2
artofadaptability,0,2,0,4,1605934800,1605934800,2
theswannwholaughs,0,2,0,7,1581397200,1581397200,2
1TARDIS2RuleThemAll,0,2,0,2,1579064400,1603512000,2
MurkingDolphins,1,1,13,5,1593835200,1593835200,2
Ramble81,0,2,0,5,1605070800,1605070800,2
blockchan,0,2,0,-12,1597291200,1602475200,2
Guthien123,0,2,0,-17,1595649600,1595736000,2
octokit,0,2,0,2,1585454400,1591243200,2
Vexus_Starquake,0,2,0,13,1595563200,1608958800,2
MoneyBizkit,0,2,0,-2,1595908800,1595908800,2
muklan,0,2,0,75,1598760000,1598760000,2
tflightz,1,1,14,49,1605589200,1606194000,2
inmymindseyedea,0,2,0,6,1573966800,1573966800,2
k8himesama,0,2,0,40,1611810000,1611810000,2
leothelion634,0,2,0,7,1587182400,1602734400,2
Mysterious_Ideal,0,2,0,78,1575522000,1593230400,2
theradicaltiger,0,2,0,7,1597723200,1600833600,2
oneone11eleven,0,2,0,2,1607317200,1607317200,2
Fred-Hampton-1488,0,2,0,14,1595476800,1595476800,2
xluckydayx,0,2,0,6,1564804800,1564977600,2
newguy889,0,2,0,0,1591243200,1591243200,2
hard_farter,0,2,0,28,1600315200,1600747200,2
Juffin,1,1,622,1,1582779600,1582866000,2
CaptainCaveSam,0,2,0,8,1606626000,1606885200,2
jehoshaphat,0,2,0,4,1584244800,1596859200,2
peacepipe1,0,2,0,2,1560571200,1560571200,2
jnoah2912,0,2,0,1,1599883200,1612069200,2
1schlick,0,2,0,42,1602043200,1606021200,2
birdiebirdybirds,1,1,946,3,1585368000,1585368000,2
eggs__dee,0,2,0,8,1554868800,1554955200,2
WesterosiResident,0,2,0,5,1571889600,1607058000,2
ultrasuperthrowaway,0,2,0,5,1600315200,1600401600,2
vagina_fang,0,2,0,2,1585454400,1585627200,2
bartgus,0,2,0,14,1548738000,1548738000,2
justme7981,0,2,0,4,1588478400,1588478400,2
JaxxWastedLife,1,1,243,2,1608699600,1608958800,2
North_Paw_5323,1,1,92,11,1578459600,1579064400,2
ricardoconqueso,0,2,0,1,1606626000,1608267600,2
MrMe0w123,0,2,0,9,1565064000,1575090000,2
suckmypoop1,0,2,0,2,1605762000,1612069200,2
jeo-neun,0,2,0,2,1594094400,1594094400,2
Judge_leftshoe,0,2,0,22,1562299200,1567483200,2
Clavo_PR,0,2,0,11,1596254400,1596254400,2
leafygurl808,0,2,0,8,1585022400,1609390800,2
WildJim420,0,2,0,3,1593144000,1601870400,2
dedoid69,0,2,0,2,1566532800,1572667200,2
mushmyhead,0,2,0,23,1606453200,1606453200,2
Physical-Connection5,0,2,0,0,1607490000,1607576400,2
theoneandonlypatriot,0,2,0,3,1587009600,1605848400,2
zwifter11,0,2,0,2,1564632000,1564632000,2
Player4Hacky4,0,2,0,3,1481950800,1481950800,2
Futureboy314,0,2,0,27,1561089600,1566360000,2
respawnedmyaccount,0,2,0,2,1606453200,1606539600,2
AreYouSomeone11,0,2,0,751,1585886400,1585886400,2
CatharsisSeven,0,2,0,8,1573966800,1573966800,2
doktorhollywood,0,2,0,38,1552363200,1552363200,2
Jonesie946,0,2,0,-2,1590120000,1590120000,2
Slackbeing,0,2,0,8,1540267200,1576040400,2
AnnaKarenina15,0,2,0,6,1611810000,1611896400,2
skyesdow,0,2,0,1,1595822400,1595822400,2
stasismachine,0,2,0,68,1611896400,1611896400,2
seooussaxo,2,0,2,0,1569211200,1570420800,2
SgtStickys,0,2,0,9,1584244800,1584244800,2
oldfourlegs,0,2,0,4,1591243200,1591243200,2
themanwhomfall,0,2,0,3,1605589200,1605589200,2
ReggaeShark7,0,2,0,-1,1568347200,1568952000,2
Zeusimus23,0,2,0,169,1594267200,1600401600,2
PathOfDesire,0,2,0,1,1600747200,1600747200,2
LegitimateConflict22,0,2,0,18,1611896400,1611896400,2
nickjayyymes,0,2,0,121,1578891600,1578891600,2
bird_song_,0,2,0,3,1605934800,1607922000,2
drstrangelovephd,0,2,0,6,1571716800,1571716800,2
TorontoToEdinburgh,0,2,0,3,1581310800,1581570000,2
Gurdel,0,2,0,50,1592020800,1593835200,2
WetConceptualization,0,2,0,4,1598932800,1598932800,2
ffshumanity,0,2,0,5,1592280000,1605157200,2
CanadianBear67,0,2,0,51,1603512000,1606712400,2
TheBoredMan,0,2,0,2,1602216000,1602216000,2
MDKphantom,0,2,0,17,1607835600,1608786000,2
trznx,0,2,0,11,1584244800,1584676800,2
xMF_GLOOM,0,2,0,2,1570766400,1570766400,2
the_mouthybeardyone,0,2,0,4,1596859200,1608699600,2
withouttheinternet,0,2,0,19,1578373200,1578546000,2
cum_dawg,0,2,0,3,1611982800,1612069200,2
IchleibeSchwein,0,2,0,-3,1605934800,1605934800,2
Ballerinallamas,0,2,0,70,1589342400,1589428800,2
Boundiesinternet,0,2,0,18,1555992000,1557720000,2
mattybagel,0,2,0,15,1583899200,1597464000,2
Knight_TakesBishop,0,2,0,-13,1606539600,1606539600,2
Actually_Ryan,0,2,0,5,1574226000,1574226000,2
GungnirReboot,0,2,0,4,1603339200,1604898000,2
mettaphysician,0,2,0,70,1547701200,1549602000,2
NateNateWW,1,1,6,1,1600488000,1600488000,2
Freak8206,0,2,0,4,1572580800,1572580800,2
DrO999,1,1,5,3,1579410000,1592280000,2
aDragonsAle,0,2,0,115,1605070800,1606021200,2
recluselatina,0,2,0,410,1579150800,1579150800,2
Flink91,0,2,0,-5,1606885200,1606885200,2
ChemicalBeautiful130,0,2,0,7,1604984400,1604984400,2
stranger1123,0,2,0,10,1587268800,1589947200,2
OGFahker,0,2,0,9,1581483600,1593662400,2
jonnygb4d,0,2,0,10,1602302400,1602388800,2
cadff,0,2,0,2,1594008000,1594008000,2
bakerbat,0,2,0,7,1587355200,1589428800,2
munmunshaa,0,2,0,3,1599710400,1599710400,2
Trick-Ad906,0,2,0,2,1635134400,1635134400,2
dropkickninja,0,2,0,20,1609390800,1609477200,2
nyequistt,0,2,0,21,1600056000,1603425600,2
lewski206,0,2,0,69,1579755600,1579755600,2
AbsoluteRichard,0,2,0,76,1601956800,1605675600,2
BitterBreadloser,1,1,2,2,1596513600,1596513600,2
failingstrength,0,2,0,61,1587441600,1607058000,2
Badusernameguy2,0,2,0,3,1576472400,1604379600,2
Othniel90,0,2,0,15,1565755200,1565755200,2
Noobleh,0,2,0,42,1563076800,1593748800,2
MacV_writes,1,1,13,2,1598500800,1598587200,2
jessie5493,0,2,0,60,1599105600,1607317200,2
Barber1992,0,2,0,9,1603512000,1604984400,2
NotAFedboy,0,2,0,11,1609390800,1609390800,2
clebsenpai,0,2,0,6,1569211200,1569211200,2
Manatee_Soup,0,2,0,23,1602820800,1603425600,2
throwaway7429138,0,2,0,11,1572408000,1572408000,2
TheBlahrg,0,2,0,5,1580619600,1580619600,2
poopenbocken,0,2,0,3,1556769600,1556769600,2
Adolf_Kipfler,0,2,0,2,1591329600,1602129600,2
infieldfly47,0,2,0,3,1573362000,1573362000,2
intermittentissues,0,2,0,4,1539921600,1539921600,2
AtSeaWithMe,0,2,0,-51,1584676800,1584676800,2
thamthrfcknruckus,1,1,42,5,1594526400,1594526400,2
defn_of_insanity,0,2,0,16,1588824000,1604293200,2
Neutrinosandgluons,0,2,0,25,1551934800,1551934800,2
drewbbles,0,2,0,21,1581397200,1581397200,2
arcticcloud,0,2,0,16,1574053200,1583470800,2
WendigoVolante,0,2,0,3,1566100800,1566100800,2
Old_Quantity_4393,0,2,0,16,1601870400,1606539600,2
deliciouscrab,0,2,0,2,1606885200,1606885200,2
MrZJones,0,2,0,3,1598328000,1598328000,2
jared_john,0,2,0,1,1599019200,1599019200,2
tanstaafl90,0,2,0,33,1606453200,1609304400,2
VeggiesForThought,0,2,0,4,1539748800,1539748800,2
notmadatall,0,2,0,101,1605589200,1605589200,2
IssphitiKOzS,0,2,0,18,1575003600,1605675600,2
XXHyenaPseudopenis,0,2,0,2,1579496400,1579496400,2
lalaeticia,1,1,213,18,1551934800,1570248000,2
Fuuxd,0,2,0,3,1607835600,1607835600,2
theeclecticpen,0,2,0,5,1565841600,1581483600,2
RoryBlank,2,0,54,0,1556856000,1578632400,2
Riparian_Rites,1,1,31,1,1599796800,1599796800,2
TheRedReverend,0,2,0,7,1551502800,1553227200,2
Girth9099,0,2,0,18,1597118400,1605675600,2
FairyflyKisses,0,2,0,4,1597723200,1609477200,2
jacob2815,0,2,0,25,1578027600,1578027600,2
nicky3123,2,0,122,0,1579669200,1607749200,2
mikhyy,0,2,0,16,1589688000,1589688000,2
Heath776,0,2,0,3,1585713600,1585713600,2
ianianson,0,2,0,5,1577941200,1578286800,2
plunfa,0,2,0,11,1594612800,1594612800,2
TheFreaky,0,2,0,17,1589342400,1589342400,2
superman467,0,2,0,1,1572753600,1572753600,2
Zarodex,0,2,0,7,1608958800,1609045200,2
Spingebill_1812Part2,0,2,0,10,1582088400,1582779600,2
AdolphusPrime,0,2,0,-1,1583470800,1583470800,2
GerhardtDH,0,2,0,33,1607662800,1608094800,2
7142856,1,1,9,5,1562731200,1581224400,2
ffilps,0,2,0,0,1611982800,1611982800,2
VerySuperGenius,0,2,0,24,1599019200,1599019200,2
CosmicPuertoRican,0,2,0,18,1565668800,1565928000,2
Youareobscure,0,2,0,14,1575349200,1607403600,2
Biettka,0,2,0,35,1571803200,1583125200,2
tgroove01,0,2,0,7,1568001600,1568001600,2
Kristenglam,0,2,0,36,1567828800,1572494400,2
Smearqle,0,2,0,61,1586318400,1586318400,2
Lurxy_,0,2,0,22,1605243600,1605243600,2
GreedyBeedy,0,2,0,1,1604379600,1604379600,2
jejunej,0,2,0,6,1604116800,1612155600,2
Tonhero,1,1,73,10,1607490000,1607490000,2
light5577,0,2,0,1,1571803200,1598932800,2
martymac1523,1,1,0,-19,1576990800,1577854800,2
laidlard,0,2,0,2,1592971200,1593489600,2
OfficialMicheleObama,0,2,0,7,1603598400,1603598400,2
positiveulz,0,2,0,1,1583211600,1586836800,2
TheLateHugoFinn,0,2,0,21,1600228800,1603771200,2
TyranoMike,0,2,0,124,1605934800,1605934800,2
AsAGayJewishDemocrat,0,2,0,54,1560657600,1573794000,2
MrBackrub,0,2,0,31,1574312400,1601179200,2
Mustachefleas,0,2,0,1,1578373200,1578459600,2
Thelliana,0,2,0,17,1555992000,1557806400,2
embarrassedalien,0,2,0,5,1575522000,1575522000,2
msstree,0,2,0,4,1576990800,1597204800,2
theinfinitejaguar,1,1,26,31,1575522000,1575781200,2
tobisb,0,2,0,3,1573534800,1582088400,2
GenitalJouster,0,2,0,5,1605502800,1605589200,2
Wirbelfeld,0,2,0,2,1585454400,1585540800,2
dI-_-I,0,2,0,-4,1596686400,1596686400,2
VoldemortsHorcrux,0,2,0,1,1585454400,1585454400,2
Contragenesis,0,2,0,8,1608094800,1608354000,2
FootThong,1,1,13,4,1587441600,1587441600,2
treblah3,0,2,0,28,1547874000,1568692800,2
fumfit,0,2,0,5,1579410000,1579496400,2
tenkaitravels,0,2,0,23,1552449600,1556337600,2
BigChungus1222,0,2,0,5,1607230800,1607317200,2
cestlavie908,1,1,14,4,1597550400,1597550400,2
CBRN66,0,2,0,9,1584504000,1584590400,2
Thinktankjf,0,2,0,4,1604379600,1604379600,2
mamabug27,0,2,0,5,1600142400,1602129600,2
LDzonis,0,2,0,-8,1559620800,1574744400,2
boring_sciencer,0,2,0,7,1594440000,1608872400,2
PhantomPolitic,0,2,0,125,1588824000,1588824000,2
MonarchOfFerrousHand,0,2,0,7,1590638400,1590638400,2
Waterslicker86,0,2,0,4,1593576000,1593576000,2
funny_like_how,0,2,0,7,1600660800,1600660800,2
vera-day,0,2,0,18,1600660800,1600920000,2
MiloFrank,0,2,0,4,1591156800,1603512000,2
littledingusbigbrain,0,2,0,32,1609304400,1611810000,2
Matka_Vuorten,1,1,169,1,1567137600,1567224000,2
diane_young,0,2,0,13,1597982400,1608958800,2
angeredbee,0,2,0,2,1600833600,1600833600,2
olivoGT000,0,2,0,2,1595476800,1595563200,2
Kurt751990,0,2,0,14,1599278400,1599537600,2
HEYALEXAPEGMEPLS,0,2,0,4,1611982800,1611982800,2
smoneklmeplz,0,2,0,5,1574485200,1574485200,2
Andrew852456,2,0,603,0,1602561600,1605762000,2
Awkward-Leopard-2683,0,2,0,39,1603512000,1603512000,2
Disposedofhero,0,2,0,39,1576126800,1577854800,2
Segundo-Sol,0,2,0,6,1609218000,1609304400,2
Youaintlikable,0,2,0,8,1609045200,1609045200,2
Nuclei,0,2,0,8,1605589200,1605589200,2
awesomega14,0,2,0,9,1594008000,1595476800,2
Grand-Mulberry,0,2,0,21,1581138000,1581483600,2
aaarrrggh,0,2,0,-4,1601870400,1601870400,2
Kenkaniff003,0,2,0,2,1603512000,1603598400,2
Justch1ll,0,2,0,2,1611982800,1612069200,2
maybejustadragon,0,2,0,76,1602129600,1611723600,2
noideasforcoolnames,0,2,0,4,1601870400,1601870400,2
dirtymahgurty,0,2,0,4,1571025600,1572930000,2
Radicalred21,0,2,0,597,1585022400,1585108800,2
Depressed_Maniac,0,2,0,2,1606626000,1606712400,2
AnarchoPodcastist,0,2,0,6,1596340800,1608786000,2
shriekingbuddha,0,2,0,62,1601179200,1602820800,2
jflb96,0,2,0,7,1596686400,1607403600,2
soupbut,0,2,0,2,1591329600,1591329600,2
queen_fucko,0,2,0,5,1572408000,1572930000,2
heynoswearing,0,2,0,15,1573016400,1573016400,2
dritarashtra,0,2,0,12,1582779600,1583038800,2
faithdies,0,2,0,11,1580014800,1584676800,2
LemonHoneyBadger,0,2,0,16,1596254400,1596859200,2
YoloMcSwagg3r,0,2,0,-1,1582606800,1606626000,2
Slykop4th,0,2,0,-8,1591156800,1591675200,2
futilitaria,0,2,0,8,1608958800,1609304400,2
tanMud,0,2,0,4,1601092800,1601092800,2
ThereInTheTrees,0,2,0,20,1584590400,1584590400,2
Lhijodelkoko,1,1,75,2,1607749200,1607749200,2
chelseabriannaa,0,2,0,14,1606712400,1606798800,2
ColonelFuckface,0,2,0,13,1573362000,1573707600,2
Earth2Monkey,0,2,0,27,1589083200,1589083200,2
quietlythedust,0,2,0,21,1603425600,1603425600,2
watchincatsrn,0,2,0,5,1598414400,1598414400,2
gackedphillip,0,2,0,9,1559102400,1559102400,2
Count_Von_Roo,0,2,0,20,1597982400,1597982400,2
Wraith-Gear,0,2,0,201,1573534800,1596168000,2
Cam5991,0,2,0,3,1597723200,1607230800,2
spacecadetali,1,1,0,-3,1602388800,1602388800,2
Cwazza18,0,2,0,7,1595736000,1595736000,2
gaffney116,0,2,0,7,1569124800,1569124800,2
HellrockBones,0,2,0,2,1560744000,1560744000,2
Jetpack_Donkey,0,2,0,28,1607403600,1607403600,2
Techbiason,2,0,0,0,1603425600,1609045200,2
djliquidvoid,1,1,1631,1,1569124800,1571630400,2
Trollercoaster101,0,2,0,472,1577941200,1578373200,2
throwwveryfaraway,0,2,0,50,1603684800,1608699600,2
double_chicken,0,2,0,81,1586664000,1586664000,2
RomanticLurker,0,2,0,10,1570593600,1570680000,2
SagerG,0,2,0,-9,1606539600,1606539600,2
BuffiRumbleberries,0,2,0,20,1560744000,1560916800,2
WIIHAPPYFEW,0,2,0,47,1572843600,1572843600,2
differentkindofcat,0,2,0,57,1569124800,1599883200,2
playa-playa81,0,2,0,46,1605589200,1605589200,2
Kamikaze_Cash,0,2,0,2,1595736000,1595736000,2
aussie_miccy,0,2,0,7,1569556800,1570420800,2
tpman1623,0,2,0,-2,1593230400,1593316800,2
dregan,0,2,0,12,1584936000,1603598400,2
SSJRiku,0,2,0,-24,1608613200,1608613200,2
mirbill24,0,2,0,4,1602648000,1604203200,2
givemebackmystones,0,2,0,39,1601524800,1601611200,2
Hellfirehello,0,2,0,-13,1561435200,1562731200,2
Funklord_Earl,0,2,0,9,1588996800,1598587200,2
Wafflemonster2,0,2,0,33,1597809600,1599710400,2
deathhead_68,0,2,0,3,1583470800,1583470800,2
whatthefuuuuuuckdude,0,2,0,6,1603425600,1604725200,2
reed_a_book,1,1,3396,8,1607144400,1607144400,2
wiggleswole,0,2,0,88,1567569600,1567656000,2
Sp00pyGh0st93,0,2,0,16,1598328000,1598328000,2
goodshitposts,1,1,50,6,1563854400,1570939200,2
MexicanViagra,0,2,0,1,1546405200,1546405200,2
TwiztidShagu,1,1,482,2,1601524800,1602043200,2
Great-Gardian,1,1,23,8,1561262400,1562212800,2
ak931912,0,2,0,66,1591243200,1591329600,2
AsurieI,0,2,0,5,1569124800,1593230400,2
Minivansarevile,0,2,0,-1,1605157200,1605157200,2
torte-petite,0,2,0,3,1597982400,1602648000,2
ResumeTA123,0,2,0,4,1581656400,1581656400,2
OderusKlytorous,0,2,0,33,1578459600,1578459600,2
jlwitchwomon,0,2,0,19,1560398400,1560571200,2
ethosorange,0,2,0,29,1564459200,1564459200,2
M1RR0R,0,2,0,19,1611982800,1612069200,2
ln94,0,2,0,8,1553486400,1571630400,2
afas460x,0,2,0,7,1560139200,1560139200,2
definantlymaybe,0,2,0,-2,1573707600,1573794000,2
SpeakMySecretName,0,2,0,24,1607662800,1607662800,2
Jonny-Marx,0,2,0,9,1557892800,1560657600,2
_spinkey,0,2,0,27,1592107200,1598932800,2
Annon227,0,2,0,3,1575176400,1602648000,2
Qminus,0,2,0,24,1592625600,1607835600,2
PrestigiousGuava,0,2,0,9,1581915600,1585195200,2
ultrash,1,1,4,2,1522296000,1522555200,2
habitat16kc,0,2,0,-1,1592798400,1592798400,2
apanbolt,0,2,0,-28,1598673600,1598760000,2
chitraders,0,2,0,-1,1589515200,1589515200,2
wizenedeyez,0,2,0,8,1600574400,1600660800,2
seitanworshiper,0,2,0,7,1576126800,1594440000,2
QuesoSquid,0,2,0,6,1607490000,1607490000,2
The_JLK,0,2,0,4,1582606800,1598328000,2
luska233,0,2,0,44,1592798400,1593403200,2
aish2995,0,2,0,10,1586404800,1607922000,2
Wooden-Building,0,2,0,4,1588478400,1591502400,2
thejeremx,1,1,80,7,1553486400,1553572800,2
Nicknatious,0,2,0,14,1596772800,1596772800,2
bullfrog96,0,2,0,37,1596686400,1596772800,2
humble_dishonesty,0,2,0,4,1587614400,1587614400,2
0bAtomHeart,0,2,0,4,1560398400,1571025600,2
pankakke_,0,2,0,25,1594094400,1601956800,2
Class_in_a_Rat,0,2,0,2,1569124800,1569124800,2
N3UROTOXIN,0,2,0,46,1567569600,1568088000,2
dependent_hippo,0,2,0,2,1605070800,1606798800,2
I_am_N0t_that_guy,0,2,0,2,1539921600,1539921600,2
devonthed00d,0,2,0,2,1555387200,1555387200,2
master-of-strings,0,2,0,2,1575694800,1575781200,2
One-Elk3532,0,2,0,2,1608354000,1609131600,2
livingonfear,0,2,0,4,1603166400,1603166400,2
YeOldeDungeonSlut,0,2,0,3,1591243200,1603598400,2
itsonlyillogical,0,2,0,2,1603512000,1603512000,2
Simple_Insect7228,1,1,8,1,1608613200,1608613200,2
mick_au,0,2,0,2,1594353600,1594699200,2
EmmakLeonardus,0,2,0,3,1604379600,1605589200,2
slyfox3333,0,2,0,2,1598932800,1598932800,2
DeathsMelvin,0,2,0,62,1593403200,1606194000,2
OutrageousEmployee,0,2,0,2,1598068800,1598068800,2
jhfridhem,0,2,0,16,1602993600,1604898000,2
monked80,0,2,0,39,1611810000,1611896400,2
oswalddo224,0,2,0,43,1597896000,1601265600,2
fuchow,0,2,0,5,1599537600,1605330000,2
Scorpion1386,0,2,0,2,1600747200,1600747200,2
kwojtek14,0,2,0,4,1597464000,1599192000,2
owenbowen04,0,2,0,54,1601870400,1606453200,2
RainTraffic,0,2,0,2,1605502800,1609304400,2
smileyfacewartime,0,2,0,18,1599019200,1599019200,2
IvanBeefkoff,0,2,0,5,1590033600,1611810000,2
jaimolnet,0,2,0,13,1560225600,1560312000,2
s1lentnarwhal,0,2,0,11,1593921600,1602820800,2
GramercyPlace,0,2,0,47,1573707600,1578373200,2
sbutt2,0,2,0,2,1591761600,1591761600,2
mfxoxes,0,2,0,3,1591934400,1591934400,2
brileaknowsnothing,0,2,0,8,1585540800,1585540800,2
xGhostEYE,0,2,0,1,1589342400,1605589200,2
corpse-employee,1,1,12,5,1580706000,1580706000,2
MeroFn,0,2,0,2,1600315200,1600315200,2
Kanedi4s,0,2,0,21,1608181200,1608354000,2
yetzer_hara,0,2,0,11,1576299600,1581138000,2
drunkentravelers,0,2,0,5,1578459600,1578632400,2
The_Shekel_MaisterJR,0,2,0,15,1565928000,1565928000,2
CakeofRage,0,2,0,2,1606885200,1606885200,2
saintalbanberg,0,2,0,43,1585281600,1597118400,2
PointK,1,1,2764,2,1592798400,1594267200,2
dickydickynums,0,2,0,19,1587355200,1589860800,2
Valerica-D4C,0,2,0,69,1560139200,1578632400,2
silicon_person,0,2,0,3,1605157200,1607749200,2
spacedoutdad,1,1,7,109,1550293200,1550898000,2
-gaytrees,0,2,0,20,1596254400,1598155200,2
11-Eleven-11,0,2,0,4,1603512000,1606021200,2
chainchomp98,0,2,0,112,1564632000,1570075200,2
Eazy_DuzIt,0,2,0,14,1542603600,1599105600,2
PositiveScarab,0,2,0,17,1579669200,1579842000,2
pretend2,0,2,0,19,1581051600,1582002000,2
RotMGStarstream,0,2,0,164,1608699600,1609045200,2
shittywitte,0,2,0,4,1587268800,1596600000,2
atticus_grey,0,2,0,44,1570161600,1570161600,2
Clownshow21,0,2,0,-4,1559016000,1559016000,2
Manifesttt,0,2,0,9,1581915600,1587528000,2
sm1ttysm1t,0,2,0,33,1587182400,1590120000,2
thereisnonamehere,0,2,0,41,1571630400,1576299600,2
sixfigurefamily10,1,1,0,-2,1541044800,1541044800,2
raydancesunshine,0,2,0,7,1603512000,1603512000,2
ViewedOak,0,2,0,5,1593576000,1593576000,2
__mud__,0,2,0,18,1604379600,1604466000,2
hermanhugh666,1,1,15,2,1580101200,1580101200,2
Retr0_b0t,1,1,4,2,1611810000,1611896400,2
DahDollar,0,2,0,15,1583557200,1583643600,2
GenitalTso,0,2,0,2,1591243200,1591243200,2
louisianajake,0,2,0,729,1577336400,1577336400,2
crusty_shaun,0,2,0,7,1608094800,1608094800,2
Webblz,0,2,0,6,1611896400,1612069200,2
nr138,1,1,15,6,1601956800,1609304400,2
cannaeinvictus,0,2,0,4,1612069200,1612069200,2
CavaliersPunter9,0,2,0,-3,1566360000,1566446400,2
Curious--Reader,0,2,0,2,1606366800,1606366800,2
Squidwards_m0m,0,2,0,8,1583384400,1584331200,2
Birdmaan73u,0,2,0,17,1582520400,1594612800,2
chapterten,0,2,0,4,1572494400,1591588800,2
Sweaty_onionpits,0,2,0,50,1599624000,1600574400,2
HaloEliteLegend,0,2,0,3,1599969600,1600574400,2
r4fiebfuerfb,1,1,120,5,1572667200,1572667200,2
joji711,0,2,0,4,1604030400,1604030400,2
Milfkilla,0,2,0,0,1562644800,1562817600,2
wewerewerewolvesonce,0,2,0,2,1589256000,1596427200,2
Spambop,0,2,0,4,1597550400,1599451200,2
Killer-of-Cats,0,2,0,-8,1577422800,1577509200,2
zapembarcodes,0,2,0,7,1607317200,1607749200,2
Newguy2554,0,2,0,1,1584072000,1584331200,2
needsmoreanus,0,2,0,10,1568865600,1568865600,2
OutOfTheDamnWay,0,2,0,20,1562904000,1569729600,2
cinaeco,0,2,0,16,1604379600,1604466000,2
loudasboof,0,2,0,7,1588996800,1588996800,2
boxxoroxx,0,2,0,8,1561348800,1561348800,2
meltingsnow265,1,1,2,2,1595995200,1595995200,2
Dear-Bodybuilder-292,0,2,0,5,1612155600,1612155600,2
CaptainTripps82,0,2,0,5,1605934800,1606021200,2
iamamexican_AMA,0,2,0,5,1605762000,1609045200,2
Cometguy7,0,2,0,68,1576299600,1576299600,2
angrytoastss,0,2,0,9,1564545600,1568088000,2
Skllpointer,1,1,59,8,1559793600,1559793600,2
AlCopain,0,2,0,13,1604293200,1604293200,2
snowy_owls,0,2,0,7,1561176000,1561521600,2
Juustokas,0,2,0,4,1605589200,1605589200,2
WholeWorker,1,1,90,13,1584331200,1584331200,2
raitalin,0,2,0,4,1576818000,1576818000,2
OptOutSlacker,0,2,0,2,1592193600,1592366400,2
chris-rox,0,2,0,10,1606021200,1606971600,2
tomato657,0,2,0,38,1596600000,1596600000,2
stars0001,0,2,0,59,1578286800,1578373200,2
shodo_apprentice,0,2,0,81,1601092800,1601092800,2
fennel1312,0,2,0,11,1607662800,1607662800,2
TurdBird24,0,2,0,2,1597982400,1598241600,2
Ihadsumthin4this,0,2,0,2,1607144400,1607144400,2
dfgh889,0,2,0,62,1579323600,1590984000,2
cestlabri,0,2,0,24,1577768400,1581483600,2
Croissant-Laser,0,2,0,34,1606280400,1606971600,2
knotmyrealname,0,2,0,72,1606021200,1606021200,2
Psychological-Dig-29,0,2,0,2,1605589200,1605589200,2
aircavrocker,0,2,0,2,1573534800,1573534800,2
Boku_no_Rythm,0,2,0,4,1585454400,1585540800,2
slowriot05,0,2,0,3,1555300800,1559188800,2
calzenn,0,2,0,142,1574139600,1575349200,2
1N54N3M0D3,0,2,0,10,1588737600,1601870400,2
gnarlycastle,0,2,0,27,1544158800,1546578000,2
mattheweddington,0,2,0,4,1580792400,1580878800,2
liquidsahelanthropus,0,2,0,1,1547528400,1570420800,2
Three-Fish,0,2,0,6,1637125200,1643000400,2
kingcarcas,0,2,0,9,1608354000,1608354000,2
Exxmorphing,0,2,0,28,1561780800,1561780800,2
FigureSorry,0,2,0,5,1611637200,1612069200,2
IVIaskerade,0,2,0,9,1580878800,1602043200,2
maidenhair_fern,0,2,0,6,1598673600,1599105600,2
kammmio,0,2,0,3,1576645200,1596772800,2
Nausikhaleesi,0,2,0,4,1560052800,1563163200,2
RelicAlshain,0,2,0,7,1603512000,1603512000,2
Mrwhitepantz,0,2,0,14,1582866000,1585281600,2
GreyGap,0,2,0,15,1582779600,1582779600,2
foljack,2,0,2541,0,1568001600,1570766400,2
crescentindigomoon,0,2,0,4,1604203200,1604203200,2
OhRyann,0,2,0,36,1590033600,1590120000,2
bruh_123456,0,2,0,11,1609477200,1609477200,2
scoutydouty,0,2,0,18,1573362000,1573362000,2
Tindiil,0,2,0,15,1588651200,1596686400,2
i_broke_wahoos_leg,0,2,0,3,1593921600,1594440000,2
RoJayJo,0,2,0,3,1549602000,1608613200,2
Bassbunny19,0,2,0,-5,1577682000,1595476800,2
uwu_idc_stfu,0,2,0,6,1607144400,1607662800,2
biscuitff,0,2,0,16,1561348800,1597723200,2
ATubOfCats,0,2,0,5,1572667200,1572667200,2
EdselHans,0,2,0,128,1569988800,1596168000,2
donutaskmeagain,1,1,3,1,1594094400,1594180800,2
dr0ptimat0r,0,2,0,2,1561694400,1561694400,2
RashRenegade,0,2,0,12,1612069200,1612069200,2
ayemef,0,2,0,5,1556683200,1560744000,2
NowImUnknown,0,2,0,121,1555646400,1555646400,2
nailkitty,0,2,0,17,1569556800,1602043200,2
dpatt9er,0,2,0,43,1585108800,1590206400,2
Careless_Tennis_784,0,2,0,9,1606194000,1606194000,2
LordJuJu15,0,2,0,4,1604030400,1604116800,2
AtLeastOneAlias,0,2,0,16,1554436800,1554436800,2
Otokolumi,0,2,0,4,1579150800,1579150800,2
ashlie_ren,0,2,0,3,1600660800,1600660800,2
just_the_truth_cfb,1,1,157,8,1597204800,1597291200,2
akabigdaddie,1,1,66,27,1551502800,1552449600,2
skillphil,0,2,0,46,1608440400,1608440400,2
astroteal,0,2,0,10,1606798800,1606798800,2
O906,0,2,0,3,1608440400,1608440400,2
okletstrythisagain,0,2,0,10,1605934800,1605934800,2
lunar-m0th,0,2,0,34,1589774400,1589860800,2
br0itskatie,0,2,0,7,1579237200,1580274000,2
TheFarnell,0,2,0,180,1571803200,1573275600,2
oguhijokle,0,2,0,5,1571457600,1577336400,2
Chingus_Khan,0,2,0,9,1573362000,1573362000,2
ChunkOmega,1,1,21,16,1573707600,1582261200,2
cosmicwavy,0,2,0,0,1611810000,1611810000,2
Hallwart,0,2,0,2,1600228800,1601870400,2
antiworkist,1,1,11,2,1587960000,1587960000,2
thinkingstardust,0,2,0,17,1596945600,1601265600,2
thesunindrag,0,2,0,12,1572580800,1572580800,2
yjvm2cb,0,2,0,17,1606280400,1608786000,2
tdh997,0,2,0,8,1601179200,1601179200,2
justhereforthekittys,0,2,0,28,1585454400,1585454400,2
2xThink,0,2,0,27,1556683200,1556856000,2
TubularHells,0,2,0,4,1565236800,1600747200,2
webular,0,2,0,6,1573534800,1579064400,2
BBLTHRW,0,2,0,18,1539921600,1539921600,2
ProfessionalShill,0,2,0,27,1598587200,1599019200,2
nevergoback123,0,2,0,5,1603598400,1603598400,2
See0hAreWhy,1,1,18,1,1593576000,1593576000,2
bottomphobia,0,2,0,4,1567224000,1567224000,2
veng6,0,2,0,154,1600920000,1601524800,2
Sophet_Drahas,0,2,0,4,1607662800,1607662800,2
Venom_Snake3,0,2,0,14,1606539600,1606539600,2
Brookeofthenorth,0,2,0,8,1563249600,1585022400,2
Pokemaster2187,0,2,0,82,1590984000,1591329600,2
Traveha,1,1,798,10,1560139200,1571544000,2
CarlTheRedditor,0,2,0,27,1567915200,1572408000,2
shitsfuckedupalot,0,2,0,3,1594353600,1594353600,2
shuckleberryfinn,0,2,0,11,1608354000,1608354000,2
feliscat,0,2,0,28,1604984400,1604984400,2
hisnameisbruno,1,1,35,9,1572148800,1572148800,2
Good_old_Marshmallow,0,2,0,9,1604898000,1608354000,2
tuskentrans,0,2,0,46,1605416400,1605589200,2
pupcoin,0,2,0,4,1592971200,1592971200,2
hashtag-123,0,2,0,17,1593057600,1593057600,2
richhomieram,0,2,0,12,1579410000,1597032000,2
dsrtxt,0,2,0,29,1600747200,1608094800,2
Tangy_Taffy,0,2,0,-4,1603944000,1604638800,2
Introvert-Alert,0,2,0,22,1596772800,1596772800,2
weedlovesyou,0,2,0,9,1572843600,1572843600,2
BloodshotRollinRed,0,2,0,18,1594267200,1594612800,2
fuyfiugiyfyrdidfjjb,1,1,8,3,1567396800,1567396800,2
Redrodder,0,2,0,7,1581310800,1581310800,2
cookiemanluvsu,0,2,0,3,1567828800,1567828800,2
multiverse72,0,2,0,3,1603512000,1603512000,2
craggolly,0,2,0,-16,1568001600,1582261200,2
lenaar,0,2,0,201,1573448400,1573534800,2
reallydope-name,0,2,0,10,1554523200,1554523200,2
radiantmilkyway,1,1,57,7,1547442000,1585368000,2
DionysianRebel,0,2,0,18,1595822400,1595822400,2
aprilleaves,0,2,0,2,1598673600,1598932800,2
mutedlute,0,2,0,2,1602216000,1602216000,2
Typical_Boshwack,0,2,0,8,1577941200,1601870400,2
_PacoMendez_,0,2,0,-7,1401595200,1401768000,2
clownsofthecoast,0,2,0,38,1589342400,1598068800,2
the_arkham_chills,0,2,0,12,1574658000,1574658000,2
dr1nfinite,0,2,0,1,1579582800,1579582800,2
agreatgreendragon,0,2,0,27,1557460800,1557547200,2
Hyperdeath_Floof,0,2,0,2,1578978000,1579064400,2
neuro__atypical,0,2,0,24,1569988800,1570161600,2
DmAn3644,1,1,55,2,1583384400,1583557200,2
forumkid,0,2,0,13,1565409600,1573966800,2
PorkSauce-,0,2,0,31,1579410000,1593230400,2
Saxxon_Rose,0,2,0,8,1576990800,1576990800,2
EricBardwin,0,2,0,20,1606885200,1606971600,2
prateeksaraswat,0,2,0,7,1560139200,1562817600,2
iiimperatrice,0,2,0,6,1586404800,1589947200,2
hollyjohanna,0,2,0,14,1593921600,1593921600,2
novanymph,0,2,0,24,1547614800,1558152000,2
Civil_Independence,0,2,0,57,1566964800,1566964800,2
abraca-duh,0,2,0,19,1562212800,1563249600,2
emelrad12,0,2,0,7,1607230800,1607230800,2
muckduck333,0,2,0,15,1579410000,1579410000,2
SippinH20,0,2,0,197,1605070800,1605070800,2
nullpoteles,1,1,11,3,1528862400,1528862400,2
LemonG34R,0,2,0,5,1577854800,1577854800,2
Cold_Leadership,0,2,0,10,1571544000,1571544000,2
STRAIGHTUPGANGS,0,2,0,19,1577336400,1577336400,2
queensage77,0,2,0,51,1600142400,1600488000,2
DBasterd,0,2,0,5,1608267600,1611810000,2
therealgoofygoober,0,2,0,11,1577422800,1577422800,2
Ivansasi,1,1,4726,11,1589601600,1590552000,2
DustyPlume,0,2,0,28,1602820800,1602820800,2
pm_cheesecakes,0,2,0,5,1573448400,1603080000,2
cnataraj7,1,1,8,6,1580965200,1581656400,2
RfTaLaP,0,2,0,-18,1573016400,1573016400,2
Waitingtobeabducted,0,2,0,12,1608613200,1609218000,2
Mypetdalek,0,2,0,9,1539835200,1539835200,2
Augustus420,0,2,0,65,1576213200,1585368000,2
ghostworldvhs,1,1,51,3,1592712000,1608958800,2
LookAtThisDudelul,0,2,0,19,1594353600,1594353600,2
SeditionOrInsurrect,0,2,0,2,1593662400,1596340800,2
JosukesMum,0,2,0,8,1586318400,1586318400,2
letterkid,0,2,0,5,1568433600,1568433600,2
Jerichar,0,2,0,14,1597550400,1597550400,2
Xaminaf,0,2,0,145,1606712400,1609304400,2
FreedomPrerogative,0,2,0,13,1608267600,1608267600,2
TheIzaacRogers,0,2,0,26,1573362000,1574139600,2
Yuli-Ban,2,0,6,0,1440302400,1446872400,2
Tirkad,0,2,0,12,1603512000,1603512000,2
MonsieurFarkwad,1,1,47,2,1599537600,1599537600,2
difersee,0,2,0,6,1603512000,1603512000,2
redthatstuf,0,2,0,14,1565236800,1600056000,2
TexBarry,0,2,0,3,1600747200,1600747200,2
URGENTCAFE,0,2,0,11,1539230400,1556251200,2
glazedpenguin,0,2,0,24,1607317200,1607749200,2
MoonBapple,1,1,20,6,1585281600,1585281600,2
NoBox5,1,1,35,1,1550206800,1550293200,2
Rampant16,0,2,0,0,1606626000,1606626000,2
danmuji98,0,2,0,5,1582693200,1582693200,2
invariablyuniquename,1,1,9,3,1606885200,1606885200,2
TheThunderousSilence,0,2,0,14,1556683200,1560830400,2
LivinOnBorrowedTime,0,2,0,24,1556251200,1556251200,2
Insanelopez,0,2,0,4,1555300800,1555300800,2
IStumbled,0,2,0,5,1557115200,1557201600,2
ReefaManiack42o,0,2,0,43,1581829200,1600660800,2
AdvancedPorridge,0,2,0,-5,1579150800,1597636800,2
ergocalciferol,0,2,0,23,1547010000,1547010000,2
arcangleous,0,2,0,50,1560657600,1560744000,2
TelmatosaurusRrifle,0,2,0,6,1608613200,1608613200,2
RottedFutures,0,2,0,9,1605070800,1607576400,2
SnakePlissken5ever,1,1,5,2,1556251200,1556251200,2
anxious_stan,0,2,0,-2,1604030400,1604030400,2
StalkTheHype,0,2,0,5,1591243200,1591243200,2
Difficult_Hornet_100,0,2,0,43,1604725200,1605243600,2
looman509,0,2,0,6,1603512000,1604379600,2
OverallLight,0,2,0,2,1580965200,1582779600,2
piHall314,0,2,0,9,1598155200,1603512000,2
Knotwood,0,2,0,-3,1586232000,1586232000,2
seeuinapeanutbutter,0,2,0,1,1607662800,1607662800,2
PrecursorBasin,0,2,0,31,1606626000,1606971600,2
AzimuthPro,0,2,0,7,1586923200,1587441600,2
ABC2s,0,2,0,7,1597291200,1603425600,2
ResurREKT99,0,2,0,20,1602734400,1603684800,2
Bewecchan,0,2,0,11,1604811600,1604811600,2
Frootbat86,1,1,8,1,1583384400,1597032000,2
tommycahil1995,1,1,19,1,1605243600,1606539600,2
GeorgesVezina99,0,2,0,27,1595995200,1595995200,2
notaneggspert,0,2,0,2,1572930000,1584417600,2
haribobosses,0,2,0,19,1574053200,1596254400,2
wishbonesma,0,2,0,3,1590724800,1600833600,2
knockedlooose,2,0,3425,0,1571112000,1571371200,2
Ruff_lyfe__,0,2,0,8,1606539600,1606539600,2
weirdmanheim,0,2,0,6,1563076800,1572667200,2
Qwikshift8,0,2,0,3,1603512000,1603598400,2
SAL10000,0,2,0,-3,1582002000,1582779600,2
Squall_G_Blade,0,2,0,4,1596859200,1596859200,2
heatinjs,0,2,0,-1,1605330000,1605416400,2
messiahoftruth,0,2,0,7,1611982800,1612069200,2
texasjezebel,0,2,0,2,1547701200,1556510400,2
Vanular,0,2,0,1,1608354000,1608354000,2
Tarah_with_an_h,0,2,0,9,1606453200,1606539600,2
nakedrottweiler,0,2,0,4,1587182400,1590984000,2
Volbia,0,2,0,6,1585454400,1585454400,2
goluboyemore,0,2,0,2,1582261200,1582261200,2
RoundSubstance,1,1,33,1,1569556800,1569556800,2
Cat_Marshal,0,2,0,6,1599451200,1599451200,2
PoopSteam,0,2,0,127,1595217600,1595217600,2
-Russian-Spy-,0,2,0,18,1595822400,1595822400,2
rxkarljones,0,2,0,70,1587268800,1587441600,2
Jabbam,0,2,0,1,1562731200,1562731200,2
sweetcinnamonpunch,0,2,0,12,1570420800,1596340800,2
dwarvenchaos,0,2,0,35,1585022400,1594267200,2
Fairytaleautumnfox,0,2,0,4,1575262800,1587614400,2
ARBosma,1,1,25,1,1597204800,1597204800,2
SimulatorDisengage,0,2,0,6,1573621200,1573621200,2
Br0ski,0,2,0,-15,1606453200,1606453200,2
whosthere1315,0,2,0,38,1558411200,1560312000,2
frackmenow,0,2,0,4,1584936000,1600142400,2
JaywellP,0,2,0,16,1597550400,1597550400,2
TomCalJack,0,2,0,47,1577422800,1587268800,2
CssMLI,0,2,0,2,1604466000,1604466000,2
Bob_Mayo,0,2,0,-10,1599019200,1599019200,2
chiswick43,1,1,18,1,1535601600,1547010000,2
Tennessee1977,0,2,0,6,1550552400,1578978000,2
geppetto123,0,2,0,9,1583812800,1599969600,2
ongimsogayfortitties,0,2,0,4,1607576400,1608699600,2
mcfish473,0,2,0,4,1604203200,1604203200,2
bigbadjesus,0,2,0,2,1432526400,1478754000,2
primoferal,0,2,0,21,1589947200,1608613200,2
rantingmagician,0,2,0,47,1586923200,1586923200,2
Driponometry,0,2,0,-3,1598500800,1600228800,2
icangetyouatoedude,0,2,0,5,1585454400,1585540800,2
quasi-dynamo,0,2,0,4,1564891200,1572753600,2
forensicbp,0,2,0,12,1556683200,1592712000,2
whatsfordinnerdad,0,2,0,23,1600920000,1602734400,2
thealphachoco,1,1,22,1,1601438400,1607922000,2
ironysparkles,0,2,0,6,1576040400,1581224400,2
its_radical96,0,2,0,69,1605934800,1608786000,2
GuntherDaBrave,0,2,0,2,1604203200,1604203200,2
drunklepockets,0,2,0,5,1601352000,1601438400,2
97779,1,1,95,3,1596772800,1607835600,2
createdcreated,0,2,0,11,1593921600,1593921600,2
panton312,0,2,0,9,1558065600,1558065600,2
somebitchsthrowaway,2,0,17,0,1607576400,1608094800,2
Alphadice,0,2,0,3,1598846400,1606539600,2
ronconcoca,0,2,0,8,1596168000,1600833600,2
7Tomus,0,2,0,5,1598587200,1598587200,2
Ger_MANG,0,2,0,3,1586404800,1586404800,2
lvl1vagabond,0,2,0,3,1616990400,1616990400,2
dmcfrog,0,2,0,2,1598932800,1598932800,2
mikejimenez1213,0,2,0,2,1609477200,1609563600,2
SapiosexualStargazer,0,2,0,23,1595563200,1595563200,2
marrrla,0,2,0,14,1601870400,1601956800,2
dethpicable,0,2,0,2,1604379600,1605934800,2
brendonuriesgirl,0,2,0,4,1607835600,1607835600,2
musicgoddess,1,1,178,4,1570507200,1570593600,2
TheGrayOnes,0,2,0,5,1594612800,1594612800,2
atavan_halen,0,2,0,43,1595390400,1595822400,2
syntheticfaith,0,2,0,6,1612155600,1612155600,2
MC_CrackPipe,1,1,4,2,1583812800,1583812800,2
Worse_than_most,0,2,0,6,1593489600,1599105600,2
whatlifegoals,0,2,0,6,1596254400,1596513600,2
theReal-timTHEfish,0,2,0,-12,1600747200,1603512000,2
The3mbered0ne,0,2,0,3,1605070800,1608872400,2
ChainExtreme,0,2,0,7,1601352000,1601697600,2
mangmere,0,2,0,12,1513832400,1513832400,2
rogue_pixeler,0,2,0,35,1567051200,1584504000,2
ballsnutsac,0,2,0,32,1578805200,1593576000,2
ripgoodhomer,1,1,11,3,1611982800,1611982800,2
thatsnotaviolin93,0,2,0,2,1600401600,1600401600,2
The_JimmyRustler,0,2,0,7,1605589200,1605589200,2
flock_of_meese,0,2,0,81,1591243200,1591243200,2
ItsBobsledTime,0,2,0,20,1605416400,1607317200,2
proudcuck1992,1,1,0,-3,1608699600,1608699600,2
notavalible666,0,2,0,8,1605848400,1607662800,2
Comrox,1,1,6,1,1556424000,1564286400,2
slavethewhales,0,2,0,11,1565928000,1603512000,2
wyoming_rider,0,2,0,6,1606280400,1607317200,2
sprace0is0hrad,0,2,0,283,1603512000,1603512000,2
NorthOaklandGuy,0,2,0,6,1605934800,1605934800,2
Alacidid,1,1,35,3,1605589200,1605589200,2
TheDraconianOne,0,2,0,2,1612069200,1612069200,2
Unforg1ven_Yasuo,0,2,0,66,1591502400,1602302400,2
KonnoSting85,0,2,0,1,1591329600,1599537600,2
scatteredround,0,2,0,5,1580101200,1580101200,2
witchlordofthewoods,0,2,0,4,1511240400,1514264400,2
GalakFyarr,0,2,0,3,1580274000,1580274000,2
Voltairefoxcat95,0,2,0,4,1594526400,1594612800,2
housingmess123,0,2,0,8,1588392000,1588392000,2
groucho_marxist89,2,0,260,0,1598760000,1599883200,2
The_Chorizo_Bandit,0,2,0,18,1609390800,1609390800,2
Silent_Neighborhood,0,2,0,12,1559620800,1562558400,2
kaitlinstayedhome,0,2,0,3,1579928400,1579928400,2
BabbaKush,0,2,0,24,1599796800,1599796800,2
bullseyes,0,2,0,12,1547787600,1547874000,2
reddit-name-asdfsdsf,0,2,0,11,1580014800,1587960000,2
shesheseabeaut,1,1,7,1,1585195200,1585454400,2
Imstillwatchingyou,0,2,0,3,1584331200,1585195200,2
07Vette,0,2,0,-4,1577336400,1577336400,2
wolfgang_armata,0,2,0,-10,1601179200,1601179200,2
sashimu,0,2,0,20,1584504000,1592107200,2
FiyaSpittnKittn,0,2,0,-20,1584676800,1584676800,2
OneSource13,0,2,0,6,1553400000,1587960000,2
nayruslovee,0,2,0,4,1591761600,1591761600,2
TheWhimsicalGod,0,2,0,38,1575349200,1575349200,2
dnaboe,0,2,0,23,1611896400,1611982800,2
GiftShopAboriginal,0,2,0,4,1593748800,1596427200,2
KeyserSozeBGM,0,2,0,3,1592712000,1592712000,2
Summamabitch,0,2,0,2,1600833600,1604379600,2
mndw111,0,2,0,11,1566532800,1606280400,2
Stereotype_Apostate,0,2,0,7,1541131200,1541131200,2
therealderksampson,1,1,12,3,1586232000,1586232000,2
FoeWithBenefits,0,2,0,24,1603512000,1606885200,2
akeetlebeetle4664,0,2,0,11,1582174800,1583899200,2
cooltreivus,0,2,0,7,1562126400,1562126400,2
better0ffbread,0,2,0,34,1597896000,1603512000,2
ApertureBear,0,2,0,4,1593748800,1608526800,2
fluffynutter13,0,2,0,6,1562212800,1563422400,2
Ozenberg,0,2,0,10,1597896000,1598846400,2
youleanbeauty,0,2,0,5,1599105600,1599451200,2
Barefoot-JohnMuir,0,2,0,67,1560571200,1565668800,2
PikaDicc,0,2,0,3,1597204800,1600920000,2
ForwardCulture,0,2,0,22,1605762000,1608094800,2
Jolly-Face,0,2,0,3,1589169600,1590033600,2
prhague,0,2,0,21,1573966800,1573966800,2
_PM_ME_YOUR_ARMPITS_,0,2,0,24,1562904000,1563508800,2
OnlyBluePie,0,2,0,2,1576645200,1577422800,2
Uniqueguy264,0,2,0,-39,1596945600,1596945600,2
Viramont,0,2,0,-15,1608440400,1609477200,2
randomnonwhiteguy,0,2,0,19,1555819200,1578891600,2
audio_54,0,2,0,5,1581224400,1581483600,2
Guillesar,0,2,0,18,1602475200,1603598400,2
rekab4820,1,1,172,37,1582002000,1582088400,2
lemonzonic,1,1,20,4,1576558800,1576558800,2
MyDamnCoffee,0,2,0,19,1598760000,1608526800,2
sharpshooter999,0,2,0,2,1607490000,1609736400,2
pwnangel,0,2,0,2,1571112000,1571716800,2
AICOM_RSPN,0,2,0,-4,1600660800,1600660800,2
Consistent_Floor,0,2,0,58,1570334400,1592107200,2
VoyeuristicDiogenes,0,2,0,63,1579928400,1579928400,2
CactusOrangeJuice,0,2,0,3,1538971200,1543208400,2
redsol23,0,2,0,26,1599969600,1599969600,2
feyretheorist,0,2,0,19,1608008400,1609045200,2
bleuciel12,0,2,0,24,1600488000,1600488000,2
CelestialConvergence,0,2,0,2,1583557200,1583557200,2
xMuffinxManx707,0,2,0,4,1611637200,1611637200,2
Xenoraiser,0,2,0,19,1598155200,1598846400,2
MrMagooishere,0,2,0,15,1589083200,1592193600,2
josemi_online,1,1,76,1,1608526800,1608526800,2
Lence98,0,2,0,3,1608440400,1608699600,2
H8ersgivemeSTR,0,2,0,8,1599710400,1601956800,2
genericusername33423,0,2,0,5,1571544000,1573621200,2
aezart,0,2,0,2,1570939200,1578891600,2
obiwormkenobi,1,1,145,5,1601697600,1601697600,2
KingCrimson87,1,1,134,9,1578459600,1578459600,2
Spaghetti_Bandit,0,2,0,2,1571544000,1571544000,2
KyleB0i,0,2,0,19,1589256000,1596600000,2
huhuhuhuhuhu123,1,1,35,4,1561521600,1562558400,2
Ayam-Cemani,0,2,0,6,1604466000,1604466000,2
Trythsout,0,2,0,6,1606539600,1606539600,2
TopLel88,0,2,0,4,1418533200,1418533200,2
NICOLONIAS,0,2,0,20,1603512000,1605070800,2
klaq,0,2,0,-23,1575003600,1575003600,2
sweetlemonywax,0,2,0,7,1551070800,1569211200,2
indifferentia123,0,2,0,3,1564113600,1564113600,2
OliverCash,0,2,0,30,1598241600,1598241600,2
OGLOCCCCC,0,2,0,206,1608094800,1608094800,2
painfullyavg,0,2,0,9,1603512000,1603598400,2
phantom_diorama,0,2,0,2,1596340800,1596340800,2
Osalosaclopticus,0,2,0,23,1593230400,1593230400,2
memesmokes,0,2,0,-32,1595649600,1595649600,2
Kylerj96,0,2,0,53,1592280000,1592280000,2
Rattlingplates,0,2,0,-1,1582779600,1582779600,2
Apolloraven,1,1,18,1,1608526800,1608526800,2
Stunt-Driver,0,2,0,14,1606021200,1606021200,2
CallMeCurious,0,2,0,41,1592798400,1592798400,2
QuarkyXDMANZ,1,1,0,1,1571025600,1571889600,2
neeedatherapist,0,2,0,39,1606798800,1607144400,2
GreatZampano1987,0,2,0,2,1561348800,1561435200,2
AmArschdieRaeuber,0,2,0,8,1566273600,1566273600,2
LockeClone,0,2,0,5,1550293200,1604638800,2
CounterproductiveAim,2,0,1027,0,1594612800,1601265600,2
bartzy_,0,2,0,17,1573621200,1576472400,2
jawshr84,0,2,0,7,1590206400,1592193600,2
met4life,1,1,36,3,1578200400,1603425600,2
Aquarian1999,1,1,59,10,1598673600,1598673600,2
bws2a,0,2,0,6,1605157200,1605157200,2
c_lark,0,2,0,2,1560139200,1560139200,2
threeamighosts,0,2,0,-11,1606798800,1607749200,2
gizmandius,0,2,0,2,1595563200,1595563200,2
atomheartmf,0,2,0,6,1575262800,1595822400,2
rayosunshine73,0,2,0,455,1581224400,1584158400,2
doodlerscafe,0,2,0,2,1608440400,1608440400,2
TheSpiteofLife,0,2,0,17,1578200400,1578200400,2
ChronosThe3rd,0,2,0,1,1608526800,1608526800,2
immortal_science,0,2,0,9,1570680000,1571976000,2
redrumWinsNational,0,2,0,15,1582434000,1597982400,2
robryan,0,2,0,3,1558670400,1602993600,2
Nesrrak,0,2,0,24,1595649600,1595649600,2
dreamcatcher-,0,2,0,6,1599278400,1599278400,2
kuetheaj,0,2,0,6,1577077200,1577077200,2
Robot-8,0,2,0,1,1589860800,1589860800,2
asperisst,0,2,0,31,1608526800,1609304400,2
miss_malefic,0,2,0,21,1611982800,1612069200,2
yung_bay_leaf,0,2,0,82,1600833600,1600833600,2
turdistheword04,0,2,0,19,1581656400,1590465600,2
_tinybutstrong,0,2,0,8,1588219200,1597636800,2
xx_deleted_x,0,2,0,8,1584590400,1585022400,2
nucleardragon235,0,2,0,23,1597118400,1597118400,2
child_0fwolf,0,2,0,8,1572408000,1572408000,2
SmackStation,0,2,0,37,1599710400,1608526800,2
Devin-Marx,0,2,0,21,1546059600,1547528400,2
ToiletMassacreof64,0,2,0,8,1575262800,1575262800,2
benjamin-online,0,2,0,6,1592625600,1608872400,2
cagewithakay,0,2,0,8,1582693200,1583125200,2
SarahC,0,2,0,13,1566446400,1566446400,2
leichendienerin,0,2,0,44,1605934800,1605934800,2
auzi-from-narnia,0,2,0,2,1593662400,1593662400,2
max95555,0,2,0,-2,1589860800,1589860800,2
CptTeddy,0,2,0,-80,1569124800,1569124800,2
OpeningAvocado294,0,2,0,13,1608440400,1608440400,2
theallredditor,0,2,0,3,1598932800,1598932800,2
PostNatalAbortionDR,0,2,0,26,1585540800,1585627200,2
treyviius,0,2,0,21,1608267600,1608267600,2
Ph9214,0,2,0,3,1603512000,1603598400,2
Slingster,0,2,0,-4,1595822400,1596772800,2
missy_muffin,0,2,0,8,1583812800,1586145600,2
0x5742,0,2,0,17,1561176000,1565755200,2
MichaelVicksPitbull,0,2,0,1,1586577600,1586577600,2
heirloomwife,0,2,0,2,1594440000,1606712400,2
real_le_million,0,2,0,3,1604030400,1604116800,2
vidoardes,0,2,0,9,1600747200,1600833600,2
Nicorhy,0,2,0,20,1608613200,1608613200,2
AmbientHelix,1,1,16,1,1593748800,1596168000,2
soulow77,0,2,0,7,1608008400,1608526800,2
inscapeable,0,2,0,30,1576818000,1576818000,2
TheWir3d,0,2,0,8,1572930000,1579064400,2
c0yboy,0,2,0,-2,1606453200,1606453200,2
UnquenchableVibes,0,2,0,3,1595908800,1595995200,2
astromason,0,2,0,8,1604984400,1604984400,2
lunarmooner17,1,1,11,1,1603771200,1603857600,2
rememberthis_1,0,2,0,6,1591416000,1591416000,2
readytobinformed247,0,2,0,2,1604379600,1604379600,2
gr0g_,0,2,0,59,1596945600,1609218000,2
omgpop,0,2,0,3,1607230800,1607317200,2
herrcoffey,0,2,0,36,1598760000,1608699600,2
bsk730,0,2,0,33,1577336400,1577336400,2
realtangy,0,2,0,31,1567137600,1567569600,2
MiccahD,0,2,0,3,1585454400,1585540800,2
SimplyRemove,0,2,0,8,1567656000,1567742400,2
idkijustcant,1,1,70,9,1598846400,1598846400,2
daillestofemall,0,2,0,7,1608526800,1608526800,2
PM_UR_SPIDERMAN_PICS,0,2,0,15,1599019200,1599105600,2
Trevski,0,2,0,20,1598068800,1603684800,2
ceresmoo,0,2,0,32,1597809600,1598068800,2
ProfitApprehensive24,0,2,0,2,1627272000,1627358400,2
NuclearRacc00n,0,2,0,-1,1573621200,1573621200,2
MadeOfClaynDTears,0,2,0,2,1573707600,1580446800,2
ARedditHypocrite,0,2,0,-7,1601265600,1601352000,2
MrOwnageQc,0,2,0,5,1587096000,1588824000,2
wiscomptonslacker,0,2,0,22,1581656400,1581742800,2
PregnantTree,0,2,0,4,1597982400,1598068800,2
Weaponstek,0,2,0,2,1591502400,1591502400,2
TheDarkbeastPaarl07,0,2,0,37,1601265600,1609218000,2
UncontainedOne,0,2,0,7,1604203200,1605070800,2
diapoetics,0,2,0,3,1606453200,1606453200,2
vb_nm,0,2,0,6,1555214400,1561780800,2
yetanotherusernamex,0,2,0,4,1584244800,1584244800,2
tony1449,0,2,0,18,1598587200,1598760000,2
Idkbr3h,0,2,0,9,1603944000,1603944000,2
bloodjet,0,2,0,30,1586318400,1601611200,2
KrugmanOwO,0,2,0,26,1605675600,1605675600,2
urdreas,0,2,0,32,1568088000,1573189200,2
Zach-uh-ri-uh,0,2,0,4,1604466000,1604466000,2
GGuesswho,0,2,0,15,1585886400,1586836800,2
othocore,1,1,3,1,1589601600,1589774400,2
snowflakelord,0,2,0,4,1607317200,1607317200,2
Jarave68,0,2,0,20,1581397200,1585627200,2
0lof,0,2,0,25,1606712400,1608094800,2
discourse_friendly,0,2,0,0,1585454400,1585540800,2
ThorOfKenya2,0,2,0,5,1588305600,1608267600,2
elleliz12,0,2,0,8,1586577600,1606453200,2
cpars98,0,2,0,-8,1599019200,1599019200,2
V8CarGuy,0,2,0,10,1592884800,1593057600,2
mr_orlo,0,2,0,2,1582866000,1582866000,2
HotDamn18V,0,2,0,14,1584504000,1590033600,2
randgeval,0,2,0,9,1601006400,1606712400,2
_socialdecay_,0,2,0,29,1579237200,1594699200,2
schroedingerspuss,0,2,0,37,1582088400,1582174800,2
ConsciousnessIsGod,0,2,0,18,1600574400,1600660800,2
restlesssheep,0,2,0,188,1573707600,1573707600,2
scrtrdtacnt,2,0,1065,0,1601956800,1602561600,2
FrequentPass,0,2,0,31,1602734400,1602734400,2
Johnny_the_hawk,0,2,0,1,1609045200,1609045200,2
NEETisNEATngl,0,2,0,15,1590033600,1590292800,2
RedtierExpo,0,2,0,7,1583899200,1583899200,2
JustTheTip___,0,2,0,12,1555992000,1556078400,2
DragoonSpoon,0,2,0,-2,1605848400,1605848400,2
Krypterr123,0,2,0,2,1584417600,1585454400,2
boardingtheplane,1,1,50,12,1585022400,1585022400,2
spillthebobaTEA,1,1,8,1,1595995200,1597723200,2
Xternel-,0,2,0,5,1597896000,1605157200,2
st120793,0,2,0,4,1596513600,1601697600,2
ElectricalWeb,0,2,0,3,1583038800,1583211600,2
superreddit2,1,1,989,3,1608181200,1608181200,2
Rene_Russos_Red_Bush,0,2,0,26,1581138000,1581138000,2
nintendo9713,0,2,0,13,1587096000,1587096000,2
heapofbears,2,0,603,0,1590724800,1591502400,2
jjdub7,0,2,0,18,1576990800,1576990800,2
grasshopperson,0,2,0,3,1568347200,1568347200,2
jwcoffee,0,2,0,-3,1571803200,1571803200,2
snizzywrong11,0,2,0,-8,1574917200,1575003600,2
2001honda_civic,0,2,0,2,1588046400,1588046400,2
The_BNut,0,2,0,9,1593489600,1599883200,2
opeaum,0,2,0,8,1572062400,1572235200,2
metalhead82,0,2,0,3,1584417600,1584417600,2
TopFollowing3003,0,2,0,2,1609304400,1609304400,2
TheAnonymousDoom,0,2,0,17,1605589200,1605589200,2
TheSapienRavenclaw,0,2,0,4,1602475200,1602475200,2
Swillsy69,0,2,0,-1,1601956800,1603080000,2
Prankster-Natra,0,2,0,8,1565409600,1606453200,2
swijvahdhsb,0,2,0,54,1576299600,1605762000,2
MacOrRoy,2,0,105,0,1606107600,1608872400,2
puja_puja,0,2,0,10,1600833600,1600920000,2
cennkefe,2,0,45,0,1528862400,1528862400,2
g4revolution,0,2,0,7,1583812800,1583899200,2
SilentLumatris,0,2,0,13,1591243200,1591329600,2
Lunchism,0,2,0,11,1594785600,1595217600,2
Cole4Christmas,0,2,0,54,1561953600,1561953600,2
GoBuffaloes,0,2,0,19,1605589200,1606280400,2
executecorporations,0,2,0,2,1590897600,1590897600,2
IVEMIND,0,2,0,9,1596772800,1596772800,2
Insolent_redneck,0,2,0,23,1575176400,1575262800,2
IFeelWeird1,0,2,0,-4,1583643600,1583643600,2
poto-cabengo,0,2,0,9,1587614400,1589515200,2
Triangle_dancer69,0,2,0,16,1595304000,1595304000,2
ThatTheoGuy,0,2,0,39,1577250000,1579928400,2
Quentyn_Oh,0,2,0,15,1554955200,1558152000,2
warmthz,0,2,0,2,1596513600,1596513600,2
emofes,0,2,0,24,1570507200,1583384400,2
learningtosail,1,1,0,2,1605070800,1605070800,2
toweldancer,1,1,15,8,1588219200,1606021200,2
everything2go,0,2,0,5,1606453200,1606539600,2
Unevenshoe656,0,2,0,2,1603512000,1603512000,2
Wokuling,1,1,563,3,1558238400,1569988800,2
Dank_Tales,0,2,0,104,1576990800,1579237200,2
VictarionGreyjoy,0,2,0,2,1605157200,1605157200,2
SuperSocrates,0,2,0,6,1576213200,1608354000,2
Surenity2,0,2,0,6,1587268800,1597896000,2
gx152,1,1,55,3,1608526800,1608526800,2
manityamtime,0,2,0,59,1609218000,1609477200,2
IhtiandrovichRex,0,2,0,5,1540785600,1541912400,2
Hansvestite,0,2,0,15,1604811600,1604898000,2
mercuryhg17,0,2,0,2,1596686400,1596686400,2
idkman4779,0,2,0,-23,1592107200,1608267600,2
MaHsdhgg,0,2,0,3,1578286800,1578373200,2
IrishMayonnaise,0,2,0,5,1573621200,1593403200,2
FareonMoist,2,0,53,0,1603512000,1609390800,2
LostLazarus,0,2,0,11,1583125200,1583125200,2
Volt_Marine,0,2,0,-86,1608181200,1608267600,2
GoooldenChests,0,2,0,20,1598846400,1605848400,2
Subworkit,0,2,0,2,1580187600,1580187600,2
metices,1,1,63,8,1607922000,1607922000,2
SkepticalAdventurer,0,2,0,0,1599969600,1600488000,2
ilovenoodles06,1,1,5,0,1603425600,1603857600,2
-ordinary,0,2,0,-1,1582779600,1582779600,2
booma-sunshine,0,2,0,0,1567828800,1569556800,2
BerniesBoner,0,2,0,3,1607922000,1607922000,2
XimcahCosmaos,0,2,0,30,1578805200,1586404800,2
OscarsNoseBeers,0,2,0,52,1548046800,1548306000,2
zhentarim_agent,0,2,0,4,1578718800,1578805200,2
itsgettingcloser,0,2,0,135,1584504000,1584504000,2
OldBabyGay,0,2,0,16,1602907200,1605157200,2
balotelli4ballondor,0,2,0,8,1584763200,1584849600,2
n_k_t_m_c,0,2,0,5,1608440400,1608440400,2
SooooooMeta,0,2,0,3,1612069200,1613106000,2
The-Phone1234,0,2,0,6,1565668800,1575954000,2
peecycling,0,2,0,2,1586059200,1586059200,2
Mortebi_Had,0,2,0,48,1599192000,1599364800,2
BoycottMathClass,1,1,46,1,1579064400,1579064400,2
HazeyHazell,0,2,0,-5,1582779600,1582779600,2
ray-of-fing-sunshine,1,1,1,5,1600920000,1600920000,2
Lord412,0,2,0,6,1576645200,1603684800,2
science10009,0,2,0,20,1571976000,1571976000,2
Ourobr,0,2,0,54,1576040400,1576040400,2
MatureTeen14,0,2,0,-9,1605589200,1605589200,2
ThrowawayMakise,0,2,0,2,1592452800,1592452800,2
0strich1,0,2,0,2,1599192000,1599796800,2
Picaronaut,0,2,0,7,1572235200,1595649600,2
Some_Topic5081,0,2,0,41,1605589200,1605848400,2
spaceman757,0,2,0,53,1599019200,1599019200,2
empyreanmax,0,2,0,35,1587009600,1587355200,2
Loginn122,0,2,0,2,1596340800,1596686400,2
substation_mechanic,0,2,0,6,1574917200,1574917200,2
stayclassytally,1,1,78,1,1605157200,1606366800,2
Unrepentant_Harpy,0,2,0,3,1609045200,1609650000,2
appearantly,0,2,0,13,1587182400,1587182400,2
Philosophantry,0,2,0,24,1608613200,1608613200,2
Rausss,0,2,0,6,1594958400,1604116800,2
-MIDDLE-MAN-,0,2,0,5,1593835200,1595649600,2
madmansmarker,0,2,0,61,1584676800,1584676800,2
sfgf,1,1,28,3,1571976000,1571976000,2
-Dancing,0,2,0,26,1602820800,1604552400,2
Rooshba,0,2,0,-46,1576299600,1576299600,2
jacebot,0,2,0,3,1591243200,1591243200,2
millii19,0,2,0,5,1607144400,1607144400,2
MasterPsaysUgh,0,2,0,3,1594353600,1594353600,2
Munchienimbles,0,2,0,249,1575954000,1589601600,2
Imadeup692,0,2,0,-1,1599796800,1599969600,2
M3chPilot,1,1,371,9,1595304000,1595304000,2
nslinkns24,0,2,0,2,1572408000,1575349200,2
tyfunk02,0,2,0,25,1585454400,1585540800,2
Rosalindlives,1,1,12,3,1591588800,1602302400,2
prunesmoothies,0,2,0,35,1579064400,1612155600,2
studmuffffffin,0,2,0,23,1599019200,1599019200,2
WannaPlayVhess,0,2,0,2,1548306000,1548306000,2
j33pwrangler,0,2,0,15,1604203200,1608872400,2
knobbysideup,0,2,0,104,1598414400,1598414400,2
astralcode,0,2,0,23,1601870400,1602907200,2
russian-scout,0,2,0,9,1588996800,1605762000,2
S1lchasRuin,0,2,0,3,1603512000,1603598400,2
Dottie_Dottie,0,2,0,125,1572235200,1591070400,2
shoppingfortime,0,2,0,7,1598932800,1599019200,2
puptake,0,2,0,9,1597896000,1606626000,2
Thatonebagel,0,2,0,4,1577336400,1578978000,2
allisonmfitness,0,2,0,13,1597291200,1597896000,2
gonkyo,0,2,0,21,1593748800,1596427200,2
FaceWithAName,0,2,0,-9,1600228800,1600228800,2
myuseless2cents,1,1,1155,3,1592366400,1593921600,2
FirmOnion,1,1,131,2,1583812800,1586318400,2
mbdavid297,1,1,21,17,1602475200,1603339200,2
Rutabaga0704,0,2,0,3,1603425600,1603598400,2
72fool,0,2,0,-25,1586923200,1586923200,2
leeaassee,0,2,0,14,1557115200,1557201600,2
YoMamas_azz,0,2,0,-16,1607576400,1607662800,2
Bjumseskat,0,2,0,2,1583985600,1583985600,2
jambrown13977931,0,2,0,4,1605157200,1605157200,2
Iamprettychill,0,2,0,9,1606021200,1608267600,2
MothrFKNGarBear,0,2,0,-7,1577422800,1577422800,2
nyaanarchist,0,2,0,40,1553486400,1604811600,2
Teisseire_Rakt,0,2,0,198,1608181200,1608181200,2
MagicZombieCarpenter,0,2,0,11,1584072000,1603598400,2
VVarlord,0,2,0,8,1580274000,1590206400,2
allanjeong,0,2,0,11,1593835200,1593835200,2
Lucifer_Sam_Cyan_Cat,0,2,0,11,1567224000,1568865600,2
Mysteriarch,0,2,0,52,1586664000,1600488000,2
Kiloku,0,2,0,3,1591329600,1601179200,2
XtremeFanForever,0,2,0,2,1576126800,1576126800,2
Realmhopper,0,2,0,6,1587009600,1587009600,2
FuckWorkLetsRide,0,2,0,15,1564545600,1590465600,2
realrentner,1,1,5,4,1548997200,1555387200,2
quitarias,0,2,0,8,1572235200,1572235200,2
BurdensomeCount,0,2,0,3,1603598400,1603598400,2
Raptoris-Khang,1,1,17,2,1609131600,1609131600,2
Mr_Asano,0,2,0,14,1598328000,1600401600,2
Yorlisin,0,2,0,3,1603684800,1603684800,2
lazyglacierSC,1,1,40,3,1555473600,1555473600,2
Kahnshaak,0,2,0,26,1607835600,1607922000,2
bassemjarkas,1,1,8,1,1496203200,1496203200,2
Thelastlatino,0,2,0,6,1578546000,1578805200,2
Colawar,0,2,0,10,1581915600,1584763200,2
Torcal4,0,2,0,3,1579064400,1591243200,2
mollymostly,1,1,8,9,1593144000,1606194000,2
justsomeph0t0n,0,2,0,43,1555646400,1555646400,2
aretumer,0,2,0,49,1573362000,1575867600,2
razorbladethorax,0,2,0,40,1604898000,1608786000,2
suk_doctor,0,2,0,127,1607835600,1607922000,2
earlofmars45,0,2,0,7,1585454400,1585454400,2
Gleabot,2,0,209,0,1578891600,1585886400,2
BurningBeechbone,0,2,0,34,1596600000,1596600000,2
aslikrr69,0,2,0,9,1580619600,1606626000,2
transrightsordie,0,2,0,11,1581570000,1581656400,2
Syrairc,0,2,0,4,1600747200,1606366800,2
Gootangus,0,2,0,24,1600574400,1600574400,2
DethNaRoK,0,2,0,-6,1562040000,1562126400,2
Pinkratsss,0,2,0,8,1603512000,1603598400,2
whatever49,0,2,0,-12,1591243200,1591243200,2
FastAsleepattheWheel,0,2,0,12,1573966800,1573966800,2
generaldisaraay,0,2,0,3,1604379600,1604379600,2
skyntbook,0,2,0,3,1595476800,1595736000,2
roxane0072,0,2,0,7,1539921600,1539921600,2
Yusho,0,2,0,22,1590638400,1590724800,2
fresnel-rebop,2,0,253,0,1551416400,1556510400,2
The_Main_Alt,0,2,0,64,1585022400,1585022400,2
MoSqueezin,0,2,0,18,1606885200,1606971600,2
Mikey3477,0,2,0,9,1604030400,1608354000,2
alkrk,0,2,0,2,1603512000,1603512000,2
nightstalker962,0,2,0,16,1572408000,1587700800,2
anoxy,0,2,0,7,1585454400,1585454400,2
Grouchy-Painter,0,2,0,7,1599710400,1599796800,2
KoverH,1,1,17,4,1601265600,1607922000,2
rieh,0,2,0,45,1572321600,1583125200,2
majorasterror,0,2,0,6,1574312400,1575608400,2
dsm1324,0,2,0,9,1589083200,1599969600,2
camesawconundrum,1,1,0,8,1600920000,1600920000,2
Neon2b,0,2,0,4,1574312400,1574312400,2
Brooke0207,0,2,0,13,1593144000,1593144000,2
StockNext,0,2,0,13,1608699600,1611723600,2
Towerss,0,2,0,4,1572148800,1572235200,2
jessigato927957,0,2,0,40,1605589200,1606107600,2
pluush,0,2,0,4,1590552000,1590638400,2
pastelrazzi,0,2,0,15,1576299600,1581138000,2
N64crusader4,0,2,0,20,1606712400,1606712400,2
ikdweshm,0,2,0,4,1596081600,1596168000,2
Orange-TippyTaps,0,2,0,40,1606107600,1608008400,2
BiffBiffBiff27,0,2,0,70,1571889600,1574312400,2
SupraSilva,0,2,0,4,1565150400,1565668800,2
Terrible_Guidance_34,0,2,0,5,1607576400,1607576400,2
Jura52,0,2,0,-20,1599019200,1599019200,2
always_lost1610,0,2,0,24,1581051600,1587614400,2
sssjabroka,0,2,0,16,1582779600,1582779600,2
QuiteinRaptures,0,2,0,3,1588132800,1599624000,2
morphoyle,0,2,0,138,1579755600,1584072000,2
IkiOLoj,0,2,0,7,1596859200,1596859200,2
deeplyprivate,1,1,11,1,1602043200,1602043200,2
PM_ME_SHALLTEAR_R34,0,2,0,46,1595822400,1595908800,2
yellowbellies,0,2,0,5,1605070800,1605070800,2
onlyspeaksiniambs,0,2,0,66,1568174400,1568174400,2
Drawtaru,0,2,0,5,1598068800,1606021200,2
Pawelek23,0,2,0,66,1579150800,1588824000,2
TheReelSalmon,0,2,0,7,1575262800,1575349200,2
VenomWood,0,2,0,6,1578286800,1593921600,2
BaleFire77,0,2,0,1,1585454400,1585540800,2
random_nightmare,0,2,0,3,1604379600,1604379600,2
couchtimes,0,2,0,15,1573016400,1586059200,2
Infinitezen,0,2,0,7,1591243200,1591243200,2
Lom2feu,0,2,0,6,1595131200,1612069200,2
ProspectPool,0,2,0,13,1591243200,1591243200,2
MummiesMan,0,2,0,13,1575694800,1575694800,2
xondk,0,2,0,3,1584763200,1584849600,2
walkin_mudd,0,2,0,18,1587182400,1587787200,2
syntheticskeleton,0,2,0,35,1596859200,1598846400,2
ddevirgiliis,0,2,0,0,1575867600,1575867600,2
muscle_man_69,0,2,0,9,1589601600,1589860800,2
doctor_drugdealer,0,2,0,11,1557892800,1557892800,2
PossiblePractice,0,2,0,7,1582520400,1582520400,2
e160681,0,2,0,19,1596081600,1596081600,2
pleasesendweed,0,2,0,5,1589083200,1608354000,2
Robin1992101,0,2,0,220,1587960000,1606885200,2
Alternative_Ad538,1,1,9,1,1605675600,1605675600,2
yeetusfetus1,0,2,0,9,1538020800,1538020800,2
Kilazur,0,2,0,3,1559966400,1559966400,2
backand_forth,0,2,0,26,1571630400,1572062400,2
Usermane01,0,2,0,32,1575003600,1577509200,2
Uncreativite,0,2,0,7,1602734400,1602734400,2
Metalgoat83,0,2,0,2,1604552400,1604552400,2
pm_me_the_revolution,0,2,0,23,1562126400,1562126400,2
cheezy_thotz,0,2,0,42,1590033600,1605330000,2
marwootra,0,2,0,40,1585281600,1585281600,2
brakesmumpsimus,1,1,39,14,1558584000,1570680000,2
gtech4542,0,2,0,-1,1591329600,1591329600,2
Jagokoz,0,2,0,6,1598155200,1603512000,2
buckedyuser,0,2,0,16,1595304000,1607317200,2
7622hello_there,0,2,0,57,1572321600,1577595600,2
BrockMcKean,0,2,0,2,1606626000,1606626000,2
lagomorpheme,0,2,0,5,1583470800,1583470800,2
losthours,0,2,0,-8,1584763200,1585022400,2
K397094,0,2,0,0,1606798800,1607403600,2
yerfdog_lives,1,1,12,1,1607576400,1607576400,2
JebBoosh,0,2,0,15,1594353600,1608267600,2
itssolol,0,2,0,203,1593057600,1594094400,2
osdalemicker,0,2,0,6,1557547200,1557979200,2
Tangurena,0,2,0,5,1576213200,1605934800,2
tbllc,0,2,0,-3,1585454400,1585454400,2
Reagalan,0,2,0,6,1602043200,1602043200,2
RedeyeChillin,0,2,0,21,1597204800,1597896000,2
tysonblak,1,1,212,6,1547528400,1547614800,2
rempel,0,2,0,10,1599105600,1602388800,2
Exponential2718----,0,2,0,6,1597032000,1597032000,2
Synaxxis,0,2,0,57,1556424000,1580274000,2
The1stmadman,0,2,0,6,1603512000,1603512000,2
waitingforachance,0,2,0,84,1570420800,1573534800,2
pinkholemunchmunch,0,2,0,17,1592366400,1594353600,2
berogg,0,2,0,-21,1608613200,1608613200,2
dootpont,0,2,0,7,1596168000,1596168000,2
lowes_employee,0,2,0,11,1589342400,1594180800,2
OldFashionedLoverBoi,0,2,0,28,1584763200,1584763200,2
chungusxl94,0,2,0,13,1595822400,1595822400,2
tipmon,0,2,0,-40,1606453200,1606453200,2
SasugaDarkFlame,0,2,0,27,1607835600,1609131600,2
Anthraksi,0,2,0,4,1562040000,1562040000,2
blvsh,0,2,0,-5,1586404800,1586404800,2
floral_disruptor,0,2,0,3,1597896000,1598328000,2
TheDoktorIsIn,0,2,0,3,1589601600,1589601600,2
catscradle474,0,2,0,8,1576558800,1578978000,2
spkvn,0,2,0,-13,1599105600,1600228800,2
Larllie,0,2,0,9,1606798800,1606885200,2
UltraCynar,0,2,0,129,1584763200,1584763200,2
Sigura83,0,2,0,10,1583384400,1590638400,2
LordPiss99,0,2,0,16,1607144400,1612069200,2
maniakb416,0,2,0,10,1597118400,1607403600,2
SugaryShrimp,0,2,0,25,1577336400,1591934400,2
nalydpsycho,0,2,0,39,1607230800,1607230800,2
satellite_uplink,0,2,0,-1,1607490000,1609736400,2
59Trees,0,2,0,27,1552194000,1552194000,2
fortlasagna,0,2,0,8,1608440400,1608526800,2
Turbulent_Custard_84,0,2,0,44,1603512000,1603598400,2
Serenewendy,0,2,0,32,1559102400,1559102400,2
subaru1992,0,2,0,-13,1565755200,1565755200,2
Faaz_Noushad4444,0,2,0,2,1605675600,1605675600,2
pidude314,0,2,0,8,1568174400,1568174400,2
KinkyZub,0,2,0,6,1602820800,1602907200,2
123kolpas,0,2,0,-5,1586664000,1587009600,2
TheatreTragedy,0,2,0,13,1579323600,1579323600,2
GuyWithTheGoods,0,2,0,16,1599278400,1599796800,2
MadRice38,0,2,0,4,1589688000,1589688000,2
Microwaveforks,0,2,0,90,1606712400,1607317200,2
bleakwinter1983,0,2,0,9,1600488000,1600488000,2
DeltaCortis,0,2,0,100,1597464000,1597464000,2
brvtxl,0,2,0,10,1579150800,1579755600,2
MASEtheACE510,0,2,0,17,1607749200,1611896400,2
braidedpubes86,0,2,0,34,1583899200,1608699600,2
ka_beene,0,2,0,16,1607403600,1607403600,2
holmyliquor,0,2,0,346,1586836800,1604203200,2
WeedAndLsd,0,2,0,16,1586491200,1586664000,2
DatBoiEBB,0,2,0,3,1605589200,1605675600,2
consumered,0,2,0,5,1605502800,1608786000,2
mitsena,0,2,0,6,1600056000,1600142400,2
McArborough,0,2,0,4,1546750800,1546750800,2
yaboipenishole,0,2,0,6,1583643600,1587528000,2
brevitx,0,2,0,11,1612069200,1612069200,2
Tangytoes97,0,2,0,9,1592107200,1600401600,2
seancm32,0,2,0,49,1581224400,1585022400,2
JamaltS,1,1,12,5,1602129600,1602129600,2
TraditionalPen4877,0,2,0,-10,1606366800,1606626000,2
screw_line,1,1,65,4,1606194000,1606194000,2
ScrapCityBlues,0,2,0,32,1588651200,1588651200,2
Obvious_Layer,1,1,4,4,1606626000,1606626000,2
poscaldious,0,2,0,7,1594699200,1594785600,2
RamblingHeathen,0,2,0,16,1608094800,1608354000,2
Agreeable-Zone,0,2,0,7,1580101200,1602993600,2
Roger3,0,2,0,49,1571112000,1571112000,2
lotyei,1,1,6,2,1555560000,1594526400,2
sleepy-girl29,0,2,0,20,1595304000,1597550400,2
soldiermodelife,0,2,0,4,1594612800,1596254400,2
nova_in_space,0,2,0,104,1598500800,1605589200,2
I_ate_a_milkshake,0,2,0,2,1585454400,1585540800,2
tpfang56,0,2,0,6,1602648000,1604552400,2
AncileBooster,0,2,0,8,1584763200,1608786000,2
arientyse,0,2,0,2,1557115200,1557460800,2
Ahndarodem,0,2,0,24,1587614400,1590379200,2
Butt-Pirate-Yarrr,1,1,4,8,1607144400,1607490000,2
saltpancake,0,2,0,71,1605934800,1606021200,2
Madnomadin,0,2,0,10,1595131200,1599883200,2
Imasniffachair,0,2,0,4,1590033600,1590033600,2
Karmasita,0,2,0,-3,1607403600,1607403600,2
007chill,0,2,0,20,1578718800,1584763200,2
sakthi38311,0,2,0,2,1594267200,1594353600,2
asianj1m,0,2,0,22,1603684800,1603684800,2
TheFrogWife,0,2,0,67,1605762000,1605762000,2
guinness5,0,2,0,12,1569816000,1577682000,2
Bicycle_Violator,0,2,0,3,1614747600,1614747600,2
terencebogards,0,2,0,11,1591243200,1591243200,2
TheGrandMann,0,2,0,7,1595822400,1595908800,2
aybbyisok,0,2,0,13,1573362000,1573362000,2
hapidjus,0,2,0,-5,1598328000,1603252800,2
Cephiroth,0,2,0,12,1572494400,1606453200,2
Mechanical_Omega_15,0,2,0,2,1570420800,1570420800,2
frank_anhist,1,1,7,1,1601352000,1602734400,2
Pizza-ona-stick,0,2,0,20,1594267200,1594267200,2
Ihavecakewantsome,0,2,0,3,1605934800,1605934800,2
LordFishFinger,0,2,0,4,1553140800,1553140800,2
TheHorseFrog,0,2,0,13,1556683200,1571284800,2
boldbe2uty1,0,2,0,3,1601697600,1601784000,2
gwanington,0,2,0,14,1593835200,1599796800,2
Buffalolife420,0,2,0,2,1594526400,1594526400,2
ButterTycoon_wife,0,2,0,12,1605589200,1605675600,2
BodegaCat,0,2,0,15,1569124800,1569124800,2
andoriyu,0,2,0,-11,1574398800,1574485200,2
throwaway9890604,1,1,30,1,1565409600,1565409600,2
neish,0,2,0,7,1576558800,1576818000,2
milthaar,0,2,0,5,1609218000,1612069200,2
thiago2213,0,2,0,3,1579064400,1579064400,2
Drmanhattan505,0,2,0,17,1608267600,1608699600,2
megas88,0,2,0,6,1592625600,1592884800,2
canles,0,2,0,4,1578373200,1578373200,2
Sebfofun,0,2,0,4,1604379600,1604466000,2
Upvote_I_will,0,2,0,0,1592366400,1603598400,2
realbluesky149,0,2,0,204,1570680000,1570680000,2
Hdjbfky,0,2,0,26,1559016000,1559016000,2
robman615,1,1,26,5,1605070800,1605070800,2
akid114,0,2,0,4,1604203200,1605589200,2
mtux96,0,2,0,24,1586577600,1586577600,2
cat_herder_64,0,2,0,9,1608786000,1611810000,2
tundra72,1,1,2,1,1437278400,1453957200,2
quahknob,0,2,0,0,1606885200,1611982800,2
Lsjethro,1,1,6,2,1599364800,1599364800,2
swaite,0,2,0,2,1593144000,1593144000,2
DruidOfDiscord,0,2,0,-18,1549515600,1549515600,2
thelobster64,0,2,0,4,1565928000,1565928000,2
misterrespectful,0,2,0,2,1585454400,1585454400,2
WizTheNose,0,2,0,33,1601352000,1609477200,2
thwnn4,0,2,0,25,1590552000,1593057600,2
GolfBaller17,0,2,0,8,1560052800,1570420800,2
EvidenceBasedOnly,0,2,0,1,1589688000,1589688000,2
Super_Colossal,0,2,0,23,1608181200,1608958800,2
Electronic-Barnacle,0,2,0,10,1606712400,1606712400,2
NoSkillGame,0,2,0,-6,1580101200,1580101200,2
celestialwreckage,0,2,0,13,1600488000,1600488000,2
Idiotbox002,0,2,0,26,1551502800,1551502800,2
fhatkow,0,2,0,1,1605589200,1605589200,2
Wolfs_Taco,0,2,0,78,1583298000,1583298000,2
mameyn4,0,2,0,34,1600833600,1600833600,2
Melodic_Elderberry,0,2,0,5,1575349200,1575435600,2
AmericanSpiritGuide,0,2,0,29,1594612800,1594872000,2
bitshitter,0,2,0,16,1557892800,1557892800,2
InternetIsNotBad,0,2,0,22,1593748800,1600488000,2
bigdickrichard122,0,2,0,125,1593576000,1606885200,2
kszczep,0,2,0,13,1594958400,1599105600,2
Tittie_Magee,0,2,0,38,1593230400,1593230400,2
TwistedNematic207,0,2,0,3,1591416000,1591416000,2
joragh,0,2,0,26,1575349200,1581656400,2
Jetset57,0,2,0,15,1548738000,1552276800,2
NotModusPonens,0,2,0,3,1581051600,1601092800,2
Drizzt396,0,2,0,3,1585195200,1585195200,2
MySoilSucks,0,2,0,6,1604030400,1605243600,2
ohbeehwon,0,2,0,4,1568865600,1570507200,2
ArmyOfMemes,0,2,0,7,1573448400,1573448400,2
opheliafea,1,1,4,2,1567051200,1567224000,2
dabberoo_2,0,2,0,37,1575954000,1579928400,2
corydeansmith,1,1,3,29,1602993600,1602993600,2
Exacerbated,0,2,0,23,1581915600,1607835600,2
Duckanator22,0,2,0,1,1598673600,1598673600,2
Pootentia,0,2,0,11,1605243600,1606798800,2
Mrteamtacticala,0,2,0,2,1606021200,1608526800,2
Square_Base_3576,0,2,0,4,1600228800,1600488000,2
futurepilot32,0,2,0,2,1585454400,1585454400,2
monsterslime,0,2,0,34,1559016000,1566273600,2
drakeblood4,0,2,0,7,1604898000,1604898000,2
deistknight,0,2,0,6,1577250000,1578891600,2
Vibe_Tribe_Inc,0,2,0,21,1612069200,1612069200,2
vbnfrwlk,1,1,5,5,1609390800,1612069200,2
skysailer,0,2,0,16,1572494400,1575003600,2
chrispan3,1,1,4,1,1591761600,1591761600,2
christie12022012,0,2,0,4,1607230800,1607230800,2
Haamboner,0,2,0,44,1578027600,1579410000,2
leslienewp,0,2,0,10,1598068800,1607835600,2
calciumsimonaque,0,2,0,164,1573534800,1584936000,2
BrandonTheStoner,1,1,8320,6,1560571200,1560657600,2
MichelleObamasCockkk,0,2,0,1,1598500800,1598587200,2
sdraz,0,2,0,2,1606626000,1606626000,2
tyrannon,0,2,0,52,1581915600,1611982800,2
thefourthpatron,0,2,0,5,1576040400,1583470800,2
capulis,0,2,0,9,1570593600,1570593600,2
SawConvention,0,2,0,2,1589601600,1593230400,2
bozoconnors,0,2,0,-1,1591243200,1591243200,2
Jackeduupp,0,2,0,6,1572494400,1572753600,2
Szeperator,0,2,0,8,1569038400,1576904400,2
Corinneruby,0,2,0,7,1607144400,1607490000,2
SuzanneSpring,0,2,0,-1,1573362000,1573362000,2
aurdinarily,0,2,0,3,1599969600,1599969600,2
BourbonQue1,0,2,0,2,1589947200,1590033600,2
candiedpink,0,2,0,71,1591416000,1591416000,2
Leonard_DaVinci,0,2,0,5,1579928400,1580014800,2
Professor-Wheatbox,0,2,0,55,1603512000,1603512000,2
-----1,0,2,0,2,1598587200,1598587200,2
jpritchard,0,2,0,-21,1584763200,1608613200,2
jeremy1051,1,1,376,24,1594526400,1594526400,2
SoppySopps,0,2,0,42,1595995200,1606021200,2
redfreedomusofa,0,2,0,2,1608094800,1608094800,2
Ienjoyeatingass77,0,2,0,8,1553140800,1553140800,2
Whatxotf,0,2,0,23,1601697600,1601697600,2
cabbagebatman,0,2,0,28,1608267600,1608440400,2
Greenmarineisbak,0,2,0,3,1600660800,1600747200,2
mr_cobweb,0,2,0,1,1605416400,1605416400,2
serketboard,1,1,297,19,1608354000,1608354000,2
upstairsnovel,0,2,0,17,1560916800,1560916800,2
fyngyrz,0,2,0,14,1603598400,1603598400,2
CircleOfTrust_IRLv2,0,2,0,-6,1612155600,1615266000,2
Simply_Existing82,0,2,0,4,1591675200,1596772800,2
jamsticks9,0,2,0,9,1555646400,1598414400,2
proxystarx1,0,2,0,313,1608267600,1609477200,2
Cjpowers33,1,1,24,12,1588392000,1595563200,2
ArkleArkleArkle,0,2,0,17,1605502800,1605934800,2
CustomerMundane,0,2,0,2,1602907200,1602907200,2
BourgeoisShark,0,2,0,2,1599105600,1599105600,2
aflockaaaa,1,1,16,11,1589601600,1589601600,2
WeHaveIgnition,0,2,0,88,1578632400,1603684800,2
theregenerates,0,2,0,12,1555992000,1555992000,2
Socrataint,2,0,18,0,1580360400,1587009600,2
EyeH8uxinfiniteplus1,0,2,0,2,1587355200,1608526800,2
MrFloutch,0,2,0,13,1588478400,1596513600,2
22courageofthegods22,0,2,0,3,1546405200,1546405200,2
arimtimtimo,0,2,0,120,1600747200,1604030400,2
Jedibean,0,2,0,64,1584331200,1595476800,2
Corey_Holland,1,1,22,6,1604811600,1604811600,2
Here_to_click,2,0,24,0,1605589200,1609218000,2
Bango-Fett,0,2,0,3,1605502800,1605502800,2
01Arjuna,0,2,0,12,1598673600,1600056000,2
wackojacko666,0,2,0,4,1589860800,1590984000,2
AvailableAudience6,0,2,0,21,1608440400,1611896400,2
hillaryrunsonpizza,0,2,0,-3,1577422800,1606539600,2
turn_page,0,2,0,86,1609304400,1609304400,2
ka_hotuh,0,2,0,3,1603512000,1604030400,2
Mr_No_Socks,0,2,0,8,1575522000,1584590400,2
Wlpxx7,0,2,0,54,1573189200,1597982400,2
Mattack3000,0,2,0,0,1608699600,1608699600,2
mariofan366,0,2,0,2,1586404800,1602648000,2
roofuskit,0,2,0,20,1577854800,1611810000,2
knee-che,0,2,0,17,1561780800,1569988800,2
honestlyhereforpr0n,0,2,0,5,1603512000,1604811600,2
AnAngryFredHampton,0,2,0,18,1558324800,1579150800,2
yoosufmuneer,0,2,0,-1,1571716800,1571716800,2
sinfymanz,0,2,0,2,1605848400,1608267600,2
commonfeatureinteria,0,2,0,4,1595822400,1597982400,2
shameonyounancydrew,0,2,0,5,1602820800,1602820800,2
Couldntbefappier,0,2,0,17,1606539600,1606626000,2
kaizomab,0,2,0,13,1578027600,1582002000,2
broodje_visman,0,2,0,2,1610773200,1610773200,2
conway1308,0,2,0,3,1596600000,1605243600,2
pdubbinators,2,0,60,0,1586923200,1592884800,2
Timo47Nl,0,2,0,15,1600056000,1600142400,2
redditisrandom,0,2,0,7,1608181200,1608699600,2
EenRedditor,0,2,0,54,1597464000,1597636800,2
Tele-Muse,0,2,0,3,1584331200,1585022400,2
Shockedge,0,2,0,-4,1597291200,1602734400,2
Convenientjellybean,0,2,0,3,1599364800,1608786000,2
Velcro1190,0,2,0,5,1571630400,1572148800,2
the-wind-sings,0,2,0,15,1570680000,1582088400,2
DOGSraisingCATS,0,2,0,18,1584158400,1584763200,2
area51police,0,2,0,3,1570939200,1571371200,2
honecker,0,2,0,3,1598846400,1598932800,2
poditoo,0,2,0,200,1567224000,1577422800,2
kindurbanite,0,2,0,0,1575954000,1575954000,2
Djmarr56,0,2,0,12,1591675200,1591675200,2
Jackmat2424,0,2,0,30,1606539600,1606539600,2
Accnr1,0,2,0,1,1603684800,1604811600,2
c_carmiRecruiter,0,2,0,-3,1606021200,1606107600,2
psychacct,0,2,0,13,1597636800,1597636800,2
Wuz314159,0,2,0,-1,1584504000,1605589200,2
sik_dik,0,2,0,-4,1571112000,1571112000,2
anothergirl009,0,2,0,2,1561003200,1561003200,2
GboyDAKing,0,2,0,2,1619323200,1619323200,2
Allodoxaphobiaa,0,2,0,2,1583899200,1587614400,2
Mr_Nobadi_M_Portent,0,2,0,4,1595217600,1598155200,2
Imtheprofessordammit,0,2,0,77,1602043200,1602129600,2
TheAntagonist1,0,2,0,30,1566446400,1567569600,2
illuminatedtiger,0,2,0,5,1608958800,1608958800,2
WiWiWiWiWiWi,0,2,0,-26,1577336400,1580014800,2
drsuperhero,0,2,0,13,1606626000,1606626000,2
HammockFanboy,0,2,0,0,1585454400,1585454400,2
Madphilosopher3,0,2,0,2,1581310800,1581310800,2
hazard__,1,1,1972,216,1597464000,1597464000,2
gg2020hello,1,1,78,1,1578286800,1578286800,2
ilikeavocadotoast,0,2,0,12,1571716800,1591761600,2
HighwayTerrorist,0,2,0,81,1605589200,1606021200,2
ptrakk,0,2,0,47,1604203200,1609218000,2
AnxiousAriel,0,2,0,19,1594008000,1594094400,2
JectorDelan,0,2,0,2,1604379600,1604379600,2
qsef9999,0,2,0,-6,1574312400,1574312400,2
Mtjacq,0,2,0,5,1608267600,1609304400,2
JeffersonSpicoli,0,2,0,-15,1598500800,1598500800,2
anon3325,1,1,37,11,1600833600,1600833600,2
PM_ME_UR_DaNkMeMe,0,2,0,-4,1562817600,1562817600,2
PrismaticDetector,0,2,0,21,1602820800,1607230800,2
nofferty,0,2,0,44,1592971200,1596686400,2
eatpencils,0,2,0,3,1607922000,1607922000,2
dededeTV,0,2,0,10,1558497600,1558497600,2
ssrose,0,2,0,24,1577163600,1578027600,2
Mrluanha,1,1,352,8,1574830800,1588219200,2
Seminolehighlander,0,2,0,4,1580360400,1589947200,2
Stinky_Eastwood,0,2,0,16,1600574400,1606021200,2
shononi,0,2,0,102,1565582400,1581051600,2
BJ_Knife-Fight_Baby,0,2,0,-1,1587096000,1587096000,2
Pineapples_26,0,2,0,23,1592539200,1592539200,2
gingermybuddy,1,1,20,28,1557547200,1602820800,2
One_Toxic_Potato,0,2,0,3,1605589200,1605589200,2
goldeyesamurai,0,2,0,25,1605589200,1611810000,2
demorub,1,1,7,33,1581483600,1581483600,2
H_E_Pennypacker,0,2,0,2,1608267600,1608267600,2
thestarswaltz,0,2,0,21,1592366400,1594094400,2
kidfriday,1,1,2298,3,1578546000,1598241600,2
76willcommenceagain,1,1,18,4,1582261200,1604898000,2
moleman114,1,1,611,34,1581483600,1581483600,2
AGuyAndHisCat,0,2,0,-18,1594785600,1594785600,2
youprintthemoney,1,1,0,-2,1576990800,1576990800,2
CardinalNYC,0,2,0,2,1603512000,1603512000,2
iamcnicole,0,2,0,18,1553918400,1555992000,2
Rcm003,0,2,0,-8,1578286800,1578373200,2
mrlongleggedmcdaddyy,0,2,0,13,1612155600,1612155600,2
Poramordedeus,0,2,0,-18,1592452800,1592452800,2
biges2,0,2,0,-2,1576645200,1576645200,2
SpellJenji,0,2,0,3,1603944000,1603944000,2
lewis01722,0,2,0,45,1567569600,1573275600,2
Sarvos,0,2,0,61,1600401600,1602302400,2
iSpaYco,0,2,0,45,1602993600,1602993600,2
GypsyPunk,0,2,0,3,1607058000,1607662800,2
RedderBarron,0,2,0,5,1562212800,1562212800,2
Destr3010,0,2,0,7,1573275600,1586491200,2
tunsun22,1,1,11,2,1579064400,1579064400,2
Hide_And_Dont_Seek,0,2,0,42,1598241600,1605243600,2
WhensLunch69,0,2,0,10,1585454400,1585540800,2
letsgouda,0,2,0,7,1603771200,1608786000,2
SeriousSamvsEzraKKK,1,1,15,6,1580360400,1580360400,2
Electronic-Goal-8141,0,2,0,2,1604725200,1604725200,2
NorthernBoy306,0,2,0,-14,1602216000,1602216000,2
maximum-climaximum,0,2,0,141,1578459600,1578459600,2
Annabellish,0,2,0,13,1583643600,1600660800,2
Paranoiadestroyer,1,1,20,3,1583125200,1583125200,2
Sugar-n-Spikes,0,2,0,27,1605502800,1609304400,2
OnlyElouise,0,2,0,3,1608786000,1608786000,2
Wohowudothat,0,2,0,11,1603598400,1603598400,2
helemikro,0,2,0,61,1573880400,1573966800,2
Righteousrob1,0,2,0,14,1581915600,1581915600,2
Tychus07,0,2,0,10,1594267200,1600056000,2
x172839x,0,2,0,-1,1606712400,1606885200,2
orangesubmareen,0,2,0,5,1599019200,1602043200,2
Richard-Cheese,0,2,0,-5,1573362000,1573448400,2
FML012e,0,2,0,3,1603944000,1606021200,2
sean1553,0,2,0,6,1605762000,1611810000,2
Bad_Hominid,0,2,0,9,1605243600,1612155600,2
mustardheadmaster,1,1,7,1,1607144400,1608354000,2
ppc-no,1,1,17,1,1597809600,1599796800,2
fb556a68d7,1,1,67,5,1552194000,1552194000,2
golfgod93,0,2,0,20,1606539600,1606539600,2
MasterTomatillo8,0,2,0,1,1547269200,1547269200,2
klystron2010,0,2,0,7,1563336000,1583038800,2
Walter_Malown,0,2,0,34,1581051600,1591675200,2
buczfan,0,2,0,24,1577422800,1577509200,2
EmergencyEntry6,0,2,0,32,1581915600,1582779600,2
wutangsamurai,0,2,0,21,1569470400,1573189200,2
demunted,0,2,0,15,1607144400,1609390800,2
ProtossTheHero,0,2,0,44,1600747200,1600747200,2
Lochinas,0,2,0,-1,1596945600,1598068800,2
MaxStatic,0,2,0,30,1577768400,1577768400,2
Farun,0,2,0,17,1601956800,1606626000,2
sockHole,0,2,0,24,1586750400,1589774400,2
stokoe11,0,2,0,7,1593403200,1593835200,2
racinreaver,0,2,0,7,1598155200,1598155200,2
redtrx,0,2,0,19,1604293200,1608786000,2
Marquis_Of_Wu,0,2,0,39,1602043200,1602043200,2
Undercover-Ways,1,1,38,1,1589342400,1606712400,2
ZeroCoolLuvsAcidBurn,0,2,0,37,1600056000,1600142400,2
lost_survivalist,0,2,0,10,1574744400,1575694800,2
MagusPerde,0,2,0,2,1430280000,1430280000,2
pawelsku,0,2,0,7,1594440000,1594612800,2
YouCouldBeBetter,1,1,61,15,1603944000,1604030400,2
TheBlonkh,0,2,0,4,1576040400,1578891600,2
IAmMostDope92,0,2,0,15,1612069200,1612069200,2
SkyslicerX2,0,2,0,-6,1578805200,1578891600,2
Noigottheconch,0,2,0,6,1605589200,1607230800,2
Moonrise513,0,2,0,3,1579323600,1579410000,2
fad94,0,2,0,2,1605416400,1605416400,2
drb0mb,0,2,0,5,1605330000,1605330000,2
wanderingbilby,0,2,0,5,1603339200,1603339200,2
deincarnated,0,2,0,6,1611982800,1611982800,2
mykekelli,0,2,0,10,1593403200,1601524800,2
Fullsebas,0,2,0,-18,1593835200,1602388800,2
Slamma_Mann,1,1,49,10,1572408000,1572408000,2
Glittering-Nothing-3,0,2,0,6,1604116800,1608613200,2
cosmin_c,0,2,0,7,1595908800,1595908800,2
dunkin_employee,0,2,0,-26,1597464000,1597464000,2
vivalachavez,0,2,0,2,1603425600,1603512000,2
christineyvette,0,2,0,86,1606712400,1606798800,2
bigdaddymango26,0,2,0,9,1605070800,1605070800,2
imanassholeok,0,2,0,-7,1571716800,1571716800,2
oranges2039495,0,2,0,3,1512190800,1512190800,2
hremmingar,0,2,0,13,1583726400,1608872400,2
BlueWolf934,0,2,0,3,1579842000,1579842000,2
SinisterSunny,0,2,0,3,1571976000,1571976000,2
haudtoo,0,2,0,11,1608267600,1608526800,2
fryreportingforduty,0,2,0,12,1597636800,1606453200,2
z0mbiegrl,0,2,0,35,1589169600,1589860800,2
beanscad,0,2,0,3,1548824400,1548824400,2
darius56,0,2,0,4,1571457600,1571457600,2
Mnemoreri,0,2,0,63,1599451200,1601265600,2
GermanDogGobbler,1,1,778,6,1597377600,1606366800,2
Kiwi__Cunt,0,2,0,-5,1595217600,1595217600,2
RIP_huell_howser,0,2,0,18,1586232000,1598241600,2
sadlunchesaresad,0,2,0,38,1608786000,1608786000,2
dontbelikeyou,0,2,0,10,1603512000,1603512000,2
BOTC33,0,2,0,4,1590638400,1590638400,2
thewileyone,0,2,0,8,1598846400,1598846400,2
havefun4me2,0,2,0,-4,1583643600,1585454400,2
Halfjack12,0,2,0,14,1597118400,1597118400,2
HodorFirstOfHisName,0,2,0,5,1552021200,1552107600,2
hopefullyneurotic,0,2,0,37,1592712000,1592712000,2
Mr_Clod,0,2,0,4,1585022400,1599019200,2
Bluetaggeo,0,2,0,14,1601697600,1606107600,2
zabths,0,2,0,8,1579755600,1592280000,2
heidikins213,0,2,0,12,1600142400,1600142400,2
oaktrees92,0,2,0,11,1575003600,1575003600,2
almostarealhologram,0,2,0,4,1599796800,1599796800,2
murdersteak,0,2,0,12,1591675200,1593403200,2
hancocbr0217,0,2,0,2,1591329600,1591329600,2
breal1fq,0,2,0,3,1607922000,1607922000,2
ProbablyANoobYo,0,2,0,71,1573189200,1575176400,2
Dongledoes,0,2,0,7,1599105600,1599105600,2
OhLookARock,0,2,0,13,1564632000,1564977600,2
RodneyOhebsion,2,0,52,0,1569556800,1573707600,2
OurGloriousLeader,0,2,0,1,1556596800,1556596800,2
lucyloolavender,0,2,0,20,1600920000,1605762000,2
da_puginto,0,2,0,-36,1572494400,1572494400,2
PeaGroundbreaking303,0,2,0,8,1600488000,1600488000,2
Julia_Arconae,0,2,0,16,1568260800,1574139600,2
im-a-guy-like-me,0,2,0,6,1605762000,1605848400,2
signuser,0,2,0,-1,1606280400,1606280400,2
Partyeagle777,0,2,0,4,1599537600,1599624000,2
ImaginaryxDoll,0,2,0,41,1548651600,1554868800,2
pandatitties,0,2,0,19,1577336400,1577336400,2
daydreaming-g,0,2,0,3,1574744400,1605589200,2
democrititus,0,2,0,39,1593748800,1593748800,2
CatalunyaNoEsEspanya,0,2,0,44,1605070800,1606194000,2
Infosearch1,0,2,0,13,1583643600,1585886400,2
Toth201,0,2,0,7,1599019200,1599019200,2
wileyshreds,0,2,0,3,1594353600,1594353600,2
dannyeOW,0,2,0,-24,1569902400,1569902400,2
radbadsadbutrad,0,2,0,7,1603512000,1603512000,2
Keevtara,0,2,0,18,1599105600,1599105600,2
meisanon,1,1,180,-3,1606453200,1608267600,2
dedalus-9,0,2,0,2,1598155200,1598500800,2
ImRedditorRick,0,2,0,3,1585022400,1606539600,2
tejae,1,1,10,2,1606453200,1608354000,2
KikiFlowers,0,2,0,14,1564113600,1604379600,2
happytrel,0,2,0,4,1573534800,1573534800,2
LoneWolf-ACAB,0,2,0,174,1597377600,1598673600,2
Cleaver_Fred,0,2,0,23,1593662400,1594440000,2
vampirequincy,0,2,0,8,1576386000,1585454400,2
afiendish1,0,2,0,56,1582866000,1600574400,2
HughJass14,0,2,0,4,1611896400,1611896400,2
ReddyReddit91,0,2,0,7,1601697600,1608526800,2
crystaltuka,0,2,0,40,1608786000,1608872400,2
radvenuz,0,2,0,85,1588651200,1601438400,2
Genericusernamexe,0,2,0,-3,1560830400,1578373200,2
queerpinata,0,2,0,37,1611896400,1611896400,2
FdasTUd82,0,2,0,-9,1601438400,1601524800,2
ToxicObeZe,0,2,0,2,1580706000,1580792400,2
17RicaAmerusa76,0,2,0,4,1611896400,1611896400,2
secretpoop75,0,2,0,5,1603425600,1605675600,2
kifn2,0,2,0,21,1604811600,1604811600,2
oneironautevs,0,2,0,32,1557547200,1560744000,2
xtrinsicboi,0,2,0,5,1604811600,1604811600,2
fanatic1123,0,2,0,2,1574139600,1574139600,2
Disastrous-Spare6919,0,2,0,9,1608526800,1608526800,2
tomyorkbday,0,2,0,30,1598328000,1608958800,2
tehsushichef,0,2,0,10,1571025600,1593748800,2
thetasteofink00,0,2,0,97,1566446400,1567742400,2
uhhuhwhatever,0,2,0,11,1569124800,1572321600,2
-hbq,0,2,0,3,1561867200,1561953600,2
TheDrunkCig,0,2,0,-22,1571976000,1571976000,2
Nameless_American,1,1,9,7,1575349200,1577682000,2
bulvai_s-forge,0,2,0,21,1602388800,1608008400,2
badgirlmonkey,0,2,0,1,1595217600,1595217600,2
professor_shortstack,1,1,328,6,1593230400,1593230400,2
anxiouslybreathing,0,2,0,37,1603944000,1603944000,2
YoStopTouchinMyDick,0,2,0,21,1584763200,1584763200,2
francesruza,0,2,0,9,1606280400,1606712400,2
lazilyloaded,0,2,0,11,1583643600,1608267600,2
wyldnvy,0,2,0,108,1589515200,1602648000,2
cismeuniverse,0,2,0,11,1600660800,1608354000,2
seekindivid,0,2,0,8,1604293200,1605243600,2
nawtree,1,1,47,8,1588564800,1588564800,2
soresu1234,1,1,29,6,1589688000,1589688000,2
lightofbeing,0,2,0,32,1584504000,1584590400,2
balding_truck420,0,2,0,-34,1592107200,1596859200,2
_golly_miss_,0,2,0,4,1605589200,1608008400,2
Mercy_Merci,0,2,0,10,1608094800,1609131600,2
ssose,0,2,0,3,1608699600,1608699600,2
cool_username_42069,0,2,0,-1,1609477200,1609477200,2
FeralWilde,0,2,0,28,1588737600,1588737600,2
Ryknight2,0,2,0,16,1576386000,1608094800,2
andrewwism,0,2,0,5,1604984400,1612155600,2
vdau,0,2,0,33,1555128000,1555128000,2
GuyAceman,0,2,0,7,1591329600,1592366400,2
IhreHerrlichkeit,0,2,0,26,1605934800,1605934800,2
whodywei,0,2,0,3,1594440000,1602820800,2
itsfinewearefine,0,2,0,13,1589083200,1589169600,2
meadbymidnight,1,1,64,67,1570248000,1570420800,2
PointNineC,0,2,0,4,1593921600,1593921600,2
lol_wut12,0,2,0,11,1571803200,1584244800,2
zaxqs,0,2,0,5,1578373200,1578459600,2
LlamaWithLargeSack,1,1,372,75,1606971600,1606971600,2
Benjamin_Grimm,0,2,0,46,1564372800,1571803200,2
Paranoid_PeoPLE,0,2,0,16,1548046800,1548910800,2
UncleVolk,0,2,0,9,1571803200,1574658000,2
hush3193,0,2,0,62,1603512000,1603512000,2
theshover,0,2,0,4,1603944000,1603944000,2
privatePK,0,2,0,4,1606885200,1606885200,2
Unbo,0,2,0,31,1573534800,1573534800,2
peedonfirehydrant,1,1,9,0,1595217600,1595217600,2
Disastrous-Access,0,2,0,11,1590724800,1593576000,2
Jaspern888,0,2,0,5,1596945600,1596945600,2
slomk5,0,2,0,2,1579496400,1580101200,2
tragoedian,0,2,0,11,1601697600,1601697600,2
iceplanet2002,0,2,0,6,1582088400,1600920000,2
thegr8fuldead,2,0,180,0,1595131200,1601265600,2
birdsmell,0,2,0,0,1588910400,1588996800,2
InfinityOwns,0,2,0,5,1569902400,1569902400,2
Mixedupteam,0,2,0,11,1588046400,1588046400,2
unnunn12,0,2,0,38,1542949200,1542949200,2
Flymayne101,2,0,7,0,1588737600,1589428800,2
panzerkampfwagen,0,2,0,6,1581138000,1605589200,2
Averagestiff,0,2,0,10,1604898000,1605934800,2
billypancakes,0,2,0,128,1607403600,1611896400,2
dirtypos,0,2,0,17,1608094800,1608786000,2
Ok-Routine-6705,0,2,0,1,1602648000,1602648000,2
Storytimenonsense,0,2,0,8,1583985600,1585454400,2
BERRISOUR,0,2,0,-1,1570075200,1570075200,2
ffffffen,0,2,0,13,1603684800,1603684800,2
im_a_zoe,0,2,0,28,1608786000,1608958800,2
myapurple,0,2,0,5,1607058000,1607058000,2
nartchie,0,2,0,-12,1581224400,1581224400,2
voltimand,1,1,450,40,1586750400,1586750400,2
vemundd,0,2,0,-2,1611982800,1611982800,2
pinkybrainblog,2,0,27,0,1503288000,1508472000,2
ArrrGaming,0,2,0,22,1584072000,1584244800,2
jackyalin,0,2,0,2,1603512000,1608267600,2
ChunkyCB,0,2,0,15,1607576400,1611982800,2
ghost-of-blockbuster,0,2,0,10,1608699600,1611896400,2
bovely_argle-bargle,0,2,0,29,1605934800,1608786000,2
beeradvice,0,2,0,3,1595217600,1595304000,2
Woratu,0,2,0,9,1573621200,1573621200,2
NapalmsMaster,0,2,0,15,1581483600,1581483600,2
throwawayturtlelily,0,2,0,3,1602734400,1604984400,2
Tabbiecat5,0,2,0,28,1603166400,1603684800,2
Silvadream,1,1,223,24,1552363200,1571112000,2
qazwscpl,0,2,0,46,1574312400,1574658000,2
Iiawgiwbi,0,2,0,2,1601179200,1601697600,2
Vastarien202,0,2,0,44,1599105600,1599105600,2
robyn_capucha,0,2,0,17,1605934800,1607749200,2
SmokeySFW,0,2,0,26,1605157200,1605157200,2
PhilSpencerP3,0,2,0,13,1572580800,1594526400,2
fluffythunderpants,0,2,0,2,1599192000,1604379600,2
TheDragonChase,0,2,0,13,1606798800,1607317200,2
andForMe,0,2,0,12,1603512000,1605157200,2
callmemavis,1,1,25,1,1572753600,1592798400,2
patienceparse,0,2,0,23,1605243600,1605416400,2
Shokushukun,0,2,0,11,1539921600,1539921600,2
Fuckhatinghatefucker,0,2,0,4,1607230800,1607230800,2
nicksum4141,1,1,117,10,1605070800,1606539600,2
no_but_srsly_tho,0,2,0,10,1586664000,1590984000,2
santaire,0,2,0,5,1595390400,1597377600,2
ChrisRunsTheWorld,0,2,0,2,1594440000,1596686400,2
from_cold_north,0,2,0,1,1611982800,1611982800,2
Sure10,0,2,0,2,1581224400,1581224400,2
Lachweee,0,2,0,18,1595217600,1604203200,2
niko4ever,0,2,0,4,1605675600,1605762000,2
TheEnbodimentofdeath,0,2,0,19,1595822400,1596168000,2
PlotinusTheOne,0,2,0,1,1598500800,1605416400,2
Gino-Solow,0,2,0,4,1608526800,1608526800,2
OOM-BattleDroid,0,2,0,4,1596513600,1596772800,2
MyNameIsDave4,1,1,0,3,1587355200,1587355200,2
Market_Anarchist,0,2,0,-1,1577163600,1587441600,2
ManReggie,0,2,0,2,1558929600,1558929600,2
Smucker5,0,2,0,5,1607403600,1607403600,2
Berkut22,0,2,0,2,1582779600,1587182400,2
Konohamaru15,0,2,0,-16,1608094800,1608094800,2
pissjetski,0,2,0,2,1566100800,1566100800,2
Orion_1986,0,2,0,3,1551330000,1551330000,2
sammyg42,1,1,5,1,1592366400,1592366400,2
GravityCentered_,0,2,0,4,1600833600,1600920000,2
cocoacowstout,0,2,0,74,1604552400,1604811600,2
PrincessSalty,0,2,0,3,1596600000,1596600000,2
sku11_kn1ght,0,2,0,167,1602129600,1607403600,2
KybalC,0,2,0,-4,1578373200,1578373200,2
jujumusk,0,2,0,5,1601092800,1608354000,2
lovingit999_999,0,2,0,5,1609131600,1609131600,2
coveredinsunscreen,0,2,0,9,1606885200,1606885200,2
zrowe_02,0,2,0,4,1595217600,1595217600,2
Thomaswiththecru,0,2,0,1,1609218000,1609218000,2
sarahrahjane,0,2,0,83,1545022800,1595131200,2
surpriseknock,0,2,0,9,1596513600,1599451200,2
SurrealDad,0,2,0,24,1579064400,1593921600,2
kmh148,0,2,0,4,1569384000,1573102800,2
Voyager87,0,2,0,21,1601265600,1601352000,2
whoamanshitsfuckedup,0,2,0,9,1543467600,1550379600,2
Multihog,0,2,0,7,1558756800,1558929600,2
interprof,0,2,0,4,1563422400,1563422400,2
dark_autumn,0,2,0,2,1608786000,1608786000,2
koliyyt,1,1,8,1,1587873600,1587873600,2
PrincessSparklefists,0,2,0,33,1595995200,1596081600,2
lazylazycat,0,2,0,9,1546405200,1595217600,2
themochabear,0,2,0,48,1556856000,1559793600,2
Ran_Prankster,0,2,0,3,1595304000,1606712400,2
maddog505,0,2,0,32,1582088400,1582088400,2
TheLateThagSimmons,0,2,0,31,1609304400,1609304400,2
Fdez90,0,2,0,8,1585627200,1586232000,2
Heyfluffu,0,2,0,8,1580965200,1585281600,2
brianary_at_work,0,2,0,10,1596081600,1605070800,2
fourleafwitch,0,2,0,2,1589083200,1589083200,2
donkeycoco,0,2,0,28,1570939200,1573966800,2
ANAL_FISHY,0,2,0,2,1579064400,1579064400,2
hempoid,0,2,0,11,1576213200,1576213200,2
Publicsting,0,2,0,14,1587182400,1597377600,2
darkmidnightblue,0,2,0,4,1599969600,1599969600,2
TytoInexspectata,0,2,0,22,1572843600,1583125200,2
Dekthro,0,2,0,17,1592625600,1592712000,2
Bombe_a_tummy,0,2,0,4,1591848000,1597291200,2
_Conway_,0,2,0,3,1609304400,1609304400,2
adudeguyman,0,2,0,15,1548046800,1548997200,2
masterpikachu_,0,2,0,5,1569124800,1569470400,2
alreadytakenj,0,2,0,6,1605762000,1605762000,2
Jinarched,0,2,0,18,1608699600,1608958800,2
Pipupipupi,0,2,0,29,1606539600,1609390800,2
shod4n,1,1,28,1,1569816000,1576213200,2
Prisoner-of-Paradise,0,2,0,2,1597377600,1597377600,2
thefisharezombies,1,1,16,2,1605243600,1605243600,2
letitsnow18,0,2,0,73,1584763200,1584763200,2
xdeadly_godx,0,2,0,52,1592193600,1606971600,2
PrinceCharles50,0,2,0,80,1603080000,1603684800,2
go-bananas-today,0,2,0,10,1606280400,1606366800,2
VowelMovement13,0,2,0,6,1583125200,1593662400,2
Le_rat_des_champs,0,2,0,4,1591934400,1591934400,2
khaaanquest,0,2,0,107,1578027600,1578027600,2
RuthGayderBinsburg,1,1,34,1,1607317200,1607317200,2
Drunky_McStumble,0,2,0,66,1607835600,1612155600,2
Embarrassed_Cow,0,2,0,6,1585454400,1585454400,2
pinkgliterpoo,1,1,39,1,1597809600,1598328000,2
dontknownothing00,2,0,165,0,1572843600,1580619600,2
Josphitia,0,2,0,-6,1584936000,1599537600,2
feraferoxdei,1,1,7,7,1598760000,1599192000,2
1stevelation,0,2,0,5,1583298000,1585972800,2
thegreatjarate,0,2,0,7,1601784000,1601956800,2
limbojunkie,0,2,0,28,1584158400,1587355200,2
CellieBellie,0,2,0,4,1563163200,1563163200,2
nopantts,0,2,0,1,1599019200,1599105600,2
HolycommentMattman,0,2,0,12,1609045200,1609045200,2
VonMouth,0,2,0,8,1593748800,1599883200,2
codeavail_expert,2,0,8,0,1603339200,1608958800,2
Heavy_Revolution,0,2,0,3,1603166400,1603166400,2
ashdog66,0,2,0,15,1597723200,1597723200,2
kuwaitchildfree,0,2,0,2,1564027200,1592798400,2
ERADICATE__Them,0,2,0,2,1576731600,1577163600,2
ikantsleep,0,2,0,2,1603944000,1603944000,2
justausername99,0,2,0,-1,1595908800,1595908800,2
GiraffixCard,0,2,0,18,1541912400,1574053200,2
imnotmrrobot,0,2,0,74,1561262400,1561262400,2
hkyman92,0,2,0,12,1588478400,1600574400,2
theangryducklings,1,1,8,2,1582866000,1582866000,2
Doc85,0,2,0,16,1544331600,1546146000,2
EustaciaVye18,0,2,0,54,1604203200,1604203200,2
Imblewyn,0,2,0,3,1608094800,1608094800,2
Bootylove4185,0,2,0,10,1572494400,1576990800,2
cocky_duck19,0,2,0,-9,1585886400,1585886400,2
VeganandLucille,0,2,0,4,1575867600,1575954000,2
Grebmolb,0,2,0,4,1590465600,1590552000,2
theleakyman,0,2,0,55,1574744400,1574744400,2
Dekarde,0,2,0,8,1588910400,1603512000,2
Redneckshinobi,0,2,0,10,1556251200,1556856000,2
ConcernedPikachu,0,2,0,2,1590292800,1590379200,2
blackflag209,0,2,0,81,1600660800,1606539600,2
SchoonBoon,0,2,0,18,1575349200,1575349200,2
roosly,0,2,0,7,1598068800,1608354000,2
g33k1nd159153,0,2,0,16,1575176400,1580101200,2
Mouthshitter,0,2,0,32,1600833600,1606539600,2
stratj45d28,0,2,0,49,1554436800,1604466000,2
cjstudent40k,0,2,0,2,1574053200,1574053200,2
smilingbutdeadly,0,2,0,6,1552968000,1574830800,2
thegreatestrobot2,0,2,0,3,1573189200,1575176400,2
fartsincognito,0,2,0,17,1596340800,1605157200,2
hrafnagaldrr,0,2,0,-4,1586404800,1586404800,2
Alyx-,0,2,0,13,1564977600,1564977600,2
DarthHaggis,0,2,0,5,1595217600,1595304000,2
7reYZVmn,0,2,0,-2,1597291200,1597291200,2
Aardvark_Man,0,2,0,6,1585627200,1585627200,2
heroin-queen,0,2,0,7,1580533200,1580533200,2
PanglosstheTutor,0,2,0,33,1581570000,1581570000,2
ThatGuyWithTwoNames,0,2,0,1,1576472400,1576472400,2
PrestigiousToe7,0,2,0,1,1607576400,1607749200,2
Kalsed,0,2,0,28,1580014800,1592539200,2
WaltLongmire0009,0,2,0,2,1608613200,1608613200,2
wakizashi_1,0,2,0,8,1546664400,1548046800,2
-Hill-La-Hill-,0,2,0,2,1550293200,1550293200,2
paintthedaytimeblack,0,2,0,11,1583125200,1597291200,2
DarkZero515,0,2,0,12,1584763200,1606971600,2
whidbekdndnd,0,2,0,9,1608613200,1609304400,2
Thehyperninja,0,2,0,3,1594612800,1594612800,2
jonnyjonson314,0,2,0,26,1573966800,1573966800,2
ArcanePunk,0,2,0,6,1577422800,1577422800,2
JackNuner,0,2,0,4,1579064400,1601870400,2
Jesse_Marie_at_221B,0,2,0,2,1592020800,1592107200,2
notagoodboye,0,2,0,3,1603512000,1603512000,2
archaeonflux,0,2,0,7,1550293200,1550293200,2
-wobblies-,0,2,0,5,1520827200,1520827200,2
Squeeze-,0,2,0,140,1600142400,1609218000,2
PrinceAzTheAbridged,0,2,0,4,1574398800,1599192000,2
sanchypanchy,0,2,0,-1,1576645200,1578200400,2
planetnatto,0,2,0,11,1611723600,1611810000,2
cfm1231,1,1,40,1,1572667200,1572843600,2
lisamummwi,0,2,0,4,1606021200,1606021200,2
calgiannis,0,2,0,15,1597291200,1600574400,2
AtDarkling,0,2,0,-30,1573448400,1589428800,2
nobodybannana,0,2,0,3,1562040000,1562731200,2
MiserableSpaghetti,0,2,0,48,1580878800,1588305600,2
Jollytruant,0,2,0,5,1576558800,1576558800,2
ProudHommesexual,0,2,0,16,1597550400,1607490000,2
StoneCold1689,0,2,0,0,1583726400,1584504000,2
notmyrealfirstname,0,2,0,2,1580101200,1580101200,2
caribbean-amphibian,0,2,0,2,1574053200,1574053200,2
Aleitheo,0,2,0,-6,1550725200,1566878400,2
Means-of-production,0,2,0,5,1571976000,1571976000,2
dipshit_loser,0,2,0,38,1564632000,1569902400,2
LordFalcoSparverius,0,2,0,32,1608699600,1608958800,2
slurmfactory,0,2,0,226,1605934800,1605934800,2
epao8,0,2,0,3,1607835600,1607835600,2
Kooky-Berry,1,1,25,5,1590465600,1590465600,2
Sheraff33,0,2,0,9,1526529600,1539921600,2
mcslender97,0,2,0,51,1602734400,1602820800,2
DuffmanStillRocks,0,2,0,-19,1594267200,1595131200,2
Lakersrock111,0,2,0,4,1564459200,1600660800,2
ScoffingYayap,0,2,0,11,1593662400,1594094400,2
Fran12344,0,2,0,2,1613106000,1613106000,2
whydidimakeausername,0,2,0,36,1577336400,1577336400,2
hunterwhomst,1,1,7,2,1572148800,1572148800,2
geufhsh,0,2,0,31,1594008000,1594008000,2
BananaBreads,0,2,0,18,1605589200,1609045200,2
nointerestsbutsleep,0,2,0,16,1571025600,1602820800,2
homebma,0,2,0,2,1592366400,1592366400,2
RavenAva,0,2,0,5,1593576000,1594353600,2
tmo27,0,2,0,8,1563249600,1575349200,2
harambewatch,0,2,0,2,1575262800,1575262800,2
slinkysuki,0,2,0,11,1587096000,1587096000,2
OldMoneyOldProblems,0,2,0,-6,1592366400,1592366400,2
alilbitobsessed,0,2,0,79,1605934800,1606107600,2
Article23Point1,0,2,0,3,1609045200,1609304400,2
everutt,0,2,0,21,1570939200,1585972800,2
nightfalldevil,0,2,0,10,1585454400,1590638400,2
InsertEdgyNameHere,0,2,0,62,1582261200,1582261200,2
xfritz5375,0,2,0,3,1581656400,1581656400,2
bhollis6895,0,2,0,2,1606626000,1606626000,2
OtherPen,0,2,0,10,1573362000,1581051600,2
thro117,0,2,0,5,1596600000,1596600000,2
alexrox360,0,2,0,121,1560225600,1561176000,2
bryzdogg,0,2,0,2,1573102800,1574744400,2
Sovem,0,2,0,7,1600747200,1600747200,2
DecentAmountOfEffort,0,2,0,2,1559275200,1575003600,2
Deeznugssssssss,0,2,0,4,1612155600,1612155600,2
eidolonengine,0,2,0,12,1596254400,1596254400,2
lostcattears,0,2,0,0,1571803200,1571803200,2
Im_The_Daiquiri_Man,0,2,0,4,1600315200,1608267600,2
Oparon,1,1,10,1,1573707600,1594440000,2
feelosophiya,0,2,0,8,1555128000,1557892800,2
silentstormchaser,0,2,0,2,1606712400,1606712400,2
Pokebro2000,0,2,0,1,1605589200,1605589200,2
mpturp,0,2,0,95,1558411200,1582606800,2
jm2628,0,2,0,11,1602648000,1602734400,2
TinaTheWavingCat,0,2,0,-1,1605416400,1608267600,2
chriso1999,0,2,0,7,1580101200,1583298000,2
hanoian,0,2,0,33,1573966800,1582088400,2
ghostoflunchtomorrow,0,2,0,1,1606712400,1609390800,2
afterbusinesshours,0,2,0,9,1612069200,1612069200,2
wombatdiplomat,0,2,0,11,1570680000,1574658000,2
dsmgriffin,0,2,0,17,1550898000,1552021200,2
JJOne101,0,2,0,11,1585454400,1585454400,2
mrloube,0,2,0,2,1588737600,1588824000,2
Zodiakos,0,2,0,2,1549256400,1549342800,2
thenewspoonybard,0,2,0,9,1587009600,1587096000,2
chakrablocker,0,2,0,6,1598760000,1607403600,2
Sottisier,0,2,0,5,1568865600,1568865600,2
whodo-i-thinkiam,0,2,0,75,1584158400,1587873600,2
Pukasz,0,2,0,12,1593230400,1593230400,2
ohyouknowthething,0,2,0,35,1608613200,1608613200,2
Mindless-Equal,0,2,0,2,1608958800,1609477200,2
sirgawain2,0,2,0,28,1551848400,1567569600,2
PogoTheDeathClown,0,2,0,5,1572148800,1572148800,2
curioustohear20,0,2,0,19,1605934800,1606107600,2
gazorpazorpazorpazor,1,1,31,2,1578373200,1578546000,2
Catbrainsloveart,0,2,0,10,1583643600,1583643600,2
Zhanji_TS,0,2,0,5,1597032000,1597032000,2
krucz36,0,2,0,10,1603512000,1609045200,2
Pilsu,0,2,0,1,1579323600,1579323600,2
drewdles151515,0,2,0,46,1561694400,1561694400,2
imgoinglobal,0,2,0,10,1607662800,1607662800,2
pumpkinwavy,0,2,0,3,1562990400,1578978000,2
SchonoKe,0,2,0,31,1604811600,1608526800,2
hohahuhi,0,2,0,12,1552276800,1552276800,2
raisingrosie,1,1,25,7,1581397200,1581397200,2
WolfeRanger,0,2,0,-24,1598932800,1598932800,2
Pactae_1129,0,2,0,6,1600660800,1600660800,2
Deanster12317,0,2,0,9,1605330000,1605330000,2
lemon_girl223,0,2,0,12,1604984400,1604984400,2
internet_surfer123,0,2,0,25,1596254400,1596254400,2
DainichiNyorai,0,2,0,112,1607749200,1607835600,2
Alternative_Flatworm,0,2,0,7,1604898000,1604898000,2
audiodormant,0,2,0,10,1589256000,1594440000,2
Crispy-Bao,0,2,0,2,1577336400,1577422800,2
e874yn094eyhu90,0,2,0,0,1606626000,1606626000,2
nofuckinbroccoli,0,2,0,14,1592539200,1604030400,2
star_banger,0,2,0,7,1577422800,1594180800,2
haha-ha,0,2,0,6,1569124800,1569124800,2
ellsworthsmelly,1,1,162,1,1602993600,1603080000,2
DOC2480,0,2,0,-9,1582779600,1582779600,2
Responsible_Bridge_4,0,2,0,0,1611810000,1611810000,2
jimm_rustle,0,2,0,10,1598760000,1604898000,2
Snuuuuupy,0,2,0,3,1608613200,1608613200,2
Wolfbit12345,0,2,0,-4,1552708800,1552708800,2
AlwaysHigh27,0,2,0,14,1570852800,1604030400,2
Brian_Lawrence01,0,2,0,26,1566360000,1569038400,2
cookiecruncher_7,0,2,0,2,1607576400,1607576400,2
HoldMyPoodle6280,0,2,0,19,1574658000,1609218000,2
Iwud42,0,2,0,193,1565409600,1578373200,2
Writingontheball,0,2,0,7,1586923200,1587355200,2
theInfiniteHammer,0,2,0,24,1589774400,1602820800,2
MarginCalled1,0,2,0,5,1608267600,1608267600,2
farez777,0,2,0,11,1595217600,1597809600,2
penguin_chacha,0,2,0,11,1598760000,1598760000,2
daydreaminh,1,1,13,9,1572580800,1576472400,2
AcidShitposting,0,2,0,4,1576731600,1576731600,2
LSweeDfairy,0,2,0,7,1592107200,1592452800,2
clever_cow,0,2,0,1,1585454400,1585454400,2
TheDevilsAdvokaat,0,2,0,11,1609390800,1609390800,2
Virtecal,0,2,0,15,1608613200,1608958800,2
sardonicstork,0,2,0,18,1594094400,1599105600,2
wentrunningback,0,2,0,13,1608354000,1608354000,2
Allswim100,0,2,0,-2,1585454400,1589256000,2
zvug,0,2,0,2,1604379600,1608786000,2
mochacho,0,2,0,9,1604984400,1604984400,2
goinginsanehomie,1,1,11,1,1559448000,1559448000,2
SpaceIsTooFarAway,1,1,7,2,1599105600,1608354000,2
humanredditor45,0,2,0,18,1598846400,1606626000,2
DiligentRaise,1,1,2,16,1591416000,1606712400,2
Lemonyclouds,0,2,0,3,1603252800,1603252800,2
redleavesrattling,0,2,0,3,1569124800,1586318400,2
ComradeTovarisch,0,2,0,19,1575176400,1586059200,2
bad__unicorn,0,2,0,45,1587009600,1587009600,2
Ramp_Up_Then_Dump,0,2,0,3,1598760000,1598760000,2
pandaperogies,0,2,0,6,1573707600,1573707600,2
rgonzal,0,2,0,4,1598155200,1598155200,2
WafflesAreEpic,0,2,0,2,1596686400,1596686400,2
Daffan,0,2,0,6,1585454400,1603512000,2
coolo04,0,2,0,3,1596513600,1596513600,2
W5SNx,0,2,0,7,1574053200,1574053200,2
heyheyitsashleyk,0,2,0,16,1607230800,1607230800,2
Mr_Heft,0,2,0,67,1600056000,1602475200,2
LunarHypnosis,0,2,0,-49,1592366400,1592452800,2
minimize_reality,0,2,0,4,1592366400,1592366400,2
Proof-Hovercraft-999,0,2,0,2,1603512000,1603684800,2
kalvinbastello,0,2,0,10,1595995200,1596081600,2
KaasKoppusMaximus,0,2,0,0,1601352000,1606626000,2
nickkangistheman,0,2,0,2,1611982800,1611982800,2
Eld223,0,2,0,6,1594440000,1594440000,2
Damnae,0,2,0,63,1599710400,1608526800,2
thebutterflydefect,1,1,28,4,1571630400,1572753600,2
Momma_Zerker,0,2,0,-17,1580706000,1580706000,2
ShitOnMyArsehole,0,2,0,3,1559361600,1559361600,2
Put_it_in_the_Booty,0,2,0,13,1602820800,1602820800,2
Mr-Fognoggins,0,2,0,6,1578286800,1578286800,2
faramaobscena,0,2,0,2,1605762000,1605762000,2
ThunderWolf2100,0,2,0,12,1575608400,1575608400,2
philgr,0,2,0,5,1564545600,1567051200,2
WolfEither,0,2,0,4,1608526800,1608613200,2
Nephyst,0,2,0,42,1597377600,1599364800,2
Advicehunt,1,1,10,1,1580965200,1581138000,2
Dr_SBrule,0,2,0,4,1563249600,1574226000,2
Favonus,0,2,0,3,1603512000,1603512000,2
prettyneeet,0,2,0,9,1566446400,1566532800,2
chicharrofrito,0,2,0,5,1605762000,1605762000,2
Rexutu,0,2,0,4,1555300800,1555300800,2
randyfloyd37,0,2,0,1,1575435600,1575522000,2
Abrohmtoofar,0,2,0,7,1604116800,1605070800,2
patermcdude_01,0,2,0,7,1581483600,1586404800,2
samjay24,0,2,0,6,1582866000,1582866000,2
wittybit,0,2,0,19,1611810000,1611896400,2
Modertochter,1,1,12,4,1571803200,1589947200,2
mroblivian1,0,2,0,2,1602907200,1602907200,2
electronicwizard,0,2,0,0,1550293200,1550293200,2
Kunzea,0,2,0,5,1598068800,1602820800,2
Kind_Strike,0,2,0,1,1602820800,1602820800,2
TimeTwisters,0,2,0,4,1612933200,1612933200,2
Thatbarefootbastard,0,2,0,5,1595304000,1604725200,2
FootstepsOfNietzsche,0,2,0,9,1608008400,1609131600,2
Super1MeatBoy,0,2,0,15,1582434000,1605330000,2
stolen_peugeot,0,2,0,8,1582779600,1582779600,2
evylina12,1,1,8,3,1597118400,1600228800,2
hailthenecrowizard,0,2,0,7,1612242000,1612242000,2
IdiAminMugabe,0,2,0,12,1591243200,1591329600,2
King_Spacecat,0,2,0,4,1593057600,1593057600,2
JustAnIgnoramous,0,2,0,30,1605070800,1606107600,2
ulterion0715,0,2,0,47,1604725200,1605157200,2
Chidit,0,2,0,7,1589860800,1589947200,2
TheThomaswastaken,0,2,0,20,1572753600,1575262800,2
LionaltheGreat,0,2,0,-4,1604379600,1604379600,2
tengo_sueno,0,2,0,9,1596168000,1596168000,2
DRMARUO,0,2,0,7,1607230800,1607230800,2
Ngwster,0,2,0,2,1585972800,1585972800,2
JacquesNuclear1,0,2,0,6,1589169600,1589169600,2
JunjiMitosis,0,2,0,16,1570852800,1601438400,2
Groovychick1978,0,2,0,205,1596600000,1607490000,2
thisbemymania,0,2,0,59,1575349200,1575349200,2
onlyloveandpeacehere,1,1,30,8,1556942400,1584244800,2
coltpython,0,2,0,764,1607403600,1607403600,2
Punk_n_Destroy,0,2,0,20,1570075200,1570075200,2
welpkelp84,0,2,0,5,1604811600,1604811600,2
OldShoulder2,0,2,0,-2,1594267200,1599883200,2
QueerEcho,0,2,0,75,1590033600,1590033600,2
oiuuunnnn,0,2,0,7,1576040400,1577854800,2
Dsteng22,0,2,0,-37,1599883200,1599883200,2
dub_liner,0,2,0,-18,1597896000,1600401600,2
yellowbanner,0,2,0,13,1585195200,1585195200,2
FosterTheSnowMan,0,2,0,-4,1569124800,1569124800,2
cherrycrocs,0,2,0,12,1591156800,1591156800,2
Zodiwacts123,0,2,0,7,1606021200,1606021200,2
chicostick,0,2,0,2,1602734400,1602734400,2
NaturesMayhem,0,2,0,29,1568260800,1568260800,2
antidoot,0,2,0,24,1601092800,1606626000,2
nllb,0,2,0,13,1594785600,1596081600,2
Raknarg,0,2,0,3,1606971600,1606971600,2
danosaurus_hex,1,1,11,1,1584504000,1584590400,2
armsnotheavy,0,2,0,5,1597118400,1597118400,2
PatrollMonkey,0,2,0,17,1601870400,1601870400,2
falgscforever2117,0,2,0,5,1579064400,1579064400,2
Bellerophon03,0,2,0,-5,1607922000,1607922000,2
spla_ar42,0,2,0,2,1582952400,1583211600,2
Nikkitsu_,0,2,0,14,1607922000,1607922000,2
AsimpleLegoPiece,0,2,0,3,1608354000,1608613200,2
cigaretteariat,0,2,0,-12,1609218000,1609218000,2
HighOfTheTiger,0,2,0,59,1602388800,1602388800,2
rmwe2,0,2,0,23,1579928400,1585454400,2
BikeNation,0,2,0,9,1607403600,1607403600,2
djqvoteme,0,2,0,29,1555214400,1555214400,2
German_Socialist,0,2,0,18,1589947200,1589947200,2
ceraunoscopy,0,2,0,21,1590552000,1594008000,2
idontlikeredditbutok,0,2,0,-2,1589860800,1597204800,2
TheGhostofWoodyAllen,0,2,0,8,1598328000,1598328000,2
Dschmidt8,0,2,0,2,1594785600,1594785600,2
Heylookitseli,1,1,5,1,1607403600,1607403600,2
cooconutty,0,2,0,4,1572580800,1572753600,2
del_snafu,1,1,287,3,1608267600,1608267600,2
bulletproofbra,0,2,0,89,1607144400,1607922000,2
kamissymoo,1,1,4,-7,1554523200,1567224000,2
MannequinKillAppeal,0,2,0,16,1583470800,1583812800,2
sfinebyme,0,2,0,60,1574658000,1581138000,2
Aquendall,0,2,0,7,1585886400,1603166400,2
kingslayer_008,0,2,0,8,1589169600,1589169600,2
stakoverflo,0,2,0,34,1583812800,1591588800,2
pookachu83,0,2,0,22,1599796800,1599883200,2
Kaizenno,0,2,0,3,1594094400,1594094400,2
Leericly,0,2,0,6,1601092800,1601179200,2
VerumJerum,0,2,0,21,1605848400,1605848400,2
bigtubz,0,2,0,-49,1577854800,1577854800,2
acamu5x,0,2,0,9,1552276800,1552276800,2
LazyHummingbirds,0,2,0,3,1571112000,1571112000,2
Alabaster_Canary,0,2,0,13,1605589200,1605589200,2
Jeihou,0,2,0,3,1606626000,1606626000,2
butznutz,1,1,127,-10,1561348800,1565582400,2
flugbone,0,2,0,12,1580014800,1580014800,2
dopechez,0,2,0,1,1585454400,1585454400,2
MacDaaady,0,2,0,28,1565582400,1565755200,2
Seamedstockings69,0,2,0,6,1595908800,1595908800,2
Transhumanistgamer,0,2,0,42,1606539600,1606626000,2
onyx_____,0,2,0,6,1604811600,1606712400,2
coyotejam,0,2,0,10,1605589200,1608354000,2
zeek1999,0,2,0,12,1596686400,1608354000,2
Roach55,0,2,0,10,1608613200,1608613200,2
GoHealthYourself,0,2,0,3,1585454400,1586145600,2
AlsetAlocin,1,1,40,1,1603598400,1603684800,2
Belial4,0,2,0,165,1579928400,1592452800,2
TheWayADrillWorks,0,2,0,28,1595995200,1597118400,2
karatebullfighter,0,2,0,2,1575003600,1608786000,2
DistantKarma271,0,2,0,9,1587182400,1587182400,2
_TallulahShark,0,2,0,9,1608699600,1608958800,2
Justforfun_x,0,2,0,3,1598068800,1598068800,2
humulus_impulus,0,2,0,12,1545022800,1545022800,2
1398329370484,0,2,0,0,1608786000,1608786000,2
geekaz01d,0,2,0,-3,1605070800,1605070800,2
Lilbaeduck3,1,1,107,1,1597982400,1599192000,2
LordyHoardy,0,2,0,10,1580446800,1598155200,2
Fabulous-Hamster5971,0,2,0,-2,1608613200,1608699600,2
RedCaio,0,2,0,255,1600401600,1601092800,2
Maiesk,0,2,0,16,1602734400,1606539600,2
starpathos,0,2,0,0,1597032000,1597032000,2
mindquad,1,1,17,2,1581310800,1581570000,2
thermopolous,0,2,0,3,1551416400,1551416400,2
jessie2rose,0,2,0,2,1595476800,1596081600,2
gurdianofleaves,0,2,0,3,1606539600,1608181200,2
watsonandsick,0,2,0,-1,1581051600,1581051600,2
xPriddyBoi,0,2,0,-1,1588651200,1588651200,2
SquashGrizzley,0,2,0,5,1608699600,1608699600,2
Joeytheskybison,1,1,26,1,1606107600,1606107600,2
PostVidoesNotGifs,0,2,0,3,1605502800,1605589200,2
Mac2663,0,2,0,3,1596945600,1597032000,2
free_help,0,2,0,9,1601265600,1601352000,2
AlmightyDenimChicken,0,2,0,-3,1584763200,1584763200,2
CommandanteZavala,0,2,0,-3,1608699600,1608699600,2
ficarra1002,0,2,0,162,1601524800,1601524800,2
100k_changeup,1,1,60,22,1606885200,1607403600,2
tydoherty,0,2,0,2,1605157200,1605157200,2
darkpixel2k,0,2,0,-1,1580360400,1580360400,2
PropaneElephant,0,2,0,1,1584158400,1584331200,2
knightcrusader,0,2,0,19,1603598400,1603598400,2
Hotmayonaisse,0,2,0,9,1582952400,1583125200,2
_zarathustra,0,2,0,198,1573707600,1575176400,2
RandomlyJim,0,2,0,23,1607576400,1607662800,2
ditfloss,0,2,0,7,1597896000,1599537600,2
trinityjadex,0,2,0,4,1608267600,1608267600,2
baaaaaadude,0,2,0,23,1590379200,1590552000,2
DarkMatterBurrito,0,2,0,-1,1605502800,1605502800,2
Rona-Still-Here,0,2,0,1,1588824000,1604030400,2
Icomefromthelandofic,2,0,101,0,1584676800,1603425600,2
zellaann,1,1,2481,3,1605762000,1605762000,2
thesenutzonurchin,0,2,0,5,1609390800,1609390800,2
TILtonarwhal,0,2,0,14,1569729600,1576299600,2
Tripp66,0,2,0,7,1582434000,1582434000,2
GanjGoblin,0,2,0,6,1608354000,1608354000,2
LSDawson,0,2,0,12,1590724800,1590811200,2
Winteg8,0,2,0,3,1606366800,1606453200,2
WholeyManoli,0,2,0,8,1587528000,1592107200,2
Heavy_Hole,0,2,0,42,1593230400,1596772800,2
SpaceGhost717,0,2,0,2,1603944000,1603944000,2
Startide,0,2,0,46,1582088400,1582088400,2
chewbacca_diamond,0,2,0,11,1602388800,1602388800,2
blarrrgo,0,2,0,20,1562472000,1562644800,2
gucci-ghostie,1,1,8,3,1595995200,1598068800,2
General_Aids,0,2,0,7,1602475200,1602475200,2
Drfarts2,0,2,0,4,1605502800,1609218000,2
sad_193,0,2,0,7,1607922000,1607922000,2
fuckmyjobthrowaway69,0,2,0,5,1589342400,1589342400,2
attunezero,0,2,0,11,1602475200,1602475200,2
moosiahdexin,0,2,0,1,1590206400,1604379600,2
lovelately,0,2,0,71,1607835600,1608008400,2
sugarplumapathy,0,2,0,65,1598068800,1598155200,2
kin4212,0,2,0,14,1600142400,1602302400,2
Uberzwerg,0,2,0,43,1605502800,1612155600,2
iSeize,0,2,0,-7,1606626000,1606626000,2
anarkia420,0,2,0,3,1588046400,1588046400,2
MrPENislandPenguin,0,2,0,4,1600574400,1603684800,2
128Gigabytes,0,2,0,1,1589947200,1591156800,2
tater_rater,0,2,0,22,1582174800,1582174800,2
DrSozuParaan,1,1,33,31,1584244800,1584676800,2
ILostMyJules,0,2,0,42,1594094400,1594440000,2
dontforgetyourjazz,0,2,0,75,1577163600,1577509200,2
Zatoichi5678,0,2,0,24,1567483200,1587009600,2
SamJulySam,0,2,0,4,1582779600,1582779600,2
Saltpot64,0,2,0,7,1575262800,1597464000,2
jager_mcjagerface,0,2,0,8,1600228800,1600228800,2
IpickThingsUp11B,0,2,0,3,1597636800,1597636800,2
ForsakenDoctor8,0,2,0,11,1594353600,1594353600,2
pro555pero,0,2,0,14,1556856000,1570507200,2
cold_star3,0,2,0,28,1599451200,1602820800,2
Soulfood_27,0,2,0,4,1597464000,1601179200,2
teddyrux,1,1,72,1,1477972800,1477972800,2
UnboundHeteroglossia,0,2,0,-1,1608958800,1609390800,2
Cadaverlanche,0,2,0,20,1563595200,1565668800,2
Dr_Doctor1992,0,2,0,4,1570420800,1575435600,2
Lazioni,0,2,0,1,1569643200,1569643200,2
ferneticine,0,2,0,4,1573102800,1573189200,2
intensely_human,0,2,0,6,1591329600,1591329600,2
mirx,0,2,0,39,1600228800,1607144400,2
weidback,0,2,0,17,1601524800,1605070800,2
noselike,0,2,0,10,1585281600,1593835200,2
PM_ME_UR_CATS_TITS,0,2,0,12,1557547200,1576472400,2
Diverdaddy0,0,2,0,18,1579755600,1579755600,2
Onlymadeforxbox,0,2,0,2,1602216000,1608267600,2
dragon_battleaxe,0,2,0,-3,1606194000,1606280400,2
Asphyxiem,0,2,0,19,1543122000,1604030400,2
RoughMedicine,0,2,0,4,1603425600,1603512000,2
Nathan1506,0,2,0,35,1606885200,1606885200,2
thedtj,0,2,0,18,1583726400,1583726400,2
wonderbreadofsin,0,2,0,12,1598846400,1598846400,2
monkfreedom,0,2,0,2,1609131600,1609131600,2
ThreeeLeaf,0,2,0,2,1520312400,1520312400,2
Magic_Bagel,0,2,0,3,1595217600,1608094800,2
NutellaFilledCelery,0,2,0,12,1569124800,1591243200,2
wangus_tangus,0,2,0,3,1573016400,1573016400,2
nocakeforme90,0,2,0,4,1594612800,1595304000,2
stresscactus,0,2,0,15,1578286800,1591243200,2
Caligula1340,0,2,0,2,1605502800,1605502800,2
snatelol,0,2,0,2,1604203200,1608267600,2
fluffychonkycat,0,2,0,58,1606712400,1606971600,2
19Kilo,0,2,0,6,1584417600,1584417600,2
donkey_kong_lover,1,1,8,7,1602820800,1604203200,2
ookers69,0,2,0,6,1608267600,1611982800,2
jnudey,1,1,61,17,1576386000,1576386000,2
CoalGravel,0,2,0,-6,1549170000,1549170000,2
DavidPT40,0,2,0,23,1577422800,1608786000,2
StuckAroundGotStuck,0,2,0,80,1607576400,1607576400,2
thesoutherzZz,0,2,0,1,1606626000,1606626000,2
violette_tea,0,2,0,27,1580792400,1580792400,2
bisousjolie,0,2,0,13,1557460800,1557460800,2
xXPeterPatterXx,0,2,0,30,1582779600,1587441600,2
ketoprom,0,2,0,-3,1608267600,1608267600,2
Thicc_Ricc1991,0,2,0,21,1607922000,1607922000,2
dualitypill,0,2,0,5,1602993600,1603080000,2
wilderop,0,2,0,-12,1597550400,1597636800,2
R1ght_b3hind_U,1,1,3572,14,1602302400,1607835600,2
Weltraumbaer,0,2,0,22,1595131200,1604379600,2
TheRealHelloDolly,0,2,0,19,1593835200,1606021200,2
HeavyD91,0,2,0,2,1585454400,1585540800,2
arabianknighttt,0,2,0,2,1597550400,1601352000,2
CelestialHeaven,0,2,0,7,1567137600,1569902400,2
rode__16,0,2,0,78,1607922000,1609390800,2
Charles_Leviathan,0,2,0,15,1585454400,1585540800,2
snrhnd,0,2,0,4,1599278400,1599278400,2
TheRustyBird,0,2,0,2,1594526400,1594526400,2
khoabear,0,2,0,18,1577941200,1606626000,2
McPoyal,0,2,0,43,1574744400,1606626000,2
Halanna,0,2,0,14,1606798800,1606885200,2
01020304050607080901,0,2,0,10,1608267600,1608267600,2
dunn_for,0,2,0,10,1600228800,1604203200,2
theCHAMPdotcom,0,2,0,2,1603512000,1603512000,2
happ_ines,0,2,0,4,1555041600,1555041600,2
PensiveAfrican,0,2,0,10,1586923200,1589688000,2
SuddenlySolaire,0,2,0,23,1579755600,1579755600,2
Stinor1,0,2,0,14,1576040400,1576040400,2
strange-currencies,0,2,0,3,1601179200,1601265600,2
gundamwfan,0,2,0,6,1544158800,1544158800,2
Velates,0,2,0,7,1608786000,1608786000,2
dallyopcs,0,2,0,3,1603598400,1603598400,2
T0RB1T,0,2,0,4,1590552000,1590552000,2
OMGitsJoeMG,0,2,0,2,1606626000,1606626000,2
joe33res,0,2,0,6,1589601600,1589601600,2
randomchaos99,0,2,0,19,1606280400,1608094800,2
MarioPainting,0,2,0,5,1604030400,1604552400,2
henchmenzero,0,2,0,29,1601179200,1601179200,2
2mice,0,2,0,20,1608008400,1608094800,2
pikkuhakki,0,2,0,-2,1576645200,1576645200,2
-dOPETHrone-,0,2,0,29,1600056000,1600056000,2
BASSLEMSHAT,0,2,0,5,1588737600,1589688000,2
wiseblueberry,0,2,0,2,1607662800,1608699600,2
teknogreek,0,2,0,105,1581656400,1582779600,2
neuroticandok,0,2,0,10,1607058000,1607058000,2
Five_Decades,0,2,0,32,1580619600,1580619600,2
Punky921,0,2,0,3,1597982400,1597982400,2
BuckSaguaro,0,2,0,-53,1602129600,1602129600,2
janred1963-,0,2,0,23,1584072000,1584072000,2
literallycantaloupe,0,2,0,17,1589860800,1589860800,2
Signal-Size,0,2,0,3,1593489600,1595217600,2
Intelligent_Tomato35,0,2,0,1,1605330000,1608699600,2
ImASeagullYeahYeah,0,2,0,13,1581051600,1581051600,2
UnclePotato_,0,2,0,2,1607576400,1607576400,2
TheDukeOfChill,0,2,0,12,1580446800,1589428800,2
RascalTech,0,2,0,51,1586577600,1588996800,2
Kerlyle,0,2,0,84,1608440400,1608526800,2
DailyPlaneteer,0,2,0,-20,1608526800,1608526800,2
AbandonedPlanet,1,1,16,7,1590811200,1590811200,2
cadavarsti,0,2,0,17,1582261200,1589601600,2
yomommawashere,0,2,0,4,1585454400,1585454400,2
TreavesC,0,2,0,-1,1605934800,1605934800,2
GooseMan126,0,2,0,4,1566964800,1612155600,2
HELP_IM_IN_A_WELL,0,2,0,41,1607749200,1607749200,2
manager_access,0,2,0,12,1580101200,1580187600,2
Icommentwhenhigh,0,2,0,9,1575522000,1575522000,2
LogansRightHand,0,2,0,99,1558411200,1558411200,2
PPDIDEY,0,2,0,56,1604379600,1604379600,2
Divingin12,1,1,22,8,1608613200,1608613200,2
Dewut,0,2,0,2,1573621200,1594785600,2
Wzvd,0,2,0,57,1561348800,1567569600,2
freewillgestalt,0,2,0,13,1569729600,1570334400,2
SeanOTG,0,2,0,6,1585454400,1585454400,2
kuntfuxxor,0,2,0,5,1593662400,1593662400,2
FlimbleDing,0,2,0,9,1605589200,1608872400,2
masonjar64,0,2,0,10,1594785600,1612155600,2
johnapplecheese,0,2,0,8,1601784000,1602907200,2
Dumbledore27,0,2,0,5,1584072000,1609304400,2
dub121686,0,2,0,4,1593576000,1596600000,2
LamboForWork,1,1,8,3,1580446800,1580533200,2
dorothy_zbornakk,0,2,0,18,1593489600,1593748800,2
toodies,2,0,136,0,1589256000,1589342400,2
like_a_horse,0,2,0,14,1578718800,1578718800,2
popopotatoes160,0,2,0,4,1603684800,1603684800,2
Chillonia,0,2,0,25,1553572800,1558411200,2
hirunekurabu,0,2,0,60,1608267600,1608613200,2
that_guy_you_know-26,0,2,0,5,1547010000,1569988800,2
kaunapil,0,2,0,6,1541998800,1541998800,2
WatchYourButts,0,2,0,11,1596427200,1596427200,2
scapescene,0,2,0,2,1595908800,1595908800,2
Howyanow10,0,2,0,8,1604293200,1608526800,2
akward-alt,0,2,0,4,1606885200,1606885200,2
smartymarty1234,0,2,0,1,1560657600,1560657600,2
_laserblades,0,2,0,3,1572235200,1572235200,2
penguincutie22,1,1,59,16,1608786000,1609304400,2
meltwaterpulse1b,0,2,0,22,1593921600,1599796800,2
Not_MrNice,0,2,0,4,1604116800,1604984400,2
dandaman1977,0,2,0,2,1603598400,1603598400,2
SammyAndyy,0,2,0,65,1570852800,1571198400,2
LincolnClayFace,0,2,0,45,1585454400,1587096000,2
socsa,0,2,0,7,1603512000,1603512000,2
pichugodofdeath,1,1,0,1,1608699600,1608699600,2
KosmischRelevant,0,2,0,32,1600574400,1605762000,2
UhOhIGotAStinkyWinky,0,2,0,119,1578891600,1578891600,2
PrizmSchizm,0,2,0,6,1597291200,1606626000,2
chickensoupsucks,0,2,0,19,1584417600,1584417600,2
PrisonIsBoring,1,1,1103,-10,1586059200,1586059200,2
jsprsplce,0,2,0,2,1575262800,1597377600,2
ErrorSoul,0,2,0,9,1576386000,1577854800,2
oh_herro_kitty,0,2,0,18,1555646400,1555905600,2
Wirnheir,0,2,0,55,1597291200,1597377600,2
Sowlolekatonieo,1,1,264,1,1576645200,1576731600,2
professorbuttermeat,0,2,0,5,1599537600,1599537600,2
average_user_,0,2,0,9,1542690000,1542776400,2
lagerpen,0,2,0,5,1569124800,1572753600,2
Alexander0528,0,2,0,2,1604466000,1604466000,2
TrentonConnector,0,2,0,7,1580706000,1580792400,2
I_done_a_plop-plop,0,2,0,109,1565928000,1575522000,2
ElfDistrict,1,1,243,9,1608526800,1608526800,2
KnightOwlForge,0,2,0,8,1603512000,1603512000,2
_kegs,0,2,0,184,1592971200,1592971200,2
JakeTheCake714,0,2,0,7,1580014800,1583384400,2
lazysarcasm,0,2,0,12,1612155600,1612155600,2
Sworn_to_the_dark,0,2,0,3,1601956800,1602302400,2
DShizilla,0,2,0,16,1589947200,1589947200,2
Fistandantalus,0,2,0,17,1607490000,1607662800,2
crazyashley1,0,2,0,6,1575867600,1603771200,2
US_Navy_Seals,0,2,0,-39,1601870400,1601870400,2
TVK777,0,2,0,6,1566360000,1573362000,2
Itsuki_K,1,1,243,25,1566446400,1566446400,2
Jackjackson401,0,2,0,-13,1593403200,1593403200,2
BigFigWasp911,0,2,0,1,1611118800,1611464400,2
shizzler,0,2,0,5,1569124800,1569124800,2
C-Hoppe-r,0,2,0,-4,1560312000,1560312000,2
ArcaneHackist,0,2,0,7,1593748800,1593748800,2
KineticPolarization,0,2,0,21,1593230400,1593230400,2
DebDestroyerTX,0,2,0,6,1601524800,1605157200,2
futurenine84316,0,2,0,21,1595995200,1606107600,2
WheatBasedWarfare,0,2,0,13,1577422800,1577422800,2
StoneColdSexual,1,1,375,50,1567224000,1567224000,2
HopeYouHaveANiceWeek,1,1,0,-5,1571976000,1572062400,2
StaircaseObsession,0,2,0,21,1582779600,1582779600,2
Twoten210,0,2,0,2,1603512000,1603512000,2
Smoovzy,0,2,0,20,1574658000,1576386000,2
pangur0ban0,1,1,1913,13,1602388800,1607922000,2
NO_FIX_AUTOCORRECT,0,2,0,10,1597982400,1598068800,2
TheMightyFlea69,0,2,0,20,1589428800,1594526400,2
HugeAccountant,0,2,0,10,1575262800,1602648000,2
3LeggoGecko,0,2,0,55,1580533200,1589256000,2
werbenjagermenjansen,0,2,0,22,1595995200,1599451200,2
Justcallmejuan,0,2,0,4,1608526800,1608526800,2
Goshiro1,0,2,0,10,1596254400,1598328000,2
chadinator69,0,2,0,-6,1604811600,1605070800,2
explosive720,0,2,0,27,1581483600,1599192000,2
I_Lke_Pretty_Things,0,2,0,6,1572408000,1572580800,2
jbondyoda,0,2,0,12,1582088400,1582088400,2
Paigeinks,0,2,0,5,1608354000,1609304400,2
SmashRocks1988,0,2,0,24,1602734400,1608267600,2
MrK_HS,0,2,0,2,1600315200,1600315200,2
dionysianwine,0,2,0,32,1600920000,1602129600,2
Doomdog619,0,2,0,3,1595304000,1601179200,2
BoringAccountNG,0,2,0,16,1594008000,1594008000,2
barfiusmaximus,1,1,22,2,1605848400,1609218000,2
NZNoldor,0,2,0,50,1605070800,1611982800,2
ManualPathosChecks,0,2,0,2,1609304400,1609304400,2
RedOtakuNeet,2,0,7,0,1562558400,1562990400,2
weirddodgestratus,0,2,0,15,1597291200,1597291200,2
sackofgarbage,0,2,0,3,1575349200,1575349200,2
ComplainsAboutWife,0,2,0,26,1608181200,1608526800,2
McCheesey1,0,2,0,8,1602129600,1605502800,2
nicobocin,0,2,0,2,1598673600,1598673600,2
goatfuckersupreme,0,2,0,-34,1588305600,1588305600,2
theMASTERMIND66,2,0,0,0,1605589200,1607662800,2
backwards-hat,0,2,0,5,1606107600,1611982800,2
theschneckenbeckons,0,2,0,157,1608354000,1608354000,2
BetaSlayerChad,0,2,0,-29,1595044800,1602820800,2
Misterfahrenheit120,0,2,0,2,1554955200,1608267600,2
decriminalizedgrow,0,2,0,110,1605934800,1605934800,2
likecicerobutdumb,0,2,0,9,1604466000,1604466000,2
EverySunIsAStar,0,2,0,62,1605416400,1606798800,2
ZOG4LAKES,0,2,0,0,1576990800,1585454400,2
Animal-lover-3000,0,2,0,-20,1609304400,1609390800,2
d1470681,0,2,0,4,1585713600,1585713600,2
Metanovai,0,2,0,10,1578286800,1596340800,2
wowitsdaniel,1,1,60,6,1592107200,1592107200,2
delsystem32exe,0,2,0,6,1608354000,1608354000,2
domoenchilado,0,2,0,9,1604116800,1604116800,2
CharlieDayeatshay,0,2,0,2,1608267600,1608267600,2
kushielsforgotten,0,2,0,2,1587528000,1601438400,2
millxans,0,2,0,13,1596081600,1603080000,2
cabbagepenetrator,0,2,0,84,1581483600,1582866000,2
maharg79,0,2,0,28,1602129600,1608699600,2
Chlorure,0,2,0,10,1592366400,1592366400,2
WhatYouLeaveBehind,0,2,0,4,1599451200,1599451200,2
OurLordGaben,0,2,0,4,1576645200,1576645200,2
rolling-brownout,0,2,0,6,1611810000,1612155600,2
Bleoox,0,2,0,10,1586404800,1587528000,2
Boricuacookie,0,2,0,4,1586923200,1592712000,2
Kartikey38,0,2,0,7,1580619600,1603080000,2
the_last_hairbender,0,2,0,7,1609390800,1609390800,2
ginx_minx,0,2,0,3,1581397200,1581397200,2
kszaku94,0,2,0,19,1560139200,1567483200,2
Jay_the_Artisan,0,2,0,4,1603598400,1606107600,2
Daforce1,0,2,0,2,1605070800,1605070800,2
PleaseUncleCalmDown,0,2,0,2,1612069200,1612069200,2
THE_HORSE91,0,2,0,12,1553486400,1554350400,2
mustangg81,0,2,0,2,1587960000,1603512000,2
CapriciousBit,0,2,0,128,1594094400,1608958800,2
lumez69,0,2,0,7,1591675200,1593230400,2
Homunculus_87,0,2,0,93,1608440400,1608526800,2
ritthrowaway2341,2,0,39,0,1573966800,1611896400,2
JussieSmollettMAGA,0,2,0,2,1572235200,1572235200,2
tomatoswoop,0,2,0,13,1571976000,1611896400,2
imWishhez,0,2,0,3,1566273600,1566273600,2
54H60-77,0,2,0,-4,1572148800,1572148800,2
Awake2long,0,2,0,2,1603425600,1604466000,2
greyjar,0,2,0,2,1637125200,1637125200,2
Camcamcam753,0,2,0,11,1598932800,1598932800,2
NickTheShtick,0,2,0,7,1599624000,1605589200,2
thatchininja,0,2,0,12,1606453200,1608354000,2
C_J_Money,0,2,0,2,1591243200,1591243200,2
CumberlandBlue,0,2,0,14,1570680000,1570680000,2
ENTP_AnarchoEgoist,1,1,0,4,1583125200,1602216000,2
brutalhippy,0,2,0,15,1607662800,1608872400,2
ArtificialSweetna,0,2,0,-10,1589601600,1589601600,2
EvilKam,0,2,0,5,1575781200,1575781200,2
greenbashterd,0,2,0,2,1573966800,1573966800,2
samantha_succubus,0,2,0,7,1576558800,1583812800,2
Hickspy,0,2,0,18,1598846400,1598846400,2
GothMullet,0,2,0,2,1584763200,1584763200,2
0tryna-be-better0,0,2,0,9,1598846400,1600920000,2
yesterdaywas24hours,0,2,0,1,1606453200,1607058000,2
ProAntiAntiANTIFA,0,2,0,9,1611982800,1611982800,2
never_hungry25,1,1,306,28,1607662800,1607662800,2
denka77,0,2,0,36,1580792400,1580792400,2
TheBestBoi,0,2,0,5,1593144000,1608872400,2
frieflee,0,2,0,46,1603512000,1603512000,2
frickeyea,0,2,0,56,1606712400,1609131600,2
gyromick35,0,2,0,-10,1602648000,1602648000,2
GodDamnYouDee,0,2,0,12,1565755200,1565928000,2
Jesterkun,0,2,0,26,1604293200,1604379600,2
ae516,2,0,340,0,1581742800,1582520400,2
DomoArigatoMrPoPo,0,2,0,-6,1585454400,1585454400,2
JaromeDome,0,2,0,5,1580360400,1580446800,2
nsowbajwbiwbs,0,2,0,-3,1582779600,1602216000,2
David3692,0,2,0,-8,1581656400,1581656400,2
letternumberstop,0,2,0,11,1576126800,1578286800,2
ClownShoeNinja,0,2,0,-1,1603598400,1609304400,2
SmashinStrudle,0,2,0,3,1572235200,1572235200,2
vaipracasa,1,1,8,1,1572667200,1572753600,2
Dontbeatrollplease1,0,2,0,-7,1560657600,1571976000,2
Bacon_Devil,0,2,0,96,1585022400,1585022400,2
PrincessApprentice,0,2,0,7,1579669200,1580101200,2
SloGlobe,0,2,0,4,1573707600,1573707600,2
Snooginzs,0,2,0,2,1583985600,1583985600,2
White_Skulls,0,2,0,58,1608094800,1608094800,2
tryptomania,0,2,0,11,1578027600,1585886400,2
MoonwalkMatthew,0,2,0,88,1594785600,1595217600,2
IFuckingHateTheSun,0,2,0,5,1608094800,1609304400,2
Choorino,0,2,0,58,1573448400,1585108800,2
xThundeRxD,0,2,0,10,1574312400,1575262800,2
jk14r3,0,2,0,30,1607749200,1607835600,2
TerribleBudget,0,2,0,15,1595131200,1595131200,2
disasterandahalf,0,2,0,5,1571803200,1587441600,2
blipman17,0,2,0,10,1598846400,1598846400,2
itonlytakes1,0,2,0,2,1605589200,1605589200,2
mtheory007,0,2,0,12,1584417600,1599710400,2
shillyburger,1,1,78,9,1606366800,1606366800,2
BeyondEarthly,0,2,0,18,1605330000,1605330000,2
murdermeplenty,0,2,0,2,1605589200,1606626000,2
spolio,0,2,0,8,1590465600,1600056000,2
JewNoseRoman,0,2,0,23,1581742800,1605934800,2
furbz1,0,2,0,4,1606798800,1608699600,2
Wandertramp,0,2,0,16,1584590400,1584676800,2
Zazadoozie,0,2,0,9,1600660800,1603684800,2
bluemoonrune,0,2,0,6,1603425600,1603425600,2
RG737,0,2,0,2,1560916800,1560916800,2
alf_ivanhoe,0,2,0,4,1601870400,1601956800,2
OfficerDudeGuy,0,2,0,3,1593144000,1593144000,2
GearsofPinata,0,2,0,10,1595390400,1605070800,2
Bitch-Baby,0,2,0,2,1593316800,1593316800,2
EnchantedSpanner,0,2,0,33,1583812800,1583812800,2
curryfriedsquid,0,2,0,6,1597204800,1599710400,2
The_Gnar_Car,0,2,0,8,1592625600,1592625600,2
blakezilla,0,2,0,16,1605070800,1609218000,2
PnutButterEggsDice,0,2,0,8,1570852800,1570852800,2
Veritas_Mundi,0,2,0,11,1603512000,1603512000,2
eloncuck,0,2,0,5,1580014800,1580014800,2
SteeMonkey,0,2,0,46,1606021200,1606971600,2
ML1948,0,2,0,19,1594353600,1594353600,2
APlantCalledEdgar,0,2,0,7,1584763200,1584763200,2
tinylilcaterpillar,0,2,0,6,1581224400,1581224400,2
moderndudeingeneral,0,2,0,17,1577163600,1581051600,2
Thedumbestgeniusever,0,2,0,22,1593403200,1601265600,2
HipstersThrowaway,0,2,0,10,1593835200,1597032000,2
McBitchinn,0,2,0,3,1584158400,1584158400,2
throwawayhaterofwork,1,1,6,2,1597809600,1597809600,2
bitchimnottheone,0,2,0,32,1592366400,1593057600,2
theblackxranger,0,2,0,4,1603512000,1604379600,2
Rexxar_-,1,1,29,3,1591934400,1591934400,2
nelsonoff,0,2,0,11,1602734400,1608440400,2
FlippantTrousers,0,2,0,6,1568088000,1569902400,2
Potash888,0,2,0,2,1606194000,1606194000,2
JakeLawe,0,2,0,7,1599710400,1599710400,2
Incredible_Edible_Ed,0,2,0,8,1555473600,1555560000,2
solidmedusa,0,2,0,3,1575608400,1575608400,2
Mr-Jings,1,1,22,4,1604898000,1612155600,2
Amaurosys,0,2,0,2,1606712400,1607490000,2
straight_trillin,0,2,0,16,1582002000,1585886400,2
CrazyAdviceGuy,0,2,0,11,1589342400,1589342400,2
analogIT,0,2,0,5,1596859200,1596859200,2
MeowthMewMew,0,2,0,1,1608699600,1608699600,2
CalydonianBoar,0,2,0,4,1555214400,1599796800,2
boundlesslights,0,2,0,7,1588046400,1588046400,2
Mistborn_First_Era,0,2,0,4,1606280400,1607058000,2
Raz3rbat,0,2,0,-8,1595908800,1605934800,2
zombychicken,0,2,0,6,1605934800,1608526800,2
noneuklid,1,1,17,1,1572930000,1572930000,2
ThePurpleGreeneries,1,1,23,2,1581397200,1581397200,2
Nekomengyo,1,1,663,9,1604811600,1604898000,2
ClammyTittyGanon,0,2,0,2,1585454400,1585454400,2
UnderIntact,1,1,27,1,1612069200,1612069200,2
LookImaMermaid85,0,2,0,18,1554868800,1554868800,2
IncompetentFrog,0,2,0,41,1607749200,1608526800,2
goshdarnyou,0,2,0,42,1572148800,1577854800,2
rottenxapple,0,2,0,4,1540958400,1541304000,2
spokid,0,2,0,5,1595649600,1607403600,2
DoTheZornhau,0,2,0,2,1583557200,1584676800,2
balls728,0,2,0,-3,1591243200,1591243200,2
snarky_AF,1,1,38,6,1584590400,1595131200,2
mark_lee,0,2,0,4,1605416400,1605416400,2
LSDeity47,0,2,0,15,1590292800,1592625600,2
Geimtime,0,2,0,11,1597204800,1605589200,2
enlightenedcentrist2,0,2,0,2,1592366400,1592366400,2
VisualMarzipan,1,1,1,1,1586664000,1586664000,2
racingwolf,0,2,0,66,1606626000,1611982800,2
Tincastle,0,2,0,-6,1576386000,1576386000,2
DatWhiteGuy,0,2,0,6,1596513600,1596513600,2
winesoup,0,2,0,43,1572494400,1575954000,2
JustExtreme,0,2,0,5,1541998800,1541998800,2
86overMe,0,2,0,7,1605762000,1605762000,2
a-spark,0,2,0,18,1587873600,1588651200,2
Kazomie,0,2,0,-6,1606626000,1608958800,2
Frugal_Midwestern,0,2,0,130,1604293200,1605934800,2
TergiversationNation,0,2,0,60,1561348800,1561348800,2
Doozenburg,1,1,108,15,1565755200,1568606400,2
whateverathrowaway00,0,2,0,4,1634443200,1634443200,2
number314,0,2,0,3,1540353600,1540353600,2
quiksi,0,2,0,32,1597636800,1597809600,2
HustlerThug,0,2,0,-3,1595995200,1595995200,2
LloydAtkinson,0,2,0,4,1595476800,1597982400,2
GuyWithRealFakeFacts,0,2,0,9,1580533200,1580533200,2
Logical_Vast,1,1,70,3,1589947200,1599451200,2
Themelonman232,0,2,0,4,1603684800,1603771200,2
Ihatebeingmorid,0,2,0,10,1584936000,1585713600,2
MopMoppington,0,2,0,7,1600056000,1600142400,2
northernabguy,0,2,0,4,1605762000,1607317200,2
Fwendly_Mushwoom,0,2,0,15,1566360000,1566360000,2
RainbowCauldron,0,2,0,40,1609131600,1609131600,2
oddmog,0,2,0,2,1587614400,1589601600,2
El_pantunfla,0,2,0,-9,1592884800,1603684800,2
beardiswhereilive,0,2,0,12,1594440000,1596600000,2
illigal,0,2,0,15,1584331200,1599105600,2
john55223,0,2,0,-1,1577509200,1585368000,2
lacedflame,0,2,0,4,1599019200,1599019200,2
StummpyTrump,0,2,0,3,1583985600,1589342400,2
caffeineassisted,0,2,0,3,1541566800,1541566800,2
i_am_a_fern_AMA,0,2,0,15,1584244800,1584244800,2
Iamreallynotok,0,2,0,44,1573966800,1611723600,2
neek85,0,2,0,20,1583384400,1584331200,2
krizzle32,0,2,0,11,1597896000,1605243600,2
DuttyJancro,0,2,0,3,1611896400,1611982800,2
thetwillz,0,2,0,59,1598673600,1601697600,2
_Daze_and_Weeks_,0,2,0,13,1599710400,1599710400,2
RedQueen29,0,2,0,10,1596168000,1609390800,2
curtycurry,0,2,0,-5,1580360400,1580360400,2
issamaysinalah,0,2,0,27,1606539600,1611810000,2
ASatyros,1,1,6,2,1605934800,1605934800,2
Lightor36,0,2,0,0,1588996800,1606453200,2
the42question,2,0,2,0,1549170000,1554177600,2
PizzaPurrfectSauce,0,2,0,19,1589342400,1589342400,2
evrakk,0,2,0,37,1555387200,1575694800,2
Nicoleneedsadvice,0,2,0,132,1607749200,1607922000,2
M0n33baggz,0,2,0,4,1581656400,1608958800,2
jessbird,0,2,0,2,1612069200,1612069200,2
Does_Not_Compile,0,2,0,29,1609218000,1609218000,2
liv1111488,0,2,0,24,1586750400,1586750400,2
GloriousCrusader,0,2,0,-1,1608958800,1608958800,2
icecoldlimewater,0,2,0,50,1606798800,1606885200,2
bl0odredsandman,0,2,0,6,1573534800,1598760000,2
Rusepro123,0,2,0,3,1607662800,1607662800,2
InstupituousJay,0,2,0,-7,1608526800,1608526800,2
norskprincess,0,2,0,12,1601265600,1601265600,2
darknessdown,0,2,0,11,1596772800,1596772800,2
Tuxedo-Duck,0,2,0,9,1603512000,1603512000,2
snaffuu585,0,2,0,4,1564891200,1565236800,2
alroidmints,0,2,0,93,1587614400,1587614400,2
honeygarlicwings,0,2,0,7,1572148800,1580965200,2
mediumrarechicken,0,2,0,3,1582606800,1602388800,2
avocadolamb,0,2,0,113,1602302400,1602388800,2
GhostGanja,0,2,0,-9,1587096000,1588910400,2
Empty_Wine_Box,0,2,0,11,1551589200,1559361600,2
electricboobaloo,0,2,0,55,1589428800,1589515200,2
N8DuhGr8,0,2,0,4,1605934800,1605934800,2
UmbraLupus64,0,2,0,15,1604984400,1604984400,2
Donkey-Haughty,0,2,0,-5,1600574400,1607835600,2
aunt_satan,0,2,0,47,1555905600,1589515200,2
chickpositive,0,2,0,6,1580101200,1580101200,2
squirrellysiege,0,2,0,582,1604725200,1604725200,2
DisneyMaiden,0,2,0,26,1563854400,1609218000,2
nonbinaryqueerfuck,0,2,0,2,1603944000,1603944000,2
Jazzlix08,1,1,46,2,1576731600,1576731600,2
coolassmotherfuckerz,0,2,0,-16,1576299600,1576299600,2
PoLops,0,2,0,8,1587873600,1587873600,2
ARTexplains,0,2,0,4,1593835200,1593835200,2
BlitzGem,0,2,0,74,1588392000,1588392000,2
trashattaq,0,2,0,3,1603339200,1603339200,2
ManufacturedMonsters,1,1,16,6,1604984400,1607317200,2
BakerIsntACommunist,0,2,0,4,1567396800,1574139600,2
d4ddyd54m4,0,2,0,-4,1550293200,1550293200,2
_stumblebum_,0,2,0,27,1604811600,1608440400,2
rnykal,0,2,0,4,1578718800,1578718800,2
jm434,0,2,0,31,1607576400,1607576400,2
d3aDcritter,0,2,0,2,1608872400,1608872400,2
YouNeedAnne,0,2,0,3,1585972800,1585972800,2
SlapTheBap,0,2,0,10,1585627200,1585627200,2
goodpseudonym,0,2,0,10,1602129600,1607230800,2
jmcbutter,0,2,0,7,1561694400,1579496400,2
Upuaut81,0,2,0,46,1561348800,1563249600,2
VincentVanGoghst,0,2,0,11,1605589200,1605675600,2
dhn1993,0,2,0,43,1559188800,1567656000,2
medoane,0,2,0,-4,1593748800,1593748800,2
icedankquote,0,2,0,8,1578805200,1580360400,2
Confle,0,2,0,76,1553918400,1554436800,2
hendey_p,0,2,0,26,1578373200,1578373200,2
whatmanever,0,2,0,-4,1598328000,1600142400,2
dannyiscool4,0,2,0,22,1572580800,1602734400,2
Mrcollaborator,0,2,0,1,1606539600,1606626000,2
bluejayokay,0,2,0,19,1575349200,1575349200,2
dorkmopolis,0,2,0,25,1596081600,1598414400,2
valkyrie217,1,1,4,1,1590984000,1590984000,2
johanfer,0,2,0,6,1565755200,1576904400,2
EchoesNL,0,2,0,9,1546837200,1553227200,2
Dedog01,0,2,0,35,1589860800,1590033600,2
MrNokill,0,2,0,16,1575003600,1579410000,2
darkgrin,0,2,0,9,1548133200,1599105600,2
TheCaptMAgic,0,2,0,9,1581224400,1581224400,2
CaliiBlaze,0,2,0,12,1602129600,1602129600,2
ShitSucksBut,0,2,0,13,1599537600,1599710400,2
Karnemir,0,2,0,7,1590897600,1605416400,2
TrashePanda,0,2,0,2,1589083200,1589083200,2
bamboojerry,0,2,0,8,1594440000,1594612800,2
whitecollarzomb13,0,2,0,5,1605589200,1605589200,2
rimpy13,0,2,0,19,1582693200,1597809600,2
Wormagenda,0,2,0,46,1580274000,1580274000,2
rockyroadsansnuts,0,2,0,14,1594958400,1600747200,2
zsert93,0,2,0,3,1605157200,1608181200,2
minorsecond,0,2,0,18,1543208400,1543208400,2
OJ_Aty,0,2,0,3,1609131600,1609304400,2
Marty_mcfresh,0,2,0,78,1596686400,1608872400,2
Cusehop,0,2,0,-22,1581915600,1581915600,2
Dr_Cypher,0,2,0,4,1603512000,1603512000,2
FilthyCurve11,0,2,0,2,1603512000,1640322000,2
DariusJenai,0,2,0,11,1573966800,1573966800,2
Whimbu1,0,2,0,4,1553486400,1560744000,2
Thatn1h1lguy,0,2,0,10,1595044800,1595044800,2
dragon-blue,0,2,0,19,1569211200,1569211200,2
LolWtfFkThis,0,2,0,2,1580533200,1580792400,2
T-MinusGiraffe,0,2,0,4,1590984000,1590984000,2
sickteeth,0,2,0,14,1605848400,1606626000,2
Rin111,0,2,0,13,1570766400,1571025600,2
FROZENGAYCHICKEN,0,2,0,32,1604116800,1604116800,2
meonscreen,0,2,0,10,1608354000,1608354000,2
Justyburger,0,2,0,1,1597809600,1604466000,2
Reashu,0,2,0,2,1603598400,1603598400,2
janie_gray,2,0,6,0,1563508800,1563854400,2
GingerFire29,0,2,0,10,1603512000,1603598400,2
andistan,0,2,0,-1,1576126800,1576731600,2
msmith721,0,2,0,56,1604466000,1607749200,2
dscoZ,0,2,0,16,1608354000,1608354000,2
charstar1,0,2,0,51,1582779600,1598760000,2
Careful_Woodpecker_3,0,2,0,2,1596600000,1596600000,2
patonphone,0,2,0,41,1606539600,1606539600,2
hard_KOrr,0,2,0,0,1550293200,1550293200,2
hail_the_cloud,0,2,0,6,1604293200,1607403600,2
crabman71,0,2,0,69,1571803200,1588564800,2
JMAN1422,0,2,0,-2,1608267600,1608267600,2
EdofBorg,0,2,0,4,1581915600,1582088400,2
squishyspy,0,2,0,10,1594872000,1594872000,2
Raeli,0,2,0,23,1608699600,1608872400,2
Lloyd417,0,2,0,12,1600488000,1606712400,2
CrossP,0,2,0,25,1598932800,1598932800,2
Mr_J-Wood,0,2,0,1,1590984000,1590984000,2
RabidIndividualist,0,2,0,2,1571284800,1582088400,2
Coblack23,0,2,0,6,1598500800,1605243600,2
MownCam,0,2,0,5,1597896000,1597896000,2
Cancerslug,0,2,0,29,1605416400,1605502800,2
keco185,0,2,0,2,1604466000,1607403600,2
Malio94,0,2,0,9,1588046400,1588046400,2
AntBandit,0,2,0,2,1593662400,1593662400,2
Beligerent,0,2,0,2,1586836800,1588651200,2
machina99,0,2,0,15,1611637200,1611723600,2
2sleezy,1,1,37,375,1587268800,1590811200,2
throwowo6,0,2,0,31,1570420800,1570420800,2
caprecious_agitator,1,1,6,5,1578718800,1587096000,2
flibgh,0,2,0,2,1590984000,1590984000,2
testableobject3,0,2,0,13,1596772800,1608786000,2
Mahd1_n,0,2,0,99,1607835600,1607835600,2
mookmook89,1,1,93,1,1592798400,1594180800,2
WoundedHart,0,2,0,46,1602648000,1606280400,2
MightyThoreau,0,2,0,40,1602734400,1603684800,2
mikew2244,0,2,0,5,1606626000,1606626000,2
thlabm,1,1,13,16,1592539200,1592539200,2
Wegak,0,2,0,2,1584072000,1584158400,2
tr3k,0,2,0,3,1605675600,1605762000,2
holyarchangels,1,1,6,1,1606626000,1606712400,2
lastshitbag1995,0,2,0,-13,1587873600,1587873600,2
kickinthebootlockers,0,2,0,29,1568865600,1568865600,2
WarProgenitor,0,2,0,19,1589860800,1589860800,2
Lysmerry,0,2,0,2,1572580800,1572580800,2
nowguccithatsmymfni,0,2,0,0,1588910400,1588910400,2
InternetJerk4U,0,2,0,46,1582779600,1582779600,2
SirEades,0,2,0,14,1604379600,1604379600,2
9tacosaredelicious9,0,2,0,0,1609304400,1609304400,2
captainsisko987,0,2,0,15,1600142400,1600660800,2
frappuccinio,0,2,0,3,1601611200,1601611200,2
kimnvy,0,2,0,2,1637125200,1637384400,2
RDGCompany,0,2,0,4,1581915600,1606021200,2
AFJtot,0,2,0,7,1571630400,1573794000,2
SGTwhocares,0,2,0,11,1597982400,1607317200,2
Yondaimesheir,0,2,0,15,1596686400,1600228800,2
CasperAnthony,0,2,0,-14,1602043200,1602043200,2
QuickFrozen,0,2,0,18,1599019200,1599019200,2
terrorerror,0,2,0,9,1605070800,1605243600,2
HugeBigMassiveTree,0,2,0,3,1608354000,1608354000,2
VeiledSyzygy,0,2,0,77,1592366400,1592366400,2
Littleman88,0,2,0,33,1576645200,1580101200,2
ocean-man,0,2,0,3,1601352000,1601352000,2
BoohooAmerica,1,1,5,18,1536897600,1536984000,2
Kiama84,0,2,0,23,1605589200,1607749200,2
BELLA161CIAO,0,2,0,30,1548133200,1552363200,2
Sadrith_Mora,0,2,0,10,1584590400,1584590400,2
Bookfan123,0,2,0,10,1570161600,1570420800,2
Bonsai668,0,2,0,12,1607403600,1607403600,2
alien88,0,2,0,11,1606798800,1606798800,2
Minusguy,0,2,0,8,1561262400,1593230400,2
aquariussi,0,2,0,15,1545800400,1556251200,2
Crypticpoptartz,0,2,0,181,1602475200,1602475200,2
Poetry_By_Gary,0,2,0,18,1593230400,1606021200,2
TheIdioticGuy,0,2,0,32,1590724800,1603166400,2
pandas25,0,2,0,4,1573275600,1581656400,2
thermal_shock,0,2,0,6,1583643600,1594612800,2
sweetpeaches99,0,2,0,7,1579928400,1580706000,2
placeholder-here,0,2,0,149,1588305600,1591243200,2
taIvir,0,2,0,1,1607576400,1607922000,2
Melianos12,0,2,0,4,1605589200,1605589200,2
charlie_charlie3,0,2,0,1,1545973200,1545973200,2
soundeng,0,2,0,3,1605848400,1605848400,2
teerude,0,2,0,5,1577336400,1577422800,2
TheBoxSloth,0,2,0,28,1593835200,1598414400,2
mogiesoul,0,2,0,2,1608354000,1608354000,2
AndyNihilate,0,2,0,12,1544936400,1549602000,2
stonerandloser,0,2,0,10,1575867600,1575867600,2
crazyzim,0,2,0,0,1581829200,1581829200,2
Future-Scone,0,2,0,3,1575176400,1575176400,2
cattivity,0,2,0,20,1552363200,1586318400,2
whydoiwantthisjob,1,1,10,5,1574744400,1574744400,2
Ok_Kangaroo_7566,0,2,0,14,1602993600,1603080000,2
NotSoGreatCourier,0,2,0,1,1608181200,1608786000,2
jberman1400,0,2,0,2,1596859200,1596859200,2
blueblurspeedspin,0,2,0,2,1597377600,1603684800,2
Madheal,0,2,0,-7,1596254400,1596254400,2
Anastariana,0,2,0,2,1597032000,1602648000,2
coledaniel8171,0,2,0,6,1573448400,1573794000,2
coginthemachine3954,1,1,19,5,1581138000,1581138000,2
CreepyGarage,1,1,33,9,1599192000,1599192000,2
CMDR_Hadion,0,2,0,64,1562904000,1565668800,2
THISISSNTMYACCOUNT,0,2,0,-13,1604466000,1604552400,2
Lombax_Rexroth,0,2,0,3,1585454400,1599883200,2
gmixy9,0,2,0,45,1606366800,1608354000,2
cw08,0,2,0,7,1575522000,1576472400,2
stophamertime,0,2,0,20,1567656000,1569124800,2
WeebmanJones,0,2,0,-8,1577854800,1577854800,2
BlueShift42,0,2,0,2,1604379600,1604379600,2
Codiax,0,2,0,9,1599883200,1602216000,2
zupius,0,2,0,4,1606021200,1606280400,2
TorontoYossarian,0,2,0,55,1600142400,1600142400,2
razaeru,0,2,0,6,1559188800,1559188800,2
Rarietty,0,2,0,4,1592798400,1598846400,2
MisterBrownBoy,0,2,0,38,1552194000,1582002000,2
Hawkmz,0,2,0,3,1602216000,1602302400,2
Pokedude2424,0,2,0,-5,1598414400,1598414400,2
sadfatsushi,0,2,0,6,1603944000,1603944000,2
abudhabikid,0,2,0,14,1572062400,1572753600,2
moulderininthegrave,0,2,0,7,1588305600,1588392000,2
Duval713,0,2,0,3,1608181200,1608699600,2
BombBombBombBombBomb,0,2,0,195,1605502800,1605502800,2
bibliotequeneaux,0,2,0,10,1604898000,1609045200,2
TheHadMatter15,0,2,0,-3,1589774400,1600488000,2
YourLocalHealer,1,1,38,1,1606021200,1606107600,2
Ragingredblue,0,2,0,1089,1601784000,1609304400,2
confettimocha,0,2,0,20,1598673600,1602388800,2
EmpathyIsAHabit,0,2,0,10,1572148800,1576904400,2
darvin_rio,0,2,0,2,1600315200,1600315200,2
_spectrehaunting,0,2,0,3,1595476800,1603425600,2
SlowPokeShawnRiguez,0,2,0,11,1608008400,1608008400,2
ItsTyrodTime,0,2,0,-3,1589601600,1589601600,2
ExBoyfriendsSweater,0,2,0,12,1578373200,1578373200,2
Universal-Omnicide,0,2,0,41,1580101200,1594353600,2
pognjen97,1,1,30,7,1607662800,1607662800,2
schmoelschmachoo,0,2,0,13,1580014800,1583298000,2
_420Kitten,0,2,0,7,1607662800,1607662800,2
bunhime,0,2,0,5,1595908800,1595908800,2
Why_Zen_heimer,0,2,0,0,1569816000,1569816000,2
narenare658,0,2,0,8,1585281600,1606280400,2
redpilledjoe,1,1,66,8,1602820800,1602820800,2
nihilismMattersTmro,0,2,0,12,1567569600,1569988800,2
Crucify_The_Rich,0,2,0,67,1578200400,1579410000,2
42words,0,2,0,18,1585022400,1585022400,2
Throwinitthrowinit,0,2,0,4,1578805200,1578805200,2
Significant_Cheek968,0,2,0,11,1604725200,1604811600,2
kuubi,0,2,0,23,1569211200,1570852800,2
tinyhouse54,0,2,0,16,1571112000,1571112000,2
Knowthyselfbitch,1,1,13,89,1548133200,1548392400,2
straycanine,0,2,0,22,1563249600,1565582400,2
21Rollie,0,2,0,6,1596945600,1608872400,2
Baxtin310,0,2,0,3,1585108800,1585108800,2
ImFriendsWithThatGuy,0,2,0,-4,1608786000,1608786000,2
some_fun,0,2,0,7,1597377600,1597377600,2
3_007JAH,0,2,0,-6,1582261200,1582261200,2
downvoteverythingxd,0,2,0,4,1578805200,1578805200,2
Ainu2019,0,2,0,6,1581656400,1581915600,2
Danksley,0,2,0,2,1573534800,1573534800,2
apexwarrior55,0,2,0,5,1607922000,1608872400,2
ShadowOfReality,0,2,0,14,1599796800,1601092800,2
YourGenderIsStupid,0,2,0,3,1604984400,1604984400,2
thelostsonreborn,0,2,0,10,1587873600,1587960000,2
K3vin_Norton,0,2,0,11,1587355200,1600315200,2
gallenfed,0,2,0,-3,1605330000,1611982800,2
pizzalumholdt,0,2,0,24,1602993600,1603771200,2
BillTheAngryCupcake,0,2,0,13,1580274000,1608354000,2
droztheus,0,2,0,8,1597636800,1606453200,2
lwright3,0,2,0,11,1542862800,1543554000,2
AmphibianAltruistic,0,2,0,2,1594180800,1594180800,2
Sasha2048,0,2,0,3,1604203200,1607922000,2
poeticjustice4all,0,2,0,9,1604725200,1606194000,2
Glitchface,0,2,0,-27,1608267600,1608267600,2
batshitterz,0,2,0,3,1578978000,1578978000,2
hailtotheking999,1,1,21,1,1599796800,1608786000,2
485L4BhJ,0,2,0,-21,1579237200,1579323600,2
WanderingFumarole2,0,2,0,5,1601265600,1601352000,2
kid207,0,2,0,17,1576904400,1577077200,2
dallinh,1,1,2,0,1583812800,1601265600,2
emil_,0,2,0,24,1609218000,1609218000,2
rightwingnews,2,0,35,0,1429761600,1433736000,2
Hapstead,1,1,39,76,1597809600,1606885200,2
CrbnBased,0,2,0,20,1594612800,1599105600,2
Bob_the_blacksmith,0,2,0,-53,1611896400,1611982800,2
ineedAA17,0,2,0,3,1593835200,1603512000,2
impressionist_boy,1,1,53,5,1572062400,1572062400,2
584005,0,2,0,5,1609390800,1609390800,2
xubax,0,2,0,4,1583899200,1593316800,2
thepaperpusher,0,2,0,6,1600574400,1600660800,2
ResearchEastern2362,0,2,0,119,1608181200,1608181200,2
jer72981m,0,2,0,2,1591329600,1600142400,2
KeepGettingBannedSMH,0,2,0,7,1561780800,1573621200,2
Monkeyleg,0,2,0,11,1575867600,1575867600,2
collechka_,0,2,0,4,1572321600,1572321600,2
anarchopessimism,0,2,0,204,1582434000,1583038800,2
xurfingerss,0,2,0,4,1569816000,1575262800,2
SirSludge,0,2,0,4,1611982800,1611982800,2
colorblooms_ghost,0,2,0,19,1600228800,1600228800,2
bunnylajoya8,1,1,223,27,1607749200,1607749200,2
Rpeddie17,0,2,0,-3,1585454400,1585454400,2
thomasrussoesq,0,2,0,-24,1559188800,1559275200,2
Dogster179,0,2,0,3,1583726400,1608094800,2
FlaccidButtPlug,0,2,0,7,1604984400,1605157200,2
familydontendinblood,0,2,0,20,1573189200,1575262800,2
JungleJim_,0,2,0,21,1594094400,1594094400,2
drkleppe,0,2,0,4,1603425600,1603684800,2
canhasdiy,0,2,0,4,1571544000,1571630400,2
koushakandystore,0,2,0,5,1608786000,1609650000,2
Snoo74279,0,2,0,11,1601784000,1601784000,2
fhstuba,0,2,0,37,1603857600,1604811600,2
saggy-helping-hobbit,0,2,0,3,1603512000,1611982800,2
dickthericher,0,2,0,-3,1608613200,1608699600,2
trashleybanks,0,2,0,3,1617336000,1621051200,2
Verstrata,0,2,0,4,1603512000,1603598400,2
trap_344,1,1,5,5,1575608400,1575608400,2
WhakaWhakaWhaka,0,2,0,2,1589947200,1589947200,2
WEAKNESSisEXISTENCE,0,2,0,3,1606539600,1606539600,2
fuckwork942394239,0,2,0,34,1574226000,1574226000,2
FC5EndingSucks,0,2,0,2,1580878800,1580878800,2
billybobjoejr330,0,2,0,77,1550206800,1550293200,2
Facky,0,2,0,14,1582088400,1583038800,2
UragaanPanzer,0,2,0,13,1608267600,1609304400,2
faithOver,0,2,0,2,1599883200,1599883200,2
ovenhead101,0,2,0,4,1565755200,1567569600,2
nonserviam420,0,2,0,48,1558843200,1558929600,2
CurtainClothes,0,2,0,6,1575522000,1608354000,2
halkiwebb,0,2,0,10,1611810000,1611810000,2
noodlyjames,0,2,0,5,1603512000,1603512000,2
homelandsecurity__,0,2,0,13,1564545600,1564545600,2
_banana_phone,0,2,0,57,1587441600,1591761600,2
Machinistsol,1,1,43,3,1573966800,1574053200,2
ErkOfficial,0,2,0,4,1592625600,1592712000,2
apd675,0,2,0,23,1574226000,1581483600,2
ladylioness_,0,2,0,3,1584158400,1591675200,2
AlohaChips,0,2,0,6,1585454400,1603512000,2
ThankYouTaceGod,0,2,0,-3,1550293200,1550293200,2
SkoobyDuBop,0,2,0,5,1612069200,1612069200,2
Oldschoolcold,0,2,0,15,1611982800,1612069200,2
CulturalWind357,1,1,14,2,1590724800,1590724800,2
Tsuki_no_Mai,0,2,0,-7,1596600000,1596600000,2
DrFartMaster,1,1,164,3,1565928000,1565928000,2
castanza128,0,2,0,21,1591243200,1599105600,2
hellohipster,0,2,0,55,1591675200,1591675200,2
LightningSalamander,0,2,0,5,1583038800,1583038800,2
Salad-and-Egg,0,2,0,59,1572408000,1572408000,2
Omniiism,0,2,0,0,1588132800,1588132800,2
catsndogsnmeatballs,0,2,0,3,1572235200,1582779600,2
skidwitch,0,2,0,15,1604203200,1604466000,2
sushirabbits,0,2,0,12,1593748800,1604030400,2
Gnarthotep,0,2,0,15,1595649600,1595649600,2
rivercb15,0,2,0,6,1584590400,1584590400,2
CF_Gamebreaker,1,1,152,8,1581829200,1581829200,2
FiveOhFive91,1,1,124,29,1599192000,1602561600,2
jumpinrobin,0,2,0,27,1587355200,1605157200,2
Sirveri,0,2,0,24,1573275600,1573275600,2
teethonachalkboard,0,2,0,4,1602734400,1603425600,2
sitcivismundi,0,2,0,5,1578373200,1579842000,2
PanderMan_265,0,2,0,18,1601611200,1601611200,2
ErikHumphrey,0,2,0,3,1609477200,1609477200,2
Vaines,0,2,0,10,1605762000,1606798800,2
thekawai,2,0,12,0,1600315200,1604466000,2
mytwinkiedog,0,2,0,55,1571112000,1587096000,2
godsheir,0,2,0,3,1563854400,1569297600,2
LilGidGid,1,1,2661,24,1549515600,1550206800,2
TheImpossibleBanana,1,1,6,4,1601870400,1602043200,2
VdubTommy,0,2,0,22,1579150800,1579150800,2
GeneralAwesome1996,0,2,0,13,1590120000,1590120000,2
jakeyjoeyo,0,2,0,44,1609390800,1611896400,2
frsty1221,0,2,0,7,1597032000,1607490000,2
whenthefirescame,0,2,0,11,1571976000,1571976000,2
TheBloodyFox,0,2,0,26,1551070800,1558411200,2
evafranxx,0,2,0,5,1572235200,1572321600,2
handsomeandsometruth,0,2,0,3,1600574400,1602993600,2
Bnic1207,0,2,0,2,1598328000,1598414400,2
ridethroughlife,0,2,0,61,1601438400,1606194000,2
neeeeeillllllll,0,2,0,-4,1601956800,1602043200,2
h4ckn3t,0,2,0,4,1572148800,1572235200,2
Wolfram9,0,2,0,8,1603512000,1603512000,2
Life_outside_PoE,0,2,0,74,1599537600,1608267600,2
commmonredditor,1,1,239,14,1564113600,1564372800,2
Stickygrits,0,2,0,39,1561176000,1561176000,2
outsidesublime,0,2,0,12,1593662400,1594094400,2
Ironclad_FTW,0,2,0,7,1594267200,1597896000,2
DiabeticThor,0,2,0,7,1601092800,1611896400,2
OGHozKats,0,2,0,9,1602302400,1602302400,2
SnowmanArtillary,0,2,0,11,1598241600,1598673600,2
ladybadcrumble,0,2,0,31,1581915600,1587096000,2
MrBatistti,0,2,0,119,1590465600,1590465600,2
basedpog,0,2,0,12,1604725200,1604725200,2
JonHatesJail,1,1,21,1,1594267200,1597204800,2
LETAROS,0,2,0,2,1608267600,1608526800,2
YourFavoriteHugbox,0,2,0,4,1590897600,1590897600,2
Indy_Liz,0,2,0,35,1594785600,1599019200,2
P-337,0,2,0,14,1579150800,1579150800,2
BugS202Eye,0,2,0,5,1608613200,1608613200,2
Junkerson13,0,2,0,105,1575522000,1575522000,2
pickypicky3217,0,2,0,3,1589688000,1597032000,2
queeniemedusa,0,2,0,32,1606971600,1607835600,2
Bi-CuriousGeorge-01,0,2,0,-6,1580619600,1580619600,2
limariabr,0,2,0,13,1600747200,1603512000,2
wilprblyneverusethis,0,2,0,5,1606021200,1606021200,2
crimewavedd,0,2,0,90,1605675600,1606021200,2
SaKaHa,0,2,0,6,1609477200,1609477200,2
ez_sleazy,0,2,0,16,1596686400,1607230800,2
hszazg,1,1,48,1,1611810000,1611810000,2
atdForge,0,2,0,7,1572667200,1575435600,2
The130CrewChief,0,2,0,238,1597118400,1597118400,2
rites0fpassage,0,2,0,29,1607317200,1608699600,2
Resaianka,0,2,0,13,1584936000,1595995200,2
icanpaywithpubes,0,2,0,6,1582779600,1602475200,2
FearlessJuan,0,2,0,33,1598760000,1600401600,2
angrybaija,0,2,0,8,1606971600,1607058000,2
Nicosemuta,0,2,0,218,1589860800,1589947200,2
crunchy_cereal_666,0,2,0,20,1608267600,1608267600,2
flip35,0,2,0,2,1589083200,1589083200,2
DeadlyYellow,0,2,0,8,1603512000,1603598400,2
QS91,0,2,0,20,1553572800,1608872400,2
NeatRepeat,0,2,0,9,1585108800,1587096000,2
andyywild,0,2,0,17,1596772800,1598414400,2
PantherEverSoPink,0,2,0,20,1554868800,1554868800,2
tim_thomersons_brows,0,2,0,7,1604984400,1608181200,2
lilivnv,0,2,0,2,1608872400,1608872400,2
cm99-2000,0,2,0,3,1582866000,1583812800,2
DunderMilton,0,2,0,17,1587614400,1587700800,2
ohgodmynuts,0,2,0,-1,1597982400,1598068800,2
Feakandersky,0,2,0,2,1578373200,1578459600,2
theironbagel,0,2,0,1,1607662800,1607662800,2
iambingalls,1,1,6,1,1608354000,1608699600,2
liliacrose,0,2,0,5,1606453200,1606453200,2
DunkMcSwish,0,2,0,0,1567051200,1567051200,2
flatwarmbeer,0,2,0,4,1581138000,1581570000,2
emberfox67,1,1,30,2,1578891600,1578978000,2
LaksasTheTrap,0,2,0,7,1582866000,1585195200,2
petonedogaday,0,2,0,5,1607922000,1607922000,2
Aim_Loading,0,2,0,6,1568606400,1569816000,2
Laphing_Drunk,0,2,0,2,1571803200,1599019200,2
kerkyjerky,0,2,0,5,1576126800,1576213200,2
Andre_Luc,0,2,0,38,1599883200,1599969600,2
theworldisyours94,1,1,26,8,1602388800,1609218000,2
hanselpremium,1,1,1,8,1599796800,1605762000,2
kaka8miranda,0,2,0,11,1589428800,1603684800,2
Treeninja1999,0,2,0,2,1576645200,1576645200,2
yourbuddy_,0,2,0,12,1573016400,1577077200,2
Velaseri,0,2,0,3,1572494400,1587873600,2
Darkhale361,0,2,0,28,1608872400,1609218000,2
IWriteWithThis,0,2,0,48,1555387200,1556683200,2
mollymartis99,0,2,0,14,1592798400,1592798400,2
cuuuuT,0,2,0,-12,1597032000,1597032000,2
Row-Common,0,2,0,-11,1607403600,1607576400,2
nemoskullalt,0,2,0,17,1601524800,1604552400,2
stagc,0,2,0,2,1549170000,1549170000,2
borntodyechaney,0,2,0,19,1579150800,1579150800,2
QT314167346,0,2,0,5,1608699600,1612069200,2
TrollMcGoal,0,2,0,6,1584072000,1584158400,2
Blubredux,0,2,0,11,1593835200,1593835200,2
Harmacc,0,2,0,106,1590724800,1603512000,2
dashingrather,0,2,0,51,1588392000,1592107200,2
Rich-Sandwich-7581,0,2,0,19,1603684800,1603771200,2
wheatheseIbread,0,2,0,7,1607576400,1608440400,2
dumpsterfire70,0,2,0,7,1564804800,1566360000,2
Ilikebreathing98,1,1,7,1,1597896000,1597896000,2
Asuzumi,0,2,0,31,1585800000,1587009600,2
simicboiuchiha,0,2,0,11,1608354000,1608354000,2
Ghost_Beach,0,2,0,4,1601092800,1601092800,2
Certified_Memologist,0,2,0,28,1596772800,1598673600,2
fatb0b,0,2,0,7,1575435600,1575435600,2
kay-nupes,0,2,0,15,1602648000,1607922000,2
Cum_Dong_Weed_Bong,0,2,0,14,1583899200,1583899200,2
Anarchymeansihateyou,0,2,0,16,1572148800,1572148800,2
UpbeatGeologist,0,2,0,4,1560830400,1560830400,2
shaggysnorlax,1,1,80,4,1597809600,1599105600,2
Hatemenow321,0,2,0,10,1582002000,1582002000,2
LippySmalls,0,2,0,13,1602820800,1606021200,2
youbutcoolerer,0,2,0,5,1584072000,1597896000,2
simonjp,0,2,0,73,1573966800,1575694800,2
Girthquakenz,1,1,31,3,1584331200,1593835200,2
XannimEX,0,2,0,19,1608786000,1608786000,2
heyway,0,2,0,-3,1612069200,1612069200,2
lovely-dea,0,2,0,7,1595563200,1595649600,2
PenultimatePopHop,0,2,0,8,1603598400,1603598400,2
dr_jiang,0,2,0,17,1603512000,1603512000,2
TonyPoly,0,2,0,2,1595649600,1595649600,2
peyote_coy0te,0,2,0,31,1555128000,1555128000,2
anarchirish,0,2,0,28,1602648000,1607317200,2
juggles321,0,2,0,76,1604984400,1605070800,2
zuperfly,0,2,0,-3,1585281600,1585713600,2
turtlelevelslow,0,2,0,22,1576299600,1603512000,2
xXPussy420Slayer69Xx,0,2,0,-5,1571716800,1609218000,2
eighphid,0,2,0,16,1594526400,1594612800,2
Gottfrid05,0,2,0,-16,1560571200,1560571200,2
fishcustard2012,1,1,65,9,1600660800,1600660800,2
destraight,0,2,0,2,1575608400,1575608400,2
SheepBantz,0,2,0,3,1607058000,1608094800,2
blargmeansno2,0,2,0,1,1608094800,1608094800,2
antiqute,0,2,0,-3,1595649600,1601179200,2
rankinrez,0,2,0,-1,1550293200,1559102400,2
anti-jay,1,1,25,1,1599192000,1599796800,2
2000smallemo,0,2,0,16,1575608400,1600574400,2
Urban_Epiphyte,0,2,0,3,1608094800,1608094800,2
Scottvrakis,0,2,0,3,1604293200,1604293200,2
foursix77,0,2,0,142,1599969600,1599969600,2
decorona,0,2,0,-1,1599883200,1608267600,2
DrakonIL,0,2,0,11,1592798400,1599019200,2
PHalfpipe,0,2,0,2,1596772800,1603425600,2
Khandakerex,0,2,0,2,1606366800,1606366800,2
just_another_scumbag,0,2,0,9,1603512000,1603512000,2
GassyGusFartCompany,0,2,0,9,1608699600,1608699600,2
sinfonien,0,2,0,3,1593144000,1593144000,2
Vanpocalypse,0,2,0,5,1582779600,1582779600,2
pihb666,0,2,0,9,1608008400,1608094800,2
Justdoit1776,0,2,0,1,1594699200,1594785600,2
shredtilldeth,0,2,0,20,1587182400,1587182400,2
duckylabour,0,2,0,105,1585195200,1585627200,2
datderewtc7,0,2,0,5,1561780800,1561780800,2
GrimaceGrunson,0,2,0,16,1578978000,1578978000,2
Significant_Manner31,0,2,0,2,1608699600,1608872400,2
mokillem,0,2,0,2,1595563200,1595649600,2
Jabbuk,0,2,0,27,1562299200,1574658000,2
7cocos,0,2,0,39,1589601600,1590033600,2
lvl5_laserlotus,0,2,0,10,1611982800,1611982800,2
Doink_Brah,0,2,0,7,1583899200,1583899200,2
hil0916,1,1,15,2,1583899200,1583899200,2
i_dont_feel_creative,0,2,0,12,1595822400,1595908800,2
JohnGenericDoe,0,2,0,6,1605589200,1605589200,2
Cassandra_Nova,0,2,0,8,1605848400,1605848400,2
SweatyDickTits,0,2,0,-49,1593230400,1593230400,2
Lildemon198,0,2,0,6,1569988800,1569988800,2
unfoldingrevolving,0,2,0,7,1576990800,1580878800,2
garbitch_bag,0,2,0,13,1606453200,1608526800,2
Younglovliness,0,2,0,-9,1576645200,1576645200,2
TrueMeer75,0,2,0,100,1611637200,1611896400,2
EddieBang,0,2,0,21,1544504400,1578459600,2
Dabmiral,0,2,0,10,1548565200,1548565200,2
UlanMal,0,2,0,32,1599278400,1601524800,2
mynameisoops,0,2,0,1,1585627200,1586577600,2
pickrunner18,0,2,0,15,1599105600,1603425600,2
tdl432,0,2,0,2,1598328000,1603512000,2
Elcabrongordo,0,2,0,79,1584417600,1584417600,2
wtf_kinda_world,0,2,0,16,1609045200,1609045200,2
CynicallyBelieveIt,0,2,0,24,1565841600,1569297600,2
MacSnoozie,0,2,0,4,1584244800,1597809600,2
MadPae,0,2,0,22,1596168000,1606626000,2
________no,0,2,0,40,1583726400,1584158400,2
-_-__-__-__-_-,0,2,0,38,1541826000,1541826000,2
herownheroine,0,2,0,23,1594094400,1608181200,2
fetuspuddin,0,2,0,9,1587528000,1597809600,2
ndbrzl,0,2,0,23,1607317200,1607317200,2
Overseer090,0,2,0,4,1605589200,1606885200,2
CanIGetOneForFastSer,0,2,0,6,1606626000,1606626000,2
layzer5,0,2,0,4,1605589200,1606798800,2
big_guy404,0,2,0,9,1600228800,1600228800,2
Fullmoonkira,0,2,0,3,1598760000,1600401600,2
TheVegter,0,2,0,1,1585108800,1585108800,2
TomoyoHoshijiro,0,2,0,8,1588910400,1588910400,2
Rude-Bit-4915,0,2,0,15,1603512000,1603598400,2
beckster,0,2,0,67,1563163200,1563163200,2
jdoog72,0,2,0,7,1573275600,1574917200,2
letmeseem,0,2,0,7,1602129600,1602216000,2
gaaralf,0,2,0,12,1575435600,1592798400,2
Awarrapan,0,2,0,5,1601956800,1602129600,2
chahoua,0,2,0,7,1570593600,1570593600,2
frustratedlemons,1,1,195,10,1579755600,1585108800,2
MikePencil69_v2,0,2,0,-36,1573102800,1573102800,2
sloppy_top_george,0,2,0,16,1612155600,1612242000,2
cheesmanii,0,2,0,2,1605330000,1605330000,2
hellochrissy,0,2,0,68,1601611200,1601784000,2
Brick_in_the_dbol,0,2,0,3,1585454400,1585454400,2
FrenchFryCattaneo,0,2,0,17,1541566800,1566100800,2
Sligee,1,1,0,0,1556078400,1556251200,2
MagicDragon212,0,2,0,4,1575176400,1575176400,2
nom-nom-nom-de-plumb,0,2,0,230,1606885200,1606885200,2
coopdawgX,0,2,0,5,1612155600,1612242000,2
skolv,0,2,0,2,1582606800,1582606800,2
bzzenp,0,2,0,3,1608181200,1608181200,2
nicknac,0,2,0,-56,1605934800,1605934800,2
Owninglegend,0,2,0,2,1580792400,1580792400,2
iamhappy0,1,1,16,2,1599624000,1599624000,2
Chemo55,0,2,0,25,1604203200,1608699600,2
suarezj9,0,2,0,8,1584676800,1584763200,2
sortamythrowaway,1,1,9,1,1581483600,1581483600,2
yeeyeesuckinteets,0,2,0,10,1581656400,1581742800,2
poisoncup,0,2,0,43,1572753600,1587096000,2
Help-Ineedsomebody-,0,2,0,7,1584936000,1585195200,2
itasteawesome,0,2,0,-4,1559188800,1559188800,2
heirbagger,0,2,0,11,1596772800,1597982400,2
lookatmeimwhite,0,2,0,-1,1601524800,1601611200,2
sw04ca,0,2,0,16,1609045200,1609045200,2
canimakeacomment,0,2,0,7,1580360400,1580360400,2
ConnectDrop,0,2,0,3,1574226000,1574398800,2
augmented-boredom,0,2,0,21,1572148800,1572235200,2
Dixy-Normous,0,2,0,9,1600315200,1600315200,2
Init_4_the_downvotes,0,2,0,7,1599710400,1603339200,2
critialerror,0,2,0,6,1599969600,1599969600,2
QueenMhysa,0,2,0,8,1594785600,1597032000,2
IrreverentKiwi,0,2,0,68,1607490000,1607490000,2
PhotoconductiveOil,0,2,0,3,1604379600,1604379600,2
trippingchilly,0,2,0,44,1584763200,1584763200,2
lilpumps_cousin,0,2,0,-71,1608440400,1608440400,2
CampfireHeadphase,0,2,0,3,1600056000,1600056000,2
MicrosoftExplorer,0,2,0,4,1600315200,1600315200,2
bukanon_69,0,2,0,9,1595476800,1605157200,2
coldseam,0,2,0,70,1578891600,1579755600,2
MisterVonJoni,0,2,0,8,1608526800,1608526800,2
Chadacas,0,2,0,2,1585195200,1596600000,2
larsen_sinclair,0,2,0,12,1603771200,1603857600,2
xkulp8,0,2,0,18,1573016400,1579237200,2
Durum2x,0,2,0,11,1599451200,1599451200,2
TrumpdUP,0,2,0,21,1568520000,1597377600,2
Orodreath,0,2,0,170,1590120000,1596340800,2
buttercupgymlover,0,2,0,2,1602907200,1602907200,2
evolvedspice,0,2,0,11,1574053200,1602302400,2
b-b-betty,0,2,0,54,1605934800,1605934800,2
ascendant-one,0,2,0,34,1602043200,1604898000,2
Aktin,0,2,0,2,1565755200,1565755200,2
Ginahyena,0,2,0,10,1596772800,1600142400,2
cwanberwyjuice,0,2,0,1,1602820800,1602820800,2
aldjfh,0,2,0,29,1590552000,1590552000,2
dont_dox_me_again,1,1,59,1,1554091200,1576386000,2
museo_del_prado,0,2,0,32,1591502400,1605243600,2
Darraghj12,0,2,0,30,1591329600,1599364800,2
brad__staple721,0,2,0,102,1572148800,1572753600,2
batterypacks,0,2,0,36,1572753600,1572753600,2
NoLifeOnlyReddit,0,2,0,1,1606107600,1606107600,2
NegativePerson,0,2,0,4,1609131600,1609304400,2
Z3r0sama2017,0,2,0,2,1573794000,1573794000,2
DashFerLev,0,2,0,7,1579064400,1579064400,2
New_Hentaiman,0,2,0,5,1595390400,1595390400,2
OhHeyImAlex,0,2,0,3,1591243200,1591243200,2
MrVinceyVince,0,2,0,6,1583726400,1587009600,2
Oscarocket2,0,2,0,12,1576386000,1576386000,2
smokeandfireflies,0,2,0,4,1594872000,1595044800,2
Vprhxpd9,0,2,0,4,1561608000,1561608000,2
gerobald,0,2,0,2,1602043200,1602043200,2
ohmightyqueen,0,2,0,16,1594612800,1608699600,2
endermelle,0,2,0,-20,1595390400,1595390400,2
engineerfieldmouse,0,2,0,2,1579669200,1611982800,2
ReadWriteArithmetic,2,0,71,0,1601265600,1602993600,2
jambi55,1,1,41,1,1606453200,1606539600,2
morebeansplease,0,2,0,34,1588132800,1590379200,2
porcelain_crab,0,2,0,3,1582779600,1587182400,2
LysergicLegend,0,2,0,6,1605934800,1606798800,2
justCantGetEnufff,0,2,0,6,1569124800,1569124800,2
thatstraycat,0,2,0,4,1572235200,1582434000,2
threepenis,0,2,0,2,1580360400,1580360400,2
brownfarts,1,1,35,4,1598760000,1598760000,2
Linaphor,0,2,0,-10,1603166400,1603252800,2
CatBoyTrip,0,2,0,19,1585454400,1609045200,2
MoreRamenPls,0,2,0,14,1591243200,1604379600,2
ieatlotsofvegetables,0,2,0,3,1605157200,1606539600,2
ccpa_compliance,0,2,0,13,1595476800,1595476800,2
RATC1440,1,1,7,40,1591070400,1599105600,2
TurkeyHotdog,0,2,0,4,1568174400,1568260800,2
doobyfish,0,2,0,11,1548651600,1548651600,2
someb0dy_elses_dog,0,2,0,6,1600660800,1600660800,2
Life-Guide,0,2,0,-1,1601611200,1601611200,2
Benedikto_,0,2,0,3,1576645200,1576645200,2
Pcostix,0,2,0,12,1561435200,1561521600,2
Dylamb,0,2,0,7,1576126800,1598932800,2
is_there_pie,0,2,0,17,1592366400,1606971600,2
Ptit_jarret,0,2,0,-32,1609131600,1609131600,2
blendthatshit,1,1,153,50,1565668800,1565668800,2
dtothep89,0,2,0,-11,1590033600,1590120000,2
apfejes,0,2,0,14,1603512000,1603512000,2
TyroneGold64,0,2,0,5,1588910400,1601179200,2
indoor_grower,0,2,0,47,1606453200,1606453200,2
overlyambitiousnerd,0,2,0,61,1601524800,1606712400,2
Son_of_Eris,0,2,0,10,1593403200,1593489600,2
Darkchick21,2,0,160,0,1577422800,1579410000,2
futurefloridaman87,0,2,0,0,1562558400,1567569600,2
Drachenpanzer,0,2,0,11,1586491200,1609045200,2
thebumm2,0,2,0,12,1603425600,1603684800,2
MasterVule,0,2,0,34,1598241600,1600488000,2
MyAltAccountBecause,0,2,0,38,1584590400,1584590400,2
JHGrove3,0,2,0,9,1603512000,1603512000,2
Three__14,0,2,0,4,1580619600,1602388800,2
brandon9769,1,1,10,2,1608267600,1608267600,2
Infantryblue,0,2,0,2,1557028800,1584676800,2
thesetinythings,0,2,0,9,1594526400,1594526400,2
Bamboobag_Pandarrell,0,2,0,13,1612155600,1612155600,2
gnome_idea_what,0,2,0,3,1571630400,1571630400,2
SlashPR,0,2,0,13,1605070800,1605157200,2
lurker1125,0,2,0,16,1599019200,1599019200,2
traechat,0,2,0,57,1594094400,1594094400,2
Cyclopher6971,0,2,0,5,1585368000,1607230800,2
Playful_Art_5364,0,2,0,8,1611810000,1611810000,2
luchorz93,0,2,0,29,1555387200,1555473600,2
tojarp,0,2,0,6,1586059200,1586059200,2
Purple-Tangelo,0,2,0,7,1583726400,1583726400,2
ahartlage4,0,2,0,-7,1606885200,1606885200,2
Screwurgod,0,2,0,-19,1606539600,1606626000,2
LeluRussell,0,2,0,28,1574053200,1574053200,2
SwedishFoot,0,2,0,23,1604638800,1606280400,2
meowese,0,2,0,27,1554696000,1555905600,2
Terpeneaholic,0,2,0,11,1581224400,1585281600,2
Tellyourdogilovethem,0,2,0,56,1590724800,1590724800,2
MrTastey,0,2,0,8,1607662800,1607662800,2
pixieleee,0,2,0,9,1570075200,1570075200,2
GonnaBeOnTiDop,0,2,0,65,1596600000,1601092800,2
_damppapertowel_,0,2,0,-15,1602734400,1602734400,2
T_for_tea,0,2,0,6,1544590800,1560484800,2
Ayoromantic,0,2,0,5,1572494400,1572667200,2
Vladd_the_Retailer,0,2,0,6,1568347200,1600228800,2
MeaT_DepartmenT_,0,2,0,14,1552276800,1552276800,2
rjbwork,0,2,0,72,1592798400,1592798400,2
THELegato,1,1,5,3,1599796800,1599883200,2
AlternativeAccount14,0,2,0,21,1570075200,1570075200,2
lingdingwhoopy,0,2,0,7,1605762000,1605762000,2
trav0073,0,2,0,6,1571544000,1580360400,2
MrGr33n31,0,2,0,8,1580446800,1580533200,2
TonyDarkSky,0,2,0,14,1605416400,1605502800,2
Stupid_Bearded_Idiot,0,2,0,6,1585454400,1585540800,2
FSM_Rabbi,1,1,113,1,1608354000,1608440400,2
BrowncoatIona,0,2,0,10,1600660800,1605934800,2
hgd123hgs,0,2,0,7,1611810000,1611810000,2
National_Region,1,1,7,1,1580101200,1580187600,2
Germsofwar,0,2,0,11,1582779600,1582779600,2
CajunKingFish,1,1,0,-3,1597896000,1611723600,2
xStabbyMcGee,0,2,0,-3,1557979200,1557979200,2
evil_con_carne,0,2,0,60,1574744400,1600660800,2
ShepherdofBeing93,0,2,0,3,1608786000,1609045200,2
aeolum,0,2,0,61,1605934800,1605934800,2
Currynrice9728,1,1,734,7,1602820800,1602993600,2
ironwill1964,0,2,0,2,1600747200,1605934800,2
J-O-C_1599,0,2,0,-18,1585454400,1585454400,2
LoafofSadness,0,2,0,75,1590379200,1590379200,2
lsirius,0,2,0,7,1571198400,1603512000,2
Uniondale,0,2,0,2,1579064400,1604379600,2
glimpee,0,2,0,2,1608699600,1611982800,2
Corvid-Moon,0,2,0,180,1560052800,1560052800,2
RemoteWasabi4,0,2,0,1,1585454400,1587528000,2
Micycle08,0,2,0,5,1603598400,1603598400,2
YourPadre,0,2,0,30,1599710400,1599710400,2
FormidableBriocheKun,0,2,0,9,1599105600,1599192000,2
boinzy,1,1,281,2,1608786000,1608872400,2
justdesserts2468,0,2,0,4,1561089600,1561089600,2
farlack,0,2,0,2,1601352000,1601352000,2
FeedUsFetusFeetPus,0,2,0,90,1565236800,1570075200,2
kokokame,0,2,0,17,1575954000,1575954000,2
ClintMcGarnacle,0,2,0,68,1589256000,1600660800,2
toscomo,0,2,0,18,1566532800,1567483200,2
simonejester,0,2,0,17,1600747200,1605330000,2
TooWideToHide,0,2,0,11,1609218000,1609218000,2
autumnraining,0,2,0,0,1594353600,1594440000,2
somefunnyladd,0,2,0,155,1600228800,1604116800,2
GeorgeTheChicken,0,2,0,0,1589169600,1589169600,2
wipeAwayThoseTears,0,2,0,24,1608613200,1608699600,2
mooninomics,0,2,0,37,1599192000,1601524800,2
ExpertDesk6,0,2,0,2,1600142400,1602043200,2
velvykat5731,0,2,0,29,1598241600,1607490000,2
steeveperry,0,2,0,12,1607662800,1607662800,2
Naultic,0,2,0,6,1608872400,1608872400,2
IAmASimulation,0,2,0,7,1567569600,1567569600,2
Im_Nino,0,2,0,3,1609390800,1609390800,2
lilyhemmy2009,0,2,0,21,1583726400,1602216000,2
jessibabyy11,0,2,0,41,1569816000,1574917200,2
Shichroron,0,2,0,-12,1571112000,1571112000,2
FragileWhiteWoman,1,1,33,2,1602475200,1602475200,2
RubbinMaoDong,0,2,0,12,1588651200,1592366400,2
Chair_Aznable,0,2,0,3,1598241600,1603771200,2
INFLATABLE_CUCUMBER,0,2,0,11,1591588800,1591588800,2
pandok_,0,2,0,79,1607576400,1607576400,2
Kolten98,1,1,8,41,1548565200,1548910800,2
ifyouseekayyou,0,2,0,2,1603512000,1606021200,2
HdeZho,0,2,0,11,1592971200,1599796800,2
video_2,0,2,0,2,1608526800,1608613200,2
jdawg7780,0,2,0,7,1555300800,1555992000,2
lollipopPandah,0,2,0,14,1590984000,1596254400,2
gfreyd,0,2,0,298,1567310400,1569384000,2
Chicken-n-Waffles,0,2,0,-10,1606885200,1606885200,2
Vlodimir_von_Everec,0,2,0,74,1581829200,1581829200,2
thesilentrobin,0,2,0,15,1609218000,1609304400,2
Mittenzmaker,0,2,0,11,1603512000,1603512000,2
FormerLurker0v0,0,2,0,3,1608699600,1608699600,2
Iamadoctor,0,2,0,6,1421125200,1421211600,2
Jerryeleceng,0,2,0,8,1595217600,1595217600,2
funsizedaisy,0,2,0,7,1601352000,1601352000,2
plekplek,0,2,0,10,1597896000,1598673600,2
mfp4life,0,2,0,71,1567310400,1571716800,2
DawcCat,0,2,0,2,1603512000,1603598400,2
coffee-and-clouds,1,1,106,30,1568779200,1568779200,2
Unicornzzz2,0,2,0,2,1594872000,1597809600,2
Hetaliauchiha,0,2,0,3,1594440000,1606194000,2
gaiusgracchus2018,0,2,0,28,1549515600,1549602000,2
fukluckduck,0,2,0,6,1638507600,1638507600,2
BedpanCheshireKnight,0,2,0,17,1598155200,1602388800,2
i-fucked-it-up-again,0,2,0,3,1606712400,1607317200,2
VladiRais,1,1,7,2,1565409600,1604203200,2
aryansupersoldier,0,2,0,9,1602216000,1602216000,2
bibasik7,0,2,0,-1,1600747200,1600747200,2
-RdV-,0,2,0,15,1608008400,1608008400,2
MrGurns,0,2,0,27,1580792400,1580792400,2
closet_activist,0,2,0,7,1570593600,1572930000,2
MyNameIsMud0056,1,1,3,3,1587960000,1606712400,2
Deviner75,0,2,0,-19,1599105600,1599105600,2
CrayolaS7,0,2,0,12,1577336400,1577336400,2
reflexesofjackburton,0,2,0,40,1572408000,1572408000,2
BUSTOFHELIOS,0,2,0,8,1592107200,1607922000,2
skypiehi26,1,1,117,8,1569816000,1574053200,2
mantronix82,0,2,0,23,1597118400,1606021200,2
doovan,0,2,0,3,1591243200,1591243200,2
Trashtie,0,2,0,42,1593835200,1604552400,2
lordskorb,0,2,0,15,1579064400,1592884800,2
TheShiff,0,2,0,3,1576126800,1576126800,2
CashWooden435,0,2,0,-4,1608786000,1608786000,2
Smokey76,0,2,0,22,1556683200,1559102400,2
ThrownAwayIRL,0,2,0,3,1603857600,1603857600,2
allaroundguy,0,2,0,-3,1573362000,1573362000,2
oicnow,0,2,0,9,1585454400,1585454400,2
Beeblebrox2020,0,2,0,18,1592539200,1592539200,2
CptOko,0,2,0,22,1586923200,1586923200,2
inchyradreams,0,2,0,9,1599451200,1599451200,2
Broad_Tax,0,2,0,16,1573621200,1573621200,2
Not_A_TRex19,0,2,0,6,1587009600,1589515200,2
BrightPegasus84,0,2,0,6,1596513600,1596600000,2
NGGJamie,0,2,0,8,1603512000,1603598400,2
Giannirobo,0,2,0,3,1593144000,1597464000,2
pavementwater,0,2,0,3,1585454400,1585454400,2
Phoenix_Salamander,0,2,0,3,1608526800,1608613200,2
Yohijiro,0,2,0,12,1605330000,1607835600,2
IntoTheWinterWell,0,2,0,6,1547355600,1547442000,2
DrDankMemesPhD,0,2,0,2,1591243200,1591243200,2
Jeedeye,0,2,0,29,1603684800,1603684800,2
pwbue,0,2,0,5,1584331200,1612069200,2
Redpill_Crypto,1,1,14,2,1608440400,1608526800,2
Hisnibbs,0,2,0,4,1605848400,1606194000,2
TautYetMalleable,0,2,0,7,1578286800,1578373200,2
shadowknows,0,2,0,12,1606280400,1608786000,2
Sterling-4rcher,0,2,0,2,1585627200,1605070800,2
IIIII00,0,2,0,14,1603944000,1605070800,2
JoPublix,0,2,0,2,1607058000,1607058000,2
Based_JuiceBox,0,2,0,2,1608699600,1608699600,2
thegrandpineapple,0,2,0,2,1589860800,1589860800,2
qqqqqx,0,2,0,36,1603598400,1603598400,2
LetsGetWeirdddddd,0,2,0,6,1585022400,1599278400,2
Lizard-Minelli,0,2,0,53,1600315200,1600315200,2
Forcripessssssake,0,2,0,20,1585713600,1600228800,2
DarthVidetur,0,2,0,8,1550984400,1550984400,2
Kooky-Shock,0,2,0,70,1604898000,1605070800,2
kurmuri,0,2,0,7,1578286800,1593576000,2
drdestroyer9,0,2,0,28,1608181200,1608181200,2
Melonenstrauch,0,2,0,4,1596600000,1604725200,2
waist26,0,2,0,11,1595304000,1601179200,2
scafutto20,0,2,0,4,1575262800,1576645200,2
finklefunk,0,2,0,21,1598500800,1607490000,2
FlashFlood_29,0,2,0,249,1600660800,1603512000,2
FearYourself676,0,2,0,8,1583470800,1607835600,2
misskitten1313,0,2,0,15,1605070800,1605070800,2
6nubz9,1,1,32,3,1583384400,1595995200,2
Dreamscape82,0,2,0,3,1580619600,1580965200,2
grosslyoverrated,1,1,3,1,1537588800,1537588800,2
Vap3Th3B35t,0,2,0,2,1605589200,1605589200,2
tristinr1,0,2,0,1,1608699600,1608699600,2
Peachy_Time,0,2,0,4,1597896000,1597982400,2
someguywithanaccount,0,2,0,6,1579237200,1579582800,2
notapotamus,0,2,0,25,1581483600,1591243200,2
3FromHell,0,2,0,6,1603512000,1604116800,2
Picapsi,0,2,0,6,1605502800,1605502800,2
opalesce,1,1,57,1,1593489600,1607058000,2
farzinshams,0,2,0,13,1601092800,1602993600,2
Chingparr,0,2,0,18,1563249600,1563249600,2
marlyarc,0,2,0,6,1600056000,1600142400,2
ope_skyooze_me,0,2,0,4,1592539200,1592539200,2
CodfishCannon,0,2,0,5,1608354000,1609390800,2
F_ckDolphins,0,2,0,5,1575262800,1575262800,2
Zero_Smoke,0,2,0,8,1597896000,1597896000,2
Jabrono,0,2,0,4,1598846400,1602043200,2
tanksuit,0,2,0,71,1575522000,1575522000,2
Doesnt_Draw_Anything,0,2,0,1,1584331200,1584331200,2
Herald_of_Cthulu,0,2,0,5,1603512000,1603598400,2
Erik__Lehnsherr,1,1,15,99,1570593600,1584158400,2
howfastthistime,0,2,0,2,1589947200,1589947200,2
Sen-of-the-Pai,0,2,0,2,1606107600,1606107600,2
ulmusglabra2,0,2,0,2,1611982800,1611982800,2
Atlas_The_Mighty,0,2,0,2,1598846400,1598846400,2
CherryPicker428,0,2,0,2,1576645200,1576645200,2
gekkemarmot69,0,2,0,3,1572235200,1572235200,2
aenild,0,2,0,-3,1572235200,1572235200,2
damop90113,0,2,0,10,1604379600,1604379600,2
neheughk,0,2,0,32,1603512000,1606626000,2
AnExhaustedSocialist,0,2,0,1,1575954000,1575954000,2
Fridayesmeralda,0,2,0,14,1578978000,1578978000,2
susbrother,0,2,0,23,1572667200,1572667200,2
Werd616,0,2,0,15,1581656400,1584504000,2
ViolentAversion,0,2,0,224,1606194000,1606280400,2
BarrySmart,1,1,7,3,1578373200,1602216000,2
aaman2018,0,2,0,2,1573534800,1573621200,2
pl__s_bl_d_n__b_l_t_,1,1,51,6,1607749200,1607749200,2
aug1516,0,2,0,4,1582693200,1585627200,2
kaweyys,0,2,0,10,1608008400,1608008400,2
johnjonjameson,0,2,0,-23,1599105600,1600660800,2
Ramin_HAL9001,0,2,0,22,1595908800,1600228800,2
Requilem,0,2,0,2,1582779600,1606885200,2
WhollyLonely,0,2,0,19,1546664400,1547182800,2
37rhr82h,0,2,0,20,1591675200,1592193600,2
DukkhaDukkhaGoose,0,2,0,19,1431576000,1570248000,2
krostybat,0,2,0,75,1603512000,1606885200,2
HAPPY_GORDON_FREEMAN,0,2,0,36,1606194000,1607576400,2
nidrach,0,2,0,-4,1570334400,1570334400,2
Xtremely_DeLux,0,2,0,4,1605589200,1605589200,2
professor_dobedo,0,2,0,27,1605589200,1605589200,2
okyea19,1,1,122,0,1596945600,1596945600,2
rawrfawks,0,2,0,3,1589860800,1593489600,2
Foutaises-,0,2,0,39,1572148800,1592366400,2
washingmachine_O_,0,2,0,19,1551243600,1551243600,2
skippwhy,0,2,0,6,1556424000,1564286400,2
dankhalo,0,2,0,2,1591243200,1591243200,2
origin_of_descent,0,2,0,27,1595390400,1598068800,2
Zefotru,0,2,0,2,1603857600,1603944000,2
MiddleBig,0,2,0,149,1573102800,1576904400,2
sunny3235,0,2,0,5,1569384000,1569384000,2
slangiindope,0,2,0,3,1567828800,1568001600,2
Brown_Eyes9,0,2,0,4,1576386000,1605070800,2
descending_angel,0,2,0,47,1550725200,1550725200,2
BuddhistNudist987,0,2,0,4,1576126800,1606971600,2
Less_Reading,0,2,0,6,1609390800,1609390800,2
breakpointGodling,0,2,0,3,1605589200,1605589200,2
AmeliaAmok,0,2,0,5,1596859200,1596859200,2
lavendercookiedough,0,2,0,3,1599451200,1599451200,2
bdkejso,0,2,0,68,1603512000,1603598400,2
StatFlow,1,1,311,5,1599969600,1600056000,2
Kitty_pink,0,2,0,2,1589428800,1589428800,2
M3mph,0,2,0,3,1569211200,1598760000,2
Kelliente,0,2,0,3,1592366400,1598587200,2
Lovz2Killz,0,2,0,3,1593662400,1604379600,2
AngeryFinn,0,2,0,3,1600401600,1601524800,2
PhoIsDelish,0,2,0,2,1601092800,1601092800,2
Tosser48282,0,2,0,68,1598846400,1605330000,2
LOLBaltSS,0,2,0,8,1575608400,1575608400,2
powerspank,0,2,0,11,1568865600,1568952000,2
t184256,0,2,0,-1,1602734400,1605330000,2
1_dirty_dankboi,0,2,0,18,1606021200,1606021200,2
Dodger8899,0,2,0,2,1572235200,1572235200,2
tobi117,0,2,0,10,1591502400,1591502400,2
MaddAddam_,0,2,0,10,1575608400,1575608400,2
HelloJoeyJoeJoe,0,2,0,2,1598846400,1600574400,2
definitelynottwelve,0,2,0,61,1568520000,1568520000,2
jay_el_gee,0,2,0,6,1534824000,1534824000,2
Insofaass,0,2,0,2,1576904400,1576904400,2
EYEBR0WSE,0,2,0,13,1567569600,1579928400,2
ObjectiveRun6,0,2,0,3,1609131600,1609131600,2
Koiq,0,2,0,4,1594094400,1594267200,2
16bitSamurai,0,2,0,2,1609045200,1609045200,2
anotherNarom,0,2,0,2,1605157200,1606280400,2
1morgondag1,1,1,3,1,1584504000,1584590400,2
The2lied,0,2,0,9,1608699600,1608699600,2
AllenKCarlson,0,2,0,4,1585454400,1585454400,2
Useless_Throwaway992,0,2,0,25,1570852800,1571198400,2
candy_paint_minivan,0,2,0,14,1596427200,1596686400,2
aGuy_InaChair,0,2,0,12,1592280000,1598500800,2
VikingDanes,1,1,20,1,1606539600,1606539600,2
MelodyM13,0,2,0,5,1594872000,1595217600,2
AKFlyingFish,0,2,0,253,1607749200,1607922000,2
lemonyfreshpine,0,2,0,5,1592625600,1592625600,2
MacCoolness,1,1,0,1,1590033600,1590033600,2
suicidepinata,0,2,0,2,1608440400,1608440400,2
TyParadoXX,0,2,0,9,1605589200,1605589200,2
elephantonella,0,2,0,3,1607576400,1607576400,2
missbelled,0,2,0,53,1581224400,1581224400,2
haircombsnightmare,0,2,0,2,1608440400,1609304400,2
Les_Fleurs-du_Mal,0,2,0,25,1557633600,1558065600,2
JasonGibbs7,0,2,0,27,1606712400,1606712400,2
Warfare_Evolved,0,2,0,-14,1584763200,1584849600,2
goofyandmax,1,1,9,2,1560657600,1573448400,2
mashedfig,1,1,13,2,1605762000,1611810000,2
Bicentennial_Douche,0,2,0,14,1588996800,1588996800,2
AntiBox,0,2,0,5,1603166400,1603166400,2
DeletThisGoyim,0,2,0,28,1556164800,1560398400,2
ObamaTookMyToast,0,2,0,5,1603512000,1603512000,2
usnavy13,0,2,0,16,1604898000,1604898000,2
kezah,0,2,0,7,1572753600,1575090000,2
buttaholic,0,2,0,3,1587355200,1594958400,2
kirakira88,0,2,0,4,1573794000,1573794000,2
burntpicasso,0,2,0,12,1605070800,1608008400,2
AdamsOnlinePersona,0,2,0,2,1605502800,1612069200,2
Bobgodzillaross,0,2,0,1,1604898000,1604898000,2
Chris_in_Lijiang,1,1,6,3,1574312400,1574312400,2
j1mb,2,0,139,0,1607490000,1608354000,2
TwilightReader100,0,2,0,27,1593230400,1598068800,2
aisle16,0,2,0,4,1580446800,1580619600,2
benjammin099,0,2,0,2,1582952400,1582952400,2
XanderBear03,0,2,0,18,1563508800,1563508800,2
Rock_Significant,0,2,0,-17,1602216000,1602216000,2
Mosqueeeeeter,0,2,0,0,1594440000,1594440000,2
Corona_Lonesome,0,2,0,29,1606885200,1607922000,2
TheseusPankration,0,2,0,0,1591243200,1591329600,2
notmeaningful,0,2,0,58,1588737600,1599710400,2
drfrenchfry,0,2,0,65,1575694800,1575694800,2
SalvadorX,0,2,0,2,1590033600,1590033600,2
GermanStreetLight,0,2,0,27,1583298000,1612155600,2
JvoTv,2,0,10,0,1605157200,1606539600,2
OldHuntersNeverDie,0,2,0,6,1600142400,1611810000,2
soillsquatch,1,1,2,1,1555473600,1570420800,2
stripper_kitty,0,2,0,4,1581310800,1581310800,2
Batavijf,0,2,0,5,1591243200,1591329600,2
Rhianu,0,2,0,6,1572843600,1572843600,2
Honestly_Just_Vibin,0,2,0,3,1594872000,1606626000,2
undeniablyllama,0,2,0,9,1603598400,1603598400,2
Invictu520,0,2,0,10,1605762000,1606885200,2
The-Big-Sneeze,0,2,0,43,1603512000,1603512000,2
remeep,0,2,0,13,1564113600,1565150400,2
aviatorlj,0,2,0,-1,1606885200,1608440400,2
Boduar,0,2,0,3,1603684800,1603684800,2
cuntfreckles,0,2,0,3,1603512000,1603598400,2
cheerful_cynic,0,2,0,45,1581570000,1581570000,2
khloweee,0,2,0,37,1602734400,1604984400,2
Ricardo1184,0,2,0,2,1575262800,1575262800,2
Halstead20,0,2,0,18,1599537600,1599537600,2
lexcrl,0,2,0,82,1573448400,1592193600,2
MicroPenis3000,0,2,0,-4,1575176400,1575262800,2
fightmilk9000,0,2,0,20,1555646400,1556078400,2
ssilBetulosbA,0,2,0,3,1542430800,1542517200,2
pumpkinspicebagel,0,2,0,21,1576299600,1581742800,2
BlueBuff1968,0,2,0,38,1576558800,1590724800,2
Dreadknock,0,2,0,9,1554609600,1554782400,2
MCMasterFlare,0,2,0,26,1605934800,1605934800,2
Parkeyoh,0,2,0,2,1605070800,1608267600,2
LupusFemmeWitch,0,2,0,2,1604984400,1605675600,2
AnotherRichard827379,0,2,0,-3,1608440400,1608440400,2
Hypno_Coon,0,2,0,9,1603512000,1603512000,2
Nicker,0,2,0,29,1594440000,1595563200,2
clincallyannoyed,1,1,121,2,1608699600,1608699600,2
100100_alt,1,1,0,1,1602561600,1608440400,2
elfis801,0,2,0,16,1605330000,1605416400,2
shoelessbob1984,0,2,0,2,1605070800,1605070800,2
mygoodnessdyi,0,2,0,6,1581742800,1604898000,2
rafaelblud,0,2,0,14,1604811600,1606280400,2
kennyD97,0,2,0,16,1587614400,1598932800,2
admiralvic,0,2,0,16,1585454400,1585454400,2
Dr__Coconutt,0,2,0,14,1599969600,1599969600,2
Whippersnapper94,0,2,0,-5,1607662800,1608354000,2
djb25,0,2,0,-18,1572843600,1572843600,2
barata_de_gravata,0,2,0,10,1607230800,1607230800,2
1rational_guy,0,2,0,6,1486098000,1486098000,2
genderlich,1,1,19,2,1599883200,1599883200,2
Al_E_Borland,0,2,0,4,1585454400,1585454400,2
PoliticalAnimalNow,0,2,0,2,1569988800,1569988800,2
itsBritanica,0,2,0,12,1560312000,1564027200,2
Nerret,0,2,0,1,1580878800,1595822400,2
jezvinder,0,2,0,4,1591502400,1591502400,2
BlvckPanther22,0,2,0,4,1607403600,1608181200,2
DisplacedSportsGuy,0,2,0,10,1604379600,1604379600,2
lanrider79,0,2,0,11,1568347200,1568779200,2
jnceppes,1,1,12,3,1603339200,1605070800,2
blingblaow2,1,1,3,1,1483938000,1483938000,2
ARatherOddOne,0,2,0,11,1607058000,1607058000,2
smyfepnb,0,2,0,31,1585972800,1585972800,2
actuallyamoth,0,2,0,8,1577422800,1579669200,2
puknut,0,2,0,-1,1599883200,1599883200,2
shrodinger69,0,2,0,-7,1600056000,1600228800,2
Lordofthetemp,0,2,0,3,1603684800,1606798800,2
soulcrushingdirtbike,0,2,0,12,1534737600,1538712000,2
SierraDespair,0,2,0,7,1547874000,1569384000,2
Mr_Mcbunns_ya,0,2,0,72,1612155600,1612328400,2
indiana_johns,0,2,0,15,1582002000,1605502800,2
BlazingCondor,1,1,27,8,1596427200,1596427200,2
snowsoracle,0,2,0,11,1603512000,1603512000,2
AntiauthoritarianSin,0,2,0,23,1573102800,1576904400,2
Gameknight995,0,2,0,28,1591502400,1591502400,2
Fuqasshole,0,2,0,2,1608267600,1608267600,2
meltingeggs,0,2,0,6,1577336400,1577422800,2
kapatikora,0,2,0,7,1557460800,1557460800,2
WoopWoopBanana,0,2,0,20,1588996800,1589083200,2
jon11888,0,2,0,15,1602648000,1602648000,2
riapemorfoney,0,2,0,20,1591243200,1591243200,2
petiteandpale16,0,2,0,11,1595649600,1607144400,2
DDol345,0,2,0,2,1613797200,1613797200,2
JustScrollinAndSht,0,2,0,2,1602820800,1602820800,2
quito9,0,2,0,4,1611982800,1611982800,2
unikittypie,0,2,0,16,1602648000,1604984400,2
Tonytuffnuts,0,2,0,30,1585627200,1586750400,2
OfficialOldSpice,0,2,0,6,1569124800,1607403600,2
JumpyLake,0,2,0,3,1598587200,1598587200,2
kyleb337,0,2,0,111,1567483200,1602388800,2
Daytime_Raccoon,0,2,0,23,1585022400,1585022400,2
GBPgoingOFF,0,2,0,140,1606539600,1606539600,2
shaggy_amreeki,0,2,0,13,1599451200,1603598400,2
eva20k15,0,2,0,2,1607403600,1607490000,2
Escheron,0,2,0,8,1587355200,1587441600,2
alanoncdm,0,2,0,30,1600228800,1601265600,2
soygirlzero,0,2,0,2,1576472400,1597032000,2
Rhetorical-Toilet,0,2,0,23,1604203200,1605157200,2
YT_RandomGamer01,0,2,0,3,1605070800,1605070800,2
FunnyDifficulty6,0,2,0,25,1608094800,1608094800,2
meatduck12,0,2,0,8,1478232000,1478318400,2
Usual-Locksmith4657,0,2,0,13,1602388800,1604725200,2
ReverendDizzle,0,2,0,19,1593316800,1593316800,2
FFKSean,0,2,0,-7,1606885200,1606885200,2
potatodoteyeo,1,1,6,1,1576731600,1583038800,2
ZmSyzjSvOakTclQW,0,2,0,-7,1598846400,1600660800,2
Brochodoce,0,2,0,13,1551070800,1552449600,2
Iwantmypasswordback,0,2,0,7,1608786000,1612155600,2
RedMossStudio,0,2,0,5,1605502800,1605589200,2
svetambara,1,1,25,3,1554696000,1554696000,2
Vercingetrix,0,2,0,5,1586404800,1588737600,2
Chobeat,0,2,0,20,1540958400,1542344400,2
WearyMorlock,0,2,0,108,1549170000,1553227200,2
OssifiedReef,0,2,0,11,1572930000,1573016400,2
Inphlamed,0,2,0,19,1599364800,1599364800,2
AgentCarmichael20,0,2,0,2,1608699600,1608699600,2
cloud_spires,0,2,0,12,1571025600,1573362000,2
lielaylainlaylaidlai,1,1,5,3,1588219200,1588219200,2
wasntexpectingthatho,0,2,0,2,1601352000,1601352000,2
TeslaBugThrowaway,0,2,0,2,1610082000,1610082000,2
dutchmangab,0,2,0,5,1608526800,1608786000,2
diskdusk,0,2,0,3,1582088400,1582088400,2
mitsandgames,0,2,0,4,1582779600,1585108800,2
ghostwilliz,0,2,0,2,1609390800,1609390800,2
Blue_Velvety,0,2,0,28,1600747200,1600833600,2
goodnibd,0,2,0,56,1608699600,1608699600,2
Level_Preparation_94,0,2,0,-10,1595131200,1595131200,2
tuomosipola,0,2,0,26,1589601600,1602993600,2
rjal1234,0,2,0,2,1576558800,1576558800,2
I_SAY_FUCK_A_LOT__,0,2,0,2,1601352000,1601697600,2
PsyPup,0,2,0,47,1606885200,1606885200,2
STCThunder12,0,2,0,7,1560657600,1560916800,2
brightmind9639,0,2,0,10,1571284800,1571371200,2
athiest_bicycles,0,2,0,4,1593057600,1606539600,2
UThMaxx42,0,2,0,-16,1597032000,1602043200,2
SynopticOutlander,0,2,0,6,1591934400,1592107200,2
PM_ME_CUTE_JAP_GIRLS,0,2,0,-8,1599710400,1599710400,2
bootywithapenis,0,2,0,22,1583384400,1599883200,2
Fhhyr3584,1,1,32,1,1582693200,1582693200,2
Awkward_Adeptness,0,2,0,4,1566446400,1598500800,2
strongscience62,0,2,0,28,1606539600,1606539600,2
CommonMilkweed,0,2,0,52,1591243200,1608699600,2
FormerNegrocel,0,2,0,27,1551589200,1560225600,2
lilchonch,1,1,6,2,1599278400,1599278400,2
spicennicee,0,2,0,40,1605416400,1605416400,2
timwtf,0,2,0,7,1606539600,1608094800,2
ekofut,0,2,0,73,1607403600,1607403600,2
Woodie626,0,2,0,-23,1559102400,1559102400,2
2dicksdeep,0,2,0,16,1607749200,1609304400,2
pnlhotelier,0,2,0,4,1589774400,1589774400,2
TheBadGuyFromDieHard,0,2,0,3,1608267600,1611896400,2
DSM-6,0,2,0,2,1600660800,1600660800,2
thrillspree,0,2,0,23,1608267600,1609390800,2
bribtod,0,2,0,39,1580792400,1580792400,2
bustakita,0,2,0,3,1608440400,1608440400,2
thadude422,0,2,0,18,1584590400,1584676800,2
TheThrowawayFox,0,2,0,379,1580533200,1595476800,2
LibrarianBarbarian1,0,2,0,-6,1605416400,1605502800,2
ledique,0,2,0,27,1573362000,1573362000,2
Ancient-Reception634,0,2,0,2,1642136400,1643000400,2
Marijuanavich,0,2,0,40,1609304400,1611896400,2
pumpernick3l,0,2,0,11,1580187600,1600228800,2
CodeWeaverCW,0,2,0,5,1560052800,1560052800,2
ZER042,0,2,0,13,1599710400,1600142400,2
Rjnzhf,0,2,0,43,1594440000,1594440000,2
YourDadsUsername,0,2,0,20,1593748800,1593835200,2
HayoungHiphopYo,0,2,0,3,1606626000,1606626000,2
OneHorseCanyon,0,2,0,2,1599969600,1599969600,2
taybay462,0,2,0,254,1608699600,1608699600,2
lauriceman,0,2,0,4,1604811600,1611896400,2
ghostsandaliens,0,2,0,16,1585886400,1585886400,2
hkun89,0,2,0,5,1559880000,1593403200,2
Greenshoe1234,0,2,0,-30,1603944000,1603944000,2
drpepguy,0,2,0,-5,1599537600,1607662800,2
IsthisanIndia,0,2,0,2,1614834000,1614834000,2
pardon_the_mess,0,2,0,12,1581829200,1603080000,2
83franks,0,2,0,5,1553832000,1553832000,2
tuckerchiz,0,2,0,3,1604552400,1605502800,2
AOA05,0,2,0,6,1576386000,1576386000,2
mediamattersqld,0,2,0,2,1607749200,1607835600,2
IntegrityImperative,0,2,0,26,1595649600,1595736000,2
ksu_person1,0,2,0,1,1556596800,1556596800,2
hellothererere123,0,2,0,10,1599105600,1599105600,2
Melodic_Salamander_9,0,2,0,16,1607230800,1608008400,2
Fatbot_in_Tijuana,0,2,0,9,1558929600,1558929600,2
sirpaulthegreat,0,2,0,2,1606021200,1606021200,2
mrgarborg,0,2,0,51,1586664000,1586664000,2
100catactivs,0,2,0,0,1589860800,1589947200,2
Finch2090,0,2,0,60,1584072000,1584072000,2
VicenteMelo,0,2,0,3,1597464000,1597896000,2
mindlessmeatpuppet,0,2,0,26,1583125200,1597550400,2
Jace_is_Unbanned,0,2,0,-20,1612069200,1612069200,2
is_it_iced_tea,0,2,0,-2,1609390800,1609390800,2
broberds,0,2,0,59,1574744400,1585195200,2
SouthPurpose,0,2,0,-19,1591329600,1591329600,2
FreedomEntertainment,0,2,0,3,1591848000,1597204800,2
alright-butthole,0,2,0,0,1561694400,1561694400,2
xanstronaut,0,2,0,2,1607058000,1607058000,2
CinnamonBunBun,0,2,0,10,1567051200,1567051200,2
JKlay13,1,1,54,2,1599710400,1609477200,2
Aiursfallen,0,2,0,25,1562817600,1570075200,2
Thanat0asted,0,2,0,52,1555387200,1585886400,2
IcyPhysics,0,2,0,22,1595649600,1595649600,2
MutteringV,0,2,0,7,1602907200,1602907200,2
inaridoesntloveme,0,2,0,2,1606453200,1607749200,2
manic_honengame,0,2,0,4,1606885200,1608613200,2
VoidIgnitia,0,2,0,28,1582088400,1597032000,2
BelmontMan,0,2,0,4,1606626000,1607662800,2
jojot13,0,2,0,7,1605416400,1605416400,2
Phalange44,0,2,0,14,1605762000,1606885200,2
throwaway73461819364,0,2,0,2,1605157200,1605157200,2
MagicianRedstone,0,2,0,14,1571544000,1575349200,2
Hades_88,0,2,0,2,1607576400,1607576400,2
ConnorOhpar,0,2,0,177,1594353600,1598846400,2
aondoe,0,2,0,4,1611896400,1612414800,2
DavidLobsterRubbish,0,2,0,5,1606021200,1606366800,2
McDonalds_ITdept,0,2,0,14,1605934800,1608094800,2
NovaKay,0,2,0,16,1591848000,1591848000,2
HerecomesChar,0,2,0,11,1587700800,1609131600,2
trevyn,0,2,0,5,1606712400,1606712400,2
casce,0,2,0,2,1585454400,1585454400,2
EternalDad,0,2,0,3,1573189200,1597291200,2
burntbacon001,0,2,0,-40,1589688000,1589688000,2
PompeiiDomum,0,2,0,-29,1587355200,1587355200,2
masondean73,0,2,0,18,1561694400,1563940800,2
nahnahna,1,1,3,1,1587614400,1587614400,2
Rarefindofthemind,0,2,0,6,1608354000,1608699600,2
1oveslug,0,2,0,10,1599796800,1606885200,2
xorfivesix,0,2,0,2,1599019200,1599019200,2
collinmcduffie,0,2,0,6,1606798800,1606798800,2
pcashmoneybrothers,0,2,0,71,1585454400,1585540800,2
BagOfShenanigans,0,2,0,47,1564632000,1566100800,2
Anarchyz11,0,2,0,25,1603684800,1604203200,2
ob12_99,0,2,0,4,1591243200,1611982800,2
starrgirI,1,1,71,10,1570680000,1578459600,2
Sloblowpiccaso,0,2,0,12,1607403600,1607403600,2
BrandinoKennedy,0,2,0,22,1586664000,1586750400,2
StevenMcphearson,0,2,0,4,1600488000,1600488000,2
firstorbit,0,2,0,1,1576386000,1603425600,2
ShitingMozart,0,2,0,3,1591329600,1591329600,2
McQueeeeef,0,2,0,27,1581051600,1581051600,2
BigStinkyNipples,0,2,0,10,1585281600,1585454400,2
kotoktet,1,1,5,1,1550206800,1550206800,2
auscontract,0,2,0,5,1566792000,1576645200,2
Aquadude23,0,2,0,68,1560139200,1572753600,2
IrrigationDitch,0,2,0,15,1605589200,1605589200,2
razorchick12,0,2,0,13,1558843200,1567915200,2
Mbauhohspa,0,2,0,21,1593835200,1594353600,2
beat-it-upright,0,2,0,4,1595822400,1595908800,2
Tensilespark,0,2,0,514,1589428800,1606280400,2
Slimdoggmill,0,2,0,2,1603512000,1603512000,2
skyjordan17,0,2,0,9,1557720000,1575003600,2
Ch1nCh1nTheG0D,0,2,0,9,1608526800,1608526800,2
Redalict,0,2,0,358,1589688000,1600574400,2
tuftylemur,1,1,194,9,1601870400,1601870400,2
DavittNSW2,0,2,0,63,1575781200,1578891600,2
th9sk9,1,1,2,1,1599451200,1599451200,2
checkoutmysides,0,2,0,8,1606107600,1606280400,2
rapefugee-,1,1,15,6,1571198400,1571198400,2
chenglish,0,2,0,18,1547096400,1547096400,2
Sknight15,0,2,0,11,1576904400,1576904400,2
MissLogios,0,2,0,-3,1591156800,1591156800,2
thebaldsisem,0,2,0,9,1569124800,1569816000,2
inscopia,0,2,0,-21,1594353600,1594353600,2
wildo83,0,2,0,17,1605848400,1605934800,2
Leightcomer,0,2,0,28,1559102400,1607490000,2
jab8484,1,1,13,1,1555041600,1555128000,2
Successful-Reserve-1,0,2,0,28,1608786000,1608872400,2
Drauul,0,2,0,8,1595390400,1595390400,2
CubesTheGamer,0,2,0,6,1578978000,1579064400,2
Chaos75321,0,2,0,7,1589947200,1589947200,2
ilovepaleoblood,0,2,0,34,1601352000,1603080000,2
Wegmarken,0,2,0,12,1592971200,1593835200,2
knghx,0,2,0,-7,1587355200,1587441600,2
soursummerchild,1,1,39,9,1560312000,1595908800,2
CopsaLau,0,2,0,4,1611810000,1612155600,2
FlaughAndOrder,0,2,0,20,1606798800,1607835600,2
Bigweeniehaver,0,2,0,-8,1573102800,1573102800,2
Agonizel,0,2,0,-13,1595736000,1595822400,2
SafeSpaceMyCunt,0,2,0,69,1550293200,1550638800,2
HemishFromPerth,2,0,25,0,1593576000,1594008000,2
DayfacePhantasm,0,2,0,25,1569816000,1569816000,2
Huemaister,1,1,6740,17,1581310800,1582693200,2
OutrageousTourist394,0,2,0,10,1603339200,1603339200,2
magadget,1,1,8,102,1591675200,1594267200,2
nyuusan,0,2,0,8,1574571600,1575003600,2
Ahvad,1,1,17,5,1587873600,1587873600,2
gdogg121,0,2,0,2,1551848400,1557892800,2
read_the_bread_book,0,2,0,15,1557720000,1557720000,2
Ellisque83,0,2,0,3,1599278400,1599278400,2
Wyntonian,0,2,0,9,1539921600,1546578000,2
Wasted_Plot,0,2,0,18,1597118400,1597118400,2
sneaky113,0,2,0,10,1606712400,1609131600,2
LizardKing187,0,2,0,19,1579496400,1580706000,2
coins22222,1,1,385,1,1579237200,1579323600,2
turnstech,0,2,0,8,1578373200,1578373200,2
AzurLaneandComplain,0,2,0,29,1599883200,1601438400,2
TaxidermistJoe,0,2,0,4,1608699600,1608786000,2
Olddirtychurro,0,2,0,18,1611810000,1611810000,2
mydadpickshisnose,0,2,0,9,1599710400,1599710400,2
BlindPenguins,0,2,0,8,1589860800,1589860800,2
ugly_dog_,0,2,0,10,1583812800,1584676800,2
Swordbears,0,2,0,3,1605502800,1605762000,2
snbrgr,0,2,0,2,1590206400,1590292800,2
divbyzero64,1,1,125,4,1595822400,1602388800,2
leahbear13,0,2,0,3,1577941200,1577941200,2
wageslave543543,1,1,11,0,1572494400,1572494400,2
Llanos31,0,2,0,-1,1601870400,1608613200,2
Motor_Arm_240,0,2,0,12,1602820800,1602907200,2
dath_bane,0,2,0,9,1605934800,1607576400,2
Slowmexicano,0,2,0,3,1601524800,1603598400,2
Dante_FromSpace,1,1,19,1,1598328000,1608094800,2
Aiden_Guy,0,2,0,22,1605934800,1605934800,2
cranberry-tart,0,2,0,8,1611810000,1611810000,2
Tesla_UI,0,2,0,3,1594180800,1594180800,2
kylebispo,0,2,0,2,1605675600,1605675600,2
Toni_361,0,2,0,32,1571457600,1575003600,2
LovingComrade,0,2,0,3,1548651600,1548651600,2
OzzyBoiiii,0,2,0,95,1606453200,1607576400,2
CastrofromT,0,2,0,-2,1568692800,1568865600,2
Spotinella,0,2,0,14,1568520000,1576040400,2
sarcassity,0,2,0,7,1601784000,1608526800,2
TootsNYC,0,2,0,39,1605070800,1605070800,2
SheSoldTheWorld,0,2,0,57,1591329600,1591329600,2
thelonius_friar,1,1,23,2,1597291200,1600660800,2
zqrt,0,2,0,7,1583125200,1587787200,2
Embryonic_Journey_,0,2,0,7,1581051600,1596168000,2
Mateulka,0,2,0,4,1552449600,1552449600,2
dontCallMeAmberlynn,0,2,0,21,1600315200,1600315200,2
DeepFreakingValue,0,2,0,-1,1612069200,1612069200,2
1hotrodney,0,2,0,2,1598760000,1603598400,2
_D_M_T_-,0,2,0,3,1595476800,1595476800,2
MitchieFred,0,2,0,11,1572148800,1573621200,2
DefNotAHuman,0,2,0,14,1590120000,1590120000,2
Juststopdontdoit,0,2,0,26,1579755600,1585368000,2
MundungusAmongus,0,2,0,5,1608958800,1608958800,2
toosweettaryn,0,2,0,27,1573448400,1574398800,2
chopsthedruid117,0,2,0,4,1592193600,1598328000,2
ToothpasteBrand,1,1,12,309,1586232000,1589515200,2
shanshark10,0,2,0,3,1579323600,1605330000,2
duke_awapuhi,0,2,0,6,1601092800,1606194000,2
Stellacoffee,0,2,0,47,1594353600,1605589200,2
LeftRadio0,0,2,0,3,1591588800,1591588800,2
69CHAINGANG,0,2,0,0,1599624000,1599796800,2
oRyan_the_Hunter,0,2,0,8,1598846400,1600488000,2
Proclaimer_of_heroes,0,2,0,442,1603425600,1604379600,2
Fadestest,0,2,0,3,1589342400,1604466000,2
diox8tony,0,2,0,1,1589947200,1589947200,2
PathToTheDawn,0,2,0,40,1602734400,1602734400,2
olibolib,0,2,0,19,1590552000,1594612800,2
VinceIsWellCool,0,2,0,11,1575090000,1575176400,2
LiwyikFinx,0,2,0,26,1549256400,1549602000,2
mermaduke,0,2,0,26,1604466000,1604984400,2
Everyday_Alien,0,2,0,17,1602388800,1602388800,2
masterchris,0,2,0,10,1585454400,1606539600,2
tryng2figurethsalout,0,2,0,9,1576299600,1576472400,2
TinyBunny88,0,2,0,13,1607749200,1607749200,2
rvngstrm,0,2,0,-1,1606626000,1606798800,2
corvidang,0,2,0,61,1573880400,1576818000,2
MixthePixel,0,2,0,4,1580533200,1580533200,2
tr1pppp,1,1,31,3,1593662400,1593748800,2
weedprincesssss,0,2,0,5,1604116800,1604552400,2
cymyn,0,2,0,3,1600574400,1608267600,2
JustLookingToHelp,0,2,0,6,1609131600,1609304400,2
slovenly_dilettante,0,2,0,39,1535256000,1537070400,2
starwishes20,0,2,0,5,1601956800,1608786000,2
Sub-Sero,0,2,0,5,1578286800,1578286800,2
benegnal,1,1,38,7,1601006400,1601092800,2
leninsrighttoe,0,2,0,8,1587441600,1589601600,2
KlassyKlown,0,2,0,10,1606539600,1606626000,2
yerbluez,0,2,0,-25,1593748800,1593748800,2
-Tomba,0,2,0,5,1600833600,1600833600,2
RNA4lyfe,0,2,0,11,1611810000,1611810000,2
swarm_mazer,0,2,0,9,1609045200,1609131600,2
chestercopperpot83,0,2,0,59,1558497600,1562385600,2
cloud_throw,0,2,0,17,1579928400,1579928400,2
TLAlwaysRead,0,2,0,46,1596772800,1597809600,2
apollyoneum1,0,2,0,52,1588996800,1590465600,2
Trotsky5,0,2,0,19,1566878400,1577768400,2
Tetra34,0,2,0,34,1599192000,1599192000,2
Rickthecloser,0,2,0,2,1598846400,1598846400,2
CzarHenri,1,1,3,-18,1573016400,1573102800,2
Urban-Cheese,0,2,0,9,1583211600,1595217600,2
reverendregret,0,2,0,-3,1601870400,1601956800,2
fomoriii,0,2,0,10,1582952400,1583125200,2
throwawayfuckohiolol,1,1,10,2,1589428800,1589428800,2
silverdrake3,0,2,0,10,1599883200,1599883200,2
just_a_imc_grunt,0,2,0,-14,1608267600,1608267600,2
tommyhawk13,0,2,0,-71,1609390800,1609390800,2
ipsum629,0,2,0,7,1569816000,1589428800,2
Explosion_Jones,0,2,0,23,1604030400,1608440400,2
craftworkbench,0,2,0,7,1611896400,1611896400,2
Hollafoo,0,2,0,4,1545368400,1546664400,2
squickley,0,2,0,40,1611810000,1611810000,2
Secretlysidhe,0,2,0,12,1554264000,1557892800,2
siyahlater,0,2,0,9,1604116800,1607317200,2
Wahly_,0,2,0,5,1600833600,1603684800,2
Remote_Cantaloupe,0,2,0,-31,1606539600,1606539600,2
Mrsla1,0,2,0,3,1612155600,1612155600,2
Goodfornothing1989,1,1,27,4,1582779600,1582779600,2
kainmalice,0,2,0,10,1581742800,1639630800,2
thrown_away_23_23,0,2,0,23,1608267600,1608267600,2
OneGreatBlumpkin,0,2,0,21,1566792000,1570939200,2
versatiledisaster,0,2,0,37,1573016400,1580014800,2
Hambone_Malone,0,2,0,4,1578286800,1578805200,2
badleather500,1,1,41,3,1593144000,1593144000,2
Yoshli,0,2,0,-34,1574917200,1574917200,2
EntertainmentOld1025,0,2,0,11,1605502800,1607490000,2
Habs1989,0,2,0,2,1605502800,1606021200,2
lvgray,0,2,0,13,1604379600,1605243600,2
Dan3099,0,2,0,3,1603080000,1604116800,2
coloncaretvertbar,0,2,0,3,1607317200,1608354000,2
bitchin-kitchin,0,2,0,1,1583125200,1583125200,2
Yeastov,0,2,0,162,1584331200,1584331200,2
AnnArchist,0,2,0,4,1575867600,1575954000,2
Comrade_Oghma,0,2,0,15,1589342400,1589342400,2
perroblanco,0,2,0,25,1580360400,1601265600,2
Demonkunga,0,2,0,5,1600920000,1600920000,2
CHlNA888,0,2,0,33,1600228800,1600315200,2
onlygrans,0,2,0,8,1612069200,1612069200,2
4-ll4h,0,2,0,14,1557892800,1557892800,2
thedudeman80085,0,2,0,-1,1585454400,1585454400,2
youngsterjesse,0,2,0,3,1608526800,1608526800,2
NewttheCat,0,2,0,23,1596427200,1607317200,2
APinkNightmare,0,2,0,53,1607403600,1607662800,2
LanguiDude,0,2,0,8,1592539200,1594612800,2
CellularBeing,0,2,0,29,1577422800,1577422800,2
zach714,0,2,0,19,1575435600,1605934800,2
72Sink,0,2,0,103,1594008000,1602648000,2
Lulu22McGoo,0,2,0,42,1604898000,1605675600,2
godofimagination,1,1,1347,3,1596686400,1602129600,2
MeinCrouton,0,2,0,7,1611982800,1611982800,2
Easy_Fox,0,2,0,13,1569902400,1569902400,2
Vranium,0,2,0,123,1582779600,1586836800,2
jjgg1123,0,2,0,24,1557806400,1558238400,2
FoxyJason,1,1,23,2,1604030400,1604030400,2
4Score77,0,2,0,0,1591243200,1591329600,2
ArieHimself,0,2,0,7,1582779600,1595131200,2
raisinbarf,0,2,0,17,1595908800,1599969600,2
HoverJet,0,2,0,166,1555992000,1555992000,2
quaint_taint,0,2,0,7,1597377600,1597809600,2
rebelmonster0009,0,2,0,38,1601611200,1601611200,2
thiourea,0,2,0,7,1597896000,1597896000,2
Wifewindup,0,2,0,13,1570334400,1570420800,2
SuspiciousMeat6696,0,2,0,6,1612069200,1613106000,2
lurkintowarddisaster,0,2,0,4,1584158400,1584158400,2
MassiveRepeat6,0,2,0,40,1599796800,1599883200,2
pacojosecaramba,0,2,0,20,1566187200,1566878400,2
JTskulk,0,2,0,3,1586404800,1591761600,2
cbh28,0,2,0,7,1600747200,1600747200,2
kingchilifrito,0,2,0,2,1603598400,1604379600,2
Stillill1187,0,2,0,12,1602216000,1602216000,2
bluezedd,0,2,0,6,1589860800,1589947200,2
MikeAC129,0,2,0,4,1566792000,1603771200,2
oriko76,2,0,6,0,1604116800,1604116800,2
SQ38,0,2,0,22,1596600000,1596600000,2
burghinator,0,2,0,-1,1588824000,1588824000,2
astonfan44,0,2,0,21,1584504000,1596600000,2
iwasanacidbaby,0,2,0,14,1608267600,1608267600,2
Ianbambooman,1,1,24,1,1606366800,1606366800,2
SuperMIK2020,0,2,0,4,1608526800,1608526800,2
Van-a-Gone,0,2,0,60,1556510400,1561176000,2
MyNewTransAccount,0,2,0,60,1604811600,1607317200,2
Practically_,0,2,0,7,1571716800,1571716800,2
marc_a09,1,1,17,4,1566792000,1600401600,2
Novarix,0,2,0,28,1606626000,1608699600,2
naturennymph,1,1,9,14,1590724800,1602388800,2
Lekfnfbfjrodj,0,2,0,52,1572148800,1572148800,2
_NotMuchToGawkAt_,0,2,0,7,1600401600,1600488000,2
InsertNovelAnswer,0,2,0,2,1643173200,1643173200,2
PostMelounXD,0,2,0,23,1585800000,1591416000,2
mmikke,0,2,0,33,1582779600,1590033600,2
lionhat,0,2,0,13,1594267200,1602561600,2
nobushini,0,2,0,14,1606021200,1606021200,2
Sir_Applecheese,0,2,0,-9,1602820800,1602820800,2
HailHamilton,0,2,0,12,1596772800,1597032000,2
tru_anon,0,2,0,26,1579755600,1589428800,2
c0mm0nSenseplz,0,2,0,11,1580014800,1605157200,2
z1142,0,2,0,8,1598241600,1600920000,2
idelta777,0,2,0,10,1582779600,1587873600,2
pitirre1970,0,2,0,6,1604203200,1604811600,2
ashimal0305,0,2,0,5,1600833600,1600833600,2
whhdhdiaibe,0,2,0,4,1601352000,1601352000,2
Rancillium,0,2,0,10,1568174400,1570593600,2
Letsbuildacar,0,2,0,8,1599710400,1599883200,2
fluffy_hen,0,2,0,2,1597550400,1598068800,2
NotoriousJazz,0,2,0,19,1606712400,1606712400,2
armed_turtle5,0,2,0,-1,1608699600,1608786000,2
xXdeathstar101Xx,0,2,0,6,1575867600,1577422800,2
dwarfhuman,0,2,0,9,1593144000,1593576000,2
batsofburden,0,2,0,4,1572062400,1587787200,2
Wrong-History,0,2,0,3,1600660800,1600660800,2
localpizzaaa,0,2,0,5,1607922000,1607922000,2
pizzanini_,0,2,0,4,1561608000,1561780800,2
Coollux,0,2,0,-11,1557720000,1557720000,2
Throwingaway_my_life,0,2,0,12,1608613200,1609390800,2
Deloin_Showerhandle,1,1,2,2,1575003600,1582779600,2
That_Girl_Cray,0,2,0,2,1607058000,1607058000,2
Empty_Vessel96,0,2,0,4,1601006400,1605589200,2
GetSpekz58,0,2,0,12,1579582800,1583470800,2
bejdbeiwnehdkfnrirjr,1,1,68,4,1552622400,1552708800,2
DAEConfused373,1,1,6,2,1611810000,1611896400,2
vieshs,0,2,0,21,1594526400,1595131200,2
danocathouse,0,2,0,4,1579582800,1579582800,2
chicknano,0,2,0,2,1612501200,1612501200,2
hypnogym,0,2,0,6,1573016400,1573102800,2
ProgrammerLast,0,2,0,10,1607403600,1607403600,2
AstonVanilla,0,2,0,5,1589601600,1589601600,2
Plenty-Ad7819,1,1,937,1,1606453200,1606626000,2
Justanotherjustin,0,2,0,32,1604725200,1604725200,2
Sully9989,0,2,0,4,1571716800,1571716800,2
LOLMaster0621,0,2,0,17,1602648000,1602648000,2
pegasus223,0,2,0,24,1598328000,1598328000,2
Tazae1,0,2,0,3,1598760000,1598760000,2
Ted_Kool,0,2,0,18,1598500800,1598673600,2
MrCheezyPotato,0,2,0,4,1582347600,1582347600,2
egalroc,0,2,0,2,1589601600,1606626000,2
tastebud_spencer,1,1,18,1,1565323200,1565323200,2
EdwardDillingerJr,0,2,0,9,1558670400,1608181200,2
Coldchimney,0,2,0,11,1576645200,1576645200,2
HangOnVoltaire,0,2,0,24,1579496400,1579496400,2
EyeGifUp,0,2,0,3,1602129600,1602129600,2
the_walrus_v2,0,2,0,5,1608094800,1608094800,2
living777,0,2,0,50,1578373200,1582002000,2
Csitbe,0,2,0,12,1575003600,1576386000,2
aswath87,2,0,9,0,1602129600,1602388800,2
EddieCheddar88,0,2,0,69,1585108800,1589428800,2
010qq01010101010,1,1,5,10,1576731600,1576731600,2
eldanielho,0,2,0,45,1569816000,1572321600,2
LivingInThePast69,0,2,0,18,1579669200,1609045200,2
Arachnatron,0,2,0,12,1607749200,1607835600,2
curbyourcynicism,1,1,37,4,1596081600,1596168000,2
FingerRoot,0,2,0,-38,1596254400,1596340800,2
witkraft,0,2,0,15,1593662400,1602216000,2
Evluu,0,2,0,37,1583298000,1608958800,2
yourmanjames,0,2,0,5,1604030400,1604030400,2
Diknak,0,2,0,-8,1584676800,1584763200,2
ILikeSpaceandMemes,0,2,0,4,1568001600,1568001600,2
Jida-polysavoir99,1,1,51,3,1595995200,1595995200,2
papazian212,1,1,13,1,1575522000,1580446800,2
Sigg3net,0,2,0,21,1594267200,1607835600,2
Groundskeepr,0,2,0,7,1570161600,1570161600,2
Vera_Veritas,0,2,0,40,1564372800,1565668800,2
Chunke33,0,2,0,3,1603857600,1603857600,2
GunplaGud,0,2,0,3,1592280000,1592366400,2
chunkboslicemen,0,2,0,12,1602734400,1603598400,2
DrugWolf,0,2,0,13,1588478400,1588737600,2
Ms_Fixer,0,2,0,4,1559966400,1568001600,2
unclewulf,0,2,0,3,1583038800,1595390400,2
Ultima_RatioRegum,0,2,0,8,1598155200,1600228800,2
LyfeO,0,2,0,8,1606798800,1606798800,2
CheeseForPeas,0,2,0,6,1612069200,1612155600,2
IslayWhisky,0,2,0,11,1576990800,1600660800,2
Free-Emergency-2879,0,2,0,7,1596254400,1596254400,2
r3ynoldswrap,0,2,0,6,1602475200,1602648000,2
nicholasjgarcia91,0,2,0,3,1578027600,1578459600,2
maybejuststfu,0,2,0,9,1608699600,1608699600,2
trippyslothofearth,0,2,0,3,1603771200,1603857600,2
yournansabricky,0,2,0,10,1607662800,1607662800,2
SadboiMaz,0,2,0,5,1607230800,1607230800,2
tallnsalty,0,2,0,6,1604379600,1604466000,2
The_OG_Master_Chef,0,2,0,-21,1591934400,1591934400,2
FunkyOldMayo,0,2,0,5,1601179200,1601352000,2
rumsoakedham,0,2,0,93,1605762000,1606280400,2
ObjetErotique,0,2,0,13,1574571600,1578805200,2
Wild_Orchids,0,2,0,22,1580792400,1580792400,2
SusWall-Smm2,0,2,0,304,1574571600,1585454400,2
jyogurt,0,2,0,2,1576645200,1576645200,2
Phantomx100,0,2,0,-75,1592366400,1592366400,2
courtoftheair,0,2,0,27,1608958800,1608958800,2
berfder,0,2,0,7,1603425600,1603425600,2
JuOlNa,1,1,0,1,1595822400,1606626000,2
ImAlwaysRightHanded,0,2,0,19,1589601600,1597291200,2
HoldenTite,0,2,0,3,1608786000,1608786000,2
knobbie-gobbler,2,0,340,0,1599278400,1600488000,2
Nicknobreak,1,1,16,6,1595476800,1595563200,2
trainfart,0,2,0,6,1540008000,1540008000,2
gh33993500,0,2,0,3,1607835600,1607835600,2
snowdood,0,2,0,5,1608786000,1608786000,2
mc1313,0,2,0,6,1557892800,1562212800,2
emilylinhla,0,2,0,9,1604379600,1604379600,2
Chronza,0,2,0,6,1596081600,1603771200,2
upurcanal,0,2,0,3,1601179200,1601611200,2
HerpthouaDerp,0,2,0,2,1582779600,1582779600,2
pooorvegan,0,2,0,4,1593576000,1600056000,2
annonimusone,0,2,0,32,1547960400,1548651600,2
zenthrowaway17,0,2,0,2,1579064400,1579064400,2
face_eater_5000,0,2,0,23,1599624000,1604725200,2
Antiworkthrowaways,1,1,8,9,1601265600,1604984400,2
Dvro,0,2,0,136,1579410000,1602561600,2
hamiestofcheeses,0,2,0,9,1582606800,1582779600,2
Leavechewiealone,0,2,0,-9,1602388800,1606626000,2
mfathrowawaya,0,2,0,20,1584763200,1606021200,2
deadpoolio413,1,1,12,4,1576558800,1576558800,2
skullchurch,0,2,0,3,1606539600,1607749200,2
teenytinycheerbear,0,2,0,6,1571198400,1573794000,2
GhostWoodDweller,0,2,0,2,1602388800,1602388800,2
squirrelynoodle,0,2,0,19,1586059200,1586059200,2
Raure,0,2,0,9,1574053200,1578286800,2
arcOthemoraluniverse,0,2,0,4,1586404800,1594440000,2
mightywomble,0,2,0,6,1567310400,1567396800,2
topaztock,0,2,0,40,1578286800,1578286800,2
voteYESonpropxw2,0,2,0,24,1598414400,1598414400,2
bigmangina,0,2,0,2,1574226000,1578286800,2
great-granny-jessie,0,2,0,10,1557979200,1602820800,2
yosoyjackiejorpjomp,0,2,0,3,1560916800,1561003200,2
DreadPiratesRobert,0,2,0,2,1573534800,1573534800,2
redd1t4l1fe,0,2,0,17,1588305600,1612069200,2
NeighborStrategy,0,2,0,154,1586836800,1587355200,2
myles4454,0,2,0,36,1606971600,1607144400,2
CursedChosenOne,0,2,0,4,1568088000,1568174400,2
TylerD958,0,2,0,23,1575349200,1600747200,2
EinsamerEberhard,1,1,10,4,1575867600,1577250000,2
Bear_HempKnight,0,2,0,12,1609304400,1609304400,2
sawworm,0,2,0,4,1601092800,1601092800,2
Lust_for_Agony,0,2,0,3,1612155600,1612155600,2
Madrov,0,2,0,0,1606626000,1606626000,2
shyxander,0,2,0,16,1595304000,1596254400,2
Man_of_Prestige,0,2,0,5,1558756800,1559707200,2
flamespond,0,2,0,6,1579064400,1598414400,2
saintex422,0,2,0,16,1558238400,1558238400,2
atropax,0,2,0,2,1599969600,1601524800,2
thenoodling,0,2,0,10,1593057600,1593576000,2
aknoll93,0,2,0,-5,1605675600,1605675600,2
newredditaccount-1,2,0,16,0,1566446400,1566619200,2
littleredpanda,0,2,0,9,1593144000,1596427200,2
Kalarys,0,2,0,29,1589428800,1589428800,2
allisonwonderland00,0,2,0,3,1606626000,1606798800,2
Holyclownman,0,2,0,4,1612328400,1612328400,2
Arrowedharry,0,2,0,8,1575694800,1575781200,2
DatWeebComingInHot,0,2,0,19,1599883200,1604030400,2
Fullerton325,1,1,257,2,1570248000,1570248000,2
Ghostnoteltd,0,2,0,3,1566878400,1566878400,2
JuanitoBanditio,0,2,0,-3,1584244800,1584244800,2
Dohi014,0,2,0,16,1605675600,1607576400,2
ostatham,0,2,0,-1,1573534800,1573534800,2
c01dz3ra,0,2,0,2,1585368000,1585368000,2
aVeryTinySmallSnake,0,2,0,44,1585713600,1586404800,2
nayoz_,0,2,0,4,1582866000,1582866000,2
Whatdduck,0,2,0,2,1603771200,1604552400,2
guimigli,0,2,0,7,1606280400,1606280400,2
junieboo62698,0,2,0,24,1582520400,1582520400,2
j1mmykillz,1,1,2,6,1600747200,1605589200,2
bluelevelmeatmarket,0,2,0,24,1603512000,1608526800,2
--drop_bobby_tables,0,2,0,8,1595131200,1598155200,2
unoanie,0,2,0,4,1600833600,1600833600,2
Skuske,1,1,16,1,1580878800,1581051600,2
g-enevieve,0,2,0,7,1592107200,1592107200,2
CommonMisspellingBot,0,2,0,1,1533614400,1533614400,2
StoicPixie,0,2,0,2,1550638800,1570420800,2
Habitsofmind1995,0,2,0,2,1594699200,1594699200,2
apaloosafire,0,2,0,7,1595995200,1595995200,2
W1SC0,0,2,0,69,1583125200,1583125200,2
AKMan6,0,2,0,-1,1605157200,1605157200,2
PlaysWthSquirrels,0,2,0,42,1561694400,1564027200,2
okilokii,0,2,0,3,1599019200,1599019200,2
_rclair,1,1,91,6,1595131200,1595304000,2
The_Rolling_Stone,0,2,0,37,1573966800,1586664000,2
allhailcflife,0,2,0,4,1575435600,1580446800,2
mewtent,0,2,0,5,1599192000,1599192000,2
Beemo-Noir,0,2,0,8,1590897600,1608786000,2
1saidy,0,2,0,-7,1540612800,1546664400,2
intentional_typoz,0,2,0,2,1558584000,1595217600,2
vkbuffet,0,2,0,2,1603339200,1605502800,2
Sgt_Tibbles,0,2,0,9,1592193600,1599278400,2
Fresher_Than_Prince,0,2,0,2,1607490000,1607662800,2
monapan,0,2,0,920,1587355200,1605070800,2
Onlymgtow88,0,2,0,32,1547096400,1554955200,2
chmegr,1,1,1241,14,1593835200,1593835200,2
samgyeopsaltorta,0,2,0,10,1578286800,1580706000,2
AnthonysBigWeiner,0,2,0,3,1568952000,1589688000,2
AwakenedToNightmare,0,2,0,6,1548565200,1554955200,2
-ItIsHappeningAgain-,0,2,0,0,1605762000,1605762000,2
aaand_another_one,0,2,0,-1,1591243200,1591243200,2
vicoertike,0,2,0,13,1606885200,1607058000,2
BasketFullofCrackers,0,2,0,7,1575262800,1577941200,2
theimpossiblequiz,0,2,0,438,1611810000,1611810000,2
DunnyGuy,1,1,0,3,1598500800,1600315200,2
justwannaplayck2,0,2,0,5,1598068800,1598068800,2
Arthur1465,0,2,0,2,1572321600,1572321600,2
Moving2Tampain2weeks,0,2,0,2,1593748800,1593748800,2
Saltonian,0,2,0,4,1589860800,1590033600,2
little-bitch-baby,0,2,0,31,1601611200,1603857600,2
bogdanPopov,0,2,0,2,1558497600,1558497600,2
benjitits,0,2,0,19,1585022400,1585022400,2
mynewromantica,0,2,0,10,1593057600,1593144000,2
squash_bosh,0,2,0,4,1575349200,1581742800,2
MientkaBulka248,0,2,0,2,1600920000,1600920000,2
Just_Some_Entity,1,1,5,2,1602302400,1605416400,2
lovecraftedidiot,0,2,0,5,1612069200,1612155600,2
Pingwinho,0,2,0,4,1605589200,1605589200,2
Ravaja,0,2,0,3,1578373200,1578373200,2
tea_amrita,0,2,0,20,1560571200,1576040400,2
148144,0,2,0,3,1600228800,1604030400,2
theyamahawk,0,2,0,2,1576558800,1579410000,2
forcedpork,0,2,0,-48,1600315200,1600315200,2
FroggerWithMyLife,0,2,0,12,1580101200,1580446800,2
francorocco,0,2,0,0,1607662800,1608267600,2
Armoreska,0,2,0,2,1620792000,1620792000,2
TheJediSenate,0,2,0,10,1605502800,1607230800,2
BadAppleInc,0,2,0,79,1606539600,1606539600,2
elsinovae,0,2,0,5,1587528000,1598673600,2
ApexTheCactus,0,2,0,16,1586836800,1600142400,2
cinemachick,0,2,0,4,1603598400,1603598400,2
acornsofsherwood,0,2,0,2,1602216000,1602216000,2
Desert_faux,0,2,0,13,1572321600,1576213200,2
WowserBowser28,0,2,0,58,1572667200,1572667200,2
40598934083490582,0,2,0,1,1579928400,1580014800,2
egg-regore,0,2,0,2,1593403200,1604898000,2
ReeHee69420,0,2,0,4,1579928400,1579928400,2
Matt_M_3,0,2,0,3,1607835600,1608872400,2
PickScylla4ME,0,2,0,23,1611637200,1611637200,2
roy_fatty,0,2,0,11,1582779600,1582779600,2
UnwiseSudai,0,2,0,10,1579669200,1579669200,2
HaViNgT,0,2,0,2,1605589200,1607662800,2
Advanced-Friend-4694,0,2,0,-11,1603080000,1608699600,2
animef33tart,0,2,0,18,1600833600,1601179200,2
Diatom-,0,2,0,12,1574571600,1574571600,2
xxHeroMainxx,0,2,0,2,1571112000,1573102800,2
cruisingwithruben,0,2,0,7,1551416400,1552021200,2
pulplesspulp,0,2,0,46,1572148800,1572148800,2
isthisstackexchange,0,2,0,2,1612069200,1612069200,2
vulture-one,0,2,0,19,1608181200,1608181200,2
philiproberts1234,0,2,0,-36,1587873600,1587873600,2
myshameismyfame,0,2,0,9,1593662400,1605070800,2
genr8,0,2,0,4,1590465600,1590465600,2
iSoulTrap,1,1,89,1,1584158400,1585108800,2
nappingintheclub,0,2,0,25,1591588800,1593230400,2
brokester,0,2,0,4,1600488000,1602043200,2
BitterFaithlessness,0,2,0,20,1599019200,1607749200,2
Blessedisthedog,0,2,0,4,1578978000,1578978000,2
AlerynFarrosala,0,2,0,93,1576126800,1577336400,2
Rpilla001,0,2,0,0,1606626000,1606626000,2
Boundlessintime,0,2,0,32,1601179200,1607922000,2
deborah2001,0,2,0,2,1590465600,1590465600,2
EatThinWheatThins,0,2,0,13,1587960000,1588046400,2
KlicerFN,0,2,0,4,1577595600,1595476800,2
bitchbot2020,0,2,0,5,1589515200,1590033600,2
s-frog,0,2,0,27,1580101200,1584936000,2
cy161692,0,2,0,47,1576040400,1576040400,2
mr_mgrraw,0,2,0,27,1585800000,1585886400,2
Clockwork_Platypus,0,2,0,4,1587009600,1587009600,2
just-some-dude07,0,2,0,15,1592712000,1592971200,2
bulge_eye_fish,0,2,0,47,1594612800,1596081600,2
Wazards,1,1,2,1,1556078400,1556078400,2
Cromancer86,0,2,0,11,1600401600,1608526800,2
mynameisnotshamus,0,2,0,-96,1606539600,1606539600,2
LikeTheDish,0,2,0,10,1596081600,1609045200,2
diogenesjunior2,2,0,16453,0,1598932800,1599019200,2
TossMeAwayToTheMount,0,2,0,4,1578459600,1578546000,2
SotiresZ,0,2,0,3,1606280400,1606280400,2
brunch-mouse,0,2,0,4,1576558800,1576645200,2
aogiritree69,0,2,0,4,1608526800,1608526800,2
lemurtard22,0,2,0,10,1591156800,1591156800,2
kcag,0,2,0,13,1575522000,1586232000,2
Bigluser,0,2,0,11,1580965200,1581742800,2
spectre_2,0,2,0,9,1580360400,1594008000,2
ImLikeAnOuroboros,0,2,0,6,1593576000,1593662400,2
SkiBagTheBumpGod,0,2,0,1,1607922000,1607922000,2
Quit_It3,0,2,0,27,1555905600,1562558400,2
Degen11,1,1,16,3,1588910400,1588996800,2
SpiritedPenguin,0,2,0,21,1599537600,1604116800,2
slowlygettingby,2,0,25,0,1599192000,1608354000,2
musiclovermina,0,2,0,3,1585281600,1585281600,2
Take-to-the-highways,1,1,15,6,1608354000,1608354000,2
Fire_Lake,0,2,0,3,1608872400,1612069200,2
ri7su7ka,0,2,0,13,1602475200,1604116800,2
levedian,0,2,0,9,1553918400,1561176000,2
amenacingballsack,0,2,0,10,1606453200,1606453200,2
mrbie23,0,2,0,14,1592020800,1596686400,2
BenDoverR8Now,2,0,0,0,1609045200,1609045200,2
Burkerss,0,2,0,27,1604898000,1606453200,2
IputTheStudInStudy,0,2,0,3,1605416400,1605416400,2
why-am-i-here-though,0,2,0,2,1607576400,1607576400,2
lotusdreams,0,2,0,37,1560312000,1580360400,2
Slyric_,0,2,0,6,1605330000,1605330000,2
c_j_timmins,2,0,65,0,1605675600,1605675600,2
Nopulu,0,2,0,50,1577336400,1588219200,2
donthatethevape,0,2,0,8,1603512000,1603512000,2
ThicccyNicccy,0,2,0,-7,1599019200,1609736400,2
IAm12AngryMen,0,2,0,25,1580533200,1601179200,2
saysthingsbackwards,0,2,0,53,1596340800,1596340800,2
kupferstuhl,0,2,0,73,1573016400,1573016400,2
tvorogmoloko,0,2,0,5,1607144400,1607144400,2
trelawney101,0,2,0,19,1603080000,1605762000,2
joco_,1,1,11,2,1551934800,1594440000,2
raphtafarian,0,2,0,5,1593144000,1593230400,2
jamrealm,0,2,0,4,1585540800,1585540800,2
WholeWheatBricks,0,2,0,5,1573362000,1577422800,2
CnC_Throwaway123,1,1,20,4,1604466000,1604466000,2
cgg5281,0,2,0,7,1604984400,1604984400,2
FathomFatAtom,1,1,22,13,1602475200,1602561600,2
Joedaddy386,0,2,0,42,1603425600,1603425600,2
NootleMcFrootle,1,1,0,-2,1607576400,1608872400,2
jsideris,0,2,0,3,1556596800,1556596800,2
unsolvablequestion,0,2,0,66,1578114000,1591416000,2
IGaveHerThe,0,2,0,34,1581570000,1581570000,2
Manguana,0,2,0,13,1568520000,1568520000,2
quierocomentar,0,2,0,4,1559188800,1574658000,2
VWVWVXXVWVWVWV,0,2,0,3,1587096000,1587096000,2
hammo01,0,2,0,2,1594008000,1594008000,2
thestorys0far,0,2,0,2,1581138000,1589774400,2
insightful_dreams,0,2,0,3,1612069200,1612069200,2
antliontame4,1,1,20,2,1564027200,1565150400,2
BikerJedi,0,2,0,10,1589860800,1601352000,2
Lurkese,0,2,0,1,1604379600,1604379600,2
CurvedD16,0,2,0,10,1574398800,1574398800,2
forgotten1996,0,2,0,5,1605243600,1608267600,2
Khe2325,0,2,0,131,1575522000,1587268800,2
Modular_Moose,0,2,0,27,1606885200,1609045200,2
BlackArchitect,0,2,0,22,1605848400,1605934800,2
Babykitten31,1,1,307,1,1601870400,1601956800,2
wompt,1,1,394,4,1608613200,1608699600,2
gibbliturtlebitz,0,2,0,70,1607317200,1607317200,2
TurdFergusonMcFlurry,0,2,0,28,1571284800,1571284800,2
EditsReddits,0,2,0,7,1595822400,1595822400,2
_-icy-_,0,2,0,9,1612069200,1612069200,2
aserrchez,1,1,9,2,1581915600,1581915600,2
kittenmittensforlife,0,2,0,4,1576645200,1576645200,2
Castieled,0,2,0,79,1607490000,1607490000,2
dazorange,0,2,0,9,1598500800,1598500800,2
lifehacksthatmatter,0,2,0,-5,1602648000,1602648000,2
Madmurkin,0,2,0,5,1612155600,1612155600,2
jkweiler74,0,2,0,9,1604898000,1605589200,2
chadwbelt,0,2,0,65,1598068800,1598155200,2
tvaughan,0,2,0,4,1589601600,1609477200,2
mdahms95,0,2,0,636,1573275600,1608267600,2
NinetyPercentHonest,1,1,4118,128,1591329600,1591329600,2
lowercasenrk,0,2,0,11,1583125200,1596859200,2
scrumpledorph,0,2,0,19,1601092800,1602820800,2
AzureJustice,0,2,0,4,1565323200,1580619600,2
FagasaurusRex69,0,2,0,3,1597032000,1597032000,2
canarialdisease,0,2,0,45,1583125200,1587009600,2
Tartositron_,0,2,0,14,1546664400,1546750800,2
Chonkthebonk,0,2,0,48,1608699600,1611982800,2
Tidezen,0,2,0,6,1598068800,1599192000,2
SuperGunnar,1,1,26,2,1574139600,1574139600,2
grantrules,0,2,0,3,1578027600,1578027600,2
nerdyogre254,0,2,0,25,1607835600,1607922000,2
grenston,0,2,0,18,1599710400,1599710400,2
clayh,0,2,0,-23,1576213200,1602907200,2
breakyourfac,0,2,0,26,1606021200,1606107600,2
Christian-momma,0,2,0,17,1601956800,1602648000,2
Wadsworth1954,0,2,0,11,1600401600,1605157200,2
cybercuzco,0,2,0,29,1599019200,1608872400,2
josephxpaterson,0,2,0,11,1599451200,1599796800,2
Maolin_Mowdown,0,2,0,14,1552795200,1557288000,2
AdamsAtoms038,0,2,0,27,1575262800,1598846400,2
BubbleNut6,0,2,0,104,1592280000,1592280000,2
Tbonethe_discospider,0,2,0,4,1603512000,1603512000,2
thesamesizeasyou,0,2,0,19,1557201600,1557201600,2
lazylazylazylad,0,2,0,2,1583298000,1591675200,2
DiamondBikini,0,2,0,4,1581138000,1581224400,2
blackwhitegreysucks,0,2,0,3,1621828800,1621915200,2
SomeStupidPerson,0,2,0,8,1588651200,1604379600,2
kalnu,0,2,0,8,1572408000,1572408000,2
MonkeyWaffles37,0,2,0,22,1574485200,1574830800,2
asuryan331,0,2,0,5,1585886400,1611982800,2
toa2tcat,0,2,0,63,1602993600,1608699600,2
HufflepuffIronically,0,2,0,35,1606453200,1609304400,2
iamonlyoneman,0,2,0,-1,1599019200,1599019200,2
Lincoln_31313131,0,2,0,-79,1608958800,1608958800,2
Ted_Buckland,0,2,0,10,1561694400,1575867600,2
dxniw,0,2,0,10,1594180800,1597982400,2
DatCanOfChefBoyardee,0,2,0,17,1598155200,1598155200,2
unsane_imagination,0,2,0,7,1594612800,1595476800,2
iamnotladygaga,0,2,0,14,1605675600,1605675600,2
3P1CM4N98,0,2,0,-4,1597723200,1600660800,2
ydhtfpots,1,1,91,1,1603512000,1604725200,2
harlow_darling,0,2,0,5,1602561600,1602561600,2
UnknownZeitgeist,0,2,0,0,1588132800,1590379200,2
Ogdomtotino,0,2,0,1,1578891600,1578891600,2
Bodark,0,2,0,2,1596859200,1596859200,2
confusedman_,0,2,0,-11,1606626000,1606626000,2
SheepiBeerd,0,2,0,17,1584417600,1584417600,2
menu-brush,0,2,0,10,1567051200,1568865600,2
thormagma,0,2,0,43,1576645200,1579150800,2
definitelynotSWA,0,2,0,39,1603857600,1605502800,2
BillyYumYumTwo-byTwo,0,2,0,22,1586318400,1593576000,2
youngatbeingold,0,2,0,7,1609304400,1609390800,2
RealAdaLovelace,0,2,0,18,1566964800,1599451200,2
ssebastian364,0,2,0,3,1605589200,1607230800,2
_xmaladjusted,1,1,252,1,1583470800,1583557200,2
JPM10,0,2,0,3,1583985600,1598155200,2
JS010,0,2,0,2,1605157200,1609563600,2
Sunshine-Queen,0,2,0,51,1608008400,1608008400,2
LemonWrappedBrick,0,2,0,3,1591243200,1591329600,2
LimpyChick,0,2,0,5,1612155600,1612242000,2
Mamacita_Nerviosa,0,2,0,4,1597377600,1602820800,2
funkschweezy,0,2,0,4,1607490000,1607490000,2
Tomoshaamoosh,0,2,0,8,1579064400,1580360400,2
dogonavespa,0,2,0,4,1604811600,1604811600,2
Not-A-SoggyBagel,0,2,0,3,1605675600,1608699600,2
chrispy_t,0,2,0,5,1573880400,1592193600,2
FrothySolutions,0,2,0,4,1584676800,1584763200,2
KZRW,0,2,0,1,1577595600,1577595600,2
Cole12890,0,2,0,-37,1571544000,1571544000,2
novaplane1000,0,2,0,-16,1547355600,1547442000,2
TheTattedspyder,0,2,0,13,1603598400,1603598400,2
Patataoh,1,1,176,-8,1596859200,1606453200,2
ForFoxSake89,0,2,0,3,1605157200,1605157200,2
mdizzle872,0,2,0,1,1600315200,1600660800,2
AngryPartizan,1,1,19,21,1578546000,1588046400,2
wallace-parker,1,1,217,1,1583384400,1585972800,2
sye_ten,1,1,23,5,1566446400,1574398800,2
sgthrowa,0,2,0,13,1574053200,1574053200,2
tm956,0,2,0,19,1563422400,1567742400,2
Slufflepuff,0,2,0,8,1604379600,1605589200,2
rennyomega,0,2,0,7,1597896000,1606626000,2
thatsHowTheyGetYa,0,2,0,253,1559102400,1563681600,2
rigitfrak341,0,2,0,20,1572235200,1580274000,2
Hepatitusguy343,0,2,0,2,1599883200,1599969600,2
Ryuain,0,2,0,2,1589515200,1589515200,2
Comramde,0,2,0,3,1606971600,1608872400,2
playin4power,0,2,0,33,1591156800,1591156800,2
totes_mygotes,0,2,0,27,1608267600,1608354000,2
SimpleOhioMan,0,2,0,362,1575262800,1577422800,2
applepickingbitch,1,1,11,1,1605675600,1605675600,2
MrMoose_69,0,2,0,8,1597118400,1597118400,2
pisceenn,1,1,89,7,1559793600,1572843600,2
Multrix,0,2,0,24,1578978000,1579064400,2
EmagehtmaI,0,2,0,42,1573621200,1589860800,2
Johnchuk,0,2,0,28,1578891600,1590379200,2
TheGingr,0,2,0,11,1597636800,1602302400,2
AShittyEarthling,0,2,0,36,1585886400,1585886400,2
Fedora_Tipper69,1,1,38,10,1570593600,1570593600,2
strellar,0,2,0,2,1589947200,1589947200,2
knot-a-robot,0,2,0,93,1583985600,1586404800,2
FullDisclosureDaemon,0,2,0,29,1590552000,1596600000,2
tbib1988,0,2,0,4,1601265600,1604030400,2
papakiller-666,1,1,0,0,1595649600,1595649600,2
Spockrocket,0,2,0,32,1567569600,1591588800,2
aspektx,0,2,0,60,1592107200,1592366400,2
Bio-Mechanic-Man,0,2,0,-16,1601179200,1601179200,2
Torinn88,0,2,0,3,1570593600,1570593600,2
Johtoboy,0,2,0,23,1575608400,1595908800,2
Cryptonativ,0,2,0,24,1598846400,1598932800,2
Umiiiii,0,2,0,336,1570507200,1572753600,2
Team_Steve,0,2,0,14,1571112000,1584590400,2
SolarTortality,0,2,0,-16,1596513600,1596513600,2
Mellowhellno123,0,2,0,11,1569988800,1569988800,2
RetreadRoadRocket,0,2,0,1,1579669200,1601352000,2
sgem29,0,2,0,64,1612069200,1612242000,2
Tsobaphomet,0,2,0,3,1593835200,1593835200,2
comprehensiveutertwo,0,2,0,53,1579496400,1594440000,2
NoHovercraft1,0,2,0,1,1592452800,1600660800,2
Benjamincoulter,0,2,0,2,1605157200,1609390800,2
davisc843,0,2,0,3,1564113600,1564113600,2
brildenlanch,0,2,0,4,1592884800,1598932800,2
BucketB7,2,0,393,0,1594872000,1595563200,2
trivialposts,0,2,0,37,1602993600,1608440400,2
chunk_o,0,2,0,12,1550293200,1552449600,2
Closetconspiracynut,0,2,0,13,1579928400,1580014800,2
APUYD,0,2,0,2,1603857600,1603857600,2
SankaraOrLURA,0,2,0,21,1566360000,1570075200,2
ArabAesthetic,0,2,0,7,1574830800,1574830800,2
botanybabe69,0,2,0,4,1572235200,1572235200,2
silky_malone,0,2,0,92,1551416400,1589601600,2
TheUnpretentiousPoet,0,2,0,16,1608267600,1608786000,2
kobrakyl,0,2,0,6,1591934400,1591934400,2
SmokeyMcBlunt,0,2,0,3,1579237200,1579237200,2
boetubs,0,2,0,-12,1590638400,1590638400,2
Phoxymormon,0,2,0,0,1601870400,1601870400,2
CovidInMyAsshole,0,2,0,241,1605589200,1608958800,2
Bricka_Bracka,0,2,0,22,1584763200,1584763200,2
Khiwalks,0,2,0,3,1592798400,1592971200,2
jvx530,0,2,0,14,1597982400,1600920000,2
DJSparksalot,0,2,0,17,1606712400,1606712400,2
Lifeesstwange,0,2,0,97,1589947200,1589947200,2
paxauror,0,2,0,21,1582779600,1611982800,2
new_old_mike,0,2,0,146,1606626000,1608267600,2
CMTXRATED,0,2,0,-8,1589515200,1591329600,2
loginlogan7,0,2,0,0,1595563200,1595736000,2
Topyka2,0,2,0,7,1488171600,1488171600,2
shartinfestedwaters,0,2,0,16,1608699600,1608699600,2
Jlogizzle,0,2,0,-32,1571025600,1571025600,2
mincucio0404,0,2,0,4,1605416400,1605416400,2
DeskParser,0,2,0,0,1583298000,1583298000,2
ARKenneKRA,0,2,0,0,1573621200,1575608400,2
BigRonnieRon,0,2,0,8,1548046800,1548046800,2
KikiBz,0,2,0,11,1559275200,1559620800,2
Br4inShredder20,1,1,23,15,1539921600,1541131200,2
ltlawdy,0,2,0,4,1606539600,1606539600,2
rlowe90,0,2,0,10,1609477200,1609477200,2
wildborbsunlimited,0,2,0,3,1604293200,1604379600,2
lennybird,0,2,0,3,1576645200,1576645200,2
itsamecocolini,0,2,0,7,1566792000,1597032000,2
nadmah10,0,2,0,5,1600228800,1600228800,2
FlightlessEagle010,0,2,0,25,1585281600,1592107200,2
hastby656,0,2,0,13,1586836800,1586836800,2
flannelman37,0,2,0,60,1575954000,1575954000,2
lzfour,0,2,0,5,1607662800,1607662800,2
Psykosid,1,1,262,10,1588996800,1588996800,2
under2x,0,2,0,9,1600142400,1601092800,2
separatebrah,0,2,0,9,1555300800,1555300800,2
jsblk3000,0,2,0,-2,1585454400,1585454400,2
PapaFranzBoas,0,2,0,9,1571457600,1574226000,2
ADSwasAISloveDKS,0,2,0,48,1581483600,1597032000,2
ih4teme,0,2,0,15,1570334400,1605157200,2
literatrolla,0,2,0,-1,1603684800,1606626000,2
thil3000,0,2,0,46,1608440400,1611896400,2
NorthernRealmJackal,0,2,0,2,1607490000,1607490000,2
subatomicbukkake,0,2,0,-7,1555992000,1559102400,2
JamesMattDillon,0,2,0,10,1611810000,1611896400,2
bat_sy,2,0,83,0,1602907200,1604898000,2
James-Worthington,0,2,0,20,1608440400,1611982800,2
hardpoopin95,0,2,0,2,1605070800,1605070800,2
fancy-socks,0,2,0,10,1565582400,1566878400,2
tangomicheal,0,2,0,8,1555473600,1557288000,2
murzeig,0,2,0,-61,1579496400,1579496400,2
Plutters,0,2,0,16,1599710400,1601352000,2
looloopklopm,0,2,0,14,1595822400,1596600000,2
Umm-yes-exactly,0,2,0,5,1608354000,1608354000,2
rughmanchoo,0,2,0,43,1607403600,1607403600,2
iDrownedlol,0,2,0,11,1579064400,1579064400,2
JJ2478,0,2,0,59,1574658000,1574658000,2
ShakaUVM,0,2,0,-5,1602216000,1602216000,2
redclited,0,2,0,25,1606021200,1606107600,2
basicbaconbitch,0,2,0,14,1588046400,1596081600,2
Adrew44,0,2,0,89,1594612800,1594612800,2
KoenDeAdvocaat,0,2,0,4,1578373200,1578978000,2
wundypundy,0,2,0,30,1600142400,1608699600,2
themonstrumologist,0,2,0,118,1574917200,1592193600,2
SethQ,0,2,0,8,1591156800,1598932800,2
Starter91,0,2,0,1,1600747200,1600747200,2
awkward_accountant89,0,2,0,39,1608440400,1608440400,2
Flag-Assault2,0,2,0,0,1608699600,1608699600,2
SecretOfTheOdds,0,2,0,21,1570939200,1570939200,2
hairaccount129,2,0,9,0,1588996800,1589083200,2
TerrestrialStowaway,0,2,0,4,1607835600,1607922000,2
routebeer,0,2,0,-3,1571112000,1571112000,2
TheBlueEarth,0,2,0,20,1596427200,1596427200,2
joelho_bom,0,2,0,31,1593403200,1596859200,2
flameman235,0,2,0,5,1598068800,1603944000,2
jetaj,1,1,28,1,1557374400,1557460800,2
NearlyNapalm,0,2,0,-5,1597982400,1604379600,2
Scrubby7,0,2,0,-4,1571803200,1571803200,2
FyuuR,0,2,0,66,1608440400,1609390800,2
RustyPwner,0,2,0,-10,1606626000,1606626000,2
las_iglasty,1,1,53,8,1602648000,1604984400,2
jennystyle8989,0,2,0,2,1593057600,1593144000,2
lemonsnacks101,0,2,0,9,1549170000,1559793600,2
Squiddy4,0,2,0,12,1603771200,1603771200,2
CuteSomic,0,2,0,34,1605589200,1609390800,2
dianaventures,0,2,0,3,1573102800,1573102800,2
respeitajanuario,1,1,160,4,1576731600,1576818000,2
Hyouta_,0,2,0,9,1587528000,1587614400,2
kfctwix,1,1,11,1,1594267200,1594872000,2
gotoki10,0,2,0,5,1567656000,1568260800,2
satire-and-solitude,0,2,0,12,1594699200,1594785600,2
GooRedSpeakers,0,2,0,11,1585022400,1587268800,2
Jaebriel,0,2,0,-15,1582002000,1582002000,2
CantoRaps,0,2,0,27,1598414400,1598500800,2
tookTHEwrongPILL,0,2,0,13,1604811600,1608526800,2
Hasemage,0,2,0,50,1549602000,1549774800,2
justdaband3,0,2,0,5,1595476800,1595476800,2
CleftJohnson,0,2,0,11,1576645200,1576645200,2
Surfacebum,0,2,0,6,1574830800,1577941200,2
StephCurryMustard,0,2,0,103,1592280000,1592280000,2
ApprehensiveFudge787,0,2,0,-4,1607749200,1608354000,2
chaosrunner87,1,1,621,3,1605848400,1606107600,2
ohcomely91,0,2,0,3,1612069200,1612155600,2
AbsurdistMonk,0,2,0,7,1580706000,1582952400,2
themaincop,0,2,0,13,1594958400,1596772800,2
ConspicuouslyBland,0,2,0,44,1597291200,1597291200,2
OppsForgotAgain,0,2,0,5,1597723200,1597723200,2
Comrade_Anon_Anonson,0,2,0,24,1555214400,1580101200,2
YahYeer,0,2,0,20,1608008400,1608094800,2
MeowMeowMeowMeowMiao,0,2,0,5,1602820800,1602907200,2
replacedbyarobot,0,2,0,12,1573189200,1573275600,2
hWatDoo,0,2,0,20,1546578000,1549256400,2
Cavanus,0,2,0,17,1578978000,1605675600,2
AnnoyingGadfly,0,2,0,8,1603598400,1603598400,2
DnaKinaseKinase,0,2,0,2,1620792000,1621742400,2
itbegins762,0,2,0,5,1601352000,1605243600,2
Lima_Peru,0,2,0,25,1578286800,1578373200,2
Hellowwzz,0,2,0,13,1594872000,1594872000,2
Noyes654,0,2,0,4,1590206400,1605243600,2
iloveSeinfield69,0,2,0,3,1594699200,1594699200,2
taelor,0,2,0,19,1554609600,1591416000,2
literallyalobster,0,2,0,3,1572235200,1598068800,2
dennyfader,0,2,0,3,1576386000,1576386000,2
MommyShark613,0,2,0,10,1574226000,1576040400,2
Consistent_Return,0,2,0,13,1592452800,1593403200,2
spookymagicians,0,2,0,45,1594008000,1594008000,2
boost_fae_bams,1,1,70,10,1592020800,1595390400,2
MuttonChopMetal,0,2,0,173,1601611200,1601611200,2
tacos_4_all,2,0,18,0,1433131200,1441857600,2
jkhockey15,0,2,0,-6,1608181200,1611982800,2
Yinonormal,0,2,0,16,1605243600,1605243600,2
TeamToken,0,2,0,9,1586232000,1609218000,2
pointlessarguments3,0,2,0,2,1610686800,1610686800,2
r4m3nn00dl3s,1,1,140,6,1587441600,1587441600,2
Lettuce-Bag,0,2,0,6,1597032000,1604466000,2
ProfessionalDish,0,2,0,30,1595304000,1605157200,2
Historical_Mud_3992,0,2,0,-26,1606539600,1606539600,2
Manganese_oxide,0,2,0,1,1577336400,1577682000,2
sjcpilot,2,0,34,0,1604379600,1605762000,2
hoarderofhoards,0,2,0,6,1612069200,1612155600,2
Ivancz,0,2,0,10,1571716800,1571716800,2
hellomrow,0,2,0,-12,1550638800,1551157200,2
internetjay,0,2,0,24,1550293200,1595044800,2
GlassMaintenance,0,2,0,8,1596340800,1608699600,2
makecars4happen,0,2,0,12,1593230400,1593230400,2
bigggdaddie,2,0,604,0,1576040400,1577077200,2
DrinkFromThisGoblet,0,2,0,7,1608440400,1609218000,2
Stranger_bings,0,2,0,6,1608872400,1608872400,2
-retaliation-,0,2,0,11,1595649600,1595649600,2
cbftw,0,2,0,1,1574398800,1607662800,2
DragMeDownToHell,0,2,0,49,1605502800,1606280400,2
ImUsuallyMoreClever,2,0,455,0,1558670400,1561348800,2
guillotineTheRich132,1,1,33,12,1572494400,1572667200,2
imdad_bot,0,2,0,6,1578546000,1578546000,2
Badoreo1,0,2,0,7,1585454400,1585454400,2
DiabetesCOLE,0,2,0,8,1597636800,1597723200,2
MervisBreakdown,0,2,0,12,1596686400,1603512000,2
anavarro1996,0,2,0,30,1600488000,1601352000,2
tastefulbuttstuff,0,2,0,115,1585627200,1585800000,2
TheLegendDaddy27,0,2,0,5,1591329600,1591329600,2
MammothCavebear,0,2,0,12,1608008400,1608958800,2
konRAD-Jarit,1,1,8,2,1598673600,1598673600,2
ughwithoutadoubt,0,2,0,2,1643259600,1643259600,2
AbBogavante,0,2,0,7,1597896000,1598587200,2
DangerousCommittee5,0,2,0,65,1588651200,1608267600,2
mrsduckie,0,2,0,52,1592193600,1597809600,2
duke-wheresmycar,0,2,0,75,1606971600,1606971600,2
UglyStru,0,2,0,42,1602388800,1602734400,2
HunkleberryFine,0,2,0,156,1593748800,1593835200,2
dear_deer_dear,0,2,0,10,1593921600,1604293200,2
JoeBarthAlsoLuvsData,0,2,0,2,1605070800,1605070800,2
MaximumBusyMuscle,0,2,0,2,1544158800,1544158800,2
killerbumblebee,0,2,0,85,1553140800,1601438400,2
zestylimeo,0,2,0,65,1594612800,1609304400,2
cobracakes,0,2,0,16,1545368400,1546750800,2
LupusWiskey,0,2,0,3,1575176400,1575176400,2
VinBarrKRO,0,2,0,3,1555473600,1555473600,2
CheezeyCheeze,0,2,0,11,1586836800,1603598400,2
KingInTheNorthDave,0,2,0,11,1584763200,1584763200,2
magicgarbagetruck,0,2,0,5,1579842000,1579842000,2
Detector_of_humans,0,2,0,2,1597636800,1606885200,2
BrighterColours,0,2,0,6,1576472400,1596772800,2
wooliewookies,0,2,0,-1,1585454400,1585540800,2
spicegardentips,1,1,21,1,1591934400,1592193600,2
--sidelines--,0,2,0,3,1570420800,1581138000,2
ravepeacefully,0,2,0,-42,1555646400,1555646400,2
bearinthebriar,0,2,0,22,1592280000,1607662800,2
chopinfan92,0,2,0,-6,1608526800,1608526800,2
Donniedark00,0,2,0,7,1572930000,1574226000,2
rapozx,0,2,0,15,1612155600,1612155600,2
DefyAsaya,0,2,0,2,1606107600,1617508800,2
SleepyATT,0,2,0,2,1603339200,1603339200,2
TheUnibrow,0,2,0,-21,1597896000,1597896000,2
HachikoLu,0,2,0,15,1591934400,1598500800,2
TheHornyHobbit,0,2,0,-5,1579064400,1579064400,2
BruceIsLoose,0,2,0,60,1600747200,1600747200,2
Halbertos,0,2,0,39,1576299600,1577336400,2
attjw,0,2,0,17,1606626000,1606626000,2
monkeyseal42,0,2,0,2,1603512000,1604379600,2
iandialone,0,2,0,6,1585454400,1585454400,2
thestationarybandit,0,2,0,2,1570161600,1603512000,2
Katze69,0,2,0,17,1570680000,1573189200,2
Joshadow11,0,2,0,-2,1607576400,1607662800,2
LinkAtrius,0,2,0,2,1569211200,1569211200,2
RocketLauncher,0,2,0,7,1578805200,1597636800,2
Helm222,0,2,0,17,1575867600,1603512000,2
revohitta,0,2,0,15,1600574400,1601784000,2
HockeyFanatic45,1,1,14,1,1574571600,1577077200,2
WELCOME2HELLKID,0,2,0,3,1601438400,1607662800,2
Hildkiin,0,2,0,2,1590638400,1611896400,2
trackedpackage,0,2,0,4,1602993600,1604116800,2
telios87,0,2,0,-1,1595304000,1603512000,2
litallday,0,2,0,3,1561003200,1561003200,2
blkbny,0,2,0,24,1603512000,1603598400,2
AirdropFaucet,0,2,0,-5,1582520400,1606798800,2
swefpelego,0,2,0,5,1471665600,1481864400,2
HexHaunter,0,2,0,25,1550984400,1594008000,2
AuthurTLightening,0,2,0,3,1607490000,1607490000,2
LemonLimeAlltheTime,0,2,0,0,1580878800,1580878800,2
itwasdark,0,2,0,50,1606798800,1609304400,2
Throwway887766,0,2,0,51,1605502800,1606626000,2
mjc3193,0,2,0,61,1593144000,1606539600,2
Pickleface32,0,2,0,3,1582779600,1603512000,2
erobertt3,0,2,0,5,1590120000,1611982800,2
jobventthrowaway,1,1,26,-3,1570161600,1570161600,2
canadian_webdev,0,2,0,102,1606021200,1609304400,2
Nodapl12,0,2,0,70,1589860800,1599710400,2
apricotblues,0,2,0,38,1605502800,1607144400,2
FirstEvolutionist,0,2,0,14,1591243200,1596772800,2
HospitableHospital,0,2,0,17,1578632400,1578632400,2
scurvyjon,0,2,0,2,1596772800,1601352000,2
A_SALTY_SEADOG,1,1,19,2,1605675600,1605675600,2
Der_Ewige_C00MER,0,2,0,33,1600056000,1600056000,2
LordX001,0,2,0,3,1565928000,1565928000,2
wavepad4,0,2,0,45,1598241600,1598328000,2
arendelliancrocus,0,2,0,15,1606712400,1606798800,2
noonenone,0,2,0,8,1477195200,1477972800,2
cwaterbottom,0,2,0,-15,1606280400,1606280400,2
AJakeR,0,2,0,12,1573016400,1607230800,2
CharlerBubbenstein,0,2,0,-9,1575435600,1575435600,2
JewishHottub,0,2,0,2,1597550400,1606971600,2
whatnow990,0,2,0,47,1598587200,1602388800,2
dontbeabitchok,0,2,0,-1,1555473600,1555646400,2
DarthGrowl,0,2,0,3,1590379200,1590379200,2
sweetie76010,0,2,0,11,1592712000,1598846400,2
penleyhenley,0,2,0,18,1606885200,1609218000,2
TimeWarpTalia,0,2,0,15,1596600000,1596945600,2
FBI-Agent-007,0,2,0,1,1579755600,1580792400,2
Bernie_Corbyn,0,2,0,2,1592020800,1592020800,2
Barboosha,1,1,3,1,1594526400,1594699200,2
dethanjel,1,1,1125,25,1572580800,1601524800,2
TheUnitedStates1776,0,2,0,-1,1589774400,1589774400,2
Cry_in_the_shower,0,2,0,21,1603425600,1603512000,2
inboredimsobored,0,2,0,7,1607230800,1607317200,2
justanotherUN4u,0,2,0,3,1613970000,1616385600,2
jtfff,0,2,0,4,1611205200,1611205200,2
wolfdog127,0,2,0,4,1602820800,1602820800,2
Dog_Pagenaud,0,2,0,9,1605502800,1607317200,2
pitifulaccountant,0,2,0,4,1570075200,1570075200,2
TealAndroid,0,2,0,28,1562040000,1587009600,2
waronxmas79,0,2,0,4,1591156800,1607922000,2
anon17543,1,1,18,5,1555041600,1555041600,2
Maddyval,0,2,0,7,1569556800,1569556800,2
bigbuzd,0,2,0,6,1546405200,1546405200,2
bedandbaconlover,0,2,0,3,1607835600,1607835600,2
boogeytheman,0,2,0,18,1577509200,1589947200,2
adoptedlemur,0,2,0,8,1586923200,1609045200,2
Lostandconfused9191,1,1,5,2,1597896000,1598760000,2
Shad223322,0,2,0,-12,1612155600,1612155600,2
geardog32,0,2,0,21,1570680000,1603944000,2
ITFucked,0,2,0,-5,1597723200,1597723200,2
OzSleeperCell,0,2,0,4,1565668800,1565755200,2
JustAGirlInTheWild,0,2,0,20,1606798800,1606798800,2
Sol2062,0,2,0,35,1593835200,1593835200,2
aliteralhumanbeing,0,2,0,25,1608094800,1611896400,2
Moviprep,0,2,0,1,1584849600,1584849600,2
d_heizkierper,0,2,0,4,1588651200,1592020800,2
CharBombshell,0,2,0,28,1571976000,1571976000,2
gaurddog,0,2,0,4,1598673600,1600660800,2
--LittleKidLover--,0,2,0,5,1602043200,1604293200,2
HenshiniPrime,0,2,0,33,1576299600,1576386000,2
Paraponera_clavata,1,1,14,1,1578718800,1582693200,2
dorianfinch,0,2,0,4,1546405200,1589860800,2
obtk,0,2,0,48,1571371200,1584072000,2
Irritatedtrout,0,2,0,0,1607403600,1609390800,2
Feyyorefox,2,0,31,0,1603080000,1606366800,2
GeraltJ,0,2,0,50,1606885200,1607922000,2
Flying_Ninja_Bunny,0,2,0,32,1591934400,1595131200,2
user190al,0,2,0,2,1607403600,1607835600,2
MataTerakhir,0,2,0,6,1607662800,1608872400,2
Nullaby,0,2,0,11,1600488000,1602216000,2
Thatcherinthery3,0,2,0,4,1608786000,1608786000,2
Cherle,0,2,0,5,1576990800,1583470800,2
Haha_Nice_Joke_Bro,0,2,0,3,1567310400,1567310400,2
necroticon,0,2,0,17,1607835600,1607835600,2
Tiny-Degree,0,2,0,4,1578114000,1578114000,2
sanjay_82,0,2,0,3,1600833600,1602820800,2
tony-durke,0,2,0,23,1593576000,1599537600,2
LessMochaJay,0,2,0,14,1608699600,1608699600,2
Sergnb,0,2,0,4,1603512000,1606539600,2
Le_Frogge,0,2,0,7,1612155600,1612155600,2
teh_fizz,0,2,0,6,1581742800,1581742800,2
thezbrooke,0,2,0,3,1594267200,1602820800,2
R_IS_SPICY_EXCEL,0,2,0,2,1584590400,1584590400,2
four_q,0,2,0,7,1554264000,1554264000,2
Monthly_Vent,0,2,0,6,1601438400,1601438400,2
ExtinguishedEmber,0,2,0,3,1547182800,1550725200,2
joule2387,0,2,0,4,1600142400,1603598400,2
dalisair,0,2,0,4,1569729600,1594440000,2
generallyihavenoidea,0,2,0,4,1602820800,1602820800,2
FIFI_BAG,0,2,0,0,1585022400,1585454400,2
DANGERSCONE,0,2,0,4,1582088400,1587009600,2
relderpaway,0,2,0,4,1579755600,1579755600,2
lnsetick,0,2,0,27,1591243200,1591243200,2
blackone65,1,1,62,4,1612069200,1612155600,2
KuraiKuroNeko,0,2,0,7,1601179200,1601179200,2
Venkas,0,2,0,15,1601092800,1601611200,2
gizzardgullet,1,1,84,7,1592280000,1592280000,2
smitywerberjegmansen,0,2,0,19,1598328000,1598414400,2
DanielMcFamiel,1,1,94,7,1604725200,1605502800,2
Lethal_Lime_,0,2,0,3,1599019200,1599019200,2
OhhWolves,0,2,0,35,1605157200,1606453200,2
_pm_me_your_memes,0,2,0,36,1596081600,1608699600,2
DestroyermattUK,1,1,0,2,1594267200,1599105600,2
brallipop,0,2,0,11,1585454400,1585454400,2
bluefenceglass,0,2,0,3,1573621200,1576731600,2
Fliibo-97,0,2,0,20,1594353600,1594353600,2
RentIsAFuck3,0,2,0,9,1572321600,1572321600,2
massiveuptake,1,1,93,9,1608699600,1608699600,2
MrBarbarianx,0,2,0,4,1598760000,1598760000,2
Boehemian,0,2,0,1,1609218000,1609218000,2
Arpytrooper,0,2,0,9,1612069200,1612069200,2
Kigichi,0,2,0,8,1585454400,1585454400,2
Sharkfinatops,0,2,0,51,1583557200,1583557200,2
DoubleDownDefense,0,2,0,64,1549515600,1549515600,2
EvadesBans,0,2,0,54,1576904400,1582088400,2
Razorsaber,0,2,0,2,1603512000,1603598400,2
geazleel,0,2,0,29,1606453200,1607317200,2
skullsandscales,1,1,10,2,1606021200,1606021200,2
AptCasaNova,0,2,0,3,1588824000,1588824000,2
IrishSalamander,0,2,0,7,1585281600,1595649600,2
marilenne,1,1,19,5,1577163600,1577163600,2
kick_his_ass_sebas,0,2,0,8,1595649600,1595649600,2
eli_eggs69,0,2,0,3,1581397200,1582693200,2
marfewj1313,0,2,0,10,1582434000,1582434000,2
Finaglers,0,2,0,8,1605848400,1605848400,2
HarmonizedSnail,0,2,0,7,1603512000,1603512000,2
AfroRonin92,0,2,0,19,1608008400,1608008400,2
Frodo_Onebaggins,0,2,0,5,1555646400,1556424000,2
CacklingCrone,0,2,0,3,1598760000,1598760000,2
sjunipero,0,2,0,2,1593144000,1593144000,2
peanut-butter-vibes,0,2,0,9,1606453200,1606453200,2
jmichaelhudsondotnet,2,0,14,0,1574398800,1575176400,2
ohnoahkim,0,2,0,-5,1605157200,1605157200,2
Henrietta9999,0,2,0,4,1602302400,1606712400,2
_Suleyka_,1,1,215,5,1582952400,1582952400,2
are-e-el,0,2,0,8,1603425600,1603598400,2
tillie4meee,0,2,0,6,1611810000,1611982800,2
zaichii,0,2,0,7,1606885200,1607317200,2
truetoyouu,2,0,251,0,1582779600,1584763200,2
comicsansisunderused,0,2,0,10,1606453200,1606453200,2
Frird2008,0,2,0,2,1609822800,1610514000,2
series_hybrid,0,2,0,26,1597809600,1603684800,2
LeatherDude,0,2,0,7,1603512000,1608181200,2
KillerRex666,1,1,33,2,1605243600,1605243600,2
bbismuth83,2,0,180,0,1597550400,1598414400,2
ITendToFail,0,2,0,2,1605330000,1605675600,2
Three00Jews,0,2,0,8,1587873600,1587873600,2
Schiffty5,1,1,76,26,1547528400,1561867200,2
EndMyOblivion,0,2,0,5,1594267200,1594267200,2
GherboGherbo,1,1,46,7,1601611200,1605243600,2
MajorWubba,0,2,0,54,1592625600,1596859200,2
NiceBobos91,0,2,0,2,1588305600,1599883200,2
Mybfspiesonme,0,2,0,13,1606626000,1606626000,2
branflakes14,0,2,0,-5,1585454400,1594008000,2
jengham,0,2,0,-20,1606712400,1606712400,2
william_chef_wallace,0,2,0,33,1585108800,1588478400,2
gray-nomad,0,2,0,1,1605934800,1606626000,2
snuffeluffegus,0,2,0,26,1568692800,1575522000,2
Scipio_Asiaticus,1,1,120,16,1547096400,1547096400,2
tchower,0,2,0,4,1552107600,1553400000,2
hoshiyari,1,1,62,5,1587096000,1594353600,2
boksinx,0,2,0,29,1555300800,1557028800,2
theDampEmpanada,1,1,465,1,1542258000,1555646400,2
Zodi_Art,1,1,11,1,1587960000,1587960000,2
Amargosamountain,0,2,0,54,1604466000,1604466000,2
FictionalNarrative,0,2,0,-9,1593230400,1593230400,2
DrunkCanadianAMA,0,2,0,12,1568174400,1568174400,2
throwaway_1ps,0,2,0,24,1608613200,1608786000,2
kerfuffle7,0,2,0,120,1605416400,1606539600,2
Kuski87,0,2,0,31,1596859200,1597809600,2
Spiritofchokedout,0,2,0,-17,1572843600,1578286800,2
sweYoda,0,2,0,-16,1611982800,1612069200,2
Shirakawasuna,0,2,0,52,1584676800,1593576000,2
fourthletter,0,2,0,2,1597118400,1605070800,2
DistractedBones,0,2,0,20,1576040400,1580187600,2
nicistardust,0,2,0,13,1562644800,1569988800,2
3mikey3,2,0,107,0,1599796800,1608526800,2
westinghouse_fan,0,2,0,16,1605070800,1605070800,2
4938290481,0,2,0,9,1567224000,1567224000,2
ItsOxymorphinTime,0,2,0,11,1585195200,1585368000,2
ilovestalepopcorn,2,0,292,0,1583985600,1584590400,2
Haqwss,0,2,0,7,1558065600,1561262400,2
Street-Caramel7045,0,2,0,-22,1607576400,1607576400,2
Tivoranger,0,2,0,3,1603598400,1603598400,2
srgoodguy,0,2,0,38,1585368000,1585368000,2
cobibe,0,2,0,13,1607317200,1607317200,2
GrumpyBeanz,0,2,0,12,1604379600,1605243600,2
allthesounds,0,2,0,6,1559707200,1559707200,2
etv2017,1,1,11,4,1579582800,1579582800,2
ngwoo,0,2,0,2,1585195200,1606021200,2
sidd_kr_sgh,0,2,0,2,1640840400,1640840400,2
JayLime,0,2,0,7,1608094800,1608526800,2
Ruggsii,0,2,0,13,1539921600,1539921600,2
seriousguynogames,0,2,0,18,1570939200,1581483600,2
Adalwolf311,0,2,0,32,1592625600,1601784000,2
galaxyinferno1111,1,1,54,6,1605416400,1606971600,2
crowleffe,0,2,0,1,1571716800,1591329600,2
Sunny_E30,0,2,0,2,1573362000,1573362000,2
MediocreLion,0,2,0,34,1575003600,1600747200,2
watermelonkiwi,0,2,0,19,1586059200,1586059200,2
wonderfulsyndicalist,0,2,0,239,1600920000,1604116800,2
FerreroEccelente,1,1,25,6,1612155600,1612155600,2
GavriloPrincip3,0,2,0,6,1595217600,1595217600,2
Krtymn400,0,2,0,48,1574398800,1574398800,2
GlancingArc,0,2,0,4,1585454400,1585454400,2
dance_rattle_shake,0,2,0,-5,1585022400,1585281600,2
the_eddga,0,2,0,10,1592193600,1592193600,2
bluegreyscale,0,2,0,3,1591761600,1605070800,2
Goldenbranches,0,2,0,11,1565236800,1573275600,2
-Constantinos-,1,1,11,9,1601870400,1603166400,2
oguert,0,2,0,12,1608181200,1609390800,2
cuda1234,0,2,0,24,1607058000,1607144400,2
TheWorldofGray,0,2,0,8,1594526400,1597809600,2
soft-wear,0,2,0,1,1604379600,1604379600,2
schiff_is_a_pedo,0,2,0,-8,1576386000,1576386000,2
Son_of_benatar,0,2,0,4,1576126800,1576126800,2
CaptainMagnets,0,2,0,18,1611810000,1611810000,2
TAEROS111,0,2,0,47,1601956800,1601956800,2
Pile_of_Walthers,0,2,0,48,1603771200,1603944000,2
Anti-Hentai-Banzai,0,2,0,52,1597809600,1599105600,2
Kid_Cornelius,2,0,820,0,1579496400,1609304400,2
Victor_Korchnoi,0,2,0,8,1585454400,1585454400,2
TheArchMason,0,2,0,-6,1601179200,1601179200,2
That_would_be_meat,0,2,0,1,1587009600,1587009600,2
cypriss,0,2,0,0,1601870400,1605416400,2
ThatITGuy1980,0,2,0,2,1567051200,1567051200,2
ChefBootKnocker,0,2,0,5,1584417600,1584417600,2
roosey09,0,2,0,13,1583125200,1586404800,2
justins_porn,0,2,0,47,1598068800,1599105600,2
windexfresh,0,2,0,42,1609304400,1609304400,2
Sctt_045,0,2,0,10,1609304400,1609304400,2
Asem1989,0,2,0,2,1604466000,1605675600,2
ku976,0,2,0,86,1547182800,1558497600,2
RDF-herpderp,0,2,0,8,1604984400,1605070800,2
BertoltOdebrecht,0,2,0,9,1579496400,1579928400,2
cynicaljinn,0,2,0,15,1608094800,1608094800,2
Diane9779,0,2,0,-29,1597291200,1606021200,2
jamestheronson50,0,2,0,2,1603598400,1603598400,2
skrtskerskrt,0,2,0,5,1599364800,1599364800,2
VisionsOfTheMind,0,2,0,3,1596686400,1596686400,2
K-Zoro,0,2,0,6,1592712000,1608267600,2
HechiceraSinVarita,0,2,0,25,1576990800,1576990800,2
systemcandy,0,2,0,63,1579928400,1579928400,2
thegreattaiyou,0,2,0,10,1597377600,1597464000,2
MikeyHatesLife,0,2,0,79,1579064400,1579842000,2
ascherbozley,0,2,0,5,1603598400,1603598400,2
JONNy-G,0,2,0,-3,1594440000,1594440000,2
KingKoln,0,2,0,8,1594526400,1608699600,2
Prometheus479,0,2,0,5,1598414400,1598414400,2
zebra_chaser,1,1,4,3,1608613200,1608613200,2
CharmandertheLegend,2,0,761,0,1591675200,1591675200,2
wrwck92,0,2,0,5,1605848400,1605848400,2
ImAProfessional1,0,2,0,7,1562644800,1563076800,2
Rice1991,0,2,0,76,1597723200,1601956800,2
Sodaina,0,2,0,4,1582434000,1582606800,2
Macnultywasahero,1,1,3,1,1584676800,1584676800,2
PrincessGrumpyBunny,0,2,0,3,1585368000,1585368000,2
thebottomofawhale,0,2,0,20,1572843600,1581570000,2
andyandcomputer,0,2,0,20,1541480400,1544245200,2
GutterRatQueen,0,2,0,43,1577854800,1577854800,2
piratecopy,0,2,0,52,1600315200,1606280400,2
corporealmetacortex,0,2,0,8,1534564800,1534564800,2
Grillos,1,1,2162,56,1584590400,1605157200,2
Lifewhatacard,0,2,0,18,1593748800,1593748800,2
sounknownyet,1,1,56,11,1583470800,1589774400,2
Aziraphale22,0,2,0,26,1597291200,1607230800,2
Isabelle-is-gay,0,2,0,2,1607662800,1607662800,2
SuzyZeusHasACold,0,2,0,7,1606280400,1606280400,2
cazssiew,0,2,0,108,1592193600,1603512000,2
GroteJager,1,1,118,1,1604203200,1606712400,2
neosmndrew,1,1,28,2,1565409600,1565496000,2
youspinaliiive,0,2,0,119,1583038800,1583038800,2
VanellopeVonSplenda,0,2,0,27,1575262800,1575349200,2
okameleon7,0,2,0,608,1598673600,1605934800,2
antiwork9959,1,1,45,12,1565409600,1565409600,2
Alekzcb,0,2,0,2,1548133200,1548133200,2
nopulse76,0,2,0,7,1601611200,1603080000,2
tells_you_hard_truth,0,2,0,15,1600315200,1604898000,2
Caihead,0,2,0,9,1602302400,1602475200,2
NotTurner,0,2,0,76,1574658000,1575867600,2
fpuen,1,1,4,1,1598328000,1598414400,2
Fivebomb,0,2,0,10,1598500800,1598587200,2
betsyletsy,0,2,0,8,1581915600,1585281600,2
bronze_by_gold,1,1,80,1,1571716800,1571716800,2
Seriouslythrowmeaway,0,2,0,5,1585454400,1585454400,2
funnyalth,0,2,0,2,1605070800,1605070800,2
PikabuOppresser228,0,2,0,3,1603684800,1604898000,2
emil94765,0,2,0,9,1595217600,1599192000,2
hellogoawaynow,0,2,0,-1,1537934400,1611205200,2
JustABaziKDude,0,2,0,48,1599192000,1605589200,2
Marapita,0,2,0,114,1585627200,1587096000,2
GenieBus,0,2,0,6,1574830800,1574830800,2
jyfutguhfujfff,1,1,42,6,1568865600,1577077200,2
laundry_day_outfit,1,1,2,2,1571803200,1571889600,2
ihatemyself45654,0,2,0,11,1549342800,1559448000,2
lem0nhe4d,1,1,80,5,1577336400,1577422800,2
attackonkyojin3,0,2,0,4,1604030400,1607749200,2
ChiliMacDaddySupreme,0,2,0,27,1601611200,1602734400,2
AngelicWaffle,0,2,0,26,1574917200,1596686400,2
madrury83,0,2,0,14,1595131200,1595217600,2
SatansLoLHelper,0,2,0,9,1608613200,1611896400,2
1337ll4ma5,0,2,0,9,1583470800,1583470800,2
Carib0ul0u,0,2,0,-2,1583812800,1583812800,2
potatocodes,0,2,0,9,1611810000,1611896400,2
Polylogue,0,2,0,4,1603598400,1603598400,2
This_1s_My_Name,0,2,0,20,1606366800,1606366800,2
IamComradeQuestion,0,2,0,4,1576990800,1577077200,2
Jesus_De_Christ,0,2,0,4,1604379600,1606280400,2
Idealcentaur363,0,2,0,1,1606626000,1606626000,2
jmswlltt,0,2,0,16,1609477200,1609477200,2
Diablo_Actual,0,2,0,12,1587009600,1587009600,2
Drotoka,0,2,0,2,1601611200,1602907200,2
Zaexyr,0,2,0,18,1575867600,1604293200,2
moondoge_coinz,0,2,0,8,1538366400,1540612800,2
TitusTheWolf,0,2,0,-5,1579669200,1579669200,2
arepollo,0,2,0,12,1592884800,1592971200,2
AmuroRay0704,0,2,0,62,1580533200,1580533200,2
TrashAssLogin,0,2,0,7,1605070800,1609304400,2
Resgignickell,0,2,0,51,1595304000,1599105600,2
PMME_YOUR_TITS_WOMAN,0,2,0,6,1582779600,1582779600,2
Recover-Prize,0,2,0,-1,1596081600,1596081600,2
dirkalict,0,2,0,8,1607403600,1607403600,2
apost8cannibal,1,1,10,2,1598846400,1598846400,2
kuniklokuris,0,2,0,22,1600142400,1600142400,2
Tyraid,0,2,0,8,1581138000,1581138000,2
KlNGCookie,0,2,0,13,1589601600,1602648000,2
KinkyStinkyPink-,0,2,0,5,1566187200,1591416000,2
ScooterChillson,1,1,101,1,1600142400,1607835600,2
NuclearEntropy,0,2,0,0,1602475200,1608613200,2
Marie9605,0,2,0,11,1612155600,1612155600,2
olivehdhfkgf,1,1,39,9,1587528000,1587528000,2
er490taco,0,2,0,6,1599019200,1599019200,2
reddit-eats-shit,0,2,0,9,1585713600,1585800000,2
Freshness518,0,2,0,8,1580360400,1609304400,2
elduba,0,2,0,8,1601179200,1601265600,2
Anonhoumous,0,2,0,2,1604030400,1604030400,2
fwvga,0,2,0,3,1549602000,1549602000,2
me-te-or-ite,0,2,0,8,1600747200,1604984400,2
Ari2010,0,2,0,5,1581829200,1606712400,2
Broten77,0,2,0,2,1576386000,1576386000,2
BungoGreencotton,0,2,0,27,1606971600,1606971600,2
Bhiggsb,0,2,0,2,1591156800,1591156800,2
jghgjb790,0,2,0,3,1608872400,1608872400,2
zebrawins,0,2,0,3,1538884800,1538884800,2
bikescapernate,0,2,0,3,1585886400,1585886400,2
Farg_classic,0,2,0,3,1587614400,1587960000,2
biogal06918,0,2,0,4,1572667200,1588996800,2
GreyArmor,0,2,0,14,1604379600,1604379600,2
bobofdeath2369,0,2,0,3,1601697600,1607490000,2
Revolutionary_Cry534,0,2,0,4,1597032000,1605589200,2
Lcdent2010,0,2,0,-2,1612069200,1612069200,2
rustyseapants,0,2,0,3,1599451200,1604379600,2
AltWhitehouse,0,2,0,11,1606712400,1607317200,2
Jacobahalls,0,2,0,5,1585454400,1585540800,2
dontwantausername_,0,2,0,6,1595649600,1595649600,2
Curious_Betsy_,0,2,0,47,1579064400,1579064400,2
bunnybear_chiknparm,1,1,55,5,1550898000,1550898000,2
zomgrasputin,0,2,0,25,1560744000,1564113600,2
Scotcheye,0,2,0,12,1606280400,1606280400,2
chalupussummus,0,2,0,4,1605589200,1605589200,2
ElonEpstein,0,2,0,1,1575435600,1577941200,2
Zee4321,0,2,0,165,1584936000,1585281600,2
Nakoichi,0,2,0,78,1572148800,1586836800,2
randythinker,0,2,0,3,1604984400,1606626000,2
SkellieLeft,0,2,0,38,1586059200,1586059200,2
VitaminDHunter,0,2,0,-7,1574312400,1574398800,2
fyhdhgg,0,2,0,6,1605848400,1607749200,2
ohreddit1,0,2,0,7,1567569600,1585108800,2
Eliouz,0,2,0,3,1606366800,1606366800,2
NationYell,0,2,0,5,1605416400,1605416400,2
umbrajoke,0,2,0,3,1605589200,1605589200,2
OlympiasRT,0,2,0,4,1609390800,1609477200,2
robert-at-pretension,0,2,0,5,1595390400,1595563200,2
Dikianify,0,2,0,2,1605589200,1605589200,2
smokeyb12,0,2,0,2,1585454400,1585454400,2
MDCCLVI,1,1,10967,19,1584936000,1601438400,2
Rosbj,0,2,0,13,1579150800,1580274000,2
heaven0nearth09,0,2,0,2,1593316800,1607144400,2
Franklet,0,2,0,15,1572062400,1572062400,2
ShifterSamy,0,2,0,-9,1572062400,1582434000,2
PotassiumBob,0,2,0,-11,1607662800,1607662800,2
maple_tiddies,0,2,0,5,1609304400,1611723600,2
AutoBot5,0,2,0,55,1602820800,1602820800,2
hugreseez,2,0,8,0,1529726400,1529726400,2
sloppyjoebob,0,2,0,39,1606539600,1607835600,2
VermhautsWormHat,0,2,0,56,1606107600,1606194000,2
Degen10110110,0,2,0,5,1606453200,1606453200,2
Financeandstuff2012,0,2,0,2,1586491200,1586491200,2
fantastupido,0,2,0,11,1594612800,1598760000,2
drrectum,0,2,0,-6,1590206400,1590292800,2
connor_baldoni,0,2,0,52,1595131200,1600488000,2
Journe1999,0,2,0,3,1606107600,1606107600,2
emopest,0,2,0,10,1573189200,1576731600,2
polskapeopleyay,0,2,0,16,1568347200,1568347200,2
artotal,0,2,0,6,1590206400,1608613200,2
MediocreMastermind,0,2,0,5,1573102800,1573275600,2
jidlar,0,2,0,11,1603857600,1603857600,2
Galyndean,0,2,0,8,1591243200,1591243200,2
BeautysBeast,0,2,0,2,1585454400,1585454400,2
Jables162,0,2,0,6,1600228800,1600228800,2
cavemancuisine,0,2,0,21,1594094400,1607230800,2
rizenphoenix13,0,2,0,6,1570248000,1570420800,2
YourMumIsAVirgin,0,2,0,-10,1606626000,1606626000,2
Hava_Nagila_73,1,1,283,1,1589428800,1595563200,2
PeachAndMint,1,1,831,17,1578286800,1578978000,2
thisahole,0,2,0,-14,1605589200,1606539600,2
DaSkullCrusher,0,2,0,11,1553659200,1569211200,2
xxel_psy_congroo,0,2,0,48,1573275600,1574485200,2
expeditionaree,1,1,13,2,1605157200,1605157200,2
Other-Coconut,0,2,0,2,1582002000,1582002000,2
KeimeiWins,0,2,0,3,1606539600,1606539600,2
Slurp_of_jelly,1,1,1707,3,1550552400,1550552400,2
Nothatsnothowitworks,0,2,0,3,1602475200,1602475200,2
Traditional-Chicken3,1,1,7,1,1609045200,1609131600,2
PsycoShrimp,0,2,0,10,1607144400,1607922000,2
commutingtexan,0,2,0,54,1572753600,1601524800,2
Underwater_Grilling,0,2,0,15,1606107600,1606107600,2
jbonosconi,1,1,15,1,1612069200,1612155600,2
KooK013,2,0,51,0,1482123600,1482123600,2
II_Sulla_IV,0,2,0,38,1577941200,1577941200,2
skeletonRiot,0,2,0,1,1589428800,1589515200,2
bootyd00d69,0,2,0,14,1549342800,1552363200,2
TheBatmann,0,2,0,20,1593057600,1605502800,2
jamiethemorris,0,2,0,66,1594008000,1603512000,2
jdguerr01,0,2,0,241,1578200400,1578200400,2
FlyingPS4Controller,1,1,2,-2,1599969600,1599969600,2
70system,0,2,0,3,1574485200,1575349200,2
SoapySapling,0,2,0,4,1608267600,1608440400,2
seylerius,0,2,0,14,1592971200,1607230800,2
wiking11b,0,2,0,18,1584072000,1584158400,2
ItsRaininMafuckas,0,2,0,5,1590379200,1590379200,2
UnlikelyPerogi,0,2,0,-28,1576818000,1576818000,2
InfiniteChimpWisdom,0,2,0,2,1573534800,1573534800,2
saucegerb,0,2,0,40,1599192000,1600920000,2
CriesOverEverything,0,2,0,-5,1599624000,1599624000,2
DudeImLoggedIn,0,2,0,9,1556510400,1564459200,2
neptune227,1,1,7,3,1595217600,1595304000,2
Propaganda_Box,1,1,42,8,1566014400,1597896000,2
g9icy,0,2,0,5,1602129600,1604898000,2
OnlyKindofaPanda,0,2,0,17,1594008000,1594008000,2
kimunication,0,2,0,-27,1604379600,1604379600,2
KeyboardSpiders,0,2,0,3,1599019200,1599019200,2
darkperil,0,2,0,6,1581224400,1591502400,2
tkyjonathan,0,2,0,2,1556596800,1556596800,2
becauseboomerang,0,2,0,75,1549602000,1550638800,2
marcioliver01,0,2,0,-9,1555992000,1581829200,2
AvielanderBright,1,1,13,34,1606107600,1606194000,2
clarkebino,0,2,0,19,1601179200,1601179200,2
JusticeBeaver94,0,2,0,3,1600747200,1601956800,2
remonacxy,0,2,0,20,1607230800,1608440400,2
moscatoandoj,0,2,0,17,1569384000,1569470400,2
jleile02,1,1,35,7,1590120000,1590120000,2
RichDicolus,0,2,0,2,1593921600,1594008000,2
-Coop-,0,2,0,13,1573707600,1585713600,2
Szudar,0,2,0,-16,1604293200,1604293200,2
Catastrophicallie,0,2,0,20,1595390400,1595390400,2
Layah091191,0,2,0,3,1606021200,1606021200,2
TheRealXen,0,2,0,35,1591243200,1600488000,2
sakinlook,1,1,100,8,1599364800,1599364800,2
GuacamoleGhost,0,2,0,3,1553486400,1563595200,2
Murky_Sense,1,1,10,63,1601092800,1602216000,2
danjohnsonson,0,2,0,15,1567656000,1599105600,2
suchislifemwahah,0,2,0,3,1606712400,1606712400,2
Angryandalwayswrong,0,2,0,23,1591243200,1591243200,2
heck_boi,0,2,0,-7,1608267600,1608267600,2
RoosterReturns,0,2,0,10,1548306000,1548306000,2
Christhephotographer,0,2,0,5,1584331200,1585454400,2
eyedeetentees,0,2,0,2,1606626000,1606626000,2
Embarassed_Tackle,0,2,0,10,1609045200,1609045200,2
tactical-chicken,0,2,0,13,1605157200,1607403600,2
parbug,0,2,0,-5,1602993600,1606107600,2
gratua,0,2,0,11,1608267600,1608354000,2
Redditsbernieboner,0,2,0,4,1590206400,1590206400,2
disfunkd,0,2,0,49,1577336400,1577336400,2
Laura_has_Secrets77,0,2,0,21,1606366800,1607922000,2
McGill4U,0,2,0,36,1545282000,1545886800,2
Arjvoet,0,2,0,7,1595131200,1596254400,2
safeword-is-moist,0,2,0,261,1569643200,1570248000,2
Digitalpun,0,2,0,4,1591243200,1591243200,2
todio,0,2,0,3,1565323200,1565496000,2
Murphnn,0,2,0,7,1561176000,1563249600,2
tylerderped,0,2,0,9,1603684800,1603684800,2
joshiethebossie,1,1,1465,37,1570507200,1570507200,2
Tcowstuff,0,2,0,2,1563249600,1563249600,2
571395,0,2,0,3,1574571600,1574571600,2
Insurrection_Prime2,0,2,0,3,1606712400,1606798800,2
Zerobeastly,0,2,0,4,1599019200,1599624000,2
HCDixon,0,2,0,4,1600660800,1600660800,2
airportwhiskey,0,2,0,19,1581397200,1605243600,2
1240mo,0,2,0,14,1541131200,1541217600,2
svfootball95,0,2,0,7,1594180800,1594180800,2
itskraiden,0,2,0,3,1576645200,1576645200,2
ThePickleJuice22,0,2,0,12,1576818000,1607576400,2
missesmackson,0,2,0,21,1598155200,1598155200,2
mrego212,0,2,0,-3,1605675600,1605675600,2
papayatwentythree,0,2,0,12,1606626000,1606626000,2
scottamus_prime,0,2,0,29,1559534400,1560657600,2
RedditorProfessional,1,1,16,3,1562990400,1563076800,2
UnshavenFlaps,0,2,0,16,1603339200,1603339200,2
ankhes,0,2,0,4,1570075200,1570075200,2
whizzythorne,0,2,0,28,1606453200,1606539600,2
stepaside22,1,1,22,2,1572408000,1572580800,2
mrsqueakyvoice97,0,2,0,25,1589860800,1602820800,2
TheMacPhisto,0,2,0,-11,1590033600,1590033600,2
redditaccount6754,0,2,0,12,1608440400,1609045200,2
cj3po15,0,2,0,3,1581224400,1581224400,2
jacknifejones,0,2,0,5,1598414400,1600574400,2
DiamondJulery,1,1,14,1,1599537600,1602648000,2
FuzzyJury,0,2,0,11,1602993600,1602993600,2
MickLittle,0,2,0,21,1585454400,1587009600,2
DrKnockOut99,0,2,0,-6,1576990800,1577077200,2
ConciousUniverse,0,2,0,4,1599105600,1599105600,2
mongrol-sludge,0,2,0,3,1600833600,1600833600,2
_DannyG_,0,2,0,52,1568001600,1568001600,2
dumdum-dolly,0,2,0,12,1568865600,1568865600,2
DUCATISLO,0,2,0,1,1601352000,1607317200,2
KayabaJac,0,2,0,9,1593835200,1593835200,2
Psiphistikkated,0,2,0,2,1607749200,1609477200,2
Odin-the-poet,0,2,0,32,1605243600,1607576400,2
zmoney92,0,2,0,7,1608699600,1608699600,2
Homeskin,0,2,0,4,1591502400,1599796800,2
Nunyabz7,1,1,442,3,1572667200,1572753600,2
carrot_farts,0,2,0,6,1588219200,1589947200,2
DAStrathdee,0,2,0,23,1579237200,1579323600,2
OfficialArgoTea,0,2,0,2,1598760000,1598760000,2
CharlieFreiheit,2,0,28,0,1570766400,1590292800,2
revoked09,0,2,0,128,1568001600,1568001600,2
ArtonFinx,0,2,0,12,1608181200,1608958800,2
saint-somnia,0,2,0,5,1572494400,1572843600,2
km377,0,2,0,22,1609304400,1609390800,2
Peeeeeeebs,0,2,0,2,1600488000,1605157200,2
Ikeaboo,0,2,0,3,1607490000,1607490000,2
Aviverse,0,2,0,5,1566187200,1566187200,2
JenkumTaker,0,2,0,10,1600228800,1600228800,2
Schniedelwoods,0,2,0,14,1595908800,1608613200,2
ianthenerd,0,2,0,3,1583470800,1583470800,2
AcrobaticHospital,0,2,0,2,1613970000,1613970000,2
kricket53,0,2,0,6,1583038800,1583211600,2
The-Dudemeister,0,2,0,7,1606280400,1606280400,2
ToraToraTilapia,0,2,0,6,1598846400,1599105600,2
Yogainthesquatrack,0,2,0,7,1549429200,1549429200,2
boxcarauman,0,2,0,74,1566792000,1567742400,2
what2d0i,0,2,0,62,1591934400,1591934400,2
awkwardAFlady,0,2,0,2,1609563600,1609650000,2
AshleyGames,0,2,0,7,1588737600,1602129600,2
gamma_centauri,0,2,0,173,1598932800,1599019200,2
Otec_Fedor,0,2,0,3,1605330000,1605330000,2
paddingtonmew,0,2,0,76,1600228800,1600228800,2
immortal_sniper1,0,2,0,3,1602820800,1607662800,2
technounicorns,0,2,0,46,1601870400,1605157200,2
abookamongstthemany,1,1,542,8,1605762000,1605762000,2
FrankZDuck,0,2,0,70,1597723200,1598760000,2
Dankhu3hu3,0,2,0,4,1608526800,1608699600,2
Onagda,0,2,0,2,1582434000,1582434000,2
ConstantlyMiserable,1,1,33,6,1566187200,1602993600,2
Good-Communication85,0,2,0,11,1595217600,1595217600,2
paraphasicdischarge,1,1,1695,26,1604379600,1604379600,2
mrkurtzz,0,2,0,14,1552276800,1589342400,2
apricotpaint,0,2,0,27,1569297600,1569297600,2
deepstatedavie,0,2,0,3,1605934800,1611550800,2
Raven_Skyhawk,0,2,0,37,1591329600,1603512000,2
Olzallen,0,2,0,-137,1607403600,1607403600,2
GalaxyMods,0,2,0,11,1575003600,1584417600,2
FairInvestigator,0,2,0,4,1592884800,1596168000,2
Apstds77,0,2,0,65,1604293200,1609045200,2
skulduggeryatwork,0,2,0,17,1517893200,1565582400,2
Hexpool,0,2,0,11,1579842000,1581397200,2
sasha_says,0,2,0,3,1550293200,1550293200,2
chill_gecko,0,2,0,-14,1608613200,1608699600,2
James_n_mcgraw,0,2,0,10,1571976000,1571976000,2
izut,0,2,0,65,1599796800,1600488000,2
CarpenterRadio,0,2,0,53,1595908800,1596168000,2
rageagainstthewage,0,2,0,3,1605589200,1605589200,2
gunjy-mouse,0,2,0,-12,1571544000,1571544000,2
Jumpy_Sorbet,0,2,0,4,1609390800,1609390800,2
_UNFUN,0,2,0,49,1592798400,1595563200,2
delusiona1,0,2,0,17,1568260800,1575608400,2
mangolassihoe,1,1,33,7,1558497600,1559707200,2
bluethegreat1,0,2,0,4,1608872400,1608872400,2
sarcasticsam21,0,2,0,2,1598932800,1598932800,2
venusianlover,0,2,0,14,1606194000,1606194000,2
TomTrybull,0,2,0,17,1575349200,1575349200,2
KelseyAnn94,0,2,0,-9,1594440000,1594440000,2
ario27,0,2,0,27,1607403600,1609218000,2
thenewaddition,0,2,0,42,1584763200,1584763200,2
susanna514,0,2,0,3,1604030400,1607749200,2
chryseobacterium,0,2,0,5,1573016400,1606626000,2
peternorrut,0,2,0,5,1582434000,1589256000,2
nburck,0,2,0,7,1607317200,1607922000,2
sittingbullms,0,2,0,-20,1595649600,1595649600,2
Soonergary,0,2,0,10,1597723200,1604898000,2
Windrider91,0,2,0,95,1584331200,1607317200,2
morassmermaid,0,2,0,20,1569211200,1605934800,2
Bear_of_Flowers,0,2,0,12,1607662800,1607749200,2
hannahbellee,0,2,0,110,1579755600,1595304000,2
TheBreathofFiveSouls,0,2,0,2,1572148800,1597291200,2
Duke_of_Ninth,0,2,0,4,1606971600,1608008400,2
amerkanische_Frosch,0,2,0,-8,1570334400,1570334400,2
Meliflu0us_,0,2,0,5,1605502800,1605502800,2
Wuellig,2,0,70,0,1602820800,1603339200,2
SlowJackMcCrow,0,2,0,-40,1600833600,1600833600,2
Vlad300,0,2,0,1,1563854400,1563854400,2
switchbackcorvid,0,2,0,2,1580446800,1580533200,2
valorsayles,0,2,0,7,1598587200,1598587200,2
you_wanka,0,2,0,7,1606885200,1606885200,2
dingo_bat,0,2,0,-20,1588564800,1588564800,2
jositoxdxd,0,2,0,-9,1591243200,1591243200,2
gurnumbles,0,2,0,4,1584936000,1585022400,2
General_Napoli,0,2,0,3,1607749200,1607749200,2
rngesus_christus,0,2,0,334,1589774400,1596168000,2
Puc,0,2,0,4,1606712400,1608094800,2
BruhNertia,0,2,0,5,1569988800,1569988800,2
Gulopithecus,0,2,0,318,1603339200,1607662800,2
moonjunkie,0,2,0,5,1557806400,1557806400,2
HuntinJiveTurkeys,0,2,0,0,1589860800,1590724800,2
overbeb,0,2,0,3,1596254400,1596340800,2
justaguy394,0,2,0,7,1575867600,1592107200,2
TheSorcerersNut,0,2,0,48,1605416400,1605416400,2
iamchineese,0,2,0,-9,1596772800,1596772800,2
soberscotsman80,0,2,0,13,1595563200,1605589200,2
jaiminrajani,2,0,701,0,1598328000,1608526800,2
alittleknitty,0,2,0,7,1596600000,1600833600,2
brainfog2016,0,2,0,8,1569816000,1569816000,2
ahungrylilsandwhich,0,2,0,3,1606626000,1606626000,2
quote12,0,2,0,4,1600056000,1600142400,2
AlastairWyghtwood,2,0,175,0,1592798400,1594008000,2
Adam__Zapple,0,2,0,4,1608526800,1608613200,2
ZeldaMudkip,1,1,12,2,1604293200,1604293200,2
polytwoglass,0,2,0,33,1594180800,1594180800,2
Fresh_Letterhead,0,2,0,3,1591329600,1591329600,2
ktulu_33,0,2,0,12,1589688000,1593921600,2
Mdmerafull,0,2,0,20,1573448400,1573534800,2
Drycabin1,0,2,0,18,1599796800,1599796800,2
gerlindee,0,2,0,6,1592280000,1602820800,2
Mary674,1,1,32,34,1555905600,1568347200,2
explosivelydehiscent,0,2,0,8,1595908800,1595908800,2
blackrose4242,0,2,0,-2,1577336400,1577422800,2
ArmadilloAl,0,2,0,14,1604379600,1604379600,2
LaBrisho,0,2,0,25,1581483600,1583470800,2
IsThisTheOpus,1,1,11,0,1605675600,1605675600,2
turkey_sandwiches,0,2,0,6,1585454400,1585454400,2
baroncockalorum,0,2,0,19,1559275200,1559275200,2
Omniventurous,0,2,0,5,1599364800,1606453200,2
put_the_record_on,0,2,0,3,1607662800,1608613200,2
horror_cheese,1,1,0,1,1594094400,1594094400,2
TAZ2532,0,2,0,2,1608526800,1608526800,2
Pyroexplosif,0,2,0,-53,1606194000,1606194000,2
Onlineinternetadvice,0,2,0,-45,1604030400,1607749200,2
WeepingAnusSores,0,2,0,2,1595304000,1595304000,2
GoodFlavor,0,2,0,41,1602388800,1606626000,2
BigBotCock,0,2,0,6,1597377600,1597377600,2
1UglyDuck,2,0,263,0,1583038800,1585022400,2
Tug_Flanders,0,2,0,193,1589428800,1594008000,2
allinthegamingchair,0,2,0,2,1571976000,1571976000,2
SweetTomorrow,0,2,0,8,1552276800,1556510400,2
PitifulKangaroo,0,2,0,9,1581051600,1607490000,2
ModsSpreadPropaganda,0,2,0,-8,1607576400,1607922000,2
kat_fud,0,2,0,27,1566446400,1572753600,2
Jwalls5096,0,2,0,15,1601870400,1608958800,2
Manof_theFuture,0,2,0,16,1600660800,1600660800,2
hihellowhatsupyo,0,2,0,3,1591156800,1591156800,2
VulpineCommander,0,2,0,81,1586923200,1586923200,2
ChilledPorn,0,2,0,47,1578718800,1579150800,2
camp-cope,0,2,0,12,1559620800,1559707200,2
PepperCake21,0,2,0,16,1598068800,1602820800,2
glapulapu112,0,2,0,20,1598587200,1611896400,2
c00chie_slayer,0,2,0,2,1575608400,1575608400,2
Observerwwtdd,0,2,0,30,1569988800,1585972800,2
AboveFiction,0,2,0,9,1598155200,1605848400,2
rosco2155,0,2,0,3,1601265600,1607230800,2
slothbossdos,1,1,14,4,1547960400,1564718400,2
GodspeedInfinity,0,2,0,104,1608094800,1608267600,2
TTheorem,0,2,0,11,1575522000,1600574400,2
thomawalk,0,2,0,4,1582434000,1586145600,2
heyheyluno,0,2,0,5,1598068800,1598241600,2
Eagleeye412,0,2,0,12,1565928000,1569988800,2
Garlik85,0,2,0,4,1611982800,1611982800,2
Electronic-Fact6618,1,1,0,2,1608526800,1608526800,2
Dal__,0,2,0,5,1605330000,1605330000,2
look_up_the_NAP,0,2,0,-39,1606626000,1612069200,2
Shaltharis,0,2,0,12,1608181200,1608267600,2
CountryJeff,0,2,0,46,1608699600,1609304400,2
freeturkeytaco,0,2,0,-1,1578891600,1609390800,2
sibbanac,0,2,0,5,1607058000,1607058000,2
jahwls,0,2,0,305,1609390800,1609477200,2
DirtieHarry,0,2,0,26,1566360000,1566446400,2
Top_Banana78,0,2,0,3,1608440400,1608440400,2
MrSomnix,0,2,0,65,1570334400,1598846400,2
WatermelonWarlord,0,2,0,13,1586318400,1586318400,2
Lambo911q,0,2,0,5,1580187600,1580187600,2
whyevenbothersmh,0,2,0,-5,1606626000,1606885200,2
Introsium,0,2,0,16,1551589200,1554955200,2
Reddituser2521,0,2,0,3,1580792400,1580792400,2
_McFluffin_,0,2,0,13,1606626000,1606626000,2
pantylion,0,2,0,5,1592712000,1592712000,2
SayWhatAgainMFPNW,0,2,0,2,1601524800,1601524800,2
MyPacman,0,2,0,6,1603512000,1603512000,2
backflip,0,2,0,9,1601524800,1601611200,2
lkiimera,0,2,0,-22,1568865600,1568952000,2
wingman361,1,1,206,1,1599278400,1599364800,2
SnooCalculations6304,0,2,0,22,1606626000,1609822800,2
anonimitea,1,1,96,3,1547874000,1547874000,2
BurkusCat,0,2,0,66,1601179200,1601179200,2
Paetur,0,2,0,20,1598760000,1598760000,2
SoRawSoRight,0,2,0,18,1604293200,1607922000,2
scbp7,0,2,0,5,1580101200,1580101200,2
qonkwan,0,2,0,10,1603512000,1603598400,2
KISSOLOGY,0,2,0,37,1607749200,1609131600,2
Josh_Woodward,0,2,0,16,1603684800,1604116800,2
crystaltay13,0,2,0,3,1600747200,1607317200,2
Sukh_Aa,2,0,1152,0,1576645200,1578027600,2
nojbro,0,2,0,5,1606539600,1608267600,2
c0smix,0,2,0,6,1563940800,1565150400,2
voteferpedro,0,2,0,0,1594267200,1594267200,2
vreddit123,0,2,0,8,1582952400,1600574400,2
TheJudgeAt425,0,2,0,3,1604379600,1609045200,2
i-am-guy,0,2,0,15,1568692800,1569729600,2
vendetta2115,0,2,0,5,1603512000,1603512000,2
population_of_china,0,2,0,25,1594353600,1594353600,2
mrt-e,0,2,0,95,1581483600,1582347600,2
Negativefalsehoods,0,2,0,11,1571803200,1571803200,2
robert_sanvagene,0,2,0,3,1573966800,1573966800,2
ThrowawayWorker10293,1,1,9,9,1592020800,1592020800,2
Kamron_J1999,0,2,0,8,1601524800,1601524800,2
Spaghettitrees,0,2,0,7,1611982800,1611982800,2
Darl1ngN1kk1,0,2,0,8,1589428800,1589428800,2
CamBen42,0,2,0,12,1599969600,1600056000,2
onisuke1997,0,2,0,2,1592798400,1592798400,2
stumblingwitch,0,2,0,26,1608699600,1608872400,2
frossenkjerte,0,2,0,6,1590897600,1593489600,2
StrangeDrivenAxMan,0,2,0,44,1573707600,1573707600,2
GalaxyDreamer0815,1,1,17,3,1552194000,1552276800,2
timid_tzimisce,0,2,0,4,1599710400,1600488000,2
wickerbitchhh,0,2,0,11,1567569600,1567828800,2
jrock1888,0,2,0,8,1594526400,1605157200,2
theeCyclops,0,2,0,12,1564891200,1565668800,2
kimj0ng-illin,1,1,7,1,1582779600,1582866000,2
BlameableEmu,0,2,0,2,1584936000,1584936000,2
Lord_Iggy,0,2,0,8,1603512000,1603598400,2
ViseMesaUBureke,1,1,0,-2,1591156800,1591156800,2
WestCoLouis,0,2,0,-23,1575608400,1575781200,2
Covet_bon_Vivant,0,2,0,2,1580533200,1582261200,2
canausernamebetoolon,2,0,29,0,1393218000,1434513600,2
DivineScience,0,2,0,6,1596686400,1596686400,2
Guapscotch,0,2,0,103,1599883200,1600833600,2
KingNate721,0,2,0,73,1588305600,1591934400,2
furzibaerli,0,2,0,31,1598760000,1605243600,2
friskysteve001,0,2,0,29,1539835200,1555905600,2
borborgym,1,1,7,5,1592539200,1595736000,2
portabledavers,0,2,0,10,1559793600,1560744000,2
dontDMme,0,2,0,-1,1604116800,1604725200,2
skwizpod,1,1,28,13,1572148800,1595304000,2
MarmaladeBeatsJam,1,1,1,7,1539921600,1539921600,2
g-alice-,0,2,0,8,1607576400,1608958800,2
greeneyedlady30,0,2,0,3,1598068800,1598068800,2
Pigeoncake1,0,2,0,3,1564977600,1565064000,2
MAINEiac4434,2,0,111,0,1552107600,1552194000,2
Sace926,0,2,0,106,1559620800,1593057600,2
Kaluan23,0,2,0,8,1608440400,1611982800,2
TheLazyBuffalo,0,2,0,4,1584244800,1592539200,2
YeellowDinisaur,0,2,0,41,1544504400,1547614800,2
endtimesforever,1,1,32,1,1598500800,1598500800,2
FoxyFoxMulder,1,1,8,1,1586404800,1586404800,2
xMarxxxthespot,0,2,0,16,1567310400,1572667200,2
silly_curious,0,2,0,19,1588910400,1589428800,2
EverybodysGrandma,1,1,25,1,1604984400,1604984400,2
johnzo6667,0,2,0,4,1605934800,1609218000,2
athena702,0,2,0,20,1557460800,1558584000,2
twelvebucksagram,0,2,0,225,1577336400,1578459600,2
AdamSingleton,0,2,0,2,1605416400,1605416400,2
burntoast43,0,2,0,19,1582088400,1590724800,2
muffinpie101,0,2,0,7,1604203200,1604203200,2
bigmanoncrampus,0,2,0,32,1573534800,1573966800,2
kloymusic,2,0,30,0,1604466000,1607749200,2
LiberalKiwi,1,1,0,1,1551243600,1551243600,2
JohnConnor7,0,2,0,58,1589342400,1607922000,2
coffeeyayaya,0,2,0,47,1564027200,1564027200,2
elle2011,0,2,0,9,1546923600,1561953600,2
--MxM--,0,2,0,35,1594699200,1594872000,2
Trancefuzion,0,2,0,42,1580792400,1605157200,2
K_ObV,0,2,0,40,1576731600,1583211600,2
sockmess,0,2,0,3,1603598400,1603598400,2
linqueque,0,2,0,5,1571803200,1576213200,2
Bzevans,0,2,0,6,1612069200,1612069200,2
InvisiblePinkUnic0rn,0,2,0,11,1608008400,1608094800,2
Iridemhard,0,2,0,1,1600574400,1600833600,2
Captain_Rags,0,2,0,179,1582088400,1582088400,2
turbotub,0,2,0,2,1590379200,1590379200,2
urbisOrbis,0,2,0,28,1598587200,1598846400,2
C21H27Cl3N2O3,0,2,0,39,1589860800,1589860800,2
_hemlocktea_,0,2,0,21,1577595600,1578459600,2
catbosspgh,0,2,0,19,1603512000,1603512000,2
WatAb0utB0b,0,2,0,11,1605070800,1611982800,2
TheAngryAudino,0,2,0,26,1560398400,1565582400,2
EDSKushQueen,0,2,0,5,1593576000,1595476800,2
Maester_Shits-A-Lot,0,2,0,38,1585108800,1588910400,2
Nak_Tripper,0,2,0,-6,1550293200,1550293200,2
br094,1,1,0,1,1570075200,1570075200,2
Thanhansi-thankamato,0,2,0,3,1606626000,1608958800,2
Babyrabbitheart,0,2,0,32,1605502800,1605502800,2
victor871129,0,2,0,5,1608872400,1612069200,2
Catchaway1000,0,2,0,8,1606971600,1606971600,2
FreudianMilquetoast,0,2,0,366,1603598400,1603684800,2
sacredse7en,0,2,0,6,1546750800,1548392400,2
Jen_Dash,0,2,0,9,1596859200,1596859200,2
throwthisTFaway01,0,2,0,24,1606626000,1606626000,2
zaliska1,0,2,0,20,1606712400,1608181200,2
schnokobaer,0,2,0,26,1577422800,1578114000,2
childofasphalt,1,1,9,2,1565668800,1565668800,2
arrogantprick1984,0,2,0,-2,1585108800,1591243200,2
TrashTsarina,1,1,2,9,1601265600,1606798800,2
JorgeXMcKie,0,2,0,122,1587787200,1587873600,2
moneyforsoy,1,1,2815,15,1578978000,1578978000,2
DTFH_,0,2,0,7,1609045200,1609045200,2
Ma5xy,0,2,0,7,1591243200,1591243200,2
Valdanos,0,2,0,4,1594353600,1594353600,2
13speed,0,2,0,-9,1577250000,1577336400,2
fuckyouyoufuckingcun,1,1,253,19,1582002000,1582002000,2
just_inforfun,0,2,0,0,1600747200,1604379600,2
ImSoSorry4BeingWhite,0,2,0,-21,1606798800,1606798800,2
EidolonGama,0,2,0,5,1609045200,1609045200,2
Kill_the_rich999,0,2,0,38,1605502800,1612069200,2
IamaVigilante,0,2,0,3,1606626000,1606626000,2
lalou87-,0,2,0,4,1606021200,1606021200,2
ZebraSyndromeGaming,0,2,0,16,1599969600,1600056000,2
HollowB0i,0,2,0,4,1608267600,1608267600,2
dunderpatron,0,2,0,3,1596772800,1596772800,2
Mikekevlar,0,2,0,4,1565323200,1565323200,2
cloudofbastard,0,2,0,319,1584331200,1584331200,2
shininghappyfuckface,0,2,0,8,1578027600,1578027600,2
TooDoneToCare,0,2,0,13,1588737600,1588737600,2
spezaltaccount,1,1,18,6,1592193600,1592193600,2
upside-down-11,0,2,0,23,1589083200,1589169600,2
GriffShama,0,2,0,15,1601006400,1602820800,2
BrendanTheHippy,0,2,0,32,1576299600,1589860800,2
AFriend07,0,2,0,3,1590811200,1593489600,2
doubleddutch,0,2,0,-101,1582606800,1582606800,2
JordanSM,0,2,0,-8,1585454400,1585454400,2
jfk6767,0,2,0,2,1591329600,1595908800,2
dotBSS,1,1,2,5,1604638800,1604811600,2
immacatgirl,0,2,0,42,1585454400,1585540800,2
holga_pataki,0,2,0,12,1570507200,1570593600,2
brutus07,0,2,0,42,1605502800,1605502800,2
wishno,0,2,0,1,1589601600,1589601600,2
axa13,0,2,0,7,1498104000,1508385600,2
dizzystar34,0,2,0,2,1604379600,1604466000,2
TheLonelyBanana117,0,2,0,2,1609304400,1609477200,2
Papaya_Ninja,0,2,0,-16,1559966400,1559966400,2
researchMaterial,0,2,0,6,1570161600,1598846400,2
Adam722,0,2,0,7,1582520400,1582520400,2
butterflyxgarden,0,2,0,4,1582779600,1585195200,2
BlankTard,0,2,0,4,1606626000,1606626000,2
Verovid,0,2,0,6,1598760000,1598760000,2
crizpy9119,0,2,0,18,1563768000,1580619600,2
creole_vietnam,0,2,0,7,1602388800,1603512000,2
sammorest,0,2,0,3,1603512000,1603512000,2
posas85,0,2,0,8,1603512000,1603684800,2
jeeveless,0,2,0,28,1582347600,1584590400,2
Just4NormalMortys,0,2,0,10,1576472400,1605502800,2
ObeseMoreece,0,2,0,0,1591329600,1591329600,2
mule_roany_mare,0,2,0,8,1611896400,1611982800,2
sleepydorian,0,2,0,2,1605934800,1605934800,2
notaprotist,0,2,0,105,1567051200,1604379600,2
genericusername724,0,2,0,1,1575349200,1589083200,2
Zenlura,0,2,0,-10,1588737600,1588737600,2
xbroodmetalx,0,2,0,2,1607749200,1607749200,2
QuantumDex,0,2,0,3,1603512000,1603512000,2
SimonRitchie79,0,2,0,11,1589860800,1603857600,2
Cinnamonstik,0,2,0,3,1593662400,1593662400,2
CptGuava,1,1,0,2,1594872000,1597032000,2
dngaay,0,2,0,22,1563249600,1564459200,2
yommish,0,2,0,4,1601611200,1601611200,2
wilsonvilleguy,0,2,0,7,1606021200,1606021200,2
Ketamine_is_Great,0,2,0,68,1575176400,1575176400,2
Myreda,0,2,0,14,1605416400,1605416400,2
politicombat,0,2,0,-7,1591243200,1591243200,2
Lainey444,0,2,0,3,1587441600,1606626000,2
Mahlet__,1,1,1006,8,1576645200,1576731600,2
JKDS87,0,2,0,38,1601870400,1602388800,2
twitterlinkbot,0,2,0,7,1549688400,1549947600,2
dbergeron1,0,2,0,2,1574139600,1575608400,2
lll----------lll,0,2,0,40,1605243600,1606280400,2
grednforgesgirl,0,2,0,17,1582520400,1603512000,2
kudzuwirewraps,1,1,26,7,1584417600,1586836800,2
Recky-Markaira,1,1,7,2,1605675600,1605675600,2
nvPilot,0,2,0,2,1611723600,1612155600,2
TheLostInayat,0,2,0,106,1608872400,1608872400,2
AlCatSplat,0,2,0,1,1594612800,1594612800,2
Maleficent_Barnacle3,0,2,0,-11,1597723200,1597723200,2
thebaconator710,0,2,0,33,1595476800,1603252800,2
Elainye,0,2,0,11,1577682000,1604379600,2
sniperhare,0,2,0,109,1594267200,1594353600,2
ItsTHCx,0,2,0,69,1599537600,1609045200,2
hallowcorehammer,0,2,0,3,1603512000,1603512000,2
GeorgesTurdBlossom,0,2,0,4,1579237200,1579323600,2
BkobDmoily,0,2,0,23,1538884800,1541480400,2
Skadumdums,0,2,0,4,1585454400,1585454400,2
girlelectric1,0,2,0,2,1605502800,1605502800,2
treydays,2,0,506,0,1595304000,1597204800,2
EvolutionX2,0,2,0,6,1609045200,1609131600,2
cybergaiato,0,2,0,8,1598068800,1598241600,2
_another_i,1,1,14,2,1606626000,1614661200,2
SirSaltie,1,1,4,1,1546923600,1547010000,2
itsmehonest,0,2,0,9,1586750400,1586750400,2
pieceofshit321,0,2,0,4,1602561600,1609218000,2
yoitsmollyo,0,2,0,2,1598500800,1598760000,2
gmbaker44,0,2,0,4,1576645200,1576645200,2
rakkoma,0,2,0,2,1592798400,1592798400,2
TheUnholyFrijole,1,1,16,3,1591243200,1591502400,2
TexasT-bag,0,2,0,27,1570852800,1571112000,2
dendawg,0,2,0,3,1591156800,1607922000,2
MattMoose23,0,2,0,23,1544590800,1605416400,2
j-neiman,0,2,0,13,1602129600,1605589200,2
Soleniae,0,2,0,7,1596686400,1596686400,2
SPoopa83,0,2,0,31,1597982400,1597982400,2
Noobsaibot225,0,2,0,15,1606626000,1606626000,2
xJewelz17,0,2,0,2,1550466000,1550466000,2
Little_Noah,0,2,0,50,1598068800,1607317200,2
AviationLift,0,2,0,16,1603252800,1603252800,2
syamil95,1,1,67,4,1604898000,1604898000,2
whachamacallme,0,2,0,103,1559793600,1562558400,2
revolverdoesntocelot,0,2,0,2,1568952000,1568952000,2
-HumphreyBoggart-,0,2,0,62,1606626000,1606626000,2
thewarrenisempty,0,2,0,57,1573966800,1573966800,2
skrrtoff,0,2,0,3,1582693200,1582693200,2
HammerfallDropTurret,0,2,0,6,1606885200,1607662800,2
WeGonnaBChampionship,0,2,0,3,1585972800,1585972800,2
RecklessWreck87,0,2,0,19,1584072000,1594008000,2
mbobcik,0,2,0,4,1555300800,1555473600,2
dys4ik,0,2,0,11,1571371200,1571371200,2
dcotoz,0,2,0,27,1608613200,1608699600,2
OfficerLollipop,0,2,0,5,1589688000,1589688000,2
Brisket_Queen,0,2,0,76,1582779600,1586664000,2
Illustrious_Name6454,0,2,0,3,1617336000,1617336000,2
UselessSound,0,2,0,5,1607835600,1607835600,2
pottyandballpits,1,1,183,4,1573448400,1596600000,2
meander8,0,2,0,7,1607662800,1608699600,2
just_a_friENT,0,2,0,3,1604552400,1604638800,2
datums,0,2,0,5,1597636800,1608354000,2
AlligatorCrocodile16,0,2,0,31,1594008000,1605070800,2
Infinitenigmatic,0,2,0,2,1606885200,1606885200,2
jobless_ujjwal2,0,2,0,36,1554436800,1562040000,2
techn9neiskod,0,2,0,35,1605070800,1608008400,2
readzalot1,0,2,0,234,1588046400,1590984000,2
GCILishuman,0,2,0,47,1584244800,1604293200,2
hell_man_karma_demon,0,2,0,10,1605502800,1605502800,2
Deep_Green_Fireflies,0,2,0,2,1613019600,1613019600,2
BaylisAscaris,0,2,0,12,1559102400,1594008000,2
MerryJustice,0,2,0,4,1581570000,1584590400,2
fly_the_plane,0,2,0,7,1581829200,1590033600,2
kiripon,1,1,16,3,1604898000,1604984400,2
sunshineonmypussy,0,2,0,101,1581656400,1591156800,2
winbig59,0,2,0,4,1590465600,1590552000,2
crod242,0,2,0,22,1542430800,1543208400,2
OceLawless,0,2,0,19,1609045200,1609045200,2
richiusvantran,0,2,0,9,1569643200,1581570000,2
forestpro_1,0,2,0,5,1599969600,1599969600,2
pterodactyl12,0,2,0,26,1569124800,1581915600,2
happyfappy,0,2,0,1,1546405200,1546405200,2
bridymurphy,0,2,0,16,1608354000,1608526800,2
ListenMinute,0,2,0,4,1616731200,1617163200,2
pajinkle,0,2,0,16,1582347600,1583557200,2
krkonos,0,2,0,29,1581138000,1581224400,2
Mercurio7,0,2,0,2,1540008000,1540008000,2
RudeInternet,0,2,0,16,1598760000,1608267600,2
noov101,0,2,0,-2,1611982800,1611982800,2
isogriv,0,2,0,2,1604030400,1605416400,2
batmilk9,0,2,0,223,1604811600,1604811600,2
Verlaando,0,2,0,17,1602043200,1602043200,2
Fuckyou62,0,2,0,18,1579755600,1601524800,2
Leonhearted,0,2,0,7,1548738000,1556424000,2
KarateKid84Fan,0,2,0,3,1604379600,1606021200,2
elmeromero718,0,2,0,21,1588392000,1588392000,2
illumillama,0,2,0,4,1584590400,1607317200,2
somethingarb,0,2,0,3,1579669200,1579669200,2
DontHateNate,0,2,0,21,1609218000,1609218000,2
LasagaMan,0,2,0,24,1567569600,1573275600,2
Holly_Koro,0,2,0,57,1606366800,1606366800,2
JangoJake,1,1,21,7,1599364800,1599364800,2
AndreasVesalius,0,2,0,57,1553486400,1570075200,2
Dovahkiin4e201,0,2,0,11,1578286800,1580187600,2
harcole,0,2,0,2,1597896000,1597982400,2
MostProfessor,0,2,0,13,1604116800,1607144400,2
dantoucan,0,2,0,191,1598760000,1598760000,2
LovesLocksYT,1,1,72,21,1555992000,1555992000,2
HarroldBushman,0,2,0,30,1609477200,1609477200,2
FlawsAndConcerns,0,2,0,-2,1600747200,1600747200,2
LaceChewy,0,2,0,-10,1609304400,1609304400,2
MTVnext2005,0,2,0,7,1598155200,1598155200,2
Ratswamp95,0,2,0,14,1600142400,1601265600,2
ElanEclat,0,2,0,3,1593921600,1604203200,2
Zoomer4206969,0,2,0,34,1577163600,1578459600,2
Fartfetish_gentleman,0,2,0,15,1578978000,1578978000,2
justadudenameddave,0,2,0,15,1569211200,1600142400,2
penis_rinkle,0,2,0,8,1585454400,1585454400,2
kendrokimed,0,2,0,5,1584590400,1585022400,2
lusinstrella,0,2,0,170,1574485200,1574571600,2
eatcuntsdaily,1,1,0,-3,1600228800,1600228800,2
bored-plutocrat,1,1,7,3,1518066000,1523246400,2
_-LOLocaust-_,0,2,0,13,1583899200,1584504000,2
pr3me,0,2,0,125,1548392400,1548910800,2
malganis12,0,2,0,3,1580187600,1580187600,2
4444Stricture,0,2,0,54,1597809600,1597896000,2
longboard_building,0,2,0,2,1572235200,1572580800,2
nope6point022e23,0,2,0,13,1588910400,1594353600,2
Itsallanonswhocares,0,2,0,43,1590638400,1593662400,2
ExceedinglyGaySlime,0,2,0,9,1590552000,1590552000,2
paulsonyourchin,0,2,0,6,1571025600,1571112000,2
Lexiconicx,1,1,22,2,1574658000,1574658000,2
Pebbledlikestoned,0,2,0,27,1595649600,1607749200,2
REELxMULLINS,0,2,0,-1,1598673600,1598673600,2
Jawazan,0,2,0,97,1560484800,1560916800,2
poemsofadork,0,2,0,5,1595995200,1595995200,2
ForTheBread,0,2,0,36,1591588800,1600747200,2
imadudebrosif,0,2,0,2,1575262800,1575349200,2
MrMxylptlyk,0,2,0,3,1603771200,1604030400,2
kapo513,0,2,0,3,1600833600,1611982800,2
TheEsophagus,0,2,0,4,1611982800,1612155600,2
dope_yeti,1,1,415,20,1586404800,1593057600,2
high-and-seek,0,2,0,26,1599710400,1601524800,2
arcrinsis,0,2,0,11,1569816000,1569816000,2
introvertedbassist,0,2,0,16,1567569600,1569124800,2
SucculentSushi,0,2,0,17,1601870400,1602129600,2
novagenesis,0,2,0,10,1535601600,1535688000,2
pinchecody,0,2,0,2,1571025600,1582693200,2
herinapotter,0,2,0,7,1571457600,1571803200,2
WingLeviosa,0,2,0,-5,1573016400,1573189200,2
StephenDawg,0,2,0,2,1604811600,1604811600,2
balakazez,0,2,0,3,1592366400,1592366400,2
TheKolbrin,0,2,0,2,1572235200,1572235200,2
TenWholeBees,0,2,0,27,1608008400,1608008400,2
Mr__Random,0,2,0,11,1582088400,1582347600,2
marvelmakesmehappy2,0,2,0,21,1567569600,1567569600,2
aaros47,0,2,0,-4,1572930000,1589860800,2
anonmarmot,1,1,190,2,1575781200,1580101200,2
robbak,0,2,0,22,1605589200,1605589200,2
Nnyxl,0,2,0,5,1608267600,1608267600,2
MsBeeslyifurnasty,1,1,14,1,1605502800,1605502800,2
Eklectus,0,2,0,6,1602216000,1602302400,2
soggypeanutbrittle,0,2,0,5,1611896400,1611896400,2
Theuderic,0,2,0,4,1590292800,1590292800,2
ACAB187,0,2,0,48,1567742400,1595822400,2
dizzira_blackrose,0,2,0,13,1578632400,1579064400,2
Cupcake_Octopus,0,2,0,60,1608267600,1608354000,2
_FROOT_LOOPS_,0,2,0,27,1576645200,1576645200,2
GetRektSSoon,0,2,0,489,1608008400,1608440400,2
suicune1234,0,2,0,-19,1588910400,1604293200,2
Beautiful_Half,0,2,0,2,1567569600,1567828800,2
Jesus-balls,1,1,1645,2,1609131600,1609304400,2
pyroblastlol,0,2,0,6,1597809600,1597809600,2
mrvinD,1,1,48,2,1598414400,1609304400,2
milaSalafaio,0,2,0,20,1605762000,1606712400,2
Liberated__SOUL,0,2,0,6,1602907200,1607662800,2
mrpo_rainfall,1,1,559,2,1558324800,1568606400,2
MiniMissSquee,1,1,3,1,1606626000,1606626000,2
VIIIVIIIVIXXXII,0,2,0,5,1523937600,1526616000,2
inippropriate,0,2,0,69,1596340800,1597636800,2
racinganon,0,2,0,4,1576213200,1576386000,2
truthneedsnodefense,1,1,11,5,1609304400,1609477200,2
LordJesterTheFree,0,2,0,12,1609304400,1609390800,2
insidedynamite,0,2,0,12,1604030400,1607144400,2
WallScreamer,1,1,41,6,1601611200,1601611200,2
napkween,1,1,42,6,1600142400,1602734400,2
corndoginsurgent,0,2,0,2,1600660800,1608267600,2
Marialagos,0,2,0,0,1606539600,1606539600,2
not-a-memorable-name,0,2,0,8,1603598400,1603598400,2
Kflynn1337,0,2,0,13,1603512000,1603771200,2
jedberg,0,2,0,7,1612069200,1612069200,2
kawaii--,0,2,0,9,1601956800,1608786000,2
adk44534534,1,1,8,2,1599019200,1599019200,2
zxcv46,0,2,0,0,1555732800,1555819200,2
joesbagofdonuts,0,2,0,-32,1576558800,1576558800,2
burningmuscles,0,2,0,4,1597204800,1599192000,2
BeardiesRule112,0,2,0,42,1606453200,1608008400,2
total_life_forever,0,2,0,39,1603166400,1603166400,2
dr_jr_president_phd,0,2,0,21,1584504000,1611810000,2
_i_like_comment_but,0,2,0,2,1585540800,1585540800,2
newedmbestof2013mix,0,2,0,2,1526788800,1589169600,2
haus_of_kraus,1,1,8,1,1560139200,1560484800,2
ASoft7,0,2,0,99,1603339200,1603339200,2
phuk-nugget,0,2,0,16,1559275200,1559361600,2
Bomcom,0,2,0,10,1602388800,1602820800,2
Loveisforclosersonly,0,2,0,32,1569988800,1572321600,2
OKEVP,0,2,0,5,1556424000,1559448000,2
7OVO7,0,2,0,4,1611810000,1611810000,2
EverythingIsBollocks,0,2,0,76,1598241600,1600574400,2
WuzatReit,0,2,0,0,1605675600,1605675600,2
LAPIS_AND_JASPER,0,2,0,3,1608267600,1608440400,2
Betruul,0,2,0,17,1572235200,1578373200,2
bluebell08,1,1,24,5,1602734400,1604466000,2
kthequick,0,2,0,2,1610168400,1610859600,2
WHISPER_ME_HEIGHT,0,2,0,4,1608699600,1608699600,2
SicilianEggplant,0,2,0,7,1605589200,1605589200,2
matthias7600,0,2,0,5,1603512000,1603512000,2
AltusVultur,0,2,0,2,1595304000,1601870400,2
bballbabs163,1,1,29,2,1605589200,1605589200,2
Welcome2_Reddit,0,2,0,38,1596859200,1597291200,2
akciire,1,1,11,3,1595131200,1595131200,2
Forbeslab,0,2,0,2,1598414400,1598414400,2
Freezy_1,1,1,27,18,1561780800,1566187200,2
Smashmix95,0,2,0,1,1568347200,1568433600,2
2kool2post,0,2,0,5,1590033600,1592798400,2
Pixelology,0,2,0,2,1612069200,1612069200,2
ProctologistUngloved,0,2,0,7,1575435600,1575435600,2
rewkom,2,0,16,0,1575262800,1579237200,2
icantdeciderightnow,0,2,0,5,1604293200,1607058000,2
KaperKorn,0,2,0,3,1608526800,1608526800,2
funked1,0,2,0,13,1547874000,1548651600,2
sicknastybr0,0,2,0,3,1598068800,1599019200,2
JediLlama666,0,2,0,5,1591243200,1592712000,2
Styrkekarl,0,2,0,3,1592712000,1594267200,2
punkjuliette,0,2,0,103,1608699600,1608786000,2
Moons3167,0,2,0,-4,1601524800,1601524800,2
sdhill006,0,2,0,-5,1589601600,1589601600,2
Im_OPs_mum,0,2,0,12,1606453200,1606453200,2
Dandere-Muffin,2,0,107,0,1565323200,1573707600,2
manavan8,0,2,0,11,1604984400,1604984400,2
RaifeM90,0,2,0,3,1601870400,1605502800,2
PrimarchMartorious,0,2,0,-1,1604811600,1608526800,2
throwitup199-99,0,2,0,3,1601092800,1601092800,2
sdixon90,0,2,0,3,1598155200,1598155200,2
1nc0rr3ct,0,2,0,3,1578373200,1578373200,2
Heretical_Demigod,0,2,0,27,1605589200,1606798800,2
EnemiesDie,1,1,23,5,1604466000,1604466000,2
mokita4u,0,2,0,2,1611723600,1611982800,2
JimmyTheG,0,2,0,2,1612069200,1612069200,2
Hodl_Your_Coins,0,2,0,9,1547528400,1555732800,2
yannickbear,0,2,0,25,1546405200,1546405200,2
Dead_Prune,0,2,0,31,1600142400,1605070800,2
cabindory,0,2,0,31,1608008400,1608008400,2
violentponykiller,0,2,0,10,1583985600,1604811600,2
Archerofyail,0,2,0,2,1604379600,1604379600,2
watercup45,0,2,0,2,1606626000,1606626000,2
leomwatts,0,2,0,16,1575694800,1576040400,2
imjustchasingkairos,0,2,0,18,1570420800,1570507200,2
RadicalRosco,0,2,0,17,1608786000,1612069200,2
hold_that_door,0,2,0,7,1601524800,1604811600,2
AxelAshes,0,2,0,8,1601438400,1601438400,2
brokenchordscansing,0,2,0,32,1547182800,1547182800,2
ratfinkprojects,0,2,0,55,1585627200,1585800000,2
Loco7022,0,2,0,42,1583557200,1583643600,2
WingedShadow83,0,2,0,8,1606107600,1606107600,2
JGtheburninator,0,2,0,60,1582002000,1583985600,2
hatterina,0,2,0,24,1609477200,1609563600,2
Steampunkfox999,1,1,41,1,1576904400,1577336400,2
adam1260,0,2,0,8,1589860800,1591243200,2
captdimitri,0,2,0,9,1471752000,1471752000,2
zynerd,0,2,0,7,1605157200,1605157200,2
Nilly_willyy,0,2,0,3,1603684800,1603684800,2
Foxfire67,0,2,0,3,1559534400,1565582400,2
Wigglefoot,0,2,0,11,1604984400,1605157200,2
spiral_ly,1,1,997,18,1563854400,1563854400,2
boilerguru53,0,2,0,2,1610859600,1615006800,2
DefectiveGadget,0,2,0,14,1596168000,1597032000,2
sleepysfw,0,2,0,5,1562558400,1569729600,2
Highschoolhandjob,0,2,0,-4,1591934400,1599019200,2
spazzoidincognito,1,1,28,5,1568174400,1568174400,2
SIeepy_Bear,0,2,0,5,1608267600,1610859600,2
thisbutironically,0,2,0,7,1573102800,1573189200,2
47620,0,2,0,-5,1606539600,1606539600,2
Sponsor_T,0,2,0,13,1581310800,1604379600,2
Four_Fourths,2,0,52,0,1594785600,1595822400,2
phrasal_grenade,0,2,0,-1,1580619600,1580619600,2
Drinks-With-The-Dead,0,2,0,8,1585454400,1611982800,2
JasperWixen,0,2,0,114,1568174400,1582347600,2
jo_blow421,0,2,0,4,1598846400,1598932800,2
Rpgwaiter,0,2,0,5,1611810000,1611810000,2
TrumpIsMyGodAndDad,0,2,0,-14,1596600000,1596600000,2
InigoMontoya_1,0,2,0,-7,1554523200,1554523200,2
Darthxan86,0,2,0,2,1565064000,1565064000,2
-_chop_-,0,2,0,8,1585195200,1585195200,2
EastEndOpera,0,2,0,13,1567051200,1587182400,2
darkabyssaldemon,0,2,0,9,1578546000,1578546000,2
throwaway6923065,0,2,0,11,1604293200,1606539600,2
papayatulus,0,2,0,8,1597291200,1600228800,2
musickeepsmeawake,0,2,0,-5,1602302400,1602302400,2
1001010101010011111,0,2,0,1,1593921600,1597550400,2
Stinkychops,0,2,0,2,1639458000,1639458000,2
eperezrubio1,0,2,0,-28,1606712400,1606798800,2
niaballew,0,2,0,10,1583125200,1596859200,2
The_Fluffy_Walrus,0,2,0,11,1602561600,1603512000,2
NightVale_Comm_Radio,0,2,0,22,1604898000,1606885200,2
WantToBeAloneGuy,0,2,0,21,1560571200,1560571200,2
Dagger_Moth,0,2,0,3,1562385600,1582693200,2
sheherenow888,0,2,0,2,1607835600,1607835600,2
Mothersyoungerbro,0,2,0,40,1570852800,1579237200,2
MossyBigfoot,0,2,0,3,1587355200,1594267200,2
rytrance,0,2,0,9,1559620800,1559707200,2
zapatismo_trap_house,0,2,0,3,1591243200,1591243200,2
DrDarkDoctor,0,2,0,11,1600315200,1603080000,2
TriEdgeDTrace,0,2,0,13,1602216000,1608094800,2
hawparvilla,0,2,0,6,1572148800,1572408000,2
Squayd,0,2,0,67,1595649600,1598587200,2
DavidHilliardMusic,1,1,14,50,1602561600,1608872400,2
adelim92,0,2,0,45,1597636800,1597636800,2
JokingImpractically,0,2,0,21,1599451200,1606626000,2
IWasATeenageMonster,0,2,0,10,1588996800,1588996800,2
CrossroadsWanderer,0,2,0,21,1600574400,1600574400,2
NoFuxToBeGiven,0,2,0,8,1581915600,1588305600,2
bertreynolds2,0,2,0,2,1606626000,1606712400,2
daikael,0,2,0,3,1603684800,1603684800,2
throwawaycat76,0,2,0,8,1601265600,1602302400,2
DassFelixx,1,1,6,2,1603944000,1603944000,2
Duonthemagnificent,0,2,0,19,1589256000,1589256000,2
Kelevracado4287,0,2,0,3,1584158400,1602129600,2
RedHeadAlex,1,1,12,3,1606194000,1606194000,2
Bubblegum-N-Orgasms,0,2,0,6,1603512000,1603512000,2
Nillacakesta,0,2,0,15,1579669200,1603598400,2
DragonFungi,0,2,0,11,1611896400,1611896400,2
Doomed_Predator,0,2,0,2,1611982800,1611982800,2
fungivore,0,2,0,23,1603252800,1603425600,2
jenaemare,0,2,0,11,1599969600,1601611200,2
samseth,0,2,0,7,1582520400,1582520400,2
alloutallthetime,0,2,0,2,1603598400,1603598400,2
afterbirth_slime,0,2,0,-27,1586232000,1586232000,2
2157345,0,2,0,4,1576126800,1576126800,2
LuciferrLu,2,0,327,0,1606626000,1609477200,2
Definitely_A_Man99,0,2,0,2,1608526800,1608526800,2
Ohboycats,0,2,0,11,1600488000,1600488000,2
starchildchamp,0,2,0,3,1581742800,1612155600,2
S-S-R,0,2,0,2,1637211600,1637211600,2
Nikkiiiiiiiiiiiiiii,0,2,0,2,1580792400,1583125200,2
CallistoLuna,0,2,0,1,1568952000,1571457600,2
BlackerOps,0,2,0,32,1591329600,1591329600,2
starshine8316,0,2,0,17,1605848400,1605848400,2
jaymobe07,0,2,0,3,1600574400,1600660800,2
Flolori01,0,2,0,13,1608008400,1608699600,2
BernieCrochu,0,2,0,36,1598500800,1598500800,2
coolproblems,0,2,0,10,1578632400,1579582800,2
Inert_Oregon,0,2,0,5,1608786000,1608786000,2
FentoBox,0,2,0,13,1600315200,1600488000,2
Carl_Marks__,0,2,0,9,1608786000,1608872400,2
throwaway21345312357,1,1,15,3,1607490000,1607490000,2
Zednem79,0,2,0,3,1604293200,1604379600,2
swatsk,1,1,258,3,1583125200,1583125200,2
LostGundyr,0,2,0,18,1579150800,1579150800,2
CarryHard,0,2,0,3,1601956800,1602302400,2
KahnSuperphone,0,2,0,3,1571025600,1571025600,2
aDAMNPATRIOT,0,2,0,-2,1584590400,1585454400,2
strawberrynausea,0,2,0,342,1602907200,1603944000,2
potatopierogie,0,2,0,14,1575867600,1608786000,2
rz449,1,1,3,1,1572580800,1572580800,2
bigack,0,2,0,6,1593144000,1593144000,2
1Rass,0,2,0,21,1595822400,1599278400,2
Aetiology,0,2,0,7,1596772800,1597032000,2
Stenik0522,0,2,0,14,1596686400,1596686400,2
GingerBakerCream,0,2,0,18,1579150800,1579150800,2
FernFlowerCA,0,2,0,131,1597896000,1604379600,2
thewitchof-el,0,2,0,20,1602475200,1602907200,2
MediocreBye,1,1,69,2,1608786000,1608786000,2
fuckyeahmoment,0,2,0,5,1572494400,1573362000,2
coffenese,0,2,0,4,1574917200,1574917200,2
Naija_Zen,0,2,0,3,1555905600,1557892800,2
HarrargnNarg,0,2,0,10,1611896400,1611896400,2
SiNiquity,0,2,0,67,1578200400,1580360400,2
globalcitizen824,0,2,0,3,1570420800,1570420800,2
KNunner,0,2,0,10,1584417600,1584417600,2
dalnorflying,0,2,0,15,1605157200,1608440400,2
NervouseDave,0,2,0,15,1602043200,1602043200,2
dontcallmechelly,0,2,0,50,1561521600,1562212800,2
GucciWapp,0,2,0,0,1587700800,1587873600,2
iEvn,0,2,0,2,1612069200,1612069200,2
knutsz,1,1,22,31,1573362000,1573362000,2
honeybee_hive,0,2,0,10,1601438400,1601438400,2
four024490502,0,2,0,18,1588824000,1592280000,2
young-and-mild,0,2,0,38,1545886800,1553313600,2
MAINEVNTtheDJ,1,1,27,7,1592107200,1599019200,2
S54Kaleb,0,2,0,2,1585972800,1585972800,2
doesnt_hate_people,0,2,0,4,1606626000,1606885200,2
Dawn-of-the-Ginger,0,2,0,13,1604293200,1604293200,2
helluvagaijin,0,2,0,24,1592971200,1609218000,2
Agolf_Lincler,0,2,0,2,1609045200,1609045200,2
MadeThis_2_SayThis_V,0,2,0,2,1592712000,1592798400,2
The_Flying_Stoat,0,2,0,4,1600228800,1600228800,2
rpguy04,0,2,0,2,1585454400,1585454400,2
NormalAdultMale,0,2,0,7,1576213200,1576213200,2
deepthroathamburger,0,2,0,16,1606021200,1607317200,2
lucius_marcus,0,2,0,57,1586836800,1586836800,2
skepticalcloud33,0,2,0,24,1608267600,1608267600,2
i_like_melodic_music,0,2,0,3,1602993600,1604116800,2
Contemplate321,1,1,26,8,1598760000,1598846400,2
dimriver,0,2,0,2,1594008000,1595649600,2
NohoTwoPointOh,0,2,0,2,1579755600,1579755600,2
JacketFarm,0,2,0,26,1593576000,1612155600,2
pinkleamon,1,1,11,1,1605070800,1605070800,2
Ballistic_86,0,2,0,2,1578373200,1581224400,2
RestoreVitae,0,2,0,-3,1589515200,1589515200,2
lilith-ness,0,2,0,0,1596600000,1596600000,2
LiCill666,0,2,0,8,1608526800,1608699600,2
Onaga19,1,1,19,3,1575003600,1575003600,2
greathousedagoth,1,1,9,3,1607230800,1607230800,2
fuzzylojiq,0,2,0,12,1585281600,1598846400,2
JammaBlamma69,0,2,0,22,1602388800,1608699600,2
dorpthorpson,0,2,0,2,1603512000,1603512000,2
vaultguru123,1,1,0,-12,1599019200,1599019200,2
mask_it,2,0,280,0,1574830800,1575003600,2
shika12,0,2,0,21,1593230400,1594440000,2
cosmictrashbash,0,2,0,20,1601956800,1602302400,2
DramaticExplanation,0,2,0,41,1573448400,1573448400,2
pepperdoof,1,1,65,6,1598587200,1600660800,2
trollingcynically,0,2,0,2,1607403600,1607490000,2
CWSwapigans,0,2,0,3,1603512000,1603512000,2
Quetzalcoatl__,0,2,0,9,1566446400,1566446400,2
Aestheticpash,1,1,120,234,1570248000,1581138000,2
holgerschurig,0,2,0,1,1582866000,1582866000,2
gopfrid,0,2,0,6,1589601600,1598241600,2
alarmsound,0,2,0,13,1611982800,1611982800,2
GFYPrototype,0,2,0,7,1608094800,1608094800,2
chinita1288,0,2,0,17,1583298000,1585108800,2
Sailingpriest,0,2,0,3,1578459600,1578459600,2
phoenix_shm,0,2,0,2,1550293200,1550379600,2
onecupcoconut,1,1,294,2,1592884800,1592971200,2
blamethemeta,0,2,0,-42,1582866000,1582952400,2
kitypity,0,2,0,14,1580965200,1581051600,2
Kylo-The-Optimist,0,2,0,100,1603512000,1604116800,2
glowstatic,1,1,31,24,1581051600,1599796800,2
G_Wash1776,0,2,0,6,1585454400,1585454400,2
letitenfold,0,2,0,4,1547096400,1547182800,2
Zorops,0,2,0,1,1578373200,1582779600,2
LittleLightOfLove,0,2,0,14,1584158400,1584244800,2
bowlingdoughnuts,0,2,0,5,1591156800,1591156800,2
peanutnozone,0,2,0,10,1604203200,1604898000,2
shadowimmage,0,2,0,55,1567656000,1576558800,2
RobieFLASH,0,2,0,11,1581224400,1600488000,2
AndrevUS,0,2,0,-14,1580533200,1580619600,2
Kettch_,0,2,0,13,1567569600,1582002000,2
RandomnessMeloness,0,2,0,-16,1606539600,1606539600,2
Friendly_Grocer,1,1,49,15,1605416400,1605502800,2
lunch_is_on_me,0,2,0,49,1606712400,1606712400,2
EagleSabre,0,2,0,25,1606280400,1607749200,2
WebbyUrchin,0,2,0,1,1549688400,1549688400,2
Flat_Lie,0,2,0,3,1546405200,1549342800,2
rubyspicer,0,2,0,15,1603512000,1611982800,2
datboi_fromthefuture,0,2,0,36,1598155200,1598155200,2
ganzas,0,2,0,5,1576040400,1602820800,2
bisou6,0,2,0,2,1572753600,1572753600,2
radditor5,0,2,0,16,1563854400,1564200000,2
413C,0,2,0,5,1607662800,1607835600,2
briloci,0,2,0,99,1600228800,1600228800,2
camattescat,0,2,0,5,1549083600,1549256400,2
plain_wrecked,0,2,0,583,1564372800,1576040400,2
redditreset86,0,2,0,3,1593576000,1605848400,2
jwes210,0,2,0,9,1594180800,1604203200,2
hollahollagotnodolla,0,2,0,3,1578718800,1578891600,2
bacharelando,0,2,0,2,1592884800,1594958400,2
NUMBERQ1,0,2,0,3,1603425600,1604203200,2
bestwest89,0,2,0,53,1588392000,1589428800,2
KillMeFastOrSlow,0,2,0,3,1605502800,1605502800,2
Allan_Dickman,0,2,0,144,1584158400,1584158400,2
XLIVtetsuo,0,2,0,20,1584072000,1599364800,2
eye_one_two_die,2,0,485,0,1600142400,1607230800,2
triclops6,0,2,0,30,1591156800,1591156800,2
basedtho,0,2,0,12,1605157200,1605848400,2
DeepSkulk,0,2,0,12,1576990800,1581656400,2
MurdokSG00,0,2,0,2,1596600000,1611810000,2
3MethylMethCathinone,0,2,0,19,1592193600,1592193600,2
Karmamamamama,0,2,0,-3,1609131600,1609131600,2
Curious_Arthropod,0,2,0,3,1576299600,1576299600,2
Richard_Sanchez_C137,0,2,0,48,1585540800,1587614400,2
Frog-Eater,0,2,0,6,1560484800,1578546000,2
Dat_name_doe2,1,1,84,14,1602907200,1602993600,2
-mooncake-,0,2,0,14,1579755600,1579755600,2
horny_indoorboy,2,0,13983,0,1587182400,1600747200,2
emptydumpling,0,2,0,3,1604898000,1606798800,2
canallavalla,0,2,0,28,1577163600,1577163600,2
AL0NS020,1,1,25,5,1571457600,1571457600,2
Umphew,0,2,0,4,1606885200,1606885200,2
oghairline,0,2,0,4,1594958400,1603425600,2
Itiredofthislife,1,1,29,7,1586491200,1586491200,2
antiestablishment,0,2,0,8,1611896400,1612155600,2
Nycewell,0,2,0,15,1608094800,1611896400,2
aliihsan_,1,1,16,0,1581570000,1581570000,2
hsun79-,1,1,34,29,1583298000,1588824000,2
yaboiejeff,0,2,0,11,1583899200,1602993600,2
whatphukinloserslmao,0,2,0,7,1594353600,1594353600,2
bennyndajetz,0,2,0,2,1591329600,1591329600,2
Buetti,1,1,22,11,1568433600,1599105600,2
Betamax77,2,0,38,0,1587614400,1593403200,2
halfass-badass,0,2,0,-8,1600315200,1600315200,2
stevebuscemispenis,1,1,1548,1,1563163200,1564372800,2
Bert_Macklin86,0,2,0,2,1603684800,1603771200,2
oater99,0,2,0,0,1606971600,1611810000,2
themastodon85,0,2,0,41,1549774800,1549774800,2
mary_eev,0,2,0,4,1584936000,1589688000,2
Winter_2018,0,2,0,6,1585108800,1604379600,2
ujnev,0,2,0,3,1605848400,1605848400,2
SerratedHumor,0,2,0,62,1611723600,1612155600,2
Kazooguru,0,2,0,102,1597118400,1598673600,2
StellaAthena,0,2,0,5,1579064400,1579064400,2
vivi_the_black_mage,0,2,0,-4,1564286400,1564286400,2
LORthrowaway6,2,0,23,0,1603512000,1603857600,2
OutrageousReply,0,2,0,1,1552449600,1552449600,2
Snacheeze69,0,2,0,-3,1593835200,1597896000,2
ShelSilverstain,0,2,0,-44,1570680000,1570680000,2
chorusabyss,0,2,0,31,1571025600,1578632400,2
CryptoWager,0,2,0,3,1596340800,1596340800,2
oMarlow99,0,2,0,1,1585454400,1585454400,2
charredcoal,0,2,0,-3,1602129600,1602129600,2
KneelDaGressTysin,0,2,0,8,1587960000,1609304400,2
sithren,0,2,0,20,1597896000,1598587200,2
baaimasheep,0,2,0,2,1585454400,1585454400,2
0xFeleventyFive,0,2,0,8,1612155600,1612155600,2
anon4972018003251,1,1,71,10,1602302400,1602302400,2
hiddendrugs,0,2,0,4,1562990400,1589947200,2
reseday,1,1,53,23,1601179200,1601179200,2
signintocomment,0,2,0,29,1598760000,1598846400,2
MetalSunsuit,0,2,0,23,1569211200,1569384000,2
indigogalaxy_,0,2,0,35,1601870400,1602734400,2
shrek_daddy79,0,2,0,8,1591243200,1594008000,2
cat_prophecy,0,2,0,18,1606539600,1609045200,2
ItsAllMyAlt,0,2,0,16,1604293200,1606971600,2
coodymunt,0,2,0,5,1600574400,1600574400,2
IAMKING77,0,2,0,3,1605589200,1606626000,2
redhandrail,0,2,0,9,1601092800,1609218000,2
jcruz321,0,2,0,5,1601870400,1601870400,2
SpookySkeleton42,0,2,0,1,1608699600,1608699600,2
TheRoboticChimp,0,2,0,7,1605589200,1605589200,2
kkeut,0,2,0,26,1606280400,1606280400,2
UomoSenzaNom3,0,2,0,3,1606366800,1606453200,2
sethrichsbrother1,0,2,0,2,1591329600,1591329600,2
dallyan,0,2,0,4,1598500800,1603080000,2
Bslayer7111,0,2,0,5,1583038800,1583038800,2
M0meRath,0,2,0,3,1581742800,1582520400,2
CarlosRanger,0,2,0,2,1585454400,1585454400,2
gama3,0,2,0,1,1576818000,1576818000,2
imanaeo,0,2,0,21,1603598400,1603598400,2
whatwhasmystupidpass,0,2,0,2,1600574400,1609304400,2
PhatPatSC,0,2,0,15,1596168000,1597896000,2
TheWhalerus,0,2,0,5,1596686400,1608094800,2
octopusnipples,0,2,0,2,1569643200,1582174800,2
SuperHans2,1,1,34,1,1557892800,1557979200,2
Shinka_Nibutani,0,2,0,10,1568001600,1568260800,2
BulletProofHarambe,0,2,0,7,1585454400,1585454400,2
trash_panda_princess,0,2,0,5,1595736000,1595736000,2
MisanthropicMensch,0,2,0,9,1561694400,1561694400,2
favouritoburrito,0,2,0,2,1442203200,1442203200,2
blagg23,0,2,0,64,1562299200,1562299200,2
snorlaxmom666,0,2,0,11,1568779200,1568865600,2
CallEmAsISeeEm1986,0,2,0,27,1607403600,1607403600,2
TheOnlyMareth,0,2,0,4,1604725200,1605675600,2
segen20,0,2,0,2,1605243600,1605243600,2
RayR91,0,2,0,-1,1572408000,1572408000,2
ApplesBananasRhinoc,0,2,0,17,1587528000,1587528000,2
Mister_Bambu,0,2,0,9,1605243600,1608094800,2
themanti54,0,2,0,1,1588824000,1588824000,2
Navy_Tree,1,1,13,14,1583125200,1593489600,2
chusurus,0,2,0,22,1543208400,1543294800,2
grrrr_avity,0,2,0,2,1564372800,1564459200,2
chokingduck,0,2,0,4,1586059200,1605157200,2
PossibleLocksmith,0,2,0,24,1600056000,1604293200,2
BowmoreDarkest,0,2,0,7,1580533200,1597377600,2
IWasMeButNowHesGone,0,2,0,24,1556251200,1557201600,2
thecoreworlds,0,2,0,10,1570248000,1570766400,2
_sniffs,0,2,0,14,1573102800,1608008400,2
Omountains,0,2,0,12,1591934400,1592452800,2
wh00pd3d00,0,2,0,8,1572408000,1572408000,2
Harvee_Normarn,0,2,0,34,1599796800,1599883200,2
LoafCommander,0,2,0,14,1595304000,1595390400,2
Sealbeater,0,2,0,4,1602820800,1602820800,2
Drink82,0,2,0,5,1599019200,1611896400,2
prettymuchdrunk,0,2,0,35,1581570000,1599364800,2
thetotalpackage7,0,2,0,5,1562472000,1582779600,2
RangerLIS,0,2,0,144,1587182400,1607144400,2
IffyWs,0,2,0,9,1550206800,1550293200,2
Kolkom,0,2,0,38,1600228800,1600228800,2
maxy505,0,2,0,-119,1584504000,1584504000,2
kungfupandasukemi,0,2,0,3,1571889600,1571976000,2
Paradise_City88,0,2,0,12,1585108800,1602734400,2
barry_nutters,0,2,0,2,1585454400,1585454400,2
xvy654,0,2,0,9,1563336000,1569988800,2
dontbotherwilly,0,2,0,2,1581224400,1603512000,2
stopme45,2,0,390,0,1589601600,1607835600,2
ace-of-spad3s,1,1,35,5,1566014400,1568347200,2
kodehu,0,2,0,57,1579064400,1582434000,2
cumsuckmuch,1,1,10,3,1602043200,1608267600,2
popcultureinsidejoke,0,2,0,12,1557460800,1557460800,2
-Linen,0,2,0,6,1602820800,1602820800,2
Lunanney,0,2,0,19,1603598400,1604203200,2
comtrailer,0,2,0,3,1603512000,1603512000,2
ellosmello,1,1,14,5,1559707200,1560657600,2
jgund,0,2,0,137,1583899200,1588996800,2
PAPPATHANOS_UwU,0,2,0,11,1572843600,1609304400,2
Mr_Underscored,0,2,0,2,1607317200,1608699600,2
JeevesVoorhees,0,2,0,236,1599451200,1607662800,2
Martidosava,0,2,0,78,1587009600,1587009600,2
link_nukem28,0,2,0,2,1603512000,1603512000,2
djbossonater,0,2,0,1,1609563600,1609650000,2
HedgeWitch68,0,2,0,6,1609218000,1609390800,2
aanvalskanon,0,2,0,17,1608267600,1608267600,2
suicidalwatergoddess,0,2,0,14,1595476800,1600920000,2
freddiesprinkle,0,2,0,3,1607576400,1607576400,2
michiganland,0,2,0,11,1595217600,1595217600,2
Muffinthepuffin,0,2,0,5,1598587200,1608267600,2
Oynnhojs,0,2,0,14,1575262800,1575262800,2
coffeeblues,0,2,0,5,1572408000,1604984400,2
MediorcreSaintsFan,0,2,0,-19,1605848400,1605848400,2
LonelyEthics,0,2,0,21,1565755200,1568779200,2
Things_with_Stuff,0,2,0,19,1603512000,1603512000,2
Genepool23,0,2,0,8,1553486400,1563768000,2
persiandesiree,0,2,0,11,1609131600,1609563600,2
bkbandit69,0,2,0,7,1595476800,1602475200,2
Economy_Cactus,0,2,0,2,1539921600,1578978000,2
Gobraxx_The_Boi,1,1,7,1,1598414400,1598500800,2
perpetualwalnut,0,2,0,6,1594699200,1594699200,2
AlwaysNowNeverNotMe,0,2,0,24,1593748800,1595304000,2
Jocomol,0,2,0,3,1575435600,1575435600,2
HydraulicConduct,0,2,0,28,1598673600,1600142400,2
NoPointDenyingItNow,0,2,0,13,1603512000,1603512000,2
blubblubblubediblub,2,0,946,0,1579496400,1584072000,2
itsnoahhhhh,0,2,0,1,1588132800,1588132800,2
IchooseYourName,0,2,0,11,1566878400,1566878400,2
aa599,0,2,0,35,1561176000,1588910400,2
slippityslapity,0,2,0,1,1588910400,1588910400,2
Alcea_Hexagram,0,2,0,18,1569211200,1569211200,2
lickmytushyhole,0,2,0,51,1566100800,1566100800,2
aleksem,0,2,0,4,1578632400,1607490000,2
tallblues,0,2,0,2,1590379200,1590379200,2
yumkittentits,0,2,0,3,1607490000,1607490000,2
ShoeTasty,0,2,0,-1,1608094800,1608181200,2
UncagedBlue,0,2,0,4,1597032000,1600142400,2
Drium,0,2,0,29,1585022400,1585022400,2
emmboo,0,2,0,68,1580187600,1608613200,2
Justpokenit,0,2,0,10,1591156800,1602302400,2
Oldskoolguitar,0,2,0,2,1603512000,1605589200,2
Dingldorf,0,2,0,9,1589256000,1594094400,2
freakypiratekid,0,2,0,3,1585540800,1605589200,2
poomethazine,0,2,0,73,1611810000,1611810000,2
FUCKITIMPOSTING,0,2,0,38,1588737600,1608786000,2
poling4shrek,0,2,0,12,1579928400,1579928400,2
cabbage_rolls89,0,2,0,10,1597291200,1597377600,2
venomousbeetle,0,2,0,-2,1603771200,1603771200,2
Moartem,0,2,0,2,1603512000,1603512000,2
Rivent116,0,2,0,147,1599192000,1602388800,2
Packfieldboy,0,2,0,13,1606626000,1606712400,2
mrwoodruff11,0,2,0,37,1603512000,1603512000,2
Oldest_Boomer,0,2,0,11,1604293200,1604293200,2
Port_96,0,2,0,4,1606280400,1606280400,2
hahahitsagiraffe,0,2,0,26,1607576400,1611982800,2
FundFriend115,0,2,0,11,1595563200,1595649600,2
Lilac275,0,2,0,2,1606626000,1606626000,2
egoapex,0,2,0,4,1596945600,1599883200,2
0g0mogo,0,2,0,3,1594872000,1602043200,2
b0w3n,0,2,0,6,1605589200,1605675600,2
Oneironaut91,0,2,0,16,1606539600,1608526800,2
ArbyLG,0,2,0,7,1608267600,1608267600,2
Mysterious_Cause_373,0,2,0,-27,1598068800,1598155200,2
kapoorprincess,1,1,17,2,1596945600,1596945600,2
Dchama86,0,2,0,15,1586318400,1587960000,2
sircumsalot88,0,2,0,4,1605070800,1605070800,2
C0L4ND3R,0,2,0,0,1573966800,1579496400,2
basssattack31,0,2,0,2,1594008000,1596686400,2
FermatsLastAccount,0,2,0,1,1573189200,1573189200,2
auntiepirate,0,2,0,10,1606798800,1606885200,2
coachz1212,0,2,0,51,1605589200,1605589200,2
CreamyCosmos,0,2,0,96,1573534800,1573534800,2
Vanessa1090,0,2,0,10,1606280400,1606366800,2
WhiteCollarRebel,1,1,1,1,1597896000,1597896000,2
PrsnPersuasion,0,2,0,4,1582088400,1582088400,2
gth746x,0,2,0,62,1596686400,1596772800,2
DemonCookie666,0,2,0,18,1605416400,1605502800,2
ruhrejrror,0,2,0,0,1582002000,1582002000,2
pennomi,0,2,0,6,1585454400,1585454400,2
Sgt_Smitty,0,2,0,37,1603252800,1603252800,2
turningsteel,0,2,0,11,1583643600,1593835200,2
3ofCups,0,2,0,3,1595217600,1601092800,2
nocontactnotpossible,0,2,0,72,1571457600,1588737600,2
corvaxx,0,2,0,167,1578459600,1588737600,2
Narnocastelo,0,2,0,14,1595908800,1595908800,2
RaresVladescu,0,2,0,2,1607576400,1607576400,2
sbjohn12,1,1,102,3,1600747200,1600833600,2
loorinm,0,2,0,79,1601265600,1601870400,2
mrpresident_2032,0,2,0,7,1590033600,1590033600,2
EscapeFromCorona,0,2,0,34,1595217600,1601524800,2
goldenwolves101,0,2,0,26,1586404800,1598414400,2
slamsomethc,0,2,0,5,1436932800,1541653200,2
nojustlurkingty,0,2,0,18,1605934800,1606885200,2
PurpleBellPepper,0,2,0,184,1602302400,1602302400,2
Redish_VP,0,2,0,84,1578027600,1584417600,2
another79Jeff,0,2,0,3,1585454400,1585540800,2
shamalamamoomoo2019,0,2,0,14,1585195200,1587614400,2
FINNCULL19,0,2,0,9,1572753600,1572753600,2
adralla,0,2,0,110,1579582800,1582261200,2
csjmagic3q,0,2,0,7,1591329600,1608613200,2
Lazyducking,0,2,0,16,1606885200,1606971600,2
Arcanellis,1,1,17,3,1583384400,1583384400,2
clout-regiment,0,2,0,32,1595563200,1597809600,2
AlastorAugustus,0,2,0,3,1535256000,1535256000,2
ViolentCrumble,0,2,0,13,1600574400,1600660800,2
No__Trade__Joe,0,2,0,3,1565064000,1565064000,2
PissSkull,1,1,141,51,1560484800,1560484800,2
brrzam,0,2,0,39,1562299200,1577509200,2
dazib,0,2,0,19,1607490000,1607922000,2
itcouldletinagiraffe,0,2,0,3,1597809600,1603857600,2
SeattleCovfefe,0,2,0,11,1572753600,1572753600,2
EnTeeDizzle,0,2,0,11,1587441600,1587528000,2
fizzzylemonade,0,2,0,24,1608613200,1609390800,2
DominoUB,0,2,0,6,1586491200,1593748800,2
willowwing,0,2,0,5,1608526800,1609304400,2
sauwin,0,2,0,6,1589428800,1593662400,2
JackIsNotAWeeb,0,2,0,-5,1607576400,1607576400,2
420Fps,0,2,0,3,1609218000,1609218000,2
Fedandalrian,0,2,0,5,1587441600,1593748800,2
TheMexicanPie,0,2,0,1,1602820800,1602820800,2
SaskatchewanFuckinEh,0,2,0,22,1605416400,1605675600,2
jaime-the-lion,0,2,0,16,1609218000,1611810000,2
Lazarus_Pits,0,2,0,3,1603598400,1603598400,2
Fluffy_ribbit,0,2,0,4,1555300800,1555300800,2
DoctorGoFuckYourself,0,2,0,-2,1609218000,1609218000,2
itsnotadeadpan,0,2,0,41,1606798800,1606971600,2
TheDJC,0,2,0,2,1557288000,1557288000,2
OJSimpin,0,2,0,3,1576213200,1576213200,2
achjapuntdrie,2,0,36,0,1438920000,1439352000,2
BlazingBirdyz,0,2,0,2,1606453200,1606453200,2
wrstlr3232,0,2,0,11,1596168000,1596168000,2
caracalcalll,0,2,0,2,1596427200,1596427200,2
erika1972,0,2,0,19,1605848400,1605934800,2
corncobcommie,0,2,0,36,1568260800,1571544000,2
MaximusAurelius666,1,1,4627,19,1607490000,1608267600,2
ifyouhaveany,0,2,0,19,1605330000,1605330000,2
iEatGarbages,0,2,0,31,1587268800,1589860800,2
peez201,1,1,65,7,1595044800,1595044800,2
kreisname,0,2,0,15,1579928400,1596254400,2
RossGellerBot,0,2,0,2,1602561600,1604984400,2
notamandime,0,2,0,7,1604293200,1604466000,2
JacenVane,0,2,0,26,1564545600,1564545600,2
Narpa20,0,2,0,11,1585454400,1590552000,2
piratecheese13,0,2,0,14,1598587200,1607922000,2
Crawfishn,0,2,0,10,1606885200,1611896400,2
knucklehead923,0,2,0,-1,1584244800,1585454400,2
stupidusermane,0,2,0,3,1593835200,1594008000,2
dankernuggets7,0,2,0,6,1608526800,1608526800,2
idek123455,1,1,30,1,1575262800,1575262800,2
DoctorMadcow,0,2,0,-12,1581051600,1581483600,2
Turbofurball,0,2,0,2,1562126400,1562126400,2
TeleTwin,0,2,0,31,1575867600,1608613200,2
needPAPsmear,0,2,0,-63,1602648000,1608872400,2
SubZeroIsNotHere,0,2,0,19,1598846400,1598846400,2
EntropyRX,0,2,0,3,1606798800,1606971600,2
Vertovenaar,0,2,0,6,1608267600,1608267600,2
Aussieausti,0,2,0,15,1586836800,1586836800,2
Mecharlottesta,0,2,0,4,1580706000,1580706000,2
ThunderaBorn,0,2,0,8,1560916800,1560916800,2
TrumpIsACuntBitch,0,2,0,1,1608958800,1609304400,2
chrpskm,0,2,0,11,1581656400,1581829200,2
drew_barrymores_lisp,0,2,0,23,1576990800,1584072000,2
grawktopus,0,2,0,5,1602734400,1609304400,2
_The_Crooked_Man_,0,2,0,162,1594008000,1594008000,2
fireonthemountain16,0,2,0,3,1595563200,1598068800,2
Screamingsutch,0,2,0,6,1599624000,1611982800,2
SonOf2Pac,0,2,0,18,1604293200,1604293200,2
Cicada33024,0,2,0,2,1566360000,1568952000,2
Mymhic,0,2,0,16,1564977600,1603512000,2
aquales120,0,2,0,12,1559361600,1584244800,2
metal_mind,0,2,0,8,1595390400,1608094800,2
throwawayyyy26453,0,2,0,17,1569124800,1569211200,2
Sanganee,1,1,73,16,1605934800,1606107600,2
Xxcunt_crusher69xX,0,2,0,11,1606885200,1606885200,2
A-Burrito-Wizard,0,2,0,162,1584590400,1599710400,2
bestiibebii,0,2,0,12,1595822400,1596600000,2
Estabania,0,2,0,14,1593144000,1595649600,2
irdangerdave,0,2,0,104,1559880000,1584331200,2
onlyupdoots,0,2,0,539,1611810000,1611810000,2
ididntpayforit,0,2,0,44,1550811600,1588132800,2
FluffyToughy,0,2,0,2,1612414800,1613019600,2
AmbigrammaticAir,0,2,0,2,1561089600,1561089600,2
tankie384,0,2,0,2,1557288000,1558238400,2
blueandwhitetoile,0,2,0,8,1592971200,1593057600,2
According-Gur-6605,0,2,0,1,1625284800,1625284800,2
Shablagoo-,1,1,14,63,1577163600,1592366400,2
foreverneilyoung,0,2,0,4,1609477200,1609477200,2
ahhhimamonfire,0,2,0,37,1551934800,1579323600,2
Waze3174,0,2,0,14,1593403200,1593489600,2
MurfMan11,0,2,0,6,1589860800,1589860800,2
SantaMoons,0,2,0,-5,1567483200,1567483200,2
Geanieous,0,2,0,-3,1603512000,1605848400,2
Spaghetti_kamika,0,2,0,2,1608267600,1608267600,2
darksim1309,0,2,0,33,1605330000,1605416400,2
NovelAdministrative6,0,2,0,29,1604984400,1604984400,2
ruspow,0,2,0,0,1591243200,1591243200,2
angrydemoncat,0,2,0,130,1596859200,1596859200,2
PierceRedditor,0,2,0,2,1599883200,1599969600,2
Rude-Transition,2,0,1899,0,1575781200,1575781200,2
gagnonca,0,2,0,3,1596772800,1598846400,2
gunslingerfry1,0,2,0,7,1563249600,1599019200,2
zysterg17,0,2,0,88,1560484800,1562472000,2
maraca101,0,2,0,2,1600315200,1611810000,2
factsnotfeelings,0,2,0,9,1599537600,1599537600,2
Chikinboi420,0,2,0,-7,1588910400,1611982800,2
Suhdew28,0,2,0,20,1575867600,1575954000,2
SweetMeatJuice,0,2,0,2,1604898000,1604898000,2
amunozo1,0,2,0,19,1576558800,1579755600,2
H_Arthur,0,2,0,2,1592798400,1609304400,2
Tornadoboy156,0,2,0,3,1614661200,1614661200,2
bamxp,0,2,0,55,1605589200,1605589200,2
The_Hot_Sauce_,0,2,0,-2,1589947200,1589947200,2
thepixelatedcat,0,2,0,9,1603425600,1606453200,2
thegoossOG,0,2,0,3,1585454400,1585540800,2
maledin,0,2,0,8,1589860800,1589860800,2
charlesedwardumland,0,2,0,52,1553486400,1560657600,2
jttoolegit,0,2,0,-1,1603598400,1603598400,2
PM_me_yo_catto,0,2,0,6,1599019200,1599019200,2
AdrienSergent,0,2,0,2,1585454400,1605589200,2
XxMrCuddlesxX,0,2,0,3,1585454400,1585454400,2
mayu1,0,2,0,8,1593144000,1604203200,2
theghostofgaryfisher,0,2,0,17,1548133200,1568692800,2
pinkmanpunk,0,2,0,9,1604379600,1604379600,2
ExuberantElephant,0,2,0,14,1572580800,1572580800,2
MandyBoy5,0,2,0,97,1604116800,1604116800,2
JaneyFromTheBlock,0,2,0,7,1563336000,1563336000,2
MsAdventureQueen,0,2,0,2,1546578000,1567569600,2
Quibbloboy,0,2,0,18,1598414400,1599624000,2
LadyGrey85,0,2,0,7,1582952400,1582952400,2
CallMeLarry,0,2,0,2,1582174800,1582520400,2
sunnyvale_shitbird,0,2,0,17,1585627200,1585627200,2
fidelioofficial,0,2,0,66,1588564800,1588564800,2
TheKnightThatGoesHmm,0,2,0,2,1603425600,1603425600,2
negro_scholarship,0,2,0,15,1592107200,1592798400,2
jens---98,0,2,0,2,1605934800,1605934800,2
ReadEmmaGoldman,0,2,0,6,1562558400,1562558400,2
ss412,0,2,0,6,1590638400,1605675600,2
AllAnswers2,0,2,0,22,1611810000,1611810000,2
edgeIveBeenAvoiding,0,2,0,2,1593489600,1593489600,2
altiuscitiusfortius,0,2,0,13,1589947200,1603512000,2
nautical-luna,0,2,0,17,1558929600,1565064000,2
aSchizophrenicCat,0,2,0,-6,1592625600,1592625600,2
gamerlol101,1,1,4,0,1608699600,1608699600,2
Ripped4Revolution,0,2,0,10,1592107200,1592107200,2
iggypowpow,0,2,0,14,1578546000,1580706000,2
batman20X7,0,2,0,10,1592280000,1596081600,2
motyareddit,0,2,0,2,1567656000,1567656000,2
SpecialSnowflake1,0,2,0,68,1594958400,1594958400,2
Excellent_Efficiency,1,1,147,1,1577077200,1577768400,2
gingerbeer5280,0,2,0,3,1599105600,1599105600,2
Bargrisar_Stoneman,0,2,0,48,1568779200,1568779200,2
TheDogBarking,0,2,0,5,1599105600,1599192000,2
neonchasms,0,2,0,174,1596081600,1608958800,2
Wolfy4226,0,2,0,30,1605330000,1606971600,2
slobs_burgers,0,2,0,8,1606626000,1606626000,2
Scarlett2222,0,2,0,-13,1602648000,1602648000,2
npc197563,0,2,0,3,1638853200,1638939600,2
flowerfaer,0,2,0,13,1551070800,1563076800,2
tkilgore,0,2,0,5,1603684800,1605762000,2
MyNSFWAlt12,0,2,0,-28,1571630400,1572580800,2
Ya_boi_Yung_Wolf,0,2,0,19,1575435600,1575608400,2
Calavant,0,2,0,37,1609218000,1609477200,2
NaidTheWarlock,0,2,0,23,1592798400,1592798400,2
Bensemus,0,2,0,8,1571630400,1586491200,2
AAaddrriiaann,0,2,0,12,1587009600,1587009600,2
Delete4chan,0,2,0,7,1586404800,1587960000,2
zyzznerd,0,2,0,7,1580446800,1581224400,2
BTCisBitcoin,0,2,0,5,1593057600,1593057600,2
KoveltSkiis,0,2,0,34,1525492800,1555214400,2
NoxWarcraft,0,2,0,-5,1612069200,1612069200,2
noleander,0,2,0,-3,1600574400,1600574400,2
sh1ttp0st3r123,1,1,28,7,1581310800,1581310800,2
messicaupsidedown,0,2,0,12,1564459200,1565582400,2
TheGreatLuzifer,0,2,0,33,1582779600,1607749200,2
nightgon,0,2,0,13,1605675600,1608958800,2
Shamewizard1995,0,2,0,4,1608267600,1608267600,2
Tidalwave808,0,2,0,-11,1609390800,1609390800,2
slobcat1337,0,2,0,7,1566187200,1566187200,2
Empyrean_MX_Prime,0,2,0,2,1603684800,1603684800,2
helerhephep,0,2,0,9,1552194000,1552194000,2
TargetWorkersUnite,2,0,43,0,1582002000,1587873600,2
Sw429,0,2,0,2,1578891600,1578891600,2
vince2423,0,2,0,-5,1608526800,1608613200,2
brandoniusly,0,2,0,30,1592452800,1594699200,2
Miracow,0,2,0,16,1533614400,1541394000,2
YoureAllInvited,0,2,0,19,1569470400,1592884800,2
kidkaboozle,2,0,664,0,1572148800,1591156800,2
Re-L5,0,2,0,14,1574658000,1600920000,2
arisasam,0,2,0,15,1567915200,1576904400,2
MySkinIsFallingOff,0,2,0,14,1601092800,1601179200,2
AirplaneDance,0,2,0,26,1595390400,1608181200,2
rcognition,0,2,0,6,1393218000,1399003200,2
varnavruz,0,2,0,5,1596254400,1605157200,2
king-boi1,0,2,0,2,1605589200,1605589200,2
Long-Live-Anarchy,0,2,0,6,1612069200,1612069200,2
Savyna2,0,2,0,4,1600747200,1600747200,2
fartbox1969,1,1,0,-1,1581224400,1581224400,2
Rorshach85,0,2,0,0,1585454400,1586404800,2
TorrentialRainstorm,1,1,116,2,1601956800,1601956800,2
15cm_guy,0,2,0,-6,1603512000,1603512000,2
Thisisjammin,0,2,0,2,1570420800,1570420800,2
gooofygooba,0,2,0,-39,1589774400,1589774400,2
QuantumFungus,0,2,0,10,1605675600,1605762000,2
pastawithrevolution,0,2,0,5,1607317200,1608181200,2
Aquadan1235,0,2,0,15,1557720000,1574571600,2
sailirish7,0,2,0,6,1607490000,1607490000,2
MrHermeteeowish,1,1,267,17,1612155600,1612155600,2
mangomandingotu,0,2,0,2,1566878400,1569038400,2
Nope_nope_nope_okay,0,2,0,2,1606626000,1606626000,2
Sumacu,0,2,0,97,1570766400,1581138000,2
HugeBoobLover69,0,2,0,5,1601352000,1602734400,2
LambertHatesGwent,0,2,0,21,1564372800,1564459200,2
BlueWhaleTL,0,2,0,3,1601179200,1602475200,2
RDGIV,0,2,0,-12,1581915600,1581915600,2
dogers69,0,2,0,-9,1588564800,1588564800,2
TheLonesomeTraveler,0,2,0,9,1584158400,1598414400,2
svendrock420,0,2,0,-24,1606453200,1606885200,2
Conservative-Hippie,0,2,0,5,1608181200,1608181200,2
oldaccountfoundout,0,2,0,1,1569556800,1569902400,2
thesmellnextdoor,0,2,0,30,1592798400,1595822400,2
thisisspeedway,0,2,0,4,1576645200,1578373200,2
johnne86,0,2,0,5,1579237200,1579237200,2
mixand,0,2,0,7,1602388800,1606798800,2
DinkandDrunk,0,2,0,4,1581224400,1591329600,2
ajc_129,0,2,0,4,1587960000,1596859200,2
death_of_flats,0,2,0,44,1605589200,1605589200,2
snakebru-sh,0,2,0,32,1589428800,1589428800,2
AnswersThirstyBrain,0,2,0,155,1587873600,1601265600,2
candyapplekid96,0,2,0,21,1607317200,1608094800,2
etherkiller,0,2,0,7,1574830800,1574830800,2
morgan1027,0,2,0,-64,1547182800,1547182800,2
n7ripper,0,2,0,9,1553054400,1553140800,2
plz_raise_my_taxes,0,2,0,2,1589601600,1589688000,2
Skybliviwind,0,2,0,2,1617854400,1617854400,2
Kyllakyle,1,1,7,59,1572235200,1580101200,2
Ren_Moriyama,0,2,0,30,1612155600,1612155600,2
zxdpe,0,2,0,-2,1562731200,1562731200,2
Hansubansu,0,2,0,7,1572408000,1572408000,2
Coxib,2,0,613,0,1558929600,1567310400,2
lyrikz74,0,2,0,-2,1605675600,1605675600,2
ocramoidev,1,1,113,8,1605589200,1605589200,2
TheSushiBoy,0,2,0,31,1603684800,1604030400,2
skirtdouglas,1,1,0,21,1595390400,1596254400,2
pewpadewk,0,2,0,5,1608008400,1608008400,2
PhoenixQueen_Azula,0,2,0,17,1575867600,1575954000,2
Witafigo,0,2,0,96,1608786000,1608872400,2
katemiw,1,1,5,5,1596168000,1608181200,2
RajboshMahal,0,2,0,-44,1586059200,1587787200,2
CarpetMarbles,0,2,0,43,1593144000,1593489600,2
Kilgus35,0,2,0,107,1559102400,1559102400,2
floradenophora,0,2,0,5,1576126800,1578114000,2
PainfulPeanutBlender,0,2,0,15,1597118400,1597118400,2
GhOsTxProGaming,0,2,0,2,1591156800,1608267600,2
SkanDrake,0,2,0,26,1586232000,1586232000,2
Micha_Bell,0,2,0,2,1571544000,1572843600,2
AnnoyingFatGuy,0,2,0,5,1589342400,1589342400,2
garythegyarados,0,2,0,25,1574830800,1591502400,2
AndrewIsMyDog,0,2,0,7,1586836800,1605589200,2
tartanboi98,0,2,0,21,1605243600,1606971600,2
LiquidSnake4L,0,2,0,5,1597464000,1597464000,2
RoyalBlueMoose,0,2,0,17,1581138000,1581138000,2
DurrDude,0,2,0,1,1606021200,1606107600,2
UnifORMeDBomBer,0,2,0,3,1604898000,1605934800,2
Emnwintery,0,2,0,-3,1591243200,1591243200,2
DeusVult1776,0,2,0,-9,1578891600,1578891600,2
14457390027345,1,1,97,10,1609218000,1609218000,2
ILOVEBINGUS2,0,2,0,0,1603598400,1603598400,2
avaholic46,0,2,0,17,1607835600,1607835600,2
pixiebellex,0,2,0,7,1596340800,1596427200,2
wrestlingrudy,0,2,0,4,1590638400,1590638400,2
InterstellarReddit,0,2,0,3,1607317200,1609045200,2
clarkholiday,0,2,0,13,1584590400,1602129600,2
Condimentarian,0,2,0,10,1586491200,1607749200,2
Alwaysanyways,0,2,0,28,1595822400,1595908800,2
With_Trees,0,2,0,5,1606712400,1606712400,2
suspect1031,0,2,0,30,1601092800,1601092800,2
Wentoutonalimb,1,1,10,2,1586664000,1588910400,2
thatsocrates,2,0,28,0,1563336000,1573016400,2
just-the-smellz,1,1,125,12,1569384000,1570507200,2
BaPef,0,2,0,9,1592798400,1605070800,2
Bisexual-Bee,1,1,55,6,1595995200,1595995200,2
dano159,0,2,0,76,1611637200,1611896400,2
mik999ak,0,2,0,46,1607576400,1607662800,2
Primetestbuild,0,2,0,42,1602043200,1602043200,2
Emptyhurtconfused,1,1,15,3,1548478800,1548478800,2
nwotvshow,0,2,0,8,1477368000,1524196800,2
ManSauce69,0,2,0,2,1606626000,1606626000,2
MarxButBeardier,0,2,0,11,1605416400,1608181200,2
cannatone,0,2,0,29,1580014800,1580014800,2
BET_1,0,2,0,61,1594699200,1594699200,2
Dirtylittlesecret88,0,2,0,2,1589083200,1592798400,2
ImABlankapillar,0,2,0,2,1604379600,1604379600,2
montelbon,0,2,0,31,1608440400,1608440400,2
acacacaca_acacacac,2,0,304,0,1597118400,1602216000,2
Dinomenal,2,0,1386,0,1569729600,1570939200,2
Bac1galup0,0,2,0,12,1602388800,1602388800,2
nearthecityofchorrol,0,2,0,58,1575090000,1601438400,2
LilEBT,0,2,0,3,1573621200,1575262800,2
3Fingers4Fun,0,2,0,-3,1591243200,1591243200,2
StrangelySensual,1,1,0,-7,1607576400,1607576400,2
gettheguillotine,0,2,0,11,1554955200,1554955200,2
stumblingmonk,0,2,0,31,1607058000,1607230800,2
DenimGod4lyfe,0,2,0,17,1560484800,1578286800,2
Ayerys,0,2,0,1,1562731200,1562731200,2
lucca_gonzales,0,2,0,57,1562299200,1562299200,2
pbk9,0,2,0,34,1603512000,1605934800,2
Boddicca,0,2,0,4,1600833600,1600833600,2
hrt_bone_tiddies,0,2,0,23,1547269200,1547269200,2
andi-kraiz,0,2,0,15,1587268800,1588910400,2
valvin88,0,2,0,3,1591243200,1591243200,2
BeyondTheTags,0,2,0,-2,1585454400,1585454400,2
SteakPotPie,0,2,0,-2,1577422800,1577422800,2
hooblefloob1,0,2,0,3,1599710400,1599796800,2
Trollslayer0104,0,2,0,2,1584244800,1612069200,2
toasthoo,0,2,0,12,1606021200,1607576400,2
HeirError,1,1,49,15,1549515600,1549515600,2
ellenkult,0,2,0,8,1590638400,1592366400,2
Azmorium,0,2,0,-21,1594440000,1594526400,2
wilderworks,0,2,0,10,1576558800,1580533200,2
EricFitzallen,0,2,0,30,1602302400,1602648000,2
Cokg,0,2,0,11,1607403600,1607403600,2
public_toothbrush,1,1,122,11,1557892800,1557892800,2
mawrmynyw,0,2,0,21,1585800000,1608008400,2
AntinatalismFTW,0,2,0,10,1582779600,1582779600,2
just_alternate_acct,0,2,0,9,1574312400,1574398800,2
sereptie,0,2,0,29,1586059200,1590811200,2
luigithebagel,0,2,0,18,1581051600,1605157200,2
KymbboSlice,0,2,0,5,1611982800,1611982800,2
GJ00,1,1,0,0,1608094800,1608094800,2
solosier,0,2,0,1,1562731200,1579755600,2
basedepartment,1,1,1,16,1605502800,1605934800,2
bui3,1,1,52,2,1581310800,1582866000,2
justcallcollect,1,1,193,10,1551848400,1589947200,2
ChewedFlipFlop,0,2,0,26,1607662800,1607662800,2
Dolphin_McRibs,0,2,0,-1,1602475200,1611982800,2
Id0ntunderstandj0kes,0,2,0,6,1607403600,1607403600,2
TokiDokiHaato,0,2,0,49,1596600000,1596600000,2
sailboat4,0,2,0,5,1590897600,1593230400,2
ilmeducator,0,2,0,7,1599796800,1599883200,2
netherworldite,0,2,0,-7,1581829200,1581915600,2
Jracx,0,2,0,19,1581138000,1581224400,2
BigBurritoBoy1,0,2,0,-9,1604898000,1607835600,2
bleu--moon,0,2,0,4,1612155600,1612155600,2
PsyTard,0,2,0,35,1591156800,1591243200,2
cuporites,0,2,0,61,1606885200,1606885200,2
Ungenauigkeit,0,2,0,57,1608872400,1608958800,2
Littlearthquakes,0,2,0,14,1552881600,1552881600,2
Just1morefix,0,2,0,71,1576904400,1607749200,2
BelterLivesMatter,0,2,0,9,1583812800,1583812800,2
DonnyP_Rs,0,2,0,-20,1606971600,1606971600,2
realsteakbouncer,0,2,0,33,1596168000,1597723200,2
oleg_musor,0,2,0,8,1606194000,1606712400,2
a252,0,2,0,18,1601179200,1606280400,2
Squeebee007,0,2,0,3,1601179200,1601265600,2
The_loudsoda,0,2,0,11,1583125200,1585540800,2
CollegeWithMattie,0,2,0,5,1600488000,1606194000,2
shexpanda,0,2,0,48,1587960000,1588392000,2
DrNick2012,0,2,0,2,1608872400,1608872400,2
DeadXecuter,0,2,0,5,1607144400,1607144400,2
redditnathaniel,0,2,0,2,1593230400,1593230400,2
MythicalRegent4,0,2,0,13,1555646400,1574398800,2
elkie1,0,2,0,67,1608181200,1608181200,2
ISpyAnIncel,0,2,0,24,1593921600,1605934800,2
GayGingerAle,0,2,0,53,1594440000,1597723200,2
bargainkangaroo,0,2,0,7,1588996800,1589256000,2
geogeogeox3,0,2,0,2,1585281600,1585281600,2
Original-Opportunity,0,2,0,6,1604379600,1604379600,2
8thOrbitalArmy,0,2,0,3,1573534800,1582434000,2
CptCarpelan,0,2,0,8,1563508800,1571630400,2
DismalBackground1,0,2,0,-10,1607922000,1607922000,2
jossatron89,0,2,0,17,1576126800,1583298000,2
SheepishInk,0,2,0,120,1606626000,1608181200,2
Whatswhat_,0,2,0,31,1586491200,1598760000,2
stealer0517,0,2,0,22,1560398400,1560484800,2
emitwatch,1,1,1,2,1584072000,1584072000,2
NeverLace,0,2,0,-10,1576299600,1576386000,2
the-lady-jessica,0,2,0,29,1591156800,1604898000,2
nannerpuss345,0,2,0,12,1607922000,1608267600,2
ReadTheEULA,0,2,0,10,1601438400,1604030400,2
mohavewolfpup,0,2,0,3,1575176400,1575176400,2
Hypseau,0,2,0,49,1593489600,1595476800,2
daddydicklooker,0,2,0,15,1608440400,1608526800,2
patrickpollard666,0,2,0,11,1584763200,1586059200,2
dottywine,0,2,0,4,1570507200,1606626000,2
Beltox2pointO,0,2,0,-6,1584676800,1584763200,2
-CasualPanda-,2,0,108,0,1598846400,1602734400,2
Solo439,0,2,0,3,1612242000,1612328400,2
puplove1315,0,2,0,3,1598587200,1608786000,2
Turbo_Fan,0,2,0,41,1587960000,1588737600,2
martialartsvegan,0,2,0,2,1594094400,1594094400,2
MrMoonMan2015,0,2,0,15,1568692800,1569124800,2
justacoacher,0,2,0,36,1601179200,1601179200,2
gooztrz,0,2,0,102,1608613200,1608699600,2
brewboy69,0,2,0,1,1593057600,1593057600,2
Gtyyler,0,2,0,0,1538020800,1538020800,2
huckandcody,1,1,4,1,1558843200,1573102800,2
ScTiger1311,0,2,0,5,1573102800,1573102800,2
CocktailbarStammheim,0,2,0,9,1562472000,1563940800,2
steeze4real,0,2,0,5,1594267200,1608354000,2
MAGA_MOM_XX,0,2,0,-30,1570420800,1570420800,2
Nemesysbr,0,2,0,17,1606971600,1606971600,2
mleahf,0,2,0,3,1605675600,1608008400,2
GlumPipe5,0,2,0,6,1605502800,1605589200,2
rapthrowaway1120,0,2,0,3,1604984400,1604984400,2
MD889,0,2,0,7,1585454400,1585540800,2
potluck88,0,2,0,3,1598760000,1608267600,2
thatvillainjay,0,2,0,138,1593748800,1597204800,2
alakazamafoo,0,2,0,23,1547528400,1552449600,2
workr_b,0,2,0,9,1593144000,1593230400,2
throwitaIIawayy,0,2,0,44,1574658000,1574744400,2
MrMcCringleberry,0,2,0,-7,1592366400,1592539200,2
CryptidCricket,0,2,0,18,1594612800,1601524800,2
Thinks_Like_A_Man,0,2,0,19,1603944000,1603944000,2
pmeaney,0,2,0,10,1582779600,1606021200,2
bgarcia117,0,2,0,14,1604116800,1604379600,2
chunkyworm,0,2,0,17,1556510400,1560312000,2
Clarkii82,0,2,0,4,1608613200,1609218000,2
MaximumHero,1,1,84,9,1590897600,1590897600,2
dayoldhansolo,0,2,0,11,1595217600,1597291200,2
Shaeress,0,2,0,4,1603080000,1603080000,2
420Chopin,0,2,0,9,1601438400,1601438400,2
philosophersass,0,2,0,-33,1601438400,1604030400,2
ZwnD,0,2,0,10,1606971600,1606971600,2
Final-Solution30,0,2,0,12,1606626000,1606712400,2
KEKPOP,0,2,0,-8,1576731600,1576818000,2
Dr_Tacopus,0,2,0,184,1605157200,1605157200,2
BEEEELEEEE,0,2,0,2,1606971600,1608354000,2
jar_full_of_farts,0,2,0,8,1598846400,1599019200,2
lactardenthusiast,0,2,0,4,1595390400,1606021200,2
fear_the_future,0,2,0,51,1600228800,1606453200,2
delimeat-thethird,0,2,0,4,1594353600,1600833600,2
ThatOneEdgySocialist,0,2,0,8,1583812800,1594440000,2
brokeboy_Oolong,0,2,0,2,1586664000,1586664000,2
Hamrave,0,2,0,18,1584158400,1604030400,2
TheMan3volves,0,2,0,-17,1569124800,1569124800,2
anonymousbrowzer,0,2,0,2,1570766400,1570852800,2
Wauhappytimez,0,2,0,21,1572235200,1572235200,2
JustOneDoOver,0,2,0,-39,1581915600,1581915600,2
slwcr,0,2,0,12,1591588800,1591588800,2
Exu-Plosions,0,2,0,13,1567051200,1567051200,2
2h2o22h2o,0,2,0,5,1598932800,1598932800,2
daveyh420,0,2,0,24,1601438400,1601438400,2
dagon85,0,2,0,3,1582952400,1582952400,2
uuyatt,0,2,0,79,1601870400,1601870400,2
Rakali,0,2,0,28,1574658000,1580619600,2
just_venting-26,0,2,0,31,1587614400,1602388800,2
charles-swagenstein,1,1,75,19,1578805200,1578891600,2
blunar00,0,2,0,26,1604811600,1607230800,2
Bennydhee,0,2,0,23,1585281600,1589515200,2
DeputyNicodemus,0,2,0,6,1596772800,1596945600,2
hothead125,0,2,0,358,1549602000,1557460800,2
Radiant_Bee,2,0,4285,0,1605070800,1605330000,2
spell09,0,2,0,6,1609390800,1609390800,2
B0eler,0,2,0,4,1605589200,1605589200,2
Similar_Alternative,0,2,0,8,1585281600,1585281600,2
Masters_domme,0,2,0,10,1569124800,1569124800,2
SpineYard,0,2,0,20,1585627200,1586923200,2
LundberJack,0,2,0,19,1594785600,1594785600,2
gimmethasmoke,0,2,0,11,1598673600,1598673600,2
FrequentDelinquent,0,2,0,5,1586404800,1588305600,2
75IQCommunist,0,2,0,4,1587960000,1587960000,2
fastestguninthewest,1,1,41,13,1607490000,1607576400,2
pupbutt,0,2,0,16,1573448400,1575435600,2
dryrainy,0,2,0,15,1600574400,1605416400,2
justatestdontworry,1,1,15,2,1564286400,1564286400,2
chicagomatty,0,2,0,-3,1575954000,1579064400,2
Ryelen,0,2,0,6,1605589200,1605589200,2
markymarksjewfro,0,2,0,4,1600142400,1600228800,2
Skindoggg,1,1,25,7,1557979200,1557979200,2
thiefexecutive,0,2,0,50,1600660800,1601265600,2
Tinydog1,0,2,0,8,1596945600,1597032000,2
The-Midwesterner,0,2,0,25,1596168000,1596600000,2
HauntedButtCheeks,0,2,0,22,1598155200,1608440400,2
fuckwalmart42069,0,2,0,6,1602993600,1602993600,2
NoMorePolitics45,0,2,0,6,1569988800,1569988800,2
Hologram760,0,2,0,74,1596686400,1596945600,2
lisette_lowe,0,2,0,14,1597377600,1597464000,2
Th3lVadam,0,2,0,28,1555992000,1562731200,2
mdeceiver79,0,2,0,12,1605243600,1609218000,2
NoBulletsLeft,0,2,0,3,1605070800,1605070800,2
gadfly1999,0,2,0,4,1590120000,1606539600,2
kenQ123,0,2,0,85,1605070800,1605070800,2
snearersnip,2,0,14,0,1609304400,1609304400,2
astral_gravel,0,2,0,5,1600747200,1600747200,2
AnneThrope,0,2,0,12,1514091600,1551243600,2
Lateraltwo,0,2,0,35,1562472000,1563249600,2
reelznfeelz,0,2,0,4,1518152400,1577854800,2
NotoriousHakk0r4chan,0,2,0,29,1595217600,1608958800,2
babygavemethebeetus,0,2,0,13,1601956800,1601956800,2
CrazyNaezy,0,2,0,2,1566705600,1566705600,2
mikeymike_74,0,2,0,3,1579755600,1585454400,2
Adderalin,0,2,0,3,1583812800,1591761600,2
12wangsinahumansuit,0,2,0,2,1560916800,1560916800,2
not_ethan_walker,0,2,0,2,1598932800,1598932800,2
Apparently_Apathetic,0,2,0,25,1586404800,1596168000,2
Zyko-Sulcam,0,2,0,69,1605502800,1605589200,2
Evangelionfinal,0,2,0,4,1582779600,1583985600,2
deadsk8er_1,0,2,0,5,1567569600,1571889600,2
breadsci,0,2,0,31,1575522000,1581915600,2
dguzman8181,0,2,0,0,1608958800,1608958800,2
XHelheimX,0,2,0,-5,1570680000,1570680000,2
UnagiSquirrel,0,2,0,4,1606885200,1606885200,2
jokinghazard,0,2,0,3,1573534800,1575090000,2
Over-Field-2850,0,2,0,2,1606712400,1606712400,2
Trick-Quit700,0,2,0,2,1606712400,1608354000,2
OldWhoFan,0,2,0,24,1603512000,1603512000,2
_non4me,0,2,0,84,1569816000,1588392000,2
Elilaidragon,0,2,0,119,1603944000,1605675600,2
kaen,0,2,0,3,1600660800,1600660800,2
TheSleach,0,2,0,17,1607144400,1607144400,2
paperkool,1,1,5,1,1458964800,1459310400,2
StankFangerz,0,2,0,12,1587700800,1604552400,2
carthuscrass,0,2,0,2,1594353600,1603512000,2
hollowdrummer2639,0,2,0,31,1599883200,1600228800,2
Heztant,0,2,0,63,1576645200,1577336400,2
BongusHo,0,2,0,16,1602820800,1607749200,2
crapeescape,0,2,0,33,1604898000,1605157200,2
sai_curious,0,2,0,2,1605070800,1605070800,2
gilbo1990,0,2,0,6,1580792400,1580792400,2
_subgenius,0,2,0,13,1591329600,1591329600,2
SpamSteal,0,2,0,2,1609563600,1609563600,2
FightingGreenMachine,0,2,0,50,1584590400,1607058000,2
stranger_with_candy,0,2,0,20,1592193600,1592193600,2
spvcevce,0,2,0,9,1575349200,1575349200,2
keithhall1025,0,2,0,45,1597550400,1597550400,2
somethingnerdrelated,0,2,0,13,1569211200,1569211200,2
TC0111N5,0,2,0,23,1607662800,1608440400,2
munkeynuggets,0,2,0,23,1597377600,1597377600,2
Aromatic-Wasabi-7188,0,2,0,1,1605762000,1611982800,2
Steven__Bills,0,2,0,2,1642309200,1642309200,2
Touch-fuzzy,0,2,0,10,1605589200,1605589200,2
SprinklesHadKittens,0,2,0,2,1570075200,1570161600,2
Mikes555901,1,1,8,1,1588824000,1588824000,2
alecloxleywrites,0,2,0,10,1598241600,1598500800,2
Olindiass,0,2,0,4,1603598400,1604811600,2
TheImmortalScientist,0,2,0,3,1579669200,1579669200,2
jasmynerice,0,2,0,8,1559188800,1559188800,2
GeneralAverage,0,2,0,50,1564632000,1564632000,2
Itsfr3sh,0,2,0,-2,1592193600,1592193600,2
Meterus,0,2,0,42,1547182800,1576299600,2
KXVXII9X,0,2,0,4,1608267600,1608267600,2
meetthesea,0,2,0,26,1596513600,1596600000,2
Sandmaster14,0,2,0,51,1571976000,1582866000,2
_CaptainKirk,0,2,0,28,1578459600,1578459600,2
marbleheader88,0,2,0,0,1612760400,1612760400,2
codyquixote,1,1,3,3,1589947200,1589947200,2
Marchman,0,2,0,-4,1601956800,1602043200,2
alphaheeb,0,2,0,-30,1577941200,1577941200,2
Servo__,0,2,0,15,1547010000,1547010000,2
Kenotai,0,2,0,46,1569643200,1572235200,2
ThePresidentsNipples,0,2,0,7,1569988800,1605243600,2
vector_o,0,2,0,-29,1590379200,1606021200,2
Commercial_Suit_9440,0,2,0,20,1608699600,1610427600,2
Aetoris,0,2,0,27,1594008000,1594699200,2
grittystitties,0,2,0,35,1585454400,1585454400,2
Dr_Insomnia,0,2,0,2,1577422800,1578373200,2
The_Evil_Skim,0,2,0,8,1603252800,1606971600,2
buzziebee,0,2,0,3,1606453200,1606539600,2
supremeusername,0,2,0,17,1598500800,1598500800,2
Multiverse_Queen,0,2,0,12,1582606800,1582866000,2
mrvladimir,0,2,0,50,1557115200,1574744400,2
4thalwaysopen,0,2,0,17,1599192000,1601611200,2
BlackBloke,0,2,0,4,1418533200,1418533200,2
kozosmos,1,1,292,1,1594353600,1599019200,2
RedditIluvit,0,2,0,2,1586664000,1586664000,2
KlesaMara,0,2,0,4,1602561600,1602561600,2
WylySkillson,0,2,0,442,1602648000,1604379600,2
destrygriffith,0,2,0,4,1573275600,1591848000,2
MitchCumStains,0,2,0,1,1607490000,1607490000,2
Please_DM_Hot_Girls,1,1,0,-5,1586232000,1586232000,2
amscraylane,0,2,0,111,1599796800,1599796800,2
diemmzzie,0,2,0,13,1577336400,1577422800,2
theZephyrne,0,2,0,34,1578978000,1581742800,2
agustybutwhole,0,2,0,6,1586836800,1586836800,2
tengufdi,0,2,0,41,1547442000,1551070800,2
ZeroRequiem87,0,2,0,19,1548392400,1548997200,2
Sprudlidoo,0,2,0,27,1576299600,1581915600,2
BuscameEnGoogle,0,2,0,119,1564632000,1594440000,2
KingofGamesYami,0,2,0,5,1603512000,1603598400,2
Mattias556,0,2,0,3,1609045200,1609131600,2
otter_tots,0,2,0,-63,1593835200,1593835200,2
Remarkable-Safety-34,0,2,0,2,1608526800,1608526800,2
ArtemisCaresTooMuch,0,2,0,-1,1594785600,1594785600,2
orbgevski,0,2,0,10,1586404800,1587096000,2
JiffiPop,0,2,0,3,1598673600,1600833600,2
diegof09,0,2,0,2,1575781200,1575781200,2
DoubleWagon,0,2,0,2,1561262400,1561262400,2
gene_parmesan_PEYE,0,2,0,16,1581138000,1581224400,2
Chanimal67,0,2,0,4,1603512000,1603598400,2
Odd_Employer,0,2,0,3,1576472400,1576558800,2
h4xrk1m,0,2,0,6,1573966800,1573966800,2
rizlagreeen345,0,2,0,30,1611896400,1611982800,2
PhilosophicalToilet,0,2,0,9,1556251200,1600488000,2
TinyWightSpider,0,2,0,-9,1583557200,1584763200,2
crispydiaper,0,2,0,4,1584504000,1584504000,2
LanesReddit,0,2,0,-2,1592539200,1603598400,2
Retrojazzer17,0,2,0,16,1603598400,1603598400,2
backboardsaretrash,0,2,0,8,1576299600,1591675200,2
drunk98,0,2,0,3,1593230400,1593230400,2
Sway40,0,2,0,-6,1585454400,1585454400,2
Figwit_,0,2,0,3,1611810000,1611810000,2
poo_poo_poo_poo_poo,0,2,0,4,1582779600,1582779600,2
BillyBatts99,1,1,138,24,1552363200,1552363200,2
sabatallica,0,2,0,1,1567396800,1567396800,2
574R5,0,2,0,2,1578546000,1578546000,2
Dezzy-Bucket,0,2,0,14,1590724800,1590724800,2
Big_E4013,0,2,0,-18,1584763200,1584763200,2
adykaty,0,2,0,32,1591502400,1591934400,2
Stephonovich,0,2,0,9,1580619600,1580619600,2
111100010100,0,2,0,57,1585454400,1585454400,2
noodles95,1,1,25,10,1581915600,1602388800,2
neznein9,0,2,0,0,1611982800,1611982800,2
ForeskinOfMyPenis,0,2,0,4,1603512000,1604379600,2
ChicoTallahassee,0,2,0,10,1611982800,1611982800,2
Heirtotheglmmrngwrld,0,2,0,27,1570161600,1570248000,2
ledhead93,0,2,0,12,1607576400,1608699600,2
iTriggaWiggas,1,1,0,-1,1602820800,1602820800,2
ReallyJackSparrow,0,2,0,56,1608181200,1612069200,2
dragonboy387,0,2,0,3,1578027600,1579928400,2
your-angry-tits,0,2,0,3,1608699600,1608786000,2
Bouck,0,2,0,26,1560398400,1579496400,2
Resident_Connection,0,2,0,-8,1585454400,1585454400,2
Max-Thunderstone,1,1,10,5,1510894800,1512018000,2
The_Tran_Dynasty,0,2,0,3,1553486400,1553486400,2
Earwigglin,0,2,0,55,1606453200,1606539600,2
WaffleCakeKitty,1,1,47,1,1607490000,1607490000,2
Zampano3,0,2,0,15,1608526800,1608526800,2
MaximaHalen,0,2,0,3,1605589200,1605589200,2
BigtoeJoJo,0,2,0,12,1593576000,1594008000,2
Present_Ad_7010,1,0,66,0,1603166400,1603166400,1
KindredHTpcNFL,0,1,0,1,1585454400,1585454400,1
wawawookie,0,1,0,42,1598673600,1598673600,1
Colinnf,0,1,0,7,1605502800,1605502800,1
ChewwyStick,0,1,0,13,1597550400,1597550400,1
FrozenMongoose,0,1,0,19,1612069200,1612069200,1
Tirasunil,0,1,0,35,1603684800,1603684800,1
thank_me_instead,0,1,0,0,1601524800,1601524800,1
RossTheBossPalmer,0,1,0,1,1592884800,1592884800,1
GlaucomicSailor,0,1,0,5,1583726400,1583726400,1
Mangulwort,0,1,0,-6,1598414400,1598414400,1
onions-make-me-cry,0,1,0,4,1602302400,1602302400,1
OneLargeCheesePizza,0,1,0,5,1588478400,1588478400,1
TheUnofficialZalthor,0,1,0,7,1564977600,1564977600,1
2Cthulu4Schoolthulu,0,1,0,6,1607835600,1607835600,1
ddebritto,0,1,0,1,1589256000,1589256000,1
retro_memer,0,1,0,5,1603598400,1603598400,1
UnknownNam3,0,1,0,30,1583812800,1583812800,1
EndlessProxy,0,1,0,1,1600574400,1600574400,1
2L84T,0,1,0,-2,1591329600,1591329600,1
bowdown2q,0,1,0,1,1605502800,1605502800,1
tired_of_tomorrow,0,1,0,6,1598673600,1598673600,1
Branchingfootsteps,0,1,0,4,1600488000,1600488000,1
astrojules,0,1,0,3,1600574400,1600574400,1
NonreciprocatingHole,0,1,0,1,1599969600,1599969600,1
ohyeaoksure,0,1,0,1,1608267600,1608267600,1
Kumozura,0,1,0,1,1607576400,1607576400,1
GodBlessWaluigi,0,1,0,3,1587355200,1587355200,1
nederino,0,1,0,1,1606626000,1606626000,1
whiskeyhammer90,0,1,0,1,1435982400,1435982400,1
ObscureRefrence,0,1,0,1,1593144000,1593144000,1
diabloPoE12,0,1,0,6,1573966800,1573966800,1
justnotok,0,1,0,1,1591588800,1591588800,1
BinzuBoi,0,1,0,1,1608699600,1608699600,1
neil_anblome,0,1,0,1,1573621200,1573621200,1
Ingenious2000,1,0,32,0,1562644800,1562644800,1
Jedi_Sandcrawler,1,0,92,0,1606885200,1606885200,1
Tvde1,0,1,0,1,1608526800,1608526800,1
shansauce81,0,1,0,9,1598846400,1598846400,1
BigShitta,0,1,0,1,1600660800,1600660800,1
Sassysmirk22,0,1,0,1,1606971600,1606971600,1
rejs7,1,0,13,0,1600056000,1600056000,1
NotKellyClarkson,0,1,0,3,1584504000,1584504000,1
arkad-IV,0,1,0,3,1598155200,1598155200,1
ZanteTheInfernal,0,1,0,1,1598846400,1598846400,1
Eatingcheeserightnow,0,1,0,3,1575435600,1575435600,1
keygrip7,1,0,22,0,1562126400,1562126400,1
bestatbeingmodest,0,1,0,1,1606626000,1606626000,1
pintoman89,0,1,0,-32,1607576400,1607576400,1
garylee23,0,1,0,4,1605589200,1605589200,1
johnsmith24689,0,1,0,1,1618977600,1618977600,1
Helix_Apostle,0,1,0,8,1588824000,1588824000,1
sleepy_svccvbvs,0,1,0,4,1577941200,1577941200,1
AlexAnthonyFTWS,0,1,0,1,1605589200,1605589200,1
nexisfan,0,1,0,4,1603512000,1603512000,1
kakkeli3,1,0,68,0,1604203200,1604203200,1
XapnMary,0,1,0,15,1577941200,1577941200,1
Gcousin,0,1,0,48,1569643200,1569643200,1
jagersrightnut,0,1,0,2,1605070800,1605070800,1
agray4444,0,1,0,2,1597032000,1597032000,1
Crabopulous,0,1,0,25,1596254400,1596254400,1
daymanIloveyou,0,1,0,3,1598760000,1598760000,1
Lexwoor,0,1,0,4,1583384400,1583384400,1
Klutzy13,0,1,0,3,1579237200,1579237200,1
RedditUserNo1990,0,1,0,1,1578978000,1578978000,1
RoosterSamurai,0,1,0,1,1600660800,1600660800,1
BadTiger85,0,1,0,33,1605589200,1605589200,1
EmailsBenghazi,0,1,0,23,1606194000,1606194000,1
tcopsugrfczilxnzmj,0,1,0,2,1609218000,1609218000,1
LoneWolfWi13,0,1,0,47,1574485200,1574485200,1
Dirtnap74,1,0,5,0,1572148800,1572148800,1
allan11011,0,1,0,-5,1590897600,1590897600,1
Gilmore75,0,1,0,0,1604379600,1604379600,1
Roll9ers,0,1,0,3,1604379600,1604379600,1
galenpannan1,0,1,0,3,1591329600,1591329600,1
ItsAll42,0,1,0,1,1607662800,1607662800,1
MrDrPresidentNotSure,0,1,0,1,1579064400,1579064400,1
koda43,0,1,0,8,1571630400,1571630400,1
ACNJ4fun,0,1,0,3,1596686400,1596686400,1
gohugatree,0,1,0,3,1600488000,1600488000,1
Yulenasta,0,1,0,7,1568088000,1568088000,1
acylase,0,1,0,1,1603598400,1603598400,1
DinnerGlass,0,1,0,4,1606194000,1606194000,1
s_exciter,0,1,0,10,1608613200,1608613200,1
nilthewokeboi,0,1,0,5,1583211600,1583211600,1
ShadowsGirl9,0,1,0,1,1607490000,1607490000,1
bigplopa,0,1,0,31,1587614400,1587614400,1
BitterTale,0,1,0,1,1600920000,1600920000,1
parkz88,0,1,0,0,1601352000,1601352000,1
Shesgoneagain,0,1,0,0,1597809600,1597809600,1
ChuckFiasco,0,1,0,7,1597636800,1597636800,1
rebeccamishra,0,1,0,3,1599710400,1599710400,1
mhp14,0,1,0,2,1607403600,1607403600,1
ZuckerThePupper,0,1,0,2,1603512000,1603512000,1
cashewsmile,0,1,0,1,1588996800,1588996800,1
holydude02,0,1,0,4,1572148800,1572148800,1
AutobahnVismarck,0,1,0,2,1577077200,1577077200,1
_Derpenberg,0,1,0,12,1573966800,1573966800,1
DannotheDouc,0,1,0,2,1568347200,1568347200,1
KypsoLol,0,1,0,7,1570939200,1570939200,1
ragnarokdreams,0,1,0,1,1603512000,1603512000,1
FictionalGirlfriend,0,1,0,5,1560744000,1560744000,1
stopneggingyounegger,0,1,0,-6,1606539600,1606539600,1
rdsyes,1,0,274,0,1587182400,1587182400,1
thetruthhurts1975,0,1,0,1,1602734400,1602734400,1
vincentravenblade,0,1,0,1,1595044800,1595044800,1
at0mheart,0,1,0,1,1584763200,1584763200,1
CppChris,0,1,0,12,1594612800,1594612800,1
ColdestList,0,1,0,1,1578632400,1578632400,1
LoadzofLemonz,0,1,0,3,1603598400,1603598400,1
BonelessTurtle,0,1,0,11,1609131600,1609131600,1
redmage07734,0,1,0,1,1635739200,1635739200,1
ogenom,0,1,0,7,1574226000,1574226000,1
behrjac,0,1,0,-2,1592366400,1592366400,1
banevasion4142,0,1,0,-5,1600660800,1600660800,1
extrememisery,0,1,0,10,1563595200,1563595200,1
mocha623,0,1,0,12,1588392000,1588392000,1
SorriorDraconus,0,1,0,2,1606971600,1606971600,1
TheRealDSMi,0,1,0,4,1604984400,1604984400,1
TalkingFromTheToilet,0,1,0,2,1551762000,1551762000,1
please-throwitaway,0,1,0,3,1599796800,1599796800,1
Abby-Zou,0,1,0,8,1601179200,1601179200,1
Moonboots606,0,1,0,2,1576645200,1576645200,1
almondface,0,1,0,1,1608786000,1608786000,1
Global_Rin,0,1,0,11,1570420800,1570420800,1
dvaohp,0,1,0,2,1578546000,1578546000,1
Listen2MeDifferently,0,1,0,26,1599796800,1599796800,1
SuperShyGuy21,0,1,0,6,1580014800,1580014800,1
PM_ME_UR_LAST_DREAM,0,1,0,3,1611723600,1611723600,1
MadLadStalin,0,1,0,0,1598760000,1598760000,1
weegbeeg,0,1,0,1,1603598400,1603598400,1
Slothpoots,0,1,0,2,1603512000,1603512000,1
Pia_moo,0,1,0,2,1565150400,1565150400,1
QueeLinx,0,1,0,4,1574917200,1574917200,1
akiralx26,0,1,0,1,1571025600,1571025600,1
syyvorous,0,1,0,1,1573534800,1573534800,1
Declanmar,1,0,222,0,1579582800,1579582800,1
smokeandmirrors1983,1,0,63,0,1607749200,1607749200,1
Uncle_Homunculus,0,1,0,17,1601438400,1601438400,1
Noisy-Bones,0,1,0,1,1608526800,1608526800,1
raddrobb67,0,1,0,2,1592280000,1592280000,1
vinestime,0,1,0,1,1554609600,1554609600,1
IntroductionSnacks,0,1,0,13,1611982800,1611982800,1
CJSZ01,0,1,0,1,1539921600,1539921600,1
jledragon,0,1,0,3,1593921600,1593921600,1
kiddnn,0,1,0,13,1602820800,1602820800,1
thegreekgamer42,0,1,0,1,1608526800,1608526800,1
scitechaddict,0,1,0,7,1562990400,1562990400,1
Feistygoat53,0,1,0,6,1593316800,1593316800,1
longhorn617,0,1,0,9,1546491600,1546491600,1
Temporary-Rabbit8836,0,1,0,19,1607662800,1607662800,1
Jenniferisnothere,0,1,0,1,1608872400,1608872400,1
malakir86,0,1,0,4,1576213200,1576213200,1
brockbenjamin,0,1,0,75,1607403600,1607403600,1
banjocoyote,0,1,0,2,1607922000,1607922000,1
groundchutney,0,1,0,5,1590379200,1590379200,1
PM_ME_Dog_PicsPls,0,1,0,2,1587441600,1587441600,1
Kat689,0,1,0,1,1585800000,1585800000,1
milkan3rd,0,1,0,1,1611982800,1611982800,1
herpesfreesince93_,0,1,0,1,1589860800,1589860800,1
42_exceptions,0,1,0,112,1600574400,1600574400,1
Zahnan,0,1,0,9,1594526400,1594526400,1
saisonufgh,1,0,0,0,1539921600,1539921600,1
boognerd,0,1,0,1,1607835600,1607835600,1
AncientMysteryBox,0,1,0,11,1601092800,1601092800,1
Pugduck77,0,1,0,13,1612069200,1612069200,1
UnlikeSome,1,0,68,0,1608613200,1608613200,1
Rat-daddy-,0,1,0,1,1635048000,1635048000,1
meinhosen,0,1,0,2,1579755600,1579755600,1
jorgecito,0,1,0,32,1605848400,1605848400,1
CptHeadSmasher,0,1,0,1,1605589200,1605589200,1
misterfletcherr,0,1,0,12,1605589200,1605589200,1
MisterQueef,0,1,0,11,1572408000,1572408000,1
LoUmRuKlExR,0,1,0,-6,1571457600,1571457600,1
oldprecision,0,1,0,6,1606021200,1606021200,1
hustl3tree5,0,1,0,22,1612069200,1612069200,1
rufolo67,1,0,1,0,1550293200,1550293200,1
cowens15,0,1,0,2,1606280400,1606280400,1
the6crimson6fucker6,0,1,0,1,1605589200,1605589200,1
vigbiorn,0,1,0,2,1599451200,1599451200,1
PeopleNeverChange,0,1,0,1,1605589200,1605589200,1
KairyuSmartie,0,1,0,3,1606798800,1606798800,1
DividedRabbit,0,1,0,3,1587268800,1587268800,1
SealightOcean,0,1,0,1,1597118400,1597118400,1
theophane_anson,0,1,0,2,1597377600,1597377600,1
attackonqynn,0,1,0,1,1581483600,1581483600,1
731te7j1nv,0,1,0,-8,1597204800,1597204800,1
marauders_footsteps,0,1,0,33,1605243600,1605243600,1
Anurse1701,0,1,0,6,1546491600,1546491600,1
MayaTamika,0,1,0,2,1574312400,1574312400,1
ND_PC,0,1,0,1,1571716800,1571716800,1
silktabby,0,1,0,-6,1600920000,1600920000,1
xerxerxex,0,1,0,1,1604466000,1604466000,1
muppet_fister,0,1,0,5,1603684800,1603684800,1
yournicefriend,0,1,0,10,1579928400,1579928400,1
H4ckerBoi,0,1,0,2,1557288000,1557288000,1
barbarbarbarians,0,1,0,3,1604293200,1604293200,1
GrindPlant6,0,1,0,3,1603512000,1603512000,1
Pro2ALib,0,1,0,1,1609477200,1609477200,1
artist_sans_medium,0,1,0,2,1602129600,1602129600,1
dasistnichtsexxxy,0,1,0,2,1603512000,1603512000,1
krennics,0,1,0,-8,1606626000,1606626000,1
biryanii,0,1,0,224,1607749200,1607749200,1
Cysion_,0,1,0,89,1576472400,1576472400,1
Avocadobaguette,0,1,0,1,1606021200,1606021200,1
deione,0,1,0,2,1605502800,1605502800,1
andyowencook,0,1,0,11,1559966400,1559966400,1
richislew1s,0,1,0,1,1574226000,1574226000,1
unclemacho,0,1,0,-1,1572843600,1572843600,1
500dollarsinprizes,0,1,0,2,1543294800,1543294800,1
Soft_Plastic2808,0,1,0,3,1596859200,1596859200,1
madknives23,0,1,0,5,1573707600,1573707600,1
G1nr0n,0,1,0,1,1604552400,1604552400,1
PM_FOR_ESKIMO_KISSES,0,1,0,1,1558324800,1558324800,1
lawl3ssr0se,0,1,0,10,1604898000,1604898000,1
OsamaK00,0,1,0,1,1601179200,1601179200,1
Surferbro921,1,0,2268,0,1584158400,1584158400,1
gainfullytart,0,1,0,22,1545195600,1545195600,1
Cool_account_man,0,1,0,2,1602820800,1602820800,1
ThatGuyFight,0,1,0,2,1589947200,1589947200,1
salchichoide,0,1,0,2,1593057600,1593057600,1
primewell,0,1,0,1,1603512000,1603512000,1
shaneeeeg,0,1,0,1,1608267600,1608267600,1
DurdenWB,0,1,0,2,1576558800,1576558800,1
PsychoLogical25,0,1,0,0,1571803200,1571803200,1
TomorrowProblem,0,1,0,25,1599796800,1599796800,1
AethericEye,0,1,0,5,1575262800,1575262800,1
StrikeZone1000,0,1,0,1,1607922000,1607922000,1
Plastiware,0,1,0,9,1572930000,1572930000,1
TA4728489,1,0,4,0,1608354000,1608354000,1
Wouter0308,0,1,0,5,1593230400,1593230400,1
sleepy_doggos,0,1,0,3,1594699200,1594699200,1
w34tyg98,0,1,0,2,1601352000,1601352000,1
iaow2,0,1,0,4,1578805200,1578805200,1
IcyChillMikes,1,0,198,0,1599969600,1599969600,1
Pandazorro,0,1,0,8,1578373200,1578373200,1
potatotub,0,1,0,3,1571112000,1571112000,1
qBiohazard,0,1,0,2,1570075200,1570075200,1
Looking4Sec,0,1,0,1,1599278400,1599278400,1
The_Rogue_Sage,1,0,1453,0,1606366800,1606366800,1
MetallicGray,0,1,0,44,1605934800,1605934800,1
Simplynotthere24,0,1,0,-7,1604293200,1604293200,1
fjacobwilon1993,0,1,0,15,1609218000,1609218000,1
MomSaysNo,0,1,0,12,1585454400,1585454400,1
maclargehuge,0,1,0,2,1595476800,1595476800,1
brooksjonx,0,1,0,2,1612069200,1612069200,1
freethenipple23,0,1,0,1,1606971600,1606971600,1
no_pasta_sauzy,0,1,0,11,1574398800,1574398800,1
Walking-HR-Violation,0,1,0,-1,1608872400,1608872400,1
Ascorbus1,0,1,0,3,1598673600,1598673600,1
indoctrinator4u,0,1,0,2,1608699600,1608699600,1
amh8011,0,1,0,1,1608872400,1608872400,1
reddannyq9,0,1,0,2,1568520000,1568520000,1
HiLls093,0,1,0,6,1607230800,1607230800,1
boner_burner_account,0,1,0,1,1595563200,1595563200,1
trolle222,0,1,0,1,1581051600,1581051600,1
annahoj_kainats,0,1,0,5,1602734400,1602734400,1
KashimDaeva,0,1,0,3,1571371200,1571371200,1
Tdayohey,0,1,0,6,1607662800,1607662800,1
goiter12345,0,1,0,3,1601438400,1601438400,1
sickcynic,0,1,0,3,1597032000,1597032000,1
1iota_,0,1,0,2,1602648000,1602648000,1
JunglePygmy,0,1,0,1,1605589200,1605589200,1
Bigbadmayo,0,1,0,9,1611896400,1611896400,1
shesdrawnpoorly,0,1,0,1,1585108800,1585108800,1
Sam_Hunter01,0,1,0,3,1606021200,1606021200,1
avalanchethethird,0,1,0,15,1576386000,1576386000,1
sidodagod,0,1,0,1,1603598400,1603598400,1
MetLyfe,0,1,0,1,1603512000,1603512000,1
saliva_exchange,0,1,0,9,1609218000,1609218000,1
EchoAndNova,0,1,0,2,1597032000,1597032000,1
Steezie_E,0,1,0,1,1603512000,1603512000,1
The_Iron_Spork,0,1,0,1,1591329600,1591329600,1
quesidilla65,0,1,0,0,1562126400,1562126400,1
Yurvurst_Knightmer,0,1,0,136,1606366800,1606366800,1
TheyCutMeDown,0,1,0,8,1532491200,1532491200,1
painahimah,0,1,0,20,1585454400,1585454400,1
gossamer_bones,0,1,0,0,1585627200,1585627200,1
2old2Bwatching,0,1,0,1,1576386000,1576386000,1
stephelan,0,1,0,1,1603512000,1603512000,1
Alkyar,0,1,0,0,1597118400,1597118400,1
Usertronic5000,0,1,0,-2,1609045200,1609045200,1
Frozty23,0,1,0,13,1602043200,1602043200,1
1RedReddit,0,1,0,26,1585281600,1585281600,1
y0urstrulyy,0,1,0,2,1592798400,1592798400,1
holdontosomething,0,1,0,1,1606626000,1606626000,1
PrehistoricPrincess,0,1,0,18,1567224000,1567224000,1
0ldB0nes,0,1,0,2,1577336400,1577336400,1
PotatoSoule,0,1,0,1,1601438400,1601438400,1
With_A_Knife,0,1,0,2,1591243200,1591243200,1
Beatlemaniac9,0,1,0,8,1593057600,1593057600,1
Muelberry,0,1,0,4,1596772800,1596772800,1
lover-boye,0,1,0,19,1601265600,1601265600,1
ExtraSpicyPls,0,1,0,1,1611982800,1611982800,1
no_name65,1,0,1487,0,1550725200,1550725200,1
flyonthewall727,0,1,0,1,1612069200,1612069200,1
nurf90,1,0,3,0,1562731200,1562731200,1
pooppooppoopypoop,0,1,0,3,1584676800,1584676800,1
Ariquitaun,0,1,0,2,1571889600,1571889600,1
lovelyqu,0,1,0,1,1608008400,1608008400,1
Yeknom6666,0,1,0,1,1580101200,1580101200,1
Mriallen,0,1,0,19,1575435600,1575435600,1
Kaingmbl,0,1,0,2,1608094800,1608094800,1
HighasaMFkite,0,1,0,29,1606971600,1606971600,1
lathund,1,0,8,0,1470974400,1470974400,1
VagarBrook,0,1,0,1,1593144000,1593144000,1
Ksiyas,0,1,0,3,1600747200,1600747200,1
Chasmatesh,0,1,0,6,1592798400,1592798400,1
Konki99,0,1,0,2,1586318400,1586318400,1
yourparadigm,0,1,0,1,1606626000,1606626000,1
Spin_Doctor96,0,1,0,8,1593662400,1593662400,1
gillesthegreat,0,1,0,2,1565496000,1565496000,1
theslutbaby,0,1,0,16,1563768000,1563768000,1
spicyduwang,0,1,0,1,1589083200,1589083200,1
3knuckshuff,0,1,0,26,1584504000,1584504000,1
DerekAnderson4EVA,0,1,0,3,1587441600,1587441600,1
Gayenough4me,0,1,0,4,1580360400,1580360400,1
rosiedokidoki,0,1,0,4,1588478400,1588478400,1
wfgraphicdesign,0,1,0,9,1608526800,1608526800,1
somewhat___damaged,0,1,0,14,1595995200,1595995200,1
_bardown,0,1,0,2,1609390800,1609390800,1
ItsAConspiracy,0,1,0,2,1557720000,1557720000,1
FeatherWorld,0,1,0,7,1603598400,1603598400,1
notsleeping,0,1,0,3,1568779200,1568779200,1
blatherskiters,0,1,0,0,1567137600,1567137600,1
TheDevil_TheLovers,0,1,0,11,1591588800,1591588800,1
SmellsLikeSadMoney,1,0,31,0,1606539600,1606539600,1
ThePoopPolice,0,1,0,3,1599883200,1599883200,1
Otherwise_Fish,1,0,102,0,1581224400,1581224400,1
kafka123,0,1,0,1,1604466000,1604466000,1
nineteenix,1,0,62,0,1576990800,1576990800,1
SteelForHumans735,0,1,0,2,1603512000,1603512000,1
Hermeran,0,1,0,47,1611982800,1611982800,1
opiatesandsuberbs,0,1,0,1,1573448400,1573448400,1
TheShoppingKart,0,1,0,1,1608786000,1608786000,1
EatsonlyPasta,0,1,0,17,1598760000,1598760000,1
hexyrobot,0,1,0,22,1560657600,1560657600,1
TheGreatSalvador,0,1,0,2,1598760000,1598760000,1
polydev,0,1,0,1,1607490000,1607490000,1
pennypacker89,0,1,0,16,1594267200,1594267200,1
smirky-face,0,1,0,3,1591675200,1591675200,1
trendepazz,0,1,0,1,1602734400,1602734400,1
LeighofMar,0,1,0,3,1578805200,1578805200,1
UselessOnion666,0,1,0,4,1562212800,1562212800,1
redpillblue,0,1,0,1,1581915600,1581915600,1
Treekin3000,0,1,0,8,1578805200,1578805200,1
runnerego,0,1,0,37,1540094400,1540094400,1
aspideylover,0,1,0,3,1593403200,1593403200,1
shutupmooncricket,0,1,0,2,1600747200,1600747200,1
-Always_Met-,0,1,0,4,1578286800,1578286800,1
All4gaines,0,1,0,23,1559016000,1559016000,1
ionlyfuck,0,1,0,4,1601870400,1601870400,1
blankstarescreamimg,0,1,0,17,1598328000,1598328000,1
FancySnugglepuff,0,1,0,3,1583985600,1583985600,1
nahmate34,1,0,12,0,1555300800,1555300800,1
future_chili,0,1,0,3,1603512000,1603512000,1
halfassery,0,1,0,2,1567483200,1567483200,1
MonsieurAuContraire,0,1,0,16,1597118400,1597118400,1
AntiAntiLowEffortBot,0,1,0,1,1555041600,1555041600,1
mehdison,0,1,0,8,1561262400,1561262400,1
krabbiepatties795,1,0,37,0,1606712400,1606712400,1
CouchieWouchie,0,1,0,1,1605243600,1605243600,1
FlamingoPepsi,0,1,0,1,1606626000,1606626000,1
Astarrynight2020,0,1,0,3,1597809600,1597809600,1
ImperatorDanny,0,1,0,1,1576645200,1576645200,1
purple__dog,0,1,0,8,1605243600,1605243600,1
LeOctopus,0,1,0,17,1547096400,1547096400,1
iNoScopedJFKoO,0,1,0,22,1600228800,1600228800,1
P0nk3yDunch,0,1,0,4,1575349200,1575349200,1
lemonade_honey,0,1,0,5,1606280400,1606280400,1
Apathy2676,0,1,0,84,1587873600,1587873600,1
PorcelainGoddess1986,1,0,951,0,1604030400,1604030400,1
Kerostasis,0,1,0,4,1599192000,1599192000,1
jesus_fn_christ,0,1,0,87,1585368000,1585368000,1
KingZlatan10,0,1,0,3,1605848400,1605848400,1
viennoiserie,0,1,0,2,1472184000,1472184000,1
usushioaji,0,1,0,2,1608958800,1608958800,1
stuwoo,0,1,0,11,1584158400,1584158400,1
sadlycantpressbutton,0,1,0,5,1605589200,1605589200,1
EndersMark,0,1,0,1,1601092800,1601092800,1
Forecydian,0,1,0,4,1592366400,1592366400,1
serenitycanned,0,1,0,3,1607317200,1607317200,1
Jeangrey86,0,1,0,5,1587268800,1587268800,1
Nurlehatesme,0,1,0,3,1606194000,1606194000,1
Duke_Theos,0,1,0,2,1577854800,1577854800,1
MichiganBrolitia,0,1,0,11,1578891600,1578891600,1
BigHairyDildo,0,1,0,2,1579237200,1579237200,1
theshardunique,0,1,0,5,1598068800,1598068800,1
jthedwalker,0,1,0,10,1604898000,1604898000,1
sctm3400,0,1,0,1,1608526800,1608526800,1
selkipio,0,1,0,5,1569038400,1569038400,1
booyakabunga,0,1,0,1,1605934800,1605934800,1
Dinklepuffus,0,1,0,1,1595649600,1595649600,1
livinglifetomax,0,1,0,2,1602820800,1602820800,1
benjancewicz,0,1,0,27,1588392000,1588392000,1
orangered77,0,1,0,2,1602043200,1602043200,1
Prestigious-Handle-6,0,1,0,1,1604030400,1604030400,1
cplforlife,0,1,0,1,1601611200,1601611200,1
holothewisewolf12345,1,0,0,0,1575435600,1575435600,1
goatsfeet,0,1,0,11,1585540800,1585540800,1
40earthlikeplanets,0,1,0,2,1582952400,1582952400,1
saltyroadhogmain,0,1,0,2,1611982800,1611982800,1
SelfMedicatedLlama,0,1,0,3,1576040400,1576040400,1
NamaruAndCrew,0,1,0,2,1592539200,1592539200,1
warsatan,0,1,0,1,1585454400,1585454400,1
Rysinor,0,1,0,1,1576731600,1576731600,1
Friedlice420,0,1,0,-2,1606539600,1606539600,1
thedeafbadger,0,1,0,18,1602648000,1602648000,1
parulaz123,0,1,0,4,1593057600,1593057600,1
Dreadpipes,0,1,0,4,1575435600,1575435600,1
adeptdecipherer,0,1,0,22,1581742800,1581742800,1
EatTheBroccoli,0,1,0,2,1606626000,1606626000,1
eludingme,0,1,0,15,1565409600,1565409600,1
Songandsilence3,0,1,0,4,1560657600,1560657600,1
carcosaa666,0,1,0,4,1607317200,1607317200,1
Keeppforgetting,0,1,0,1,1608526800,1608526800,1
lincolnhornet68,0,1,0,1,1604984400,1604984400,1
AKATHESEAL,0,1,0,-2,1606626000,1606626000,1
jasonshappyagain,0,1,0,1,1559793600,1559793600,1
Live-Love-Lie,0,1,0,1,1600228800,1600228800,1
pabstsucks,1,0,11,0,1465876800,1465876800,1
SizzlingHotDeluxe,0,1,0,1,1607749200,1607749200,1
dovesondoves,0,1,0,1,1584244800,1584244800,1
0818wedding,0,1,0,15,1576213200,1576213200,1
giraffesbluntz,1,0,15,0,1598587200,1598587200,1
Dweezilalso,0,1,0,1,1592971200,1592971200,1
metz420,0,1,0,19,1600228800,1600228800,1
VersaceDemon69,0,1,0,7,1581310800,1581310800,1
Deminishingreturn,0,1,0,3,1599883200,1599883200,1
Truth_SeekingMissile,0,1,0,-29,1587873600,1587873600,1
LiLCris111999,0,1,0,-2,1571716800,1571716800,1
namjeef,0,1,0,1,1589947200,1589947200,1
geebr,0,1,0,9,1604030400,1604030400,1
ProfessorAutodidact,0,1,0,2,1607576400,1607576400,1
Adventux,0,1,0,4,1582088400,1582088400,1
lckstckn2smknbarrels,0,1,0,368,1606971600,1606971600,1
Luci_LUXFERRE,0,1,0,1,1607317200,1607317200,1
Kenny-Brockelstein,0,1,0,1,1601352000,1601352000,1
thisperson,0,1,0,20,1546578000,1546578000,1
KateBeckinsale_PM_Me,0,1,0,1,1598760000,1598760000,1
MitchfromMich,0,1,0,13,1593230400,1593230400,1
Carltheawesome777,0,1,0,19,1574485200,1574485200,1
Myantology,0,1,0,1,1608267600,1608267600,1
TheDefendingChamp,0,1,0,10,1603512000,1603512000,1
partisparti,0,1,0,17,1581310800,1581310800,1
Matticus_Rex,0,1,0,1,1564113600,1564113600,1
Indigocell,0,1,0,8,1562299200,1562299200,1
cccccRRRRRRuuuuu,1,0,0,0,1581310800,1581310800,1
fishtimer,0,1,0,2,1593662400,1593662400,1
WhyDoIFeelLikeTA,0,1,0,2,1570507200,1570507200,1
insidezone64,0,1,0,3,1558843200,1558843200,1
drsapirstein,0,1,0,7,1607576400,1607576400,1
GoblinMonk,0,1,0,3,1603598400,1603598400,1
berkut3000,0,1,0,85,1605070800,1605070800,1
chunkmasterflecs,1,0,16,0,1592193600,1592193600,1
81829,0,1,0,3,1611982800,1611982800,1
Imaginary-Location-8,0,1,0,15,1606626000,1606626000,1
Ionmaster130,0,1,0,2,1576645200,1576645200,1
yoberf,0,1,0,3,1605934800,1605934800,1
Sythus,0,1,0,4,1606539600,1606539600,1
mattlinggun,1,0,444,0,1592884800,1592884800,1
QuietMouseBitch,0,1,0,1,1561089600,1561089600,1
No_cuts,0,1,0,1,1621742400,1621742400,1
PTMoney18,0,1,0,4,1567396800,1567396800,1
MikeMOMO22,0,1,0,0,1572062400,1572062400,1
lullichan,0,1,0,7,1604984400,1604984400,1
AgentWashingtub1,0,1,0,1,1605589200,1605589200,1
Blankrabbit,0,1,0,2,1607749200,1607749200,1
snowfox222,0,1,0,1,1560571200,1560571200,1
Seveneyesindarkness,0,1,0,4,1599105600,1599105600,1
breathen123,0,1,0,3,1573448400,1573448400,1
lost_wavelenght,0,1,0,1,1600056000,1600056000,1
AeneasWalk,0,1,0,2,1608699600,1608699600,1
BroReece,0,1,0,-1,1607662800,1607662800,1
roaming_polanski,1,0,8,0,1602648000,1602648000,1
Brawl_Beatdown,0,1,0,0,1598414400,1598414400,1
dm_me_ur_chickens,0,1,0,7,1552536000,1552536000,1
thoalmighty,0,1,0,2,1579669200,1579669200,1
combativeginger,0,1,0,1,1593144000,1593144000,1
FoxShirts,0,1,0,30,1596081600,1596081600,1
ParapaPalace,0,1,0,21,1611723600,1611723600,1
CoolWizard88,0,1,0,-2,1571112000,1571112000,1
ZPTs,0,1,0,89,1547874000,1547874000,1
Morfutus,0,1,0,0,1570420800,1570420800,1
Fuzzleton,0,1,0,38,1600833600,1600833600,1
Kirschi,0,1,0,7,1567310400,1567310400,1
Melyjane312,0,1,0,41,1607922000,1607922000,1
bradyyybunchhhwhooo,1,0,12,0,1596513600,1596513600,1
ultracoolman,0,1,0,3,1603512000,1603512000,1
stiephel,0,1,0,3,1587787200,1587787200,1
thekillerspaceking,0,1,0,1,1593316800,1593316800,1
kdifjeh,0,1,0,2,1580101200,1580101200,1
denelic,0,1,0,26,1580792400,1580792400,1
KillaQMoney,0,1,0,9,1570507200,1570507200,1
michael_ohan,0,1,0,1,1600660800,1600660800,1
TheNorselord,0,1,0,1,1606626000,1606626000,1
TheRougeSkeptic,1,0,114,0,1588392000,1588392000,1
Shot-Wheel,0,1,0,1,1587268800,1587268800,1
Anarchist_Geochemist,0,1,0,1,1642654800,1642654800,1
gfdsjfsfsfdsfd,0,1,0,1,1608094800,1608094800,1
Lil_Figgus,0,1,0,-12,1602129600,1602129600,1
rayvin4000,0,1,0,2,1608008400,1608008400,1
bluestarfishh,0,1,0,4,1600488000,1600488000,1
Phantompooper03,0,1,0,0,1588651200,1588651200,1
RebelliousTreecko,0,1,0,6,1599105600,1599105600,1
watermelonspanker,0,1,0,1,1604725200,1604725200,1
NeokjSantana,0,1,0,9,1608008400,1608008400,1
neatzsche_,1,0,11,0,1608181200,1608181200,1
say_ruh,0,1,0,14,1601697600,1601697600,1
idkbtwlou,0,1,0,23,1607490000,1607490000,1
Hawkson2020,0,1,0,11,1585454400,1585454400,1
ajaxanc,0,1,0,1,1603512000,1603512000,1
ShakaZuluYourMom,0,1,0,3,1597982400,1597982400,1
Solonys,0,1,0,-4,1581138000,1581138000,1
whosthat,0,1,0,2,1605070800,1605070800,1
pisshead_,0,1,0,3,1590379200,1590379200,1
bardtheonly,0,1,0,1,1562644800,1562644800,1
dudeydudee,0,1,0,1,1604466000,1604466000,1
endangerednigel,0,1,0,1,1608699600,1608699600,1
Rongulbringus,0,1,0,11,1581915600,1581915600,1
morehumblethanyou,0,1,0,1,1578718800,1578718800,1
GiantPileofCats,0,1,0,20,1608613200,1608613200,1
pearsonm957,0,1,0,2,1592798400,1592798400,1
harabanaz,0,1,0,2,1590120000,1590120000,1
k-hanos,0,1,0,1,1555905600,1555905600,1
RDSZ,0,1,0,1,1594267200,1594267200,1
england_is_my_gender,0,1,0,2,1594008000,1594008000,1
HomieeJo,0,1,0,11,1592798400,1592798400,1
interfail,0,1,0,66,1571976000,1571976000,1
Gnar__Marx,0,1,0,10,1603771200,1603771200,1
mrholiday45,0,1,0,1,1584763200,1584763200,1
mahklayner,0,1,0,13,1589860800,1589860800,1
Pyrheart,0,1,0,7,1588046400,1588046400,1
Darthvegeta81,0,1,0,5,1600488000,1600488000,1
CheeseGrater1900,0,1,0,5,1608440400,1608440400,1
Fuckerdine,0,1,0,1,1591329600,1591329600,1
Powercel,0,1,0,41,1586404800,1586404800,1
recongio,1,0,1,0,1456549200,1456549200,1
GhostOfAlSmith,1,0,0,0,1590206400,1590206400,1
NhlProShawn,0,1,0,-16,1581397200,1581397200,1
witherspork,0,1,0,8,1607403600,1607403600,1
Faulkal,0,1,0,3,1605589200,1605589200,1
RevolutionRose,0,1,0,1,1603252800,1603252800,1
Squanchedschwiftly,0,1,0,5,1602820800,1602820800,1
Stankypanky1,0,1,0,1,1604725200,1604725200,1
u33437296_2,0,1,0,1,1608872400,1608872400,1
GooseSnek,1,0,3,0,1574658000,1574658000,1
travman6,0,1,0,1,1589342400,1589342400,1
PenceyC,0,1,0,1,1604116800,1604116800,1
DjDrGandalf,1,0,56,0,1587355200,1587355200,1
xGingx755,0,1,0,0,1606885200,1606885200,1
cyanobobalamin,0,1,0,11,1607662800,1607662800,1
bumble_squirrel,1,0,52,0,1574226000,1574226000,1
Pilotwaver,0,1,0,2,1602129600,1602129600,1
unkown-shmook,0,1,0,2,1583985600,1583985600,1
MaxGivingHeadroom,1,0,370,0,1601870400,1601870400,1
Elite051,0,1,0,4,1582779600,1582779600,1
HappyNihilist,0,1,0,-2,1605416400,1605416400,1
WallStreetSingapore,0,1,0,5,1604725200,1604725200,1
Sleepingguitarman,0,1,0,1,1604379600,1604379600,1
ohshallots,0,1,0,1,1582520400,1582520400,1
69IntrusiveThots,0,1,0,6,1584504000,1584504000,1
horror-,0,1,0,3,1581656400,1581656400,1
kibblesandbitch33,0,1,0,1,1641013200,1641013200,1
MedicalInternal,0,1,0,3,1603425600,1603425600,1
megacad,0,1,0,1,1540958400,1540958400,1
brendanlad,0,1,0,2,1612328400,1612328400,1
Terrymacdud,0,1,0,2,1603512000,1603512000,1
JeffIpsaLoquitor,0,1,0,1,1442030400,1442030400,1
RockHardBooner,0,1,0,19,1608786000,1608786000,1
jeffpickens1,0,1,0,0,1595563200,1595563200,1
omke,0,1,0,33,1601870400,1601870400,1
Billy1234Bob,0,1,0,1,1598846400,1598846400,1
samg2020kmudbut,0,1,0,1,1608181200,1608181200,1
IceBre4th,0,1,0,11,1577250000,1577250000,1
Southside_Burd,0,1,0,2,1607662800,1607662800,1
borgol,0,1,0,1,1453611600,1453611600,1
medaumplacebo,0,1,0,5,1601524800,1601524800,1
existentialhack1,0,1,0,5,1604203200,1604203200,1
capriciousVelpecula,0,1,0,6,1563681600,1563681600,1
pm_ur_duck_pics,0,1,0,1,1560744000,1560744000,1
poorunluckyman,0,1,0,1,1572930000,1572930000,1
glyph18863,0,1,0,13,1605330000,1605330000,1
habbathejutt,0,1,0,2,1591243200,1591243200,1
TheMajorMedic,0,1,0,-14,1604293200,1604293200,1
MWanderone,0,1,0,5,1569470400,1569470400,1
Cold_FuzZ,0,1,0,1,1574744400,1574744400,1
OkProposal3,0,1,0,11,1558411200,1558411200,1
80bug,0,1,0,2,1573707600,1573707600,1
lazylion_ca,0,1,0,1,1611982800,1611982800,1
nikaido_devil,0,1,0,2,1601352000,1601352000,1
StabbyUnicornActual,0,1,0,7,1607576400,1607576400,1
djaevlenselv,0,1,0,5,1608699600,1608699600,1
ThePhudSon,0,1,0,1,1599796800,1599796800,1
invisiblink,0,1,0,13,1611896400,1611896400,1
-HoosierBob-,0,1,0,1,1607058000,1607058000,1
smashilin,1,0,7,0,1477886400,1477886400,1
SSiirr,0,1,0,4,1555646400,1555646400,1
ThatCableGuy,0,1,0,7,1598414400,1598414400,1
rotenbart,0,1,0,1,1608699600,1608699600,1
Incandescent_Lass,0,1,0,21,1602129600,1602129600,1
OriginalPostSearcher,0,1,0,1,1440993600,1440993600,1
leahish,0,1,0,3,1603425600,1603425600,1
foxphace,0,1,0,9,1547528400,1547528400,1
uglynaked24,0,1,0,28,1598587200,1598587200,1
burnsieburns,0,1,0,2,1600660800,1600660800,1
linkalong,0,1,0,7,1600574400,1600574400,1
nicknasteeee,0,1,0,1,1594699200,1594699200,1
BestGarbagePerson,0,1,0,4,1575522000,1575522000,1
Fretzli,0,1,0,4,1581310800,1581310800,1
wubalubadubdub1983,0,1,0,14,1603684800,1603684800,1
yanric,0,1,0,3,1602043200,1602043200,1
Enable-GODMODE,0,1,0,2,1607058000,1607058000,1
sunshineanrain,0,1,0,10,1581829200,1581829200,1
DrBeePhD,0,1,0,35,1580360400,1580360400,1
Zelper_,0,1,0,5,1577941200,1577941200,1
todaysthedaytoday,0,1,0,5,1611982800,1611982800,1
sadboiboop,0,1,0,3,1586923200,1586923200,1
star0705,0,1,0,1,1608094800,1608094800,1
TimeStaysWeGo,0,1,0,0,1603512000,1603512000,1
Justin325,0,1,0,9,1598155200,1598155200,1
Zuglaz,1,0,12,0,1606798800,1606798800,1
TickleMonsterCG,0,1,0,7,1575781200,1575781200,1
Brown_Sugah424,0,1,0,8,1595304000,1595304000,1
Geruvah,0,1,0,3,1603598400,1603598400,1
Ticodacat,0,1,0,2,1601352000,1601352000,1
garfield-1-2323,0,1,0,-4,1601870400,1601870400,1
CorrosiveAgent,0,1,0,8,1611896400,1611896400,1
IhateMichaelJohnson,0,1,0,1,1603512000,1603512000,1
KernowBysVykken93,0,1,0,60,1571457600,1571457600,1
uunan1,0,1,0,40,1611896400,1611896400,1
user289i,0,1,0,5,1570593600,1570593600,1
Buge_,0,1,0,1,1571976000,1571976000,1
unlimitedmayonaise,0,1,0,-7,1603512000,1603512000,1
NeonChampion2099,0,1,0,1,1601611200,1601611200,1
Beautiful-Credit-784,1,0,3,0,1605762000,1605762000,1
duca-b,0,1,0,3,1562472000,1562472000,1
masterplaytails,0,1,0,1,1590206400,1590206400,1
kittenhiss,0,1,0,21,1608613200,1608613200,1
hippiefromolema,0,1,0,14,1602907200,1602907200,1
everydays_lyk_sunday,0,1,0,1,1611464400,1611464400,1
ItchyUnfavorableness,0,1,0,2,1579064400,1579064400,1
Noslodamus,0,1,0,19,1602734400,1602734400,1
T3ddyBeast,1,0,0,0,1599969600,1599969600,1
Spookd_Moffun,0,1,0,1,1584072000,1584072000,1
Orsty,0,1,0,1,1608786000,1608786000,1
stickswithsticks,1,0,25,0,1605589200,1605589200,1
shewy92,0,1,0,3,1604379600,1604379600,1
higherrecreation,0,1,0,1,1609390800,1609390800,1
spongythingy,0,1,0,13,1593835200,1593835200,1
MegasNexal84,0,1,0,53,1597982400,1597982400,1
SusDabKing,0,1,0,-1,1559188800,1559188800,1
shaggydogg,0,1,0,16,1607576400,1607576400,1
ella2130,1,0,1,0,1606366800,1606366800,1
2IndianRunnerDucks,0,1,0,14,1606712400,1606712400,1
uebermacht,0,1,0,0,1581829200,1581829200,1
Travelling_Draba,0,1,0,6,1603684800,1603684800,1
Peripheral72,0,1,0,2,1575349200,1575349200,1
LeapYearPro,0,1,0,1,1634702400,1634702400,1
thalesjferreira,0,1,0,11,1570420800,1570420800,1
happycamper357,0,1,0,1,1588737600,1588737600,1
Yarash2110,0,1,0,1,1588996800,1588996800,1
sleepthetablet,0,1,0,1,1596772800,1596772800,1
AConcernedParent,0,1,0,1,1605934800,1605934800,1
VladamirTakin,0,1,0,6,1609304400,1609304400,1
mutantIke,0,1,0,50,1607230800,1607230800,1
mouthbreather390,0,1,0,11,1581397200,1581397200,1
MINNESOTAKARMATRAIN_,0,1,0,8,1607662800,1607662800,1
sobeyobi0,0,1,0,1,1599192000,1599192000,1
Illigalmangoes,0,1,0,1,1609304400,1609304400,1
memesdied,0,1,0,12,1545109200,1545109200,1
lepusamissa,0,1,0,30,1547701200,1547701200,1
WeLiveInASociety-Man,0,1,0,1,1578373200,1578373200,1
blackdragonnidhogg,0,1,0,3,1604293200,1604293200,1
droidsurlooking4,0,1,0,5,1602302400,1602302400,1
Squodgephelph,0,1,0,30,1608440400,1608440400,1
General_Stratog,0,1,0,1,1576818000,1576818000,1
septemberhelpless,0,1,0,6,1575262800,1575262800,1
darealarms,0,1,0,2,1607749200,1607749200,1
PillKosby69,0,1,0,6,1602388800,1602388800,1
beastmaster11,0,1,0,1,1608526800,1608526800,1
GoodFascistDead,0,1,0,2,1603512000,1603512000,1
RlyShldBWrkng,0,1,0,22,1608267600,1608267600,1
d3RUPT,0,1,0,1,1594785600,1594785600,1
hudoo2,0,1,0,1,1597809600,1597809600,1
fromplanetmars,0,1,0,11,1599105600,1599105600,1
colorfullysarah,0,1,0,20,1570593600,1570593600,1
MadAzza,0,1,0,25,1605934800,1605934800,1
Nyarlathotep90,0,1,0,9,1592884800,1592884800,1
civitts10,0,1,0,10,1604030400,1604030400,1
ZefSoFresh,0,1,0,2,1603512000,1603512000,1
disdi89,1,0,6,0,1548392400,1548392400,1
MakingIn,0,1,0,8,1597636800,1597636800,1
dixie-flyer,0,1,0,1,1604811600,1604811600,1
Smooth_Disaster,0,1,0,9,1603425600,1603425600,1
captnausm,0,1,0,6,1596168000,1596168000,1
AnonymousN8V,0,1,0,0,1604552400,1604552400,1
Tompthwy,0,1,0,7,1611982800,1611982800,1
notlaser,1,0,3,0,1590206400,1590206400,1
DistrictApart4571,0,1,0,1,1605502800,1605502800,1
SlitherQNan,0,1,0,1,1593748800,1593748800,1
Myfakeplantsloveme,0,1,0,3,1583125200,1583125200,1
rocketsalesman,0,1,0,1,1602907200,1602907200,1
polovash,0,1,0,3,1605070800,1605070800,1
tattoedlydia,0,1,0,1,1579410000,1579410000,1
alt717,0,1,0,3,1599883200,1599883200,1
tylerfuckingmarch,0,1,0,0,1603512000,1603512000,1
alfred_27,0,1,0,2,1603166400,1603166400,1
maximuspantelones,0,1,0,0,1581224400,1581224400,1
Rueyousay,0,1,0,10,1606626000,1606626000,1
nwahsrellim,0,1,0,1,1598760000,1598760000,1
justarandomfromEU,0,1,0,33,1585627200,1585627200,1
AncientCityGator,0,1,0,4,1608008400,1608008400,1
jackssmile,0,1,0,5,1593835200,1593835200,1
Omneorift,0,1,0,5,1563163200,1563163200,1
Error_Empty,0,1,0,516,1602648000,1602648000,1
CountdownToCake,0,1,0,1,1576731600,1576731600,1
bismerablemastard,0,1,0,9,1599710400,1599710400,1
savi0r117,0,1,0,31,1576904400,1576904400,1
asurawalker,0,1,0,2,1565409600,1565409600,1
Mech751999,0,1,0,1,1608613200,1608613200,1
BumbleStar,0,1,0,2,1528862400,1528862400,1
LushAscensionalist,0,1,0,2,1577768400,1577768400,1
psterie,0,1,0,2,1600660800,1600660800,1
ThatsOnYoutube,0,1,0,9,1606280400,1606280400,1
LawyermanAdultson,0,1,0,3,1604466000,1604466000,1
blackgandalff,0,1,0,3,1585022400,1585022400,1
Throwawayagogo12,0,1,0,1,1580533200,1580533200,1
BowlDesigner,1,0,34,0,1611810000,1611810000,1
tsuzuku_ryudo,0,1,0,11,1582174800,1582174800,1
trezzinator,0,1,0,3,1593662400,1593662400,1
uniqueusor,0,1,0,3,1581051600,1581051600,1
3wolftshirtguy,0,1,0,2,1600833600,1600833600,1
CriminalMacabre,0,1,0,3,1606539600,1606539600,1
NoEyedGirl,0,1,0,10,1603771200,1603771200,1
platitood,0,1,0,1,1600574400,1600574400,1
RoguePsychonaut19,0,1,0,1,1602648000,1602648000,1
Fortiman,0,1,0,8,1604725200,1604725200,1
TheSoundDude,0,1,0,6,1595476800,1595476800,1
digitalh3rmit,0,1,0,3,1590033600,1590033600,1
dariik,0,1,0,1,1567569600,1567569600,1
JaneTheNotNotVirgin,0,1,0,5,1602820800,1602820800,1
MaybeMitch,0,1,0,28,1567310400,1567310400,1
proballynotaduck,0,1,0,3,1608613200,1608613200,1
frisch85,0,1,0,11,1572235200,1572235200,1
A_sweet_boy,0,1,0,3,1581051600,1581051600,1
greendubya,0,1,0,1,1584244800,1584244800,1
TheFrenchSavage,0,1,0,23,1601524800,1601524800,1
cuentaderana,0,1,0,2,1585454400,1585454400,1
IAmWeAr,0,1,0,4,1599105600,1599105600,1
Onceintx,0,1,0,1,1603512000,1603512000,1
Punkwinchester,0,1,0,1,1601524800,1601524800,1
asfgfsa,0,1,0,1,1636347600,1636347600,1
GrandAdmiralKoba,0,1,0,10,1606626000,1606626000,1
TAreq101,0,1,0,7,1571198400,1571198400,1
mark0x,0,1,0,333,1589947200,1589947200,1
SirBebrama,0,1,0,11,1578632400,1578632400,1
Oogiville,0,1,0,11,1591070400,1591070400,1
TeamOpieoids,0,1,0,14,1557720000,1557720000,1
thehawaiianjesus,0,1,0,8,1605675600,1605675600,1
parker1019,0,1,0,2,1609304400,1609304400,1
Captain_of_Skene,1,0,7,0,1593748800,1593748800,1
Carouselcolours,0,1,0,1,1598068800,1598068800,1
VintageOG,0,1,0,1,1604379600,1604379600,1
StaticTuesday,0,1,0,17,1559188800,1559188800,1
Youkindofare,0,1,0,51,1583643600,1583643600,1
scaylos1,0,1,0,12,1586836800,1586836800,1
foobargoop,0,1,0,4,1571025600,1571025600,1
unicornicopia1,0,1,0,6,1579928400,1579928400,1
NegativeAnte,0,1,0,23,1600660800,1600660800,1
Apprehensive_Aspect,0,1,0,3,1585454400,1585454400,1
Sonmaru,0,1,0,4,1566187200,1566187200,1
AladeenModaFuqa,0,1,0,0,1578978000,1578978000,1
6Solus,0,1,0,1,1588996800,1588996800,1
Mustafahahaha,0,1,0,0,1606626000,1606626000,1
AuroraNidhoggr,0,1,0,5,1574744400,1574744400,1
MayorPufnstuf,0,1,0,1,1570420800,1570420800,1
Jack-Bracken,0,1,0,6,1580274000,1580274000,1
alex12m,0,1,0,3,1602129600,1602129600,1
nandakv,0,1,0,24,1607835600,1607835600,1
Robuk1981,0,1,0,1,1572843600,1572843600,1
huggalump,0,1,0,7,1608958800,1608958800,1
ExpellYourMomis,0,1,0,18,1596945600,1596945600,1
kangdor3,0,1,0,9,1607490000,1607490000,1
LtEnglishMajor,0,1,0,65,1581570000,1581570000,1
red_rover33,0,1,0,1,1561780800,1561780800,1
Kareenuts,0,1,0,1,1593316800,1593316800,1
SamanKunans02,0,1,0,-4,1607662800,1607662800,1
OrsonWiggin,0,1,0,1,1582779600,1582779600,1
TehPharaoh,0,1,0,10,1559102400,1559102400,1
dick_tickles,0,1,0,3,1607058000,1607058000,1
Zulrock123,0,1,0,3,1602820800,1602820800,1
ketimmer,0,1,0,2,1607576400,1607576400,1
Sundance37,0,1,0,-3,1589601600,1589601600,1
Stoddartje,0,1,0,-2,1584763200,1584763200,1
MisguidedMiscreants1,0,1,0,36,1606885200,1606885200,1
SarcasticRiposte,0,1,0,2,1603512000,1603512000,1
thygrrr,0,1,0,4,1573621200,1573621200,1
desdeaden,0,1,0,1,1612155600,1612155600,1
M0j0Rizn,0,1,0,1,1583643600,1583643600,1
-k-onte,0,1,0,7,1607144400,1607144400,1
Fieryshit,0,1,0,2,1606021200,1606021200,1
ginchou,0,1,0,3,1602043200,1602043200,1
paradisimperiala,0,1,0,1,1604725200,1604725200,1
DabbyDabber711,0,1,0,3,1588305600,1588305600,1
Punknigg,0,1,0,3,1609390800,1609390800,1
californiadutch,0,1,0,2,1561694400,1561694400,1
SoldadoEZLN,0,1,0,1,1589256000,1589256000,1
hawxhaw,0,1,0,0,1600660800,1600660800,1
AustralasianCannabis,0,1,0,5,1598587200,1598587200,1
shiverglow,0,1,0,2,1587441600,1587441600,1
redhen19,0,1,0,2,1418274000,1418274000,1
t00th-fairy,0,1,0,14,1556251200,1556251200,1
Rierais,0,1,0,1,1606626000,1606626000,1
Ttobba_Cusimani,0,1,0,2,1599624000,1599624000,1
Niko_47x,0,1,0,7,1597204800,1597204800,1
Courtbird,0,1,0,31,1577250000,1577250000,1
uteuteuteute,0,1,0,1,1582779600,1582779600,1
Emergency-Anywhere51,0,1,0,39,1612069200,1612069200,1
MrInRageous,0,1,0,46,1576126800,1576126800,1
h3llyul,0,1,0,3,1609390800,1609390800,1
7United7,0,1,0,2,1591243200,1591243200,1
whirlwindbanshee,0,1,0,3,1570420800,1570420800,1
_doggiemom,0,1,0,30,1585454400,1585454400,1
solsbarry,0,1,0,1,1606021200,1606021200,1
FrogCola,0,1,0,1,1606626000,1606626000,1
sjjshfjsjakalfjjama,0,1,0,1,1604552400,1604552400,1
spyguy27,0,1,0,11,1577336400,1577336400,1
Sentientbeingofvenus,0,1,0,9,1604552400,1604552400,1
Dythiese,0,1,0,2,1599192000,1599192000,1
roggesound,0,1,0,3,1553054400,1553054400,1
kenob,0,1,0,0,1560484800,1560484800,1
equinixion,0,1,0,7,1611810000,1611810000,1
cassdots,0,1,0,7,1605675600,1605675600,1
hold__still,0,1,0,-9,1603598400,1603598400,1
Conbz,0,1,0,5,1572930000,1572930000,1
phalaenopesis,0,1,0,7,1566187200,1566187200,1
OliveiraLeo17,0,1,0,2,1608699600,1608699600,1
BigZeff27,0,1,0,6,1587182400,1587182400,1
cyborgjohnkeats,0,1,0,5,1583298000,1583298000,1
redditwanderer101,0,1,0,1,1600833600,1600833600,1
takaperoinen-miete,1,0,502,0,1605848400,1605848400,1
89saint,0,1,0,2,1569124800,1569124800,1
howlinwolfe86,0,1,0,8,1580101200,1580101200,1
anonymous-mood,0,1,0,2,1580360400,1580360400,1
xFurorCelticax,0,1,0,3,1607230800,1607230800,1
the_missing_worker,0,1,0,12,1595908800,1595908800,1
M-T-Burgermeister,0,1,0,4,1537502400,1537502400,1
Robbo1027,0,1,0,2,1580446800,1580446800,1
CarlMarksFredAngles,0,1,0,15,1549947600,1549947600,1
hauntedlantern,0,1,0,3,1601524800,1601524800,1
InHocWePoke3486,0,1,0,2,1602129600,1602129600,1
tude90_3v,0,1,0,2,1539921600,1539921600,1
soft_mystery,0,1,0,37,1592884800,1592884800,1
100MScoville,0,1,0,6,1603512000,1603512000,1
randusr36474,0,1,0,1,1585281600,1585281600,1
lurkeratthegate666,0,1,0,3,1599537600,1599537600,1
Exemus,0,1,0,7,1611982800,1611982800,1
fartbox-confectioner,0,1,0,10,1577941200,1577941200,1
FastGinFizz,1,0,84,0,1601352000,1601352000,1
perpetually-dreaming,0,1,0,8,1595131200,1595131200,1
BobbysueWho,0,1,0,6,1577336400,1577336400,1
KelSelui,0,1,0,21,1591243200,1591243200,1
KrimzonK,0,1,0,1,1600660800,1600660800,1
NwYrNwRdt,0,1,0,18,1601870400,1601870400,1
sundun7,0,1,0,3,1592884800,1592884800,1
couldbeanyonebutme,0,1,0,1,1606971600,1606971600,1
hawtfabio,0,1,0,1,1608786000,1608786000,1
jyrds,0,1,0,5,1607403600,1607403600,1
TheTerrasque,0,1,0,1,1612069200,1612069200,1
whatajoke92,0,1,0,10,1572843600,1572843600,1
onlyforthisair,0,1,0,3,1588651200,1588651200,1
LiberalParadise,0,1,0,4,1596686400,1596686400,1
whirly-girly69,0,1,0,2,1596772800,1596772800,1
rrrealllyyy20,0,1,0,4,1606626000,1606626000,1
WutintheOHO,0,1,0,2,1584244800,1584244800,1
notepad20,0,1,0,6,1575349200,1575349200,1
hihelloneighboroonie,0,1,0,2,1557201600,1557201600,1
NikiSmash,0,1,0,1,1600574400,1600574400,1
sleepybear5000,0,1,0,16,1585281600,1585281600,1
Squirrelly_thr33,0,1,0,1,1608699600,1608699600,1
laceteapixie,0,1,0,2,1612155600,1612155600,1
DovahFerret,0,1,0,1,1592798400,1592798400,1
spearshake,0,1,0,7,1575694800,1575694800,1
iwillbesuccesful,0,1,0,3,1599537600,1599537600,1
TreesAreFood,0,1,0,3,1562817600,1562817600,1
91flip,0,1,0,1,1558411200,1558411200,1
erichmatt,0,1,0,2,1603598400,1603598400,1
Assault_Rabbit,0,1,0,1,1550293200,1550293200,1
ctr3999,0,1,0,13,1581310800,1581310800,1
dTR43oHKsceXTT,0,1,0,4,1579150800,1579150800,1
rayquazza1994,0,1,0,3,1609304400,1609304400,1
candymackd,0,1,0,13,1595908800,1595908800,1
RedBaron180,0,1,0,2,1572843600,1572843600,1
WhiteOak77,0,1,0,7,1608958800,1608958800,1
Marksta,0,1,0,0,1612069200,1612069200,1
the-meanest-boi,0,1,0,1,1634529600,1634529600,1
No-Watercress-337,0,1,0,2,1611982800,1611982800,1
MangoAtrocity,0,1,0,1,1574571600,1574571600,1
pacificgreenpdx,0,1,0,9,1577682000,1577682000,1
IMPICKLEMICKSOBERAF,0,1,0,4,1601352000,1601352000,1
rousing_suspicion,0,1,0,9,1606798800,1606798800,1
CAautozoneEmployee,1,0,6,0,1608181200,1608181200,1
HoldThePao,0,1,0,4,1607835600,1607835600,1
ch33sencrackers,0,1,0,9,1601265600,1601265600,1
MadeUAcctButIEatedIt,0,1,0,1,1598068800,1598068800,1
jaredkushnerisabutt,0,1,0,2,1600660800,1600660800,1
kapaciosrota,0,1,0,3,1606971600,1606971600,1
facciabrutta,1,0,68,0,1604725200,1604725200,1
federalmeatinspector,0,1,0,5,1575522000,1575522000,1
jermajay,0,1,0,1,1596427200,1596427200,1
Cyril-Splutterworth,0,1,0,7,1573707600,1573707600,1
TheRedGerund,0,1,0,2,1607230800,1607230800,1
rodeoclownboy,0,1,0,-1,1606539600,1606539600,1
FrankBarley,0,1,0,3,1606712400,1606712400,1
unresign,0,1,0,1,1573534800,1573534800,1
europhorico,0,1,0,1,1561003200,1561003200,1
panicpixiememegirl,0,1,0,6,1576386000,1576386000,1
WareGaKaminari,0,1,0,2,1585108800,1585108800,1
IAMAchavwhoknocks,0,1,0,10,1587355200,1587355200,1
onlyhelpfulthings,0,1,0,9,1564372800,1564372800,1
wheelerKingjr,0,1,0,10,1593921600,1593921600,1
WhereIsYourEvidence,0,1,0,1,1591243200,1591243200,1
Marco-Green,0,1,0,12,1585540800,1585540800,1
Galena1227,0,1,0,1,1612155600,1612155600,1
sociopath14,0,1,0,1,1593662400,1593662400,1
zombiehHunter,1,0,3,0,1559534400,1559534400,1
wantinTheBonobo,0,1,0,2,1599019200,1599019200,1
tenuousgriponreality,0,1,0,7,1586145600,1586145600,1
Sasquatch8649,0,1,0,3,1595822400,1595822400,1
Geodude8022,0,1,0,4,1595563200,1595563200,1
dancoe,0,1,0,1,1605070800,1605070800,1
vivavivaviavi,0,1,0,12,1607230800,1607230800,1
Yunghucci,0,1,0,1,1590206400,1590206400,1
P0rkNb34n5,0,1,0,65,1566446400,1566446400,1
AOBE777,0,1,0,0,1551762000,1551762000,1
BulldogChair,0,1,0,74,1608181200,1608181200,1
iamnotgoing,1,0,5,0,1549256400,1549256400,1
wolfenstein72,0,1,0,1,1559275200,1559275200,1
rrespino,0,1,0,1,1572235200,1572235200,1
xWaffleHousex,0,1,0,11,1581483600,1581483600,1
JollyGreenLittleGuy,0,1,0,2,1597291200,1597291200,1
RealLiveChicken,0,1,0,2,1569297600,1569297600,1
The_karma_that_could,0,1,0,41,1576040400,1576040400,1
JohnnyValet,0,1,0,1304,1602043200,1602043200,1
TheHoekey,0,1,0,9,1591243200,1591243200,1
Anustartonreddit,0,1,0,21,1570075200,1570075200,1
lo-oI,0,1,0,1,1600142400,1600142400,1
_moneymakingmitch,0,1,0,-6,1565582400,1565582400,1
intirb,0,1,0,3,1567483200,1567483200,1
GeneralStrike2021,0,1,0,5,1609390800,1609390800,1
Peachykeener71,0,1,0,5,1585454400,1585454400,1
so_that_other_one,0,1,0,31,1560657600,1560657600,1
MattTheMillenial,0,1,0,1,1600142400,1600142400,1
Greenboy28,0,1,0,4,1605675600,1605675600,1
cbbuntz,0,1,0,8,1581051600,1581051600,1
Kermanism,0,1,0,-2,1606626000,1606626000,1
Garathon,0,1,0,7,1561089600,1561089600,1
yrthso,0,1,0,1,1589860800,1589860800,1
BackwardsCog,0,1,0,102,1574571600,1574571600,1
TheGoodNews01,0,1,0,1,1422162000,1422162000,1
WorshipnTribute,0,1,0,3,1584158400,1584158400,1
thatidid,0,1,0,1,1598414400,1598414400,1
invert-,0,1,0,4,1534737600,1534737600,1
bigaus25,1,0,7,0,1596081600,1596081600,1
DiddleSenpai,0,1,0,0,1601352000,1601352000,1
I__like__men,0,1,0,1,1589947200,1589947200,1
10thLevelNeerBerd,0,1,0,13,1605934800,1605934800,1
tpx187,0,1,0,14,1581138000,1581138000,1
SerialOptimists,0,1,0,3,1606539600,1606539600,1
PheagleAdler,0,1,0,1,1572235200,1572235200,1
YoungVoxelWizard,0,1,0,1,1596686400,1596686400,1
cemvr,0,1,0,3,1603512000,1603512000,1
MsFaolin,0,1,0,1,1582174800,1582174800,1
Hannerman,0,1,0,2,1601352000,1601352000,1
Training-Plant,0,1,0,5,1607749200,1607749200,1
Snikkelbaars,0,1,0,6,1579669200,1579669200,1
GrungePlunger,0,1,0,30,1551157200,1551157200,1
ChocolateHumunculous,0,1,0,19,1589342400,1589342400,1
Swayze_Train,0,1,0,8,1580446800,1580446800,1
parallax693,0,1,0,3,1583643600,1583643600,1
KhanCipher,0,1,0,1,1606539600,1606539600,1
LukeVisk,0,1,0,1,1605330000,1605330000,1
wrxs_are_slow,0,1,0,-9,1582261200,1582261200,1
NinjaVanLife,0,1,0,1,1605589200,1605589200,1
Waeningrobert,0,1,0,12,1594094400,1594094400,1
summonblood,0,1,0,-11,1582347600,1582347600,1
bommake123,0,1,0,5,1569729600,1569729600,1
trash__bucket,0,1,0,4,1601697600,1601697600,1
Sandminotaur,0,1,0,1,1606626000,1606626000,1
grassgrowingwatcher,0,1,0,0,1604293200,1604293200,1
jayrad333,0,1,0,1,1606021200,1606021200,1
WorthlessFly,0,1,0,108,1578978000,1578978000,1
thepasswordis-oh_noo,0,1,0,1,1587355200,1587355200,1
kefurbush,0,1,0,1,1583726400,1583726400,1
VodkaHappens,0,1,0,13,1595217600,1595217600,1
_DeshellingAcrab_,0,1,0,1,1578373200,1578373200,1
detourxp,0,1,0,24,1605934800,1605934800,1
Nammuabzu,0,1,0,1,1583125200,1583125200,1
creamchipbeef50,0,1,0,1,1608267600,1608267600,1
aquariusssqween,0,1,0,1,1613797200,1613797200,1
erincorrigable,0,1,0,1,1596772800,1596772800,1
englishbreak,0,1,0,1,1548219600,1548219600,1
shrinkyD123,0,1,0,9,1599796800,1599796800,1
maschinen_drache,0,1,0,1,1585454400,1585454400,1
Joannasweetgirl,0,1,0,4,1592971200,1592971200,1
zGunrath,0,1,0,1,1584590400,1584590400,1
satan300wsm,0,1,0,-4,1607576400,1607576400,1
KyloRensTiddies,0,1,0,5,1572930000,1572930000,1
Renago,0,1,0,2,1595390400,1595390400,1
h0b0b0z0,0,1,0,2,1601870400,1601870400,1
corvette1710,0,1,0,4,1576558800,1576558800,1
rosan_banana,0,1,0,12,1554264000,1554264000,1
Tiiba,0,1,0,48,1585022400,1585022400,1
hooligan99,0,1,0,5,1600920000,1600920000,1
That1one1dude1,0,1,0,55,1611896400,1611896400,1
drew249,0,1,0,1,1606021200,1606021200,1
lemons_of_doubt,0,1,0,0,1611982800,1611982800,1
Racc00nfiesta,0,1,0,1,1607230800,1607230800,1
Mr_Steal_Your_Waifu,0,1,0,1,1612155600,1612155600,1
IndividualFriend,0,1,0,4,1599796800,1599796800,1
REDNAXELa6354,0,1,0,1,1597896000,1597896000,1
buffestcat,0,1,0,5,1578546000,1578546000,1
4arc,0,1,0,1,1591848000,1591848000,1
DarknessAtBest,1,0,6,0,1606194000,1606194000,1
remmy-50,0,1,0,2,1573707600,1573707600,1
DataDrivenGuy,0,1,0,67,1599019200,1599019200,1
TripAndFly,0,1,0,4,1603512000,1603512000,1
MGollan,0,1,0,1,1600660800,1600660800,1
s1h4d0w,0,1,0,1,1608267600,1608267600,1
ucatione,0,1,0,1,1591243200,1591243200,1
klezart,0,1,0,1,1581138000,1581138000,1
minimus67,0,1,0,1,1591329600,1591329600,1
pizzakat666,0,1,0,1,1600833600,1600833600,1
eltupido,0,1,0,2,1588824000,1588824000,1
winstonvonwhaley,0,1,0,2,1559793600,1559793600,1
WithinMyBlood,0,1,0,38,1605502800,1605502800,1
Sufficient-String,0,1,0,3,1608613200,1608613200,1
andyhart23,1,0,54,0,1545454800,1545454800,1
i_like_your_buns,0,1,0,52,1597464000,1597464000,1
tinymongoose909,0,1,0,4,1607749200,1607749200,1
jimBean9610,0,1,0,2,1594008000,1594008000,1
Crits253,0,1,0,5,1608354000,1608354000,1
belte5252,0,1,0,3,1607317200,1607317200,1
SpankerCore,0,1,0,3,1591416000,1591416000,1
SirRettfordIII,0,1,0,2,1603684800,1603684800,1
myusernameblabla,0,1,0,9,1603512000,1603512000,1
Saz0r,0,1,0,7,1546146000,1546146000,1
Cramorantcramsalot,0,1,0,18,1587009600,1587009600,1
bluescholar1,0,1,0,5,1599019200,1599019200,1
seedonkey,0,1,0,1,1606021200,1606021200,1
Dyingsparks,0,1,0,1,1588305600,1588305600,1
Lykin_It,0,1,0,-4,1589428800,1589428800,1
jonnyboyjon,0,1,0,1,1600747200,1600747200,1
Crazed_pillow,0,1,0,1,1591243200,1591243200,1
LedZeppelin31,0,1,0,11,1572580800,1572580800,1
Gamrok4,0,1,0,0,1598760000,1598760000,1
5catzncounting,0,1,0,7,1572667200,1572667200,1
sympathyfortheVCR,0,1,0,3,1607662800,1607662800,1
Robot200906,0,1,0,1,1592971200,1592971200,1
TrappedInFiction,0,1,0,3,1602561600,1602561600,1
mindtrick42,0,1,0,1,1602648000,1602648000,1
Anlysia,0,1,0,76,1603512000,1603512000,1
TonkatsuRa,0,1,0,13,1596340800,1596340800,1
Lem0ns_Lemons,0,1,0,2,1557633600,1557633600,1
TurkeyMoon,0,1,0,1,1607317200,1607317200,1
favabeanss,0,1,0,3,1597896000,1597896000,1
meoxu8,0,1,0,5,1573794000,1573794000,1
SquidPies,0,1,0,1,1554350400,1554350400,1
Local_Glove,0,1,0,2,1591243200,1591243200,1
paisymes,1,0,1,0,1456635600,1456635600,1
le_troisieme_sexe,0,1,0,14,1606366800,1606366800,1
Kino_Afi,0,1,0,2,1598241600,1598241600,1
shahism3,0,1,0,1,1597896000,1597896000,1
Curlytomato,0,1,0,1,1599019200,1599019200,1
RADposter21,0,1,0,2,1606626000,1606626000,1
Matlabguru,1,0,0,0,1603425600,1603425600,1
Berandiepe,0,1,0,5,1607230800,1607230800,1
Arsenalfan1993,0,1,0,3,1607922000,1607922000,1
lobster_in_your_coat,0,1,0,1,1608181200,1608181200,1
anonymousdoes,0,1,0,1,1604466000,1604466000,1
happynessisgames,0,1,0,1,1613797200,1613797200,1
somborne,0,1,0,1,1604466000,1604466000,1
Masturbortion,0,1,0,40,1593748800,1593748800,1
Interestedmage,0,1,0,1,1605243600,1605243600,1
stevo427,0,1,0,1,1606021200,1606021200,1
SJJ00,0,1,0,7,1598760000,1598760000,1
machette_malle,0,1,0,6,1570248000,1570248000,1
Good_god_lemonn,0,1,0,4,1605157200,1605157200,1
NuclearNoodle77,0,1,0,2,1611982800,1611982800,1
Mkefrce1,0,1,0,-1,1589947200,1589947200,1
Dotrue,0,1,0,23,1591156800,1591156800,1
TribeCalledStressed,0,1,0,3,1566360000,1566360000,1
perseuslark,0,1,0,1,1602561600,1602561600,1
anchorsandreefs,1,0,136,0,1605848400,1605848400,1
NotAlive1101,0,1,0,1,1604379600,1604379600,1
thedefmute,0,1,0,2,1580274000,1580274000,1
Bad-dee-ess,0,1,0,1,1582866000,1582866000,1
Captain_Waffle,0,1,0,1,1609304400,1609304400,1
Mental_Measurement_1,0,1,0,1,1636171200,1636171200,1
187ForNoReason,0,1,0,3,1608699600,1608699600,1
sayitthewayitis,0,1,0,2,1566014400,1566014400,1
MoltenKhor,0,1,0,2,1603598400,1603598400,1
TTTTT693,0,1,0,5,1604030400,1604030400,1
NeverFuckinSellin,0,1,0,1,1611982800,1611982800,1
UnreliableChemist,0,1,0,1,1605502800,1605502800,1
tNielsenLHS,0,1,0,6,1573448400,1573448400,1
ShamefulDisplayName,0,1,0,5,1603512000,1603512000,1
TheWilkyWay,0,1,0,3,1597550400,1597550400,1
QuintonBeck,0,1,0,15,1573707600,1573707600,1
Russell_SMM,0,1,0,2,1568347200,1568347200,1
nameuser56,0,1,0,3,1603684800,1603684800,1
Monchete99,0,1,0,86,1572843600,1572843600,1
Uviation,0,1,0,1,1572148800,1572148800,1
kimurayournan,0,1,0,1,1596081600,1596081600,1
56k_modem_noises,0,1,0,7,1603512000,1603512000,1
PM_ME_UR_SQUIRRELS,0,1,0,71,1561262400,1561262400,1
RS_0x539,1,0,60,0,1603425600,1603425600,1
howtochoose,0,1,0,16,1597896000,1597896000,1
Atma_Weapon1,0,1,0,31,1567051200,1567051200,1
ScottPetrus,0,1,0,-1,1567310400,1567310400,1
Devnkc,0,1,0,3,1598155200,1598155200,1
Snooze_Face,0,1,0,3,1594612800,1594612800,1
The_Pointless_Point,0,1,0,13,1582261200,1582261200,1
PastelGripPump,0,1,0,1,1601265600,1601265600,1
Sweet-N-Seat_Saver,0,1,0,5,1582779600,1582779600,1
papabardo,0,1,0,5,1611896400,1611896400,1
sir_moleo,0,1,0,3,1611982800,1611982800,1
Ashi360_YT,0,1,0,1,1597982400,1597982400,1
Docktorwho149,0,1,0,5,1573880400,1573880400,1
HogwartsHousePoints,0,1,0,15,1553486400,1553486400,1
degansudyka,0,1,0,1,1573534800,1573534800,1
DankLaser,0,1,0,1,1608267600,1608267600,1
cat-eye-glasses,0,1,0,32,1588564800,1588564800,1
bigmemes4,0,1,0,7,1605675600,1605675600,1
DownWithAuthority,0,1,0,3,1591588800,1591588800,1
znyhus,0,1,0,2,1569556800,1569556800,1
CurlyKs,0,1,0,2,1593921600,1593921600,1
CandyCoatedSpaceship,0,1,0,5,1574312400,1574312400,1
74018,0,1,0,17,1606539600,1606539600,1
throwaway5352901,0,1,0,0,1601352000,1601352000,1
Chesterspark,0,1,0,3,1602216000,1602216000,1
gunfell,0,1,0,1,1594008000,1594008000,1
mrbaydog,0,1,0,4,1573362000,1573362000,1
ryder720,0,1,0,103,1580274000,1580274000,1
Boa811,0,1,0,6,1569470400,1569470400,1
Formerly21,1,0,62,0,1601006400,1601006400,1
throwawae44,0,1,0,1,1603512000,1603512000,1
Hasarian,0,1,0,1,1606194000,1606194000,1
MyGreatGrayRainbow,1,0,0,0,1604984400,1604984400,1
CeCH_57,1,0,21,0,1552449600,1552449600,1
Habeeb_kolawole,1,0,6,0,1593835200,1593835200,1
Rohwupet,0,1,0,2,1573534800,1573534800,1
shansensi,0,1,0,2,1607662800,1607662800,1
CozyEpicurean,0,1,0,20,1606366800,1606366800,1
Impossible_Tenth,0,1,0,23,1603598400,1603598400,1
PIchillin456,0,1,0,10,1601179200,1601179200,1
SenpaiSusu,0,1,0,-1,1592193600,1592193600,1
Socialxerd17,0,1,0,8,1582866000,1582866000,1
Andy_LaVolpe,0,1,0,3,1597550400,1597550400,1
TN_Jeffcoat,0,1,0,0,1572753600,1572753600,1
robszans,0,1,0,1,1603252800,1603252800,1
96vette,0,1,0,0,1576645200,1576645200,1
Evil_This,0,1,0,4,1585454400,1585454400,1
amdprocs,1,0,8,0,1608094800,1608094800,1
colorfulzeeb,0,1,0,31,1592971200,1592971200,1
googledthatshit,0,1,0,6,1600747200,1600747200,1
Supernova-93,0,1,0,36,1609304400,1609304400,1
ApocDream,0,1,0,27,1609304400,1609304400,1
monicalewinsky8,0,1,0,1,1572753600,1572753600,1
AccomplishedLiar,0,1,0,1,1599537600,1599537600,1
v0idkile,0,1,0,2,1605502800,1605502800,1
bmidontcare,0,1,0,2,1577854800,1577854800,1
Savethebreadties,0,1,0,24,1609045200,1609045200,1
Shambhala87,0,1,0,8,1555128000,1555128000,1
Getsumdinnerufatlard,0,1,0,1,1573794000,1573794000,1
swole_goalie,0,1,0,5,1593489600,1593489600,1
Guzzleguts,0,1,0,2,1580619600,1580619600,1
Bobarhino,0,1,0,2,1601265600,1601265600,1
Rykill87,0,1,0,-3,1601179200,1601179200,1
JesusMurphy33,0,1,0,12,1586059200,1586059200,1
ParsnipsNicker,0,1,0,4,1585454400,1585454400,1
TwoUp22,0,1,0,1,1591329600,1591329600,1
keleadra,0,1,0,1,1573448400,1573448400,1
anon476433,0,1,0,1,1586059200,1586059200,1
MemesOfTheResistance,0,1,0,-16,1576472400,1576472400,1
Pallie01,0,1,0,13,1609131600,1609131600,1
JohnDoen86,0,1,0,26,1599883200,1599883200,1
spacerangerdunc,0,1,0,1,1606626000,1606626000,1
Deviso,0,1,0,3,1574658000,1574658000,1
theLord666666,0,1,0,5,1606971600,1606971600,1
SlimGrthy,0,1,0,0,1603425600,1603425600,1
Psychosomaticcc,1,0,2,0,1563681600,1563681600,1
Mouthpiecepeter,0,1,0,21,1585368000,1585368000,1
g8torsni9per,1,0,1,0,1608440400,1608440400,1
hansonhols,0,1,0,2,1603598400,1603598400,1
Zeuswashere13,1,0,115,0,1576645200,1576645200,1
Happily_a_Human,1,0,5,0,1583557200,1583557200,1
UndeadKurtCobain,0,1,0,2,1583899200,1583899200,1
wawrzuu,0,1,0,1,1600660800,1600660800,1
clam4thelove,0,1,0,5,1602475200,1602475200,1
xiaobitxchz,0,1,0,2,1600660800,1600660800,1
hiimapril,0,1,0,1,1597982400,1597982400,1
YUNoDie,0,1,0,4,1584244800,1584244800,1
Shikaku,0,1,0,4,1580101200,1580101200,1
skatingsarah,0,1,0,2,1606280400,1606280400,1
Heyitstoni,0,1,0,15,1569816000,1569816000,1
esgrove2,0,1,0,3,1606021200,1606021200,1
bruski,0,1,0,3,1589860800,1589860800,1
Ringbearer31,0,1,0,115,1605157200,1605157200,1
Returnofthethom,0,1,0,24,1604466000,1604466000,1
_SpruceMouthman,0,1,0,1,1574830800,1574830800,1
DesignatedFailures,0,1,0,2,1559361600,1559361600,1
TheGoodmonson,0,1,0,2,1601784000,1601784000,1
JeffreyJoestar,0,1,0,2,1555214400,1555214400,1
SEBAM06,0,1,0,10,1540008000,1540008000,1
AeonsOfInstants,0,1,0,15,1581829200,1581829200,1
Snax63,0,1,0,1,1605934800,1605934800,1
dylightful,0,1,0,4,1599192000,1599192000,1
chaos_jockey,0,1,0,8,1562212800,1562212800,1
1TrueScotsman,0,1,0,0,1589860800,1589860800,1
SmoothRedHammer,0,1,0,9,1609218000,1609218000,1
cHalanX,0,1,0,2,1598068800,1598068800,1
tmannintendo,0,1,0,2,1598587200,1598587200,1
Nebiroze,0,1,0,0,1601265600,1601265600,1
theillustratedgirl,0,1,0,8,1606453200,1606453200,1
Lexx4,0,1,0,3,1612069200,1612069200,1
Alys_009,0,1,0,8,1605762000,1605762000,1
SIRSHOGUNSENSEI,0,1,0,1,1609390800,1609390800,1
naked_guy_says,0,1,0,1,1612069200,1612069200,1
thecaramelbandit,0,1,0,1,1599192000,1599192000,1
Briab21,0,1,0,1,1606626000,1606626000,1
AssyMcNips,1,0,718,0,1552622400,1552622400,1
LavendarAmy,0,1,0,1,1600660800,1600660800,1
Locksmith_Majestic,0,1,0,1,1609477200,1609477200,1
blairthebear,0,1,0,17,1595822400,1595822400,1
CeramicLicker,0,1,0,1,1598932800,1598932800,1
ForTheLoveOfRomance_,0,1,0,2,1601179200,1601179200,1
folskygg,0,1,0,2,1590984000,1590984000,1
randomaccountnameidk,0,1,0,1,1600228800,1600228800,1
Hilazing,0,1,0,2,1580101200,1580101200,1
Disagreeable_upvote,0,1,0,60,1583812800,1583812800,1
tissuesforreal,0,1,0,2,1612069200,1612069200,1
EatWeedSmokeYogurt,0,1,0,26,1606021200,1606021200,1
twickdaddy,0,1,0,1,1611896400,1611896400,1
Seems-Reasonable,0,1,0,9,1603512000,1603512000,1
Turdicken,0,1,0,13,1603512000,1603512000,1
GregulasMaximus,0,1,0,1,1612069200,1612069200,1
ExpensiveClassroom8,0,1,0,-2,1595649600,1595649600,1
Philosophile,0,1,0,7,1573189200,1573189200,1
DeshaundreWatkins,0,1,0,1,1599019200,1599019200,1
ur_opinion_is_wrong,0,1,0,3,1571716800,1571716800,1
IAmMyOwn_God,0,1,0,0,1607662800,1607662800,1
BrokenDogLeg7,0,1,0,1,1595822400,1595822400,1
Incarnam,1,0,44,0,1598241600,1598241600,1
scatterling1982,0,1,0,12,1587182400,1587182400,1
Kimchi1i,0,1,0,1,1600920000,1600920000,1
getbentgent,0,1,0,41,1606626000,1606626000,1
BitterSoutherner,0,1,0,5,1566446400,1566446400,1
dontdrinkpaintwater,0,1,0,12,1606453200,1606453200,1
nibblerzahid,0,1,0,48,1605675600,1605675600,1
flackoxgod,0,1,0,95,1573275600,1573275600,1
tiredcommie,1,0,639,0,1567569600,1567569600,1
Apophis90,0,1,0,3,1588478400,1588478400,1
Kotoy77,0,1,0,5,1557979200,1557979200,1
scrivensB,0,1,0,1,1607922000,1607922000,1
seichh,0,1,0,4,1572494400,1572494400,1
superficialsacrifice,1,0,37,0,1578632400,1578632400,1
Baud1996,0,1,0,3,1603598400,1603598400,1
ElleIndieSky,0,1,0,1,1598760000,1598760000,1
mondrianblue,0,1,0,27,1601870400,1601870400,1
TheGenocidalMachine2,0,1,0,1,1580187600,1580187600,1
JamminTamarin,0,1,0,14,1571284800,1571284800,1
whinywino89,0,1,0,1,1578805200,1578805200,1
sitarane,0,1,0,23,1592798400,1592798400,1
Cleghorn,0,1,0,2,1598760000,1598760000,1
SCAMystiC,0,1,0,13,1577509200,1577509200,1
st-john-mollusc,1,0,35,0,1603771200,1603771200,1
Omega_Man7,0,1,0,1,1578027600,1578027600,1
nam2pbrc,0,1,0,2,1608094800,1608094800,1
sadgrkboy,0,1,0,4,1579842000,1579842000,1
S14s,0,1,0,1,1605934800,1605934800,1
Be-Gone-Thooot,1,0,1,0,1585800000,1585800000,1
StragglingShadow,0,1,0,1,1588392000,1588392000,1
BIG_TRAN_E_B0NER,0,1,0,1,1595044800,1595044800,1
Zilean_Ulted_Jesus,0,1,0,1,1449032400,1449032400,1
bsfree2004,0,1,0,4,1603684800,1603684800,1
RandoManz-,0,1,0,2,1582261200,1582261200,1
TheProbIsCapitalism,0,1,0,14,1597723200,1597723200,1
mulli282,0,1,0,90,1561435200,1561435200,1
Favip,0,1,0,1,1586836800,1586836800,1
VJWN,0,1,0,-1,1585454400,1585454400,1
darkbrown999,0,1,0,1,1560744000,1560744000,1
nicolaskn,0,1,0,1,1605157200,1605157200,1
Kimchi-D,0,1,0,1,1610859600,1610859600,1
j3535,0,1,0,0,1571544000,1571544000,1
nopostingforme,0,1,0,4,1563336000,1563336000,1
Fofeu,0,1,0,2,1607490000,1607490000,1
mman0385,0,1,0,2,1602820800,1602820800,1
Jonnyplasma4321,0,1,0,1,1576213200,1576213200,1
enlightenedwalnut,0,1,0,9,1609045200,1609045200,1
Smedleyton,0,1,0,1,1581310800,1581310800,1
Username_Used,0,1,0,2,1603684800,1603684800,1
saurpodah,1,0,48,0,1589947200,1589947200,1
kay9402,0,1,0,46,1573362000,1573362000,1
Flipping_Flopper,0,1,0,5,1607922000,1607922000,1
BarrelMan77,0,1,0,1,1579150800,1579150800,1
tjax88,0,1,0,1,1598846400,1598846400,1
roybz99,0,1,0,5,1559707200,1559707200,1
insolencyy,0,1,0,0,1593316800,1593316800,1
Fedorito_,0,1,0,1,1561780800,1561780800,1
MerakiKosmos,0,1,0,1,1577422800,1577422800,1
mermaidsoluna,0,1,0,3,1572580800,1572580800,1
nojumpinginthesewers,0,1,0,1,1582261200,1582261200,1
pannecouck,0,1,0,2,1577941200,1577941200,1
thizzymarley,0,1,0,2,1604116800,1604116800,1
myparadoxicallurker,0,1,0,1,1603684800,1603684800,1
MeTwo222,0,1,0,2,1558929600,1558929600,1
Lavender_Wendigo,0,1,0,25,1568001600,1568001600,1
SMKCheeba,0,1,0,1,1598760000,1598760000,1
Dartiboi,0,1,0,2,1584158400,1584158400,1
Leumas1021,0,1,0,12,1606885200,1606885200,1
-whitemonkey-,0,1,0,2,1601352000,1601352000,1
TheDiceNerd9,0,1,0,5,1577336400,1577336400,1
p5ych0babble,0,1,0,1,1604466000,1604466000,1
secroothatch,0,1,0,-1,1591243200,1591243200,1
DrStalker,0,1,0,7,1574571600,1574571600,1
NapstablookZZ,0,1,0,2,1597118400,1597118400,1
NotaSemiconductor,0,1,0,2,1578200400,1578200400,1
Greenevers,0,1,0,11,1596772800,1596772800,1
happyguy49,0,1,0,10,1569124800,1569124800,1
Aeon_acid-re_Flux,0,1,0,4,1596945600,1596945600,1
SadJobs,0,1,0,8,1593748800,1593748800,1
IsomDart,0,1,0,2,1597982400,1597982400,1
mermaid_brook,0,1,0,1,1573621200,1573621200,1
ForsakenBrute,0,1,0,1,1598760000,1598760000,1
Force_52,0,1,0,2,1569124800,1569124800,1
mickey_kneecaps,0,1,0,2,1592625600,1592625600,1
pig_poker,0,1,0,1,1611810000,1611810000,1
Shawn1141,0,1,0,7,1606539600,1606539600,1
bluejellyjam,0,1,0,9,1561348800,1561348800,1
gtg930r,0,1,0,13,1575349200,1575349200,1
Bobbi_fettucini,0,1,0,7,1576904400,1576904400,1
greenbot131,0,1,0,1,1611982800,1611982800,1
Travster99,0,1,0,10,1556683200,1556683200,1
hotelmotelshit,0,1,0,1,1604030400,1604030400,1
zer0fuxweregivn,0,1,0,1,1591329600,1591329600,1
pibma,1,0,0,0,1580446800,1580446800,1
mightierthor,0,1,0,1,1603512000,1603512000,1
Quailman81,0,1,0,1,1606021200,1606021200,1
Cryptomoolah,0,1,0,-3,1561694400,1561694400,1
urbanfirestrike,0,1,0,4,1554523200,1554523200,1
kitesurfpro2not4,0,1,0,1,1589256000,1589256000,1
spudbuffer,0,1,0,2,1608267600,1608267600,1
AnonApple6,0,1,0,6,1587614400,1587614400,1
safetyscotchegg,0,1,0,4,1606626000,1606626000,1
Cataphlin,0,1,0,7,1583384400,1583384400,1
TinTinCT617,0,1,0,33,1580533200,1580533200,1
roasted-like-pork,0,1,0,1,1598932800,1598932800,1
Aldarian76,0,1,0,30,1587096000,1587096000,1
JohnMcPineapple,0,1,0,-6,1569816000,1569816000,1
da96whynot,0,1,0,0,1601870400,1601870400,1
krljust,0,1,0,1,1579064400,1579064400,1
EnricoLUccellatore,0,1,0,1,1601870400,1601870400,1
PocketFullOfArrows,0,1,0,10,1582174800,1582174800,1
PussyHunter1916,0,1,0,0,1602648000,1602648000,1
TheDutchman7,0,1,0,2,1590638400,1590638400,1
kahori24,0,1,0,1,1608267600,1608267600,1
InnerTrips,0,1,0,17,1602475200,1602475200,1
flyfree12312323,0,1,0,1,1592280000,1592280000,1
AdGdy7324,0,1,0,4,1611810000,1611810000,1
lepontneuf,0,1,0,-1,1592280000,1592280000,1
Wide-Track778,0,1,0,1,1608267600,1608267600,1
Chronostasis,0,1,0,12,1585454400,1585454400,1
galleryofplaces,0,1,0,5,1584158400,1584158400,1
Little-stinker-no1,0,1,0,1,1624420800,1624420800,1
lopapopa123,1,0,344,0,1590379200,1590379200,1
ReverseFez,0,1,0,2,1607749200,1607749200,1
_timetoplatypus,0,1,0,1,1594353600,1594353600,1
ForthNow,0,1,0,4,1603684800,1603684800,1
blipblipbeep,0,1,0,1,1599451200,1599451200,1
theotherevilone,0,1,0,2,1605502800,1605502800,1
LRK-,0,1,0,2,1604379600,1604379600,1
slotholomew,0,1,0,11,1551934800,1551934800,1
illit1,0,1,0,-1,1591243200,1591243200,1
Hollywood_Ho_Kogan,0,1,0,1,1608872400,1608872400,1
AFXTWINK,0,1,0,25,1605589200,1605589200,1
McDowdy,1,0,134,0,1594094400,1594094400,1
dontputondido,0,1,0,4,1602129600,1602129600,1
ghoul_in_the_attic,0,1,0,1,1598760000,1598760000,1
imrealbizzy2,0,1,0,3,1606626000,1606626000,1
Merlyn21,0,1,0,1,1598760000,1598760000,1
slipstream808,0,1,0,0,1606798800,1606798800,1
Human-Lady-Person,0,1,0,1,1598846400,1598846400,1
vadose24,0,1,0,-5,1604293200,1604293200,1
Nickolai808,0,1,0,1,1574658000,1574658000,1
lllyx,0,1,0,12,1606885200,1606885200,1
TheArmouredCockroach,0,1,0,6,1573534800,1573534800,1
AlcoPollock,0,1,0,1,1569124800,1569124800,1
-dp_qb-,0,1,0,8,1589428800,1589428800,1
Katie_McA123,0,1,0,1,1592798400,1592798400,1
StoicJ,0,1,0,1,1606021200,1606021200,1
zerotorque84,0,1,0,0,1606021200,1606021200,1
inosukeismywaifu,0,1,0,0,1586664000,1586664000,1
Longschlongenstein,0,1,0,6,1605934800,1605934800,1
johnrswagg,0,1,0,8,1608094800,1608094800,1
throwawaywsra1577,0,1,0,5,1605589200,1605589200,1
mrpownnv,0,1,0,1,1588824000,1588824000,1
mastercurt14,0,1,0,1,1594180800,1594180800,1
SnapKreckelPop,0,1,0,10,1605934800,1605934800,1
Sierra_Fox,0,1,0,5,1604984400,1604984400,1
Alcarinque88,0,1,0,5,1606366800,1606366800,1
212th_batallion,0,1,0,-14,1579842000,1579842000,1
Head_Tension,0,1,0,2,1598155200,1598155200,1
PrimarchKonradCurze,0,1,0,7,1590984000,1590984000,1
Archer_is_Weed,0,1,0,1,1621742400,1621742400,1
Spazmolytix,0,1,0,7,1600574400,1600574400,1
2ndQuickestSloth,0,1,0,-6,1564891200,1564891200,1
Yettan,0,1,0,7,1602907200,1602907200,1
Methlab322,0,1,0,9,1600228800,1600228800,1
oliveaustin,0,1,0,9,1592712000,1592712000,1
Asa182,0,1,0,76,1605675600,1605675600,1
Sputniksteve,0,1,0,6,1604293200,1604293200,1
Oxcar17,0,1,0,1,1607403600,1607403600,1
Gora_OwO,0,1,0,8,1577768400,1577768400,1
HaverfordHandyman,0,1,0,1,1608699600,1608699600,1
floobelcrank69,0,1,0,1,1595822400,1595822400,1
ItsVidad,0,1,0,73,1607662800,1607662800,1
pawncheaux,0,1,0,1,1603425600,1603425600,1
lAmBenAffleck,0,1,0,1,1586318400,1586318400,1
da_realest_23,0,1,0,0,1582779600,1582779600,1
bareluke,0,1,0,2,1612069200,1612069200,1
radioactive_muffin,0,1,0,2,1603771200,1603771200,1
basedmattnigga7,0,1,0,2,1580533200,1580533200,1
norelita,0,1,0,1,1606539600,1606539600,1
MemeReligion,0,1,0,11,1574053200,1574053200,1
dontGoChasenWtrFalls,0,1,0,15,1601352000,1601352000,1
NoTimeForDowntime,0,1,0,1,1605589200,1605589200,1
iphoneyou2,0,1,0,-8,1591502400,1591502400,1
ositabelle,0,1,0,1,1609131600,1609131600,1
AllistheVoid,0,1,0,3,1605589200,1605589200,1
dweebish_putz,0,1,0,2,1601956800,1601956800,1
slippy521,1,0,0,0,1551675600,1551675600,1
buttercorncandycream,0,1,0,14,1588046400,1588046400,1
schnellpress,0,1,0,2,1567310400,1567310400,1
civil_wyrm,0,1,0,1,1593489600,1593489600,1
CallidusNomine,0,1,0,5,1562472000,1562472000,1
RunToDagobah-T65,0,1,0,2,1611896400,1611896400,1
basketOfHammers,0,1,0,1,1560571200,1560571200,1
positiveinstead,0,1,0,1,1602129600,1602129600,1
Aeki00,0,1,0,2,1578373200,1578373200,1
PHX480,0,1,0,1,1606626000,1606626000,1
IneaBlake,0,1,0,1,1608699600,1608699600,1
old_man_snowflake,0,1,0,3,1584763200,1584763200,1
Stumpingumption,0,1,0,4,1609390800,1609390800,1
itsnotcalledchads,0,1,0,1,1549429200,1549429200,1
mellowmonk,0,1,0,52,1589601600,1589601600,1
Produce_Police,0,1,0,1,1603512000,1603512000,1
VSelf47,0,1,0,6,1571716800,1571716800,1
desquished,0,1,0,1,1591243200,1591243200,1
transvot,0,1,0,4,1592798400,1592798400,1
Stegosaurus_Peas,0,1,0,54,1608440400,1608440400,1
SHPthaKid,0,1,0,-1,1609304400,1609304400,1
therealcaptaincrunch,0,1,0,10,1573707600,1573707600,1
screenwriter63,0,1,0,17,1577509200,1577509200,1
thinkbrownrice,0,1,0,10,1609304400,1609304400,1
truthseekerboi,0,1,0,3,1602129600,1602129600,1
Unbentmars,0,1,0,11,1597982400,1597982400,1
VioletUltra88,1,0,299,0,1583384400,1583384400,1
teamfriendship,1,0,2,0,1585627200,1585627200,1
JustaCrackintheWall,0,1,0,1,1605675600,1605675600,1
seacookie89,0,1,0,15,1590465600,1590465600,1
plugifyable,0,1,0,-2,1600315200,1600315200,1
That1weirdperson,0,1,0,0,1600574400,1600574400,1
Cake_Day_Is_420,0,1,0,1,1612069200,1612069200,1
Camulus,0,1,0,4,1604203200,1604203200,1
rummy89,0,1,0,29,1570334400,1570334400,1
Big_Aymish,0,1,0,3,1567569600,1567569600,1
DesperateForDD,0,1,0,0,1608181200,1608181200,1
GruntyoDoom,0,1,0,14,1574398800,1574398800,1
showerfriendtotheend,0,1,0,1,1606798800,1606798800,1
NewNameWhoDisThough,0,1,0,12,1576645200,1576645200,1
Alpha_9,0,1,0,1,1559361600,1559361600,1
RocketshipRoadtrip,0,1,0,13,1576299600,1576299600,1
itsmuddy,0,1,0,1,1600747200,1600747200,1
Cat_eater1,0,1,0,1,1598068800,1598068800,1
toseptember,1,0,9,0,1577595600,1577595600,1
Kipchippy,0,1,0,3,1580014800,1580014800,1
Cforq,0,1,0,8,1611896400,1611896400,1
cantbuymechristmas,0,1,0,6,1606798800,1606798800,1
mikally,0,1,0,-1,1585454400,1585454400,1
Nautilus177,0,1,0,2,1594267200,1594267200,1
angelinaottk,0,1,0,2,1579064400,1579064400,1
Wajirock,0,1,0,1,1599019200,1599019200,1
sirflintsalot,0,1,0,-2,1591329600,1591329600,1
Demmy27,0,1,0,1,1593835200,1593835200,1
not_inacult,0,1,0,6,1598673600,1598673600,1
Spaceboy779,0,1,0,15,1579928400,1579928400,1
killarotten,0,1,0,11,1568088000,1568088000,1
username3,0,1,0,3,1578286800,1578286800,1
arctic_fisherman,0,1,0,1,1598932800,1598932800,1
burwizzledizzle,1,0,388,0,1547701200,1547701200,1
Niickfoxxx,0,1,0,5,1608786000,1608786000,1
Tombfz,0,1,0,1,1588392000,1588392000,1
debra_beretta,0,1,0,20,1559188800,1559188800,1
EliasTobias,1,0,9,0,1606194000,1606194000,1
snchzls,0,1,0,36,1575867600,1575867600,1
TITTYFUCKER09,0,1,0,1,1605589200,1605589200,1
CB_lemon,0,1,0,1,1605589200,1605589200,1
FuckmuffinTops,0,1,0,2,1598500800,1598500800,1
Sekoroth363,0,1,0,2,1604984400,1604984400,1
mamabrew,0,1,0,1,1589860800,1589860800,1
stephen140,0,1,0,1,1609131600,1609131600,1
Latter_IllustratorTT,0,1,0,9,1573189200,1573189200,1
Edmund37,0,1,0,12,1573362000,1573362000,1
llizardqueen,0,1,0,19,1608094800,1608094800,1
kaaaaahle651,1,0,0,0,1598500800,1598500800,1
Pegacorn21,0,1,0,9,1565150400,1565150400,1
avl365,1,0,91,0,1561521600,1561521600,1
The_Big_Lad,0,1,0,-1,1605589200,1605589200,1
Assassin4nolan,0,1,0,1,1609218000,1609218000,1
RoyalSamurai,0,1,0,11,1579669200,1579669200,1
TheAnonOptimAnar,1,0,39,0,1587614400,1587614400,1
Pashev,0,1,0,-2,1607576400,1607576400,1
HoneySunrise,0,1,0,2,1553918400,1553918400,1
shatterwood,0,1,0,4,1612155600,1612155600,1
reified,0,1,0,8,1562990400,1562990400,1
Elee3112,0,1,0,1,1603598400,1603598400,1
tooawkwrd,0,1,0,1,1548738000,1548738000,1
Think-Think-Think,0,1,0,4,1584763200,1584763200,1
wilmabeest,0,1,0,9,1540008000,1540008000,1
Telemachus70,0,1,0,27,1593662400,1593662400,1
idontfitintosociety,0,1,0,6,1606885200,1606885200,1
MistressDYNAXX45,0,1,0,1,1604030400,1604030400,1
ch00f,0,1,0,7,1607230800,1607230800,1
paloumbo,0,1,0,3,1572148800,1572148800,1
Tru3Ka0s,0,1,0,2,1581138000,1581138000,1
Mauleus,0,1,0,-15,1596686400,1596686400,1
capwalton,0,1,0,13,1574830800,1574830800,1
Lady-Culture,0,1,0,31,1594785600,1594785600,1
KakuKitsune,0,1,0,2,1580274000,1580274000,1
space_fox_overlord,0,1,0,1,1605502800,1605502800,1
ToughishNerd,0,1,0,1,1593230400,1593230400,1
PeachhT,0,1,0,1,1574312400,1574312400,1
hello_ambro,0,1,0,1,1594440000,1594440000,1
lysandercat,0,1,0,10,1562212800,1562212800,1
dogfartswamp,0,1,0,11,1599796800,1599796800,1
pawbean18,0,1,0,6,1600142400,1600142400,1
sc00pzoficecream,0,1,0,2,1594872000,1594872000,1
Countrysedan,0,1,0,1,1573362000,1573362000,1
ChuckyTee123,0,1,0,1,1580101200,1580101200,1
the-mighty-moshua,0,1,0,1,1605070800,1605070800,1
SadMNFan,0,1,0,27,1608872400,1608872400,1
tossingaway656,1,0,7,0,1600833600,1600833600,1
su_z,0,1,0,2,1598932800,1598932800,1
AlexTJA,0,1,0,24,1597982400,1597982400,1
amaretto_jr,0,1,0,15,1587528000,1587528000,1
satenlover666,0,1,0,23,1572494400,1572494400,1
getrealpeople,0,1,0,2,1603512000,1603512000,1
Homeless_Programmer,0,1,0,-62,1597636800,1597636800,1
PubFiction,0,1,0,2,1572062400,1572062400,1
Life_is_important,0,1,0,2,1539921600,1539921600,1
drumboy256,0,1,0,1,1606626000,1606626000,1
yeet76543,1,0,0,0,1611982800,1611982800,1
curious_neophyte,1,0,19,0,1570939200,1570939200,1
AGoodSteve,0,1,0,1,1609304400,1609304400,1
LoudMimeDave,0,1,0,3,1592366400,1592366400,1
OctopusRegulator,0,1,0,14,1577509200,1577509200,1
aFrothyMix,0,1,0,2,1576990800,1576990800,1
Lolthelies,0,1,0,12,1585022400,1585022400,1
3chance,0,1,0,1,1640235600,1640235600,1
Umpskit,0,1,0,2,1600228800,1600228800,1
solacend,0,1,0,4,1602302400,1602302400,1
norki21,0,1,0,2,1557633600,1557633600,1
nurseynurse77,0,1,0,1,1605934800,1605934800,1
jblax08,0,1,0,0,1606366800,1606366800,1
DarthRevanAF,0,1,0,-7,1605502800,1605502800,1
Fucked_a_bird,0,1,0,1,1597204800,1597204800,1
Friendly-Constant,0,1,0,6,1594353600,1594353600,1
_aspiringnomad,0,1,0,2,1549688400,1549688400,1
therealzeezy,0,1,0,1,1569211200,1569211200,1
Croned,0,1,0,2,1545022800,1545022800,1
CyberneticPanda,0,1,0,1,1612069200,1612069200,1
LaheyOnTheLiquor,0,1,0,4,1573621200,1573621200,1
anonymousalmondmilk,0,1,0,2,1565496000,1565496000,1
melaningawdess,0,1,0,1,1599105600,1599105600,1
kratom541,0,1,0,3,1583643600,1583643600,1
thewallking,0,1,0,8,1577077200,1577077200,1
jake0000,0,1,0,6,1598328000,1598328000,1
Ninja636FTW,0,1,0,6,1606280400,1606280400,1
timmytimtimm9,0,1,0,1,1607230800,1607230800,1
Kadethh,0,1,0,27,1605243600,1605243600,1
Terza_Rima,0,1,0,13,1575522000,1575522000,1
Gatt__,0,1,0,1,1611982800,1611982800,1
davesdoublefrostie,0,1,0,11,1585022400,1585022400,1
ogscrubb,0,1,0,2,1575435600,1575435600,1
cosmic_underwear_,0,1,0,1,1591329600,1591329600,1
coppertech,0,1,0,4,1577422800,1577422800,1
KennyGaming,0,1,0,8,1607490000,1607490000,1
No_Reception5237,0,1,0,21,1607662800,1607662800,1
cincuentaanos,0,1,0,13,1600574400,1600574400,1
Meganjustdoes,0,1,0,1,1606280400,1606280400,1
Drathothic,0,1,0,1,1602734400,1602734400,1
Phyco_Boy,0,1,0,6,1562644800,1562644800,1
MeteorKing,0,1,0,2,1603512000,1603512000,1
picklev33,0,1,0,5,1607662800,1607662800,1
Vampirgiant,0,1,0,10,1587182400,1587182400,1
Chordin,0,1,0,28,1584936000,1584936000,1
The_last_trick,0,1,0,1,1605934800,1605934800,1
Parym09,0,1,0,11,1597550400,1597550400,1
BretTitmanFart,0,1,0,4,1592280000,1592280000,1
spaces-make-hypens,0,1,0,38,1596686400,1596686400,1
big_tracy,0,1,0,-4,1584158400,1584158400,1
izotAcario,0,1,0,1,1599105600,1599105600,1
poseidon_96,0,1,0,3,1551675600,1551675600,1
drunksouls69,0,1,0,4,1573794000,1573794000,1
stallingsfilm,0,1,0,1,1608786000,1608786000,1
zuziite1,1,0,3,0,1593489600,1593489600,1
narwhale111,0,1,0,2,1556078400,1556078400,1
KaleBrecht,0,1,0,58,1602043200,1602043200,1
1939728991762839297,0,1,0,5,1607576400,1607576400,1
rbgij,0,1,0,9,1562126400,1562126400,1
Floatingduckss,0,1,0,3,1577422800,1577422800,1
JelleNeyt,0,1,0,1,1611982800,1611982800,1
NewCenturyNarratives,0,1,0,10,1607576400,1607576400,1
Ebvardh-Boss,0,1,0,32,1569124800,1569124800,1
jmerlinb,0,1,0,2,1604811600,1604811600,1
The_Observer_Effect,0,1,0,65,1611896400,1611896400,1
carlyfries1318,0,1,0,3,1603252800,1603252800,1
Good_day_sunshine,0,1,0,1,1559361600,1559361600,1
Trotter823,0,1,0,0,1585454400,1585454400,1
F1re_Face,1,0,0,0,1585022400,1585022400,1
i-love-my-friend,1,0,55,0,1587700800,1587700800,1
NessieWasHere,0,1,0,1,1598846400,1598846400,1
Melimathlete,0,1,0,1,1600488000,1600488000,1
picometric,0,1,0,5,1607230800,1607230800,1
Radishisfaaaaaattttt,0,1,0,12,1605934800,1605934800,1
VikRS,0,1,0,7,1604811600,1604811600,1
DontTreadOnMeh,0,1,0,2,1598932800,1598932800,1
sheiiri,0,1,0,1,1592280000,1592280000,1
J_Fly,0,1,0,14,1564632000,1564632000,1
ihadtotypesomething,0,1,0,-11,1599710400,1599710400,1
rainbowroad1414,0,1,0,2,1572148800,1572148800,1
RecedingQuasar,0,1,0,1,1590206400,1590206400,1
nonnewtonianfluids,0,1,0,20,1597377600,1597377600,1
issamess,1,0,44,0,1564459200,1564459200,1
McJagged,0,1,0,6,1607490000,1607490000,1
ilyemco,0,1,0,1,1561780800,1561780800,1
smokeyshaggy,0,1,0,1,1600747200,1600747200,1
ADDDr,0,1,0,2,1588651200,1588651200,1
brysonz,0,1,0,44,1596513600,1596513600,1
Armalis,0,1,0,7,1588910400,1588910400,1
JimmyTMalice,0,1,0,3,1605070800,1605070800,1
EU_Onion,0,1,0,54,1573534800,1573534800,1
astro-gay,0,1,0,5,1603252800,1603252800,1
gimmickypuppet,0,1,0,1,1605589200,1605589200,1
ivrt,0,1,0,2,1604466000,1604466000,1
GoalieMom53,0,1,0,9,1604293200,1604293200,1
Tellenit,0,1,0,7,1608526800,1608526800,1
Tehenndewai,0,1,0,7,1578459600,1578459600,1
Colt1052,0,1,0,2,1595822400,1595822400,1
rommie47,0,1,0,-22,1570593600,1570593600,1
Mountain_Dragonfly8,0,1,0,2,1584417600,1584417600,1
Azumari11,0,1,0,1,1550552400,1550552400,1
Flounder-Euphoric,0,1,0,0,1598760000,1598760000,1
Spishal_K,0,1,0,66,1584590400,1584590400,1
Reasonable_Ad_2264,0,1,0,0,1611896400,1611896400,1
Googolfunk,0,1,0,1,1603512000,1603512000,1
Squidbit,0,1,0,4,1605070800,1605070800,1
RomainVonRott,0,1,0,11,1547355600,1547355600,1
D-B-Drums,0,1,0,40,1578978000,1578978000,1
TOROON08,0,1,0,1,1608267600,1608267600,1
I_must_do_it,0,1,0,2,1602216000,1602216000,1
KotoElessar,0,1,0,6,1576126800,1576126800,1
UserApproaches,0,1,0,9,1608699600,1608699600,1
ComradeDelter,0,1,0,39,1607576400,1607576400,1
Hummblerummble,0,1,0,1,1634270400,1634270400,1
SwordfshII,0,1,0,0,1550293200,1550293200,1
atacapacheco,0,1,0,2,1611896400,1611896400,1
whyliepornaccount,0,1,0,20,1605070800,1605070800,1
rage_floyd,0,1,0,2,1603252800,1603252800,1
SweatyMeats18,0,1,0,5,1600660800,1600660800,1
awoodby,0,1,0,1,1591502400,1591502400,1
grumpypeach9001,0,1,0,-1,1589601600,1589601600,1
Corona21,0,1,0,6,1600747200,1600747200,1
the-dangerous,0,1,0,1,1600660800,1600660800,1
thnksqrd,0,1,0,9,1570075200,1570075200,1
tetsugakusei,0,1,0,1,1578546000,1578546000,1
ElectricFleshlight,0,1,0,1,1625716800,1625716800,1
lightpinkdrink,0,1,0,1,1572235200,1572235200,1
PollutionPeople,0,1,0,7,1570593600,1570593600,1
nuttyrunner,0,1,0,1,1598241600,1598241600,1
Mr_MisterJake,0,1,0,9,1605589200,1605589200,1
swordinthestream,0,1,0,4,1562040000,1562040000,1
Thromkai,0,1,0,50,1603512000,1603512000,1
T_b62K_z_8jD3M_,1,0,1,0,1455426000,1455426000,1
Sanchezinthesubs,0,1,0,6,1600574400,1600574400,1
unknownamigoo,0,1,0,4,1602561600,1602561600,1
Bahmanis,0,1,0,1,1574917200,1574917200,1
L118855df,0,1,0,16,1600142400,1600142400,1
oktnt1,0,1,0,-1,1602216000,1602216000,1
Automat1701,0,1,0,-1,1605934800,1605934800,1
mxrichar,0,1,0,2,1603598400,1603598400,1
clstewart1,1,0,1,0,1589688000,1589688000,1
StillRussian1,0,1,0,7,1606626000,1606626000,1
Bethrezen333,0,1,0,6,1489035600,1489035600,1
smithsp86,0,1,0,23,1584763200,1584763200,1
ElderlyKratos,0,1,0,1,1608267600,1608267600,1
ArcarozX,0,1,0,1,1612155600,1612155600,1
mythicalpuppy,0,1,0,1,1583643600,1583643600,1
Celestrus,0,1,0,2,1592798400,1592798400,1
silverbones777,0,1,0,57,1569297600,1569297600,1
BNLboy,0,1,0,1,1531108800,1531108800,1
Nutmegftw,0,1,0,6,1591934400,1591934400,1
nalyd358,0,1,0,13,1579842000,1579842000,1
JadedAirport6,0,1,0,118,1599192000,1599192000,1
sharksfan707,0,1,0,7,1608267600,1608267600,1
NorthernUnIt,0,1,0,1,1589860800,1589860800,1
EmperorsCanaries,0,1,0,1,1603512000,1603512000,1
redditistheway,0,1,0,1,1608267600,1608267600,1
ItsTimeToFinishThis,0,1,0,1,1604379600,1604379600,1
GREAT_SALAD,0,1,0,58,1602820800,1602820800,1
Chaetori,0,1,0,3,1599451200,1599451200,1
notadoggy,0,1,0,47,1582088400,1582088400,1
frankie365,0,1,0,1,1601265600,1601265600,1
n0t-my-real-name,0,1,0,7,1547701200,1547701200,1
InfiniteLychee,0,1,0,2,1602302400,1602302400,1
kerozen666,0,1,0,5,1579323600,1579323600,1
TieflingTech,0,1,0,2,1576213200,1576213200,1
Zerothekitty,0,1,0,3,1606539600,1606539600,1
variareee,0,1,0,45,1589601600,1589601600,1
TimeCup0,0,1,0,-3,1597723200,1597723200,1
charger282,0,1,0,26,1574658000,1574658000,1
Tulemasin,0,1,0,2,1611982800,1611982800,1
PHlLLlP,0,1,0,27,1583985600,1583985600,1
p2020_,0,1,0,28,1608440400,1608440400,1
Robotech87,0,1,0,-6,1595563200,1595563200,1
blackdragon8577,0,1,0,3,1603512000,1603512000,1
xvink,0,1,0,2,1594872000,1594872000,1
only1interest,0,1,0,1,1459051200,1459051200,1
Atethelastfrenchfry,0,1,0,2,1576645200,1576645200,1
lavendrambr,0,1,0,3,1600488000,1600488000,1
azallday,0,1,0,6,1588737600,1588737600,1
I_already_reddit_,0,1,0,9,1581570000,1581570000,1
loploh,0,1,0,17,1586404800,1586404800,1
Komischer_Vogel123,0,1,0,5,1594267200,1594267200,1
CloudyFriend,1,0,7,0,1588996800,1588996800,1
hyfen666,0,1,0,5,1606712400,1606712400,1
hippofumes,0,1,0,1,1608786000,1608786000,1
Itarotchi,0,1,0,0,1601352000,1601352000,1
ecp001,0,1,0,1,1603512000,1603512000,1
TornadoOfDestruction,0,1,0,1,1577422800,1577422800,1
MGorak,0,1,0,3,1535515200,1535515200,1
pointlesslypointing,0,1,0,1,1570420800,1570420800,1
JoecephusMeeks,0,1,0,1,1605157200,1605157200,1
upstartgiant,0,1,0,25,1593748800,1593748800,1
Lapper,0,1,0,24,1560571200,1560571200,1
elv3e,0,1,0,3,1609304400,1609304400,1
LordoftheShep,0,1,0,1,1539921600,1539921600,1
Arbiterjim,0,1,0,6,1594872000,1594872000,1
DanTheMan_15,0,1,0,1,1587873600,1587873600,1
scotchbreakfast,0,1,0,1,1585022400,1585022400,1
balckdddd,0,1,0,-7,1575349200,1575349200,1
Phenix2370726,0,1,0,1,1583125200,1583125200,1
FrozenEggo27,0,1,0,1,1603512000,1603512000,1
joeufo1,0,1,0,1,1594872000,1594872000,1
TheLonelyBull,0,1,0,0,1583211600,1583211600,1
staynelaley,0,1,0,4,1587960000,1587960000,1
PC_Pigeon,0,1,0,1,1606626000,1606626000,1
Ifhjlhfsfhg,0,1,0,-3,1575954000,1575954000,1
ohfaith,0,1,0,19,1580360400,1580360400,1
Nokomoko01,0,1,0,1,1607662800,1607662800,1
stateslee,0,1,0,7,1607490000,1607490000,1
Black_FyreHaze,1,0,26,0,1590724800,1590724800,1
PM_me_dog_butts,0,1,0,5,1564545600,1564545600,1
gandostar,0,1,0,4,1600401600,1600401600,1
Enrichmentx,0,1,0,1,1595304000,1595304000,1
birthingswamp,0,1,0,10,1581915600,1581915600,1
ktrucklover2,0,1,0,1,1605848400,1605848400,1
Kotja,0,1,0,2,1608699600,1608699600,1
GrantUsFries,0,1,0,5,1566878400,1566878400,1
purposeseeking91,0,1,0,7,1561780800,1561780800,1
darling_lycosidae,0,1,0,5,1607403600,1607403600,1
Anna_Erisian,0,1,0,1,1594353600,1594353600,1
AsherGray,0,1,0,2,1606107600,1606107600,1
NYgirl12387,0,1,0,5,1591243200,1591243200,1
HonestSummer,0,1,0,2,1606107600,1606107600,1
MrT0rtured,0,1,0,10,1581483600,1581483600,1
Sirgolfs,0,1,0,1,1605589200,1605589200,1
SteamyTortellini,0,1,0,2,1605589200,1605589200,1
BlankTile,0,1,0,4,1588392000,1588392000,1
Streetduck,0,1,0,1,1603512000,1603512000,1
Right-Relationship43,0,1,0,0,1598932800,1598932800,1
Mckeegles,0,1,0,8,1582088400,1582088400,1
thinkinwrinkle,0,1,0,2,1569556800,1569556800,1
PurpleYoshiEgg,0,1,0,2,1640322000,1640322000,1
free-speech-absolute,0,1,0,1,1603598400,1603598400,1
Wingblade7,0,1,0,6,1579755600,1579755600,1
Jellorage,0,1,0,29,1599278400,1599278400,1
aguaagua,1,0,5221,0,1605416400,1605416400,1
juggug,0,1,0,1,1609218000,1609218000,1
Gregory_Appleseed,0,1,0,9,1605157200,1605157200,1
frankpuga,0,1,0,3,1576904400,1576904400,1
airduderino,0,1,0,45,1605070800,1605070800,1
SeeNinetyNine,0,1,0,35,1597982400,1597982400,1
vegtosterone,0,1,0,30,1584158400,1584158400,1
BarracudaBae,0,1,0,2,1566619200,1566619200,1
mybrainhurts2525,0,1,0,1,1612069200,1612069200,1
Gulfcoastrepub,0,1,0,-2,1593662400,1593662400,1
whofuckincares2,1,0,68,0,1598414400,1598414400,1
jr24530,0,1,0,1,1556596800,1556596800,1
jennymck21,1,0,45,0,1604898000,1604898000,1
BJLangmaid,0,1,0,3,1582952400,1582952400,1
OddWelcome4,0,1,0,8,1602993600,1602993600,1
ssuuss,0,1,0,23,1564977600,1564977600,1
gyarrrrr,0,1,0,1,1585454400,1585454400,1
albuk89,0,1,0,15,1575349200,1575349200,1
Jaters,0,1,0,3,1597636800,1597636800,1
Stastic,0,1,0,1,1591243200,1591243200,1
blahbah,0,1,0,3,1557374400,1557374400,1
b02151,0,1,0,3,1570593600,1570593600,1
SelfHelpAddict,0,1,0,9,1612155600,1612155600,1
gwynbliedd_,0,1,0,2,1599710400,1599710400,1
adrift456,0,1,0,3,1611896400,1611896400,1
Twizlz112,0,1,0,1,1575608400,1575608400,1
Gypt_,0,1,0,1,1600228800,1600228800,1
anti_mainstream,1,0,31,0,1539835200,1539835200,1
themtiddies,0,1,0,3,1577336400,1577336400,1
lovelysad69,0,1,0,1,1581483600,1581483600,1
rogueShadow13,0,1,0,23,1607230800,1607230800,1
QuartzPuffyStar,0,1,0,1,1609045200,1609045200,1
BurnThree,0,1,0,3,1585627200,1585627200,1
TeddyTwoShoes2,0,1,0,4,1611982800,1611982800,1
cerebralfeast,0,1,0,4,1599451200,1599451200,1
NatalyaRostova,0,1,0,2,1579582800,1579582800,1
Bah-Fong-Gool,0,1,0,1,1611896400,1611896400,1
Betweengreen,0,1,0,10,1592193600,1592193600,1
LeftTurnAtAlbuqurque,0,1,0,2,1600315200,1600315200,1
Vipexx_Venim,0,1,0,25,1603512000,1603512000,1
Atheism_Minus,0,1,0,12,1588737600,1588737600,1
ProjectIronYT,0,1,0,2,1566705600,1566705600,1
Ravenpuffs,0,1,0,8,1606798800,1606798800,1
Alexander_the_sk8,0,1,0,2,1608786000,1608786000,1
0ne_Guyy,0,1,0,1,1599192000,1599192000,1
ofmyloverthesea,0,1,0,7,1605070800,1605070800,1
420Minions,0,1,0,8,1566187200,1566187200,1
balanced_goat,0,1,0,1,1542085200,1542085200,1
heyyohighHo,0,1,0,1,1603512000,1603512000,1
abuz148,0,1,0,3,1591329600,1591329600,1
Super-Ad7894,0,1,0,7,1600833600,1600833600,1
Fauxtrok,0,1,0,10,1602043200,1602043200,1
KofCrypto0720,0,1,0,1,1599019200,1599019200,1
thatguyinpublic,0,1,0,2,1585713600,1585713600,1
unemployedandhappy,0,1,0,13,1566964800,1566964800,1
brianismad,0,1,0,2,1573621200,1573621200,1
Chlslynn,0,1,0,3,1559275200,1559275200,1
Alskdj56,0,1,0,2,1604898000,1604898000,1
KING6238,0,1,0,1,1600660800,1600660800,1
RandyTheDwarf,0,1,0,2,1603598400,1603598400,1
DThor536,0,1,0,2,1603512000,1603512000,1
whitemage82,0,1,0,26,1607662800,1607662800,1
Ataos,0,1,0,1,1639630800,1639630800,1
Sometimes_She_Goes,0,1,0,4,1600747200,1600747200,1
The_Power_of_Life-YT,0,1,0,-2,1599796800,1599796800,1
Skotch21680,0,1,0,1,1600833600,1600833600,1
Otherwise_Zebra,0,1,0,1,1606539600,1606539600,1
blagovda,0,1,0,7,1573102800,1573102800,1
F4hype,0,1,0,67,1580014800,1580014800,1
travisturtle,0,1,0,1,1608699600,1608699600,1
ZeePirate,0,1,0,1,1591243200,1591243200,1
ogchilly,0,1,0,2,1601956800,1601956800,1
notRedditingInClass,0,1,0,-1,1602734400,1602734400,1
KyleMerovin,0,1,0,3,1567569600,1567569600,1
jdmnsprd,0,1,0,1,1603512000,1603512000,1
Nerdomat,1,0,461,0,1579582800,1579582800,1
ILikeVidjaGames,0,1,0,2,1584763200,1584763200,1
Niemand_94,0,1,0,8,1573189200,1573189200,1
WorkForce_Developer,0,1,0,14,1561089600,1561089600,1
mukino,0,1,0,6,1588478400,1588478400,1
the-lone-squid,0,1,0,1,1599192000,1599192000,1
KingKookus,0,1,0,-9,1572930000,1572930000,1
IIIIllllllIIIll,0,1,0,-4,1579064400,1579064400,1
SaurfangtheElder,0,1,0,1,1608699600,1608699600,1
DoctorShemp,0,1,0,3,1605502800,1605502800,1
steaksoldier,0,1,0,2,1600747200,1600747200,1
rockybond,0,1,0,1,1566014400,1566014400,1
AFreshVegetable,0,1,0,1,1588219200,1588219200,1
ArnoldNapalmer007,0,1,0,-4,1563940800,1563940800,1
tootooroo22,0,1,0,-4,1585022400,1585022400,1
Thatsitdanceoff,0,1,0,3,1599019200,1599019200,1
independentwoman1776,1,0,64,0,1588392000,1588392000,1
pablitenio,0,1,0,5,1584417600,1584417600,1
Letsnotdocorn101,0,1,0,3,1585454400,1585454400,1
FrenchFryBandit,0,1,0,1,1611810000,1611810000,1
Virtual-Flower1943,1,0,64,0,1608699600,1608699600,1
Reraver,0,1,0,44,1607662800,1607662800,1
Kaleb_G,0,1,0,0,1591243200,1591243200,1
dissapponted-daddy,0,1,0,1,1607922000,1607922000,1
blayoblab,0,1,0,1,1557460800,1557460800,1
Mysterious-Seesaw,1,0,116,0,1589515200,1589515200,1
doctronic,0,1,0,11,1606194000,1606194000,1
SquareSaltine15,0,1,0,2,1576645200,1576645200,1
GauntingTrash,0,1,0,7,1587960000,1587960000,1
affilia,0,1,0,2,1600574400,1600574400,1
trailingComma,0,1,0,5,1604293200,1604293200,1
MyPasswordStartsWith,0,1,0,0,1609218000,1609218000,1
apocalypsebuddy,0,1,0,9,1579755600,1579755600,1
tjf314,0,1,0,2,1594440000,1594440000,1
the_new_fatality,1,0,10,0,1588824000,1588824000,1
Ev0Iution,0,1,0,1,1596772800,1596772800,1
Raccoon_Army_Leader,0,1,0,3,1605243600,1605243600,1
SkillLaton,0,1,0,1,1600228800,1600228800,1
silverpanther17,0,1,0,1,1555905600,1555905600,1
watsfacepelican,0,1,0,5,1590724800,1590724800,1
throwaway246810234,0,1,0,11,1560484800,1560484800,1
DiscombobulatedBabu,0,1,0,2,1601438400,1601438400,1
-BennyAdeline-,0,1,0,4,1602648000,1602648000,1
kesselschlacht,0,1,0,13,1604984400,1604984400,1
aloflow,0,1,0,4,1559534400,1559534400,1
Sandite,0,1,0,7,1608526800,1608526800,1
east_joe,0,1,0,1,1506657600,1506657600,1
VWC980,0,1,0,-9,1590465600,1590465600,1
xp0_,0,1,0,16,1607144400,1607144400,1
deinterest,0,1,0,1,1607317200,1607317200,1
WaIes,0,1,0,1,1596686400,1596686400,1
AtlUtdGold,0,1,0,3,1602475200,1602475200,1
sheepdog-underoath,0,1,0,-2,1603512000,1603512000,1
mad_1981_02,0,1,0,1,1598760000,1598760000,1
waifu_Material_19,0,1,0,1,1608267600,1608267600,1
Im-a-scumbag-baby,0,1,0,1,1603598400,1603598400,1
Ze_Reid,0,1,0,1,1593057600,1593057600,1
fishkat420,0,1,0,1,1599537600,1599537600,1
bem135,0,1,0,1,1597204800,1597204800,1
tupapa5,0,1,0,1,1585454400,1585454400,1
GregorSamsa69,0,1,0,2,1575867600,1575867600,1
LuvULongTime,0,1,0,6,1565496000,1565496000,1
MidshipAC,0,1,0,1,1599883200,1599883200,1
bruhhhharkpa,0,1,0,1,1606626000,1606626000,1
darrius_,1,0,6,0,1597723200,1597723200,1
JimmerMcFARTman,0,1,0,3,1603512000,1603512000,1
TheMatt561,0,1,0,1,1600660800,1600660800,1
balboaporkter,0,1,0,53,1603425600,1603425600,1
overzealous_dentist,0,1,0,1,1589515200,1589515200,1
SkunksSmellBad,0,1,0,-5,1603512000,1603512000,1
redzoneernie,0,1,0,11,1570939200,1570939200,1
Long_Mechagnome,0,1,0,-1,1603684800,1603684800,1
karibearie,0,1,0,8,1585022400,1585022400,1
BlueOysterCultist,0,1,0,8,1602907200,1602907200,1
nerplederple,0,1,0,2,1609218000,1609218000,1
noodlesandalfred,0,1,0,4,1599969600,1599969600,1
firematt422,0,1,0,1,1598846400,1598846400,1
ProfPriestess,0,1,0,16,1601006400,1601006400,1
Yocchan283,0,1,0,1,1597809600,1597809600,1
Wtfisthisgamebtw,0,1,0,2,1604379600,1604379600,1
asseesh,0,1,0,2,1605502800,1605502800,1
weedek2003,0,1,0,2,1596859200,1596859200,1
rottenpossum,0,1,0,2,1609045200,1609045200,1
finalarrowhail,0,1,0,1,1572062400,1572062400,1
itsmethefish,0,1,0,0,1606798800,1606798800,1
Doctor_Mudshark,0,1,0,11,1579755600,1579755600,1
TrashApocalypse,0,1,0,17,1603512000,1603512000,1
jazzismythang,0,1,0,-2,1584158400,1584158400,1
Crystal_Mammoth,0,1,0,3,1595476800,1595476800,1
nxrada2,0,1,0,1,1593835200,1593835200,1
arthurbandit,0,1,0,4,1552021200,1552021200,1
Theguygotgame777,0,1,0,-3,1562731200,1562731200,1
justeedo,0,1,0,2,1572408000,1572408000,1
UnalomeThree,0,1,0,18,1594699200,1594699200,1
3D_Idiot,0,1,0,3,1609477200,1609477200,1
Christian4423,0,1,0,8,1609218000,1609218000,1
throwaway22172429,0,1,0,-2,1585454400,1585454400,1
stringtheoryman,0,1,0,1,1597291200,1597291200,1
titsahoy1,0,1,0,-1,1576558800,1576558800,1
paigedrgnfly,0,1,0,3,1600488000,1600488000,1
Spideryeb,0,1,0,25,1605675600,1605675600,1
nomad1c,0,1,0,-1,1584244800,1584244800,1
Quell31,0,1,0,1,1576645200,1576645200,1
TheThirdSaperstein,0,1,0,5,1579755600,1579755600,1
Express_Opposite,0,1,0,3,1602388800,1602388800,1
crazy4schwinn,0,1,0,1,1600660800,1600660800,1
silicon-network,0,1,0,1,1608267600,1608267600,1
il0vepancak3s,1,0,474,0,1599019200,1599019200,1
alaskathunderfxck,0,1,0,2,1600660800,1600660800,1
Shelzzzz,0,1,0,1,1599364800,1599364800,1
LumbarPuncture123,0,1,0,1,1608526800,1608526800,1
bogart991,0,1,0,10,1575435600,1575435600,1
PaperbackBuddha,0,1,0,10,1597809600,1597809600,1
Pimp_Hand_Luke,1,0,43,0,1579582800,1579582800,1
MajinCry,0,1,0,2,1576645200,1576645200,1
PhuncleSam,0,1,0,3,1583125200,1583125200,1
Maleficent_Tailor,0,1,0,9,1606971600,1606971600,1
BabyEatersAnonymous,0,1,0,8,1603512000,1603512000,1
MomentsofEternity,1,0,913,0,1594267200,1594267200,1
therealgoose21,0,1,0,1,1579669200,1579669200,1
not_old_redditor,0,1,0,1,1604379600,1604379600,1
PunkOnTheRocks,0,1,0,11,1601438400,1601438400,1
beefTesties,0,1,0,7,1582434000,1582434000,1
ShalimarExtrait,0,1,0,1,1601956800,1601956800,1
Yvgar,0,1,0,8,1584763200,1584763200,1
Educational_Ninja_76,0,1,0,1,1605589200,1605589200,1
Goatmo,0,1,0,1,1579064400,1579064400,1
Popnpizza,0,1,0,1,1604898000,1604898000,1
Dr_who_fan94,0,1,0,5,1608958800,1608958800,1
Professional_Lab_548,0,1,0,2,1607490000,1607490000,1
theibbster,0,1,0,2,1578718800,1578718800,1
astrozombie11,0,1,0,2,1608008400,1608008400,1
TheRealFoucault,0,1,0,5,1591329600,1591329600,1
XRPPPPP,0,1,0,2,1607317200,1607317200,1
theivoryserf,0,1,0,1,1609822800,1609822800,1
takes_many_shits,0,1,0,6,1611982800,1611982800,1
FoggyMcCloud,0,1,0,22,1606539600,1606539600,1
Mag31316,0,1,0,1,1596168000,1596168000,1
Kachingloool,0,1,0,1,1608526800,1608526800,1
CPCivil,0,1,0,2,1574312400,1574312400,1
Bocephalus,0,1,0,-1,1611982800,1611982800,1
mallowbomber,0,1,0,31,1602475200,1602475200,1
Dr_ChungusAmungus,0,1,0,3,1578978000,1578978000,1
xFlameneticon,1,0,0,0,1602129600,1602129600,1
mylifeisadankmeme,0,1,0,9,1576731600,1576731600,1
nicolee1994,0,1,0,2,1577422800,1577422800,1
bayareachino,0,1,0,1,1608872400,1608872400,1
frozensepulcro,0,1,0,2,1603771200,1603771200,1
1sagas1,0,1,0,1,1591243200,1591243200,1
Bruh-4-mp3,0,1,0,2,1611982800,1611982800,1
foodsocks,0,1,0,11,1585454400,1585454400,1
dolphin_ultra,0,1,0,1,1598760000,1598760000,1
hingusmccringus,0,1,0,-2,1589947200,1589947200,1
AnemoneEnema,0,1,0,7,1601870400,1601870400,1
GenLinuxer,0,1,0,1,1608267600,1608267600,1
Wrinklepaw,0,1,0,0,1549515600,1549515600,1
wink2tall2,0,1,0,-6,1601179200,1601179200,1
omrmike,0,1,0,1,1606885200,1606885200,1
waggishrogue8,0,1,0,2,1593057600,1593057600,1
Bryancreates,0,1,0,5,1608354000,1608354000,1
painus_in_the_anus,0,1,0,1,1603512000,1603512000,1
edarkvine,0,1,0,1,1601179200,1601179200,1
doobieONE,0,1,0,3,1600660800,1600660800,1
Dryadells,1,0,4,0,1602561600,1602561600,1
KoolKid9002,0,1,0,5,1603512000,1603512000,1
smirnovamon,0,1,0,31,1601611200,1601611200,1
BLEVLS1,0,1,0,1,1603512000,1603512000,1
Rob21680,0,1,0,3,1581915600,1581915600,1
grownabit,0,1,0,4,1589342400,1589342400,1
positiveonly938,0,1,0,1,1600660800,1600660800,1
pirefyro,0,1,0,3,1606798800,1606798800,1
Thistlefizz,0,1,0,1,1606021200,1606021200,1
MetroHelp,0,1,0,2,1597896000,1597896000,1
preyno5,0,1,0,3,1558411200,1558411200,1
darksaber101,0,1,0,1,1605502800,1605502800,1
fuckinusernamestaken,0,1,0,18,1579928400,1579928400,1
notdelet,0,1,0,1,1598760000,1598760000,1
domrg,0,1,0,0,1585454400,1585454400,1
magiknight2016,0,1,0,1,1600574400,1600574400,1
another_ai,0,1,0,22,1606453200,1606453200,1
Mr-Bibb,0,1,0,3,1608526800,1608526800,1
FragrantOkra,0,1,0,2,1572930000,1572930000,1
khanates,0,1,0,0,1608613200,1608613200,1
onistar,0,1,0,2,1589947200,1589947200,1
iwanttoeattt,0,1,0,19,1577941200,1577941200,1
WileyKoyote,0,1,0,13,1608699600,1608699600,1
codyjones88,0,1,0,52,1593057600,1593057600,1
wV_forr3st,1,0,112,0,1605330000,1605330000,1
myevilalt,0,1,0,1,1609477200,1609477200,1
tipsywolf89,0,1,0,2,1571803200,1571803200,1
DeluxeMammoth,1,0,9,0,1603425600,1603425600,1
bigicecream,0,1,0,5,1553486400,1553486400,1
Stryker295,0,1,0,1,1559966400,1559966400,1
Mahoney2,0,1,0,7,1603598400,1603598400,1
squobiime,0,1,0,3,1556251200,1556251200,1
Sam_Yule,0,1,0,1,1590379200,1590379200,1
neogod,0,1,0,0,1601265600,1601265600,1
Akshay537,0,1,0,1,1608267600,1608267600,1
masterofreality20,0,1,0,5,1560830400,1560830400,1
wrixashe,0,1,0,3,1602993600,1602993600,1
serc0,0,1,0,5,1599278400,1599278400,1
Pink-Llamas,0,1,0,5,1595390400,1595390400,1
darlingdimples,0,1,0,5,1606453200,1606453200,1
DNTMNDMESTPINURCRIME,0,1,0,1,1598155200,1598155200,1
EmbarassedCheesecake,0,1,0,2,1585454400,1585454400,1
Raidicus,0,1,0,1,1531108800,1531108800,1
RelativeSheepherder1,1,0,55,0,1606798800,1606798800,1
slow_this_bird_down,0,1,0,57,1522900800,1522900800,1
damndirtyhippy,0,1,0,2,1602907200,1602907200,1
ZetaPower,0,1,0,1,1608872400,1608872400,1
Niadain,0,1,0,6,1604030400,1604030400,1
SpaceCuddles1358,0,1,0,8,1552795200,1552795200,1
in2theF0ld,0,1,0,4,1585454400,1585454400,1
joeyjojoeshabadoo,0,1,0,1,1608526800,1608526800,1
FlamingTrollz,0,1,0,1,1603512000,1603512000,1
blueeyeswhitemayo,0,1,0,2,1562040000,1562040000,1
LoneWolf4717,0,1,0,1,1603512000,1603512000,1
TechGuy219,0,1,0,2,1582779600,1582779600,1
Nightdweller90210,0,1,0,0,1600747200,1600747200,1
IndyHermit,0,1,0,15,1607576400,1607576400,1
theundadxx,0,1,0,1,1572062400,1572062400,1
Pokepep,0,1,0,5,1596859200,1596859200,1
OutcastMastodon,0,1,0,3,1580360400,1580360400,1
DislexicCthulhu,0,1,0,2,1574139600,1574139600,1
taddl,0,1,0,8,1589169600,1589169600,1
BreathOfTheTilt,0,1,0,2,1601179200,1601179200,1
auroreamiami,0,1,0,1,1591329600,1591329600,1
mclukas,0,1,0,1,1600747200,1600747200,1
scottsummers1137,0,1,0,3,1581051600,1581051600,1
MatthewBob666,0,1,0,3,1605848400,1605848400,1
generalgeorge95,0,1,0,3,1609304400,1609304400,1
browniesarethebest,0,1,0,1,1599364800,1599364800,1
Emyxn,0,1,0,3,1574658000,1574658000,1
mcpat21,0,1,0,5,1585454400,1585454400,1
isowolf,0,1,0,4,1594872000,1594872000,1
MrHallmark,0,1,0,1,1598760000,1598760000,1
eazyirl,0,1,0,11,1590120000,1590120000,1
tnel77,0,1,0,1,1556596800,1556596800,1
NSFWies,0,1,0,27,1575003600,1575003600,1
Regal_Wolf,0,1,0,6,1582779600,1582779600,1
GloomToon,0,1,0,1,1604293200,1604293200,1
FraGough,0,1,0,1,1607317200,1607317200,1
TiredAndHappyLife,0,1,0,2,1575608400,1575608400,1
danks111,0,1,0,12,1551848400,1551848400,1
seacorm,0,1,0,11,1601870400,1601870400,1
thirdwallbreak,0,1,0,20,1592193600,1592193600,1
CallumBrine,1,0,18,0,1599883200,1599883200,1
mrs_rue,0,1,0,3,1561435200,1561435200,1
rv29,0,1,0,11,1603512000,1603512000,1
tesch34,0,1,0,4,1608008400,1608008400,1
GummyKyun,0,1,0,1,1606366800,1606366800,1
conburi,1,0,93,0,1609131600,1609131600,1
SorryIreddit,0,1,0,1,1575522000,1575522000,1
AspirantCrafter,0,1,0,4,1584072000,1584072000,1
Mesozoica89,0,1,0,2,1609477200,1609477200,1
Dudeitsmiles,0,1,0,1,1589947200,1589947200,1
socialmaxcom,1,0,16,0,1575176400,1575176400,1
redpisces2,0,1,0,16,1605848400,1605848400,1
donfinkso,0,1,0,3,1582779600,1582779600,1
DystopicAmericana,0,1,0,2,1580619600,1580619600,1
potsdamn,0,1,0,2,1598846400,1598846400,1
robeinpublic,0,1,0,1,1606539600,1606539600,1
brat112,0,1,0,21,1578373200,1578373200,1
Muffinmurdurer,0,1,0,3,1584417600,1584417600,1
nicgarelja,0,1,0,7,1587009600,1587009600,1
Dewdgye,0,1,0,1,1541394000,1541394000,1
Acceptable-Taste345,0,1,0,26,1597118400,1597118400,1
LetsGoEatHonk,0,1,0,7,1607317200,1607317200,1
Cave-Bunny,0,1,0,3,1588651200,1588651200,1
CalRobert,0,1,0,2,1603598400,1603598400,1
ven0m1x,0,1,0,1,1591243200,1591243200,1
lascar,0,1,0,4,1592107200,1592107200,1
_ixtlilxochitl_,0,1,0,1,1595563200,1595563200,1
Belllringer,0,1,0,2,1569816000,1569816000,1
diego97yey,0,1,0,3,1606280400,1606280400,1
Brave29,0,1,0,10,1589860800,1589860800,1
worldnews0bserver,0,1,0,4,1599624000,1599624000,1
kummatus,0,1,0,14,1568260800,1568260800,1
Lilithdeficiency,0,1,0,23,1548910800,1548910800,1
JremyH,0,1,0,1,1608613200,1608613200,1
AssyrianOG,0,1,0,1,1554609600,1554609600,1
bcanada92,0,1,0,2,1605070800,1605070800,1
delayedsynapse,0,1,0,4,1575435600,1575435600,1
PaintTheTownScarlet,0,1,0,2,1579755600,1579755600,1
sampai87,0,1,0,17,1611896400,1611896400,1
SnorriSturluson,0,1,0,1,1596168000,1596168000,1
Phantom7568,0,1,0,37,1604811600,1604811600,1
awarforgedwarlock,0,1,0,3,1607317200,1607317200,1
BIG8L_117,0,1,0,1,1611982800,1611982800,1
hausomad,0,1,0,2,1591156800,1591156800,1
Skyeeflyee,0,1,0,6,1605934800,1605934800,1
Mallaceis,0,1,0,-6,1598760000,1598760000,1
Responsible_Ad5085,0,1,0,2,1606107600,1606107600,1
MasterofSexPuppets,0,1,0,7,1576558800,1576558800,1
soberasfuck,0,1,0,1,1574744400,1574744400,1
endless-sunshine,0,1,0,3,1587873600,1587873600,1
redbastie,0,1,0,4,1604984400,1604984400,1
Cringeria,0,1,0,8,1581224400,1581224400,1
Substantial_Bath999,0,1,0,2,1611982800,1611982800,1
erikmar,0,1,0,19,1584763200,1584763200,1
geon,0,1,0,3,1600574400,1600574400,1
lostlore0,0,1,0,1,1598760000,1598760000,1
LeRedditMoment825,0,1,0,3,1600574400,1600574400,1
pm_me_your_buds,0,1,0,1,1555992000,1555992000,1
kal_ulysses,1,0,53,0,1611896400,1611896400,1
cosmos_jm,0,1,0,3,1608267600,1608267600,1
goldenGoose48,0,1,0,1,1607835600,1607835600,1
franksfollower,1,0,814,0,1608526800,1608526800,1
TkachenkoPavel,0,1,0,1,1589515200,1589515200,1
silverbackgojira,0,1,0,1,1602216000,1602216000,1
SponzifyMee,0,1,0,0,1608699600,1608699600,1
thepeachthief,0,1,0,2,1564200000,1564200000,1
jobinslapsdabass,0,1,0,6,1560484800,1560484800,1
Tedd-yyy,0,1,0,0,1602648000,1602648000,1
flyguysd,0,1,0,1,1608267600,1608267600,1
fftropstm,0,1,0,1,1621742400,1621742400,1
CandleRedwoodBeam,1,0,2,0,1597377600,1597377600,1
KantBelieveYou,0,1,0,5,1605848400,1605848400,1
Inspector_Certain,0,1,0,3,1605762000,1605762000,1
GekkosGhost,0,1,0,16,1605589200,1605589200,1
WarrenMuppet007,0,1,0,1,1605502800,1605502800,1
drfunkles1986,0,1,0,1,1591329600,1591329600,1
ChristinithBanks,0,1,0,1,1611982800,1611982800,1
PizzaDeliveryBoy3000,0,1,0,14,1575176400,1575176400,1
Gladiatorterror,0,1,0,3,1593403200,1593403200,1
Crunchthemoles,0,1,0,4,1566187200,1566187200,1
Penrunopenandes,0,1,0,6,1606885200,1606885200,1
FutureAuthorSummer,0,1,0,3,1603598400,1603598400,1
giantillusion,0,1,0,-5,1588219200,1588219200,1
Block_Me_Amadeus,0,1,0,1,1582002000,1582002000,1
GroveTC,0,1,0,17,1597118400,1597118400,1
xxdropdeadlexi,0,1,0,3,1594008000,1594008000,1
Wind_Yer_Neck_In,0,1,0,119,1605848400,1605848400,1
Aqua2d,0,1,0,12,1550898000,1550898000,1
No_Dont_Think_So,0,1,0,5,1560052800,1560052800,1
thumz,1,0,57,0,1601438400,1601438400,1
bedbuffaloes,0,1,0,10,1606885200,1606885200,1
BlancFranc,0,1,0,2,1548738000,1548738000,1
zzhhvee88,0,1,0,1,1605243600,1605243600,1
Daviddaprodigy,1,0,123,0,1599796800,1599796800,1
HelpHotSauceInMyEyes,0,1,0,1,1602216000,1602216000,1
Zindou,0,1,0,2,1570420800,1570420800,1
glytxh,0,1,0,1,1599451200,1599451200,1
Chyeahboichekov7034,0,1,0,23,1605762000,1605762000,1
jakirk01,0,1,0,-16,1567051200,1567051200,1
ImKimchiii,0,1,0,1,1597809600,1597809600,1
illini_2017,0,1,0,-2,1605502800,1605502800,1
DeathServer15,0,1,0,1,1609045200,1609045200,1
morat69,0,1,0,15,1609131600,1609131600,1
SnarkSnout,0,1,0,12,1598500800,1598500800,1
davidk861,0,1,0,2,1563854400,1563854400,1
secretreddname,0,1,0,1,1608786000,1608786000,1
TBDID,0,1,0,2,1606453200,1606453200,1
draxsmon,0,1,0,1,1607144400,1607144400,1
drgrnthum33,0,1,0,1,1562040000,1562040000,1
BigSweatyYeti,0,1,0,1,1606626000,1606626000,1
TartanGiraffe,0,1,0,1,1612069200,1612069200,1
anjroow,0,1,0,1,1584763200,1584763200,1
Grand_Paladin_Rose,0,1,0,1,1554177600,1554177600,1
cheakysquair,0,1,0,184,1603512000,1603512000,1
DS-bonfire,0,1,0,1,1581915600,1581915600,1
firemaster,0,1,0,1,1591243200,1591243200,1
LivableStranger,0,1,0,6,1597809600,1597809600,1
Wildcat7878,0,1,0,7,1578718800,1578718800,1
Newdadontheblock,0,1,0,1,1598760000,1598760000,1
davevw9898,0,1,0,9,1611896400,1611896400,1
Mr_Anomalistic,0,1,0,2,1598760000,1598760000,1
SonOfBlackstaff,0,1,0,3,1605243600,1605243600,1
weggaan_weggaat,0,1,0,13,1605330000,1605330000,1
knharp,0,1,0,4,1556164800,1556164800,1
Silent_but_diddly,0,1,0,2,1599537600,1599537600,1
phizool,0,1,0,9,1593921600,1593921600,1
AmazingMustache,0,1,0,1,1602129600,1602129600,1
bedevop_420,0,1,0,2,1562040000,1562040000,1
arisano,0,1,0,-2,1592798400,1592798400,1
squints94,0,1,0,1,1585454400,1585454400,1
probablySNOW_gold,0,1,0,1,1606626000,1606626000,1
Constapatris,0,1,0,15,1605070800,1605070800,1
ZZaddyLongLegzz,0,1,0,4,1603771200,1603771200,1
megamethodman,0,1,0,7,1582088400,1582088400,1
Wakeupimdyinghere,0,1,0,1,1585540800,1585540800,1
pm_me_downvotes_plox,0,1,0,11,1580274000,1580274000,1
schroedingers_charr,0,1,0,10,1555646400,1555646400,1
HNixon,0,1,0,12,1600142400,1600142400,1
Anton-Pius,0,1,0,84,1540008000,1540008000,1
paperplanes445,0,1,0,7,1563508800,1563508800,1
T-U-R-B-O,0,1,0,2,1544590800,1544590800,1
MutualAid_aFactor,0,1,0,4,1587182400,1587182400,1
tenredux,0,1,0,15,1541998800,1541998800,1
RebeccaUsesReddit,0,1,0,1,1602043200,1602043200,1
DudeFreek,0,1,0,16,1598673600,1598673600,1
Logstick,0,1,0,4,1606626000,1606626000,1
Spiritual_Leather_26,1,0,405,0,1602648000,1602648000,1
bbadkin,0,1,0,-16,1606626000,1606626000,1
LadyE123,0,1,0,1,1591329600,1591329600,1
theghostthatsaysfuck,0,1,0,133,1571544000,1571544000,1
polymeimpressed,0,1,0,8,1602907200,1602907200,1
pjx008,0,1,0,2,1573880400,1573880400,1
-rigid,0,1,0,12,1591243200,1591243200,1
Noppera-Bou,0,1,0,3,1608440400,1608440400,1
kaaaaath,0,1,0,4,1575954000,1575954000,1
SnakePlant7000,0,1,0,1,1601697600,1601697600,1
zackkorth,0,1,0,11,1609477200,1609477200,1
FalseTagAttack,0,1,0,58,1584158400,1584158400,1
savage5656,0,1,0,2,1590120000,1590120000,1
Medical-Drink,0,1,0,1,1585454400,1585454400,1
spibbiez21,0,1,0,1,1578200400,1578200400,1
Glitchsono,0,1,0,3,1590811200,1590811200,1
MountainsAreBug,0,1,0,15,1604725200,1604725200,1
Rubberbabybuggybum,0,1,0,35,1585022400,1585022400,1
ashymr,0,1,0,14,1601352000,1601352000,1
NewGuyPhoto,0,1,0,3,1603598400,1603598400,1
Dresslerj1,1,0,15,0,1561521600,1561521600,1
Rabid-Child,0,1,0,127,1608267600,1608267600,1
Canodros,0,1,0,2,1584676800,1584676800,1
neoluxs1988,0,1,0,6,1582606800,1582606800,1
Therinicus,0,1,0,13,1576299600,1576299600,1
EoJej,0,1,0,1,1588824000,1588824000,1
TwoBitCliff,0,1,0,15,1571630400,1571630400,1
OdinTheHugger,0,1,0,1,1585108800,1585108800,1
DiskoSpider,0,1,0,-3,1599969600,1599969600,1
SCP-3042-Euclid,0,1,0,1,1606626000,1606626000,1
farneyb,0,1,0,2,1606971600,1606971600,1
UnusuallyUsuallyLate,0,1,0,10,1598241600,1598241600,1
CockAToo87,0,1,0,33,1609045200,1609045200,1
Hatch10k,0,1,0,3,1611982800,1611982800,1
joozyj,0,1,0,1,1604203200,1604203200,1
Hakeem928,0,1,0,1,1534564800,1534564800,1
audreysjackets,0,1,0,1,1583985600,1583985600,1
porkbuffet,0,1,0,1,1606626000,1606626000,1
unsmashedpotatoes,0,1,0,23,1568865600,1568865600,1
malamorcannai,0,1,0,1,1580274000,1580274000,1
DillieDally,0,1,0,1,1600056000,1600056000,1
moresleepy1,0,1,0,1,1601956800,1601956800,1
fashion_info_finder,1,0,733,0,1599710400,1599710400,1
ebraahimoo,0,1,0,4,1606194000,1606194000,1
da_real_Memeaholic,0,1,0,10,1604293200,1604293200,1
Drireltan,0,1,0,2,1585454400,1585454400,1
ngosheun,1,0,5,0,1527912000,1527912000,1
yankieMcspanky,0,1,0,3,1595563200,1595563200,1
slvc1996,0,1,0,5,1607576400,1607576400,1
hamzasreddit,0,1,0,8,1579150800,1579150800,1
Sierra-117-,0,1,0,13,1580792400,1580792400,1
Mhubel24,0,1,0,9,1608786000,1608786000,1
dreamingofpancakes,1,0,8,0,1608094800,1608094800,1
usefoolidiot,0,1,0,1,1589947200,1589947200,1
Drumwin,0,1,0,2,1605330000,1605330000,1
GalacticDemon,0,1,0,2,1557288000,1557288000,1
SweaterKittens,0,1,0,5,1541566800,1541566800,1
SmileTribeNetwork,0,1,0,2,1607662800,1607662800,1
easlern,0,1,0,5,1583899200,1583899200,1
TheJimmyRustler,0,1,0,2,1575262800,1575262800,1
buckeye111,0,1,0,1,1603512000,1603512000,1
Urdus,0,1,0,3,1569124800,1569124800,1
MleemMeme,0,1,0,3,1576645200,1576645200,1
magicninjabacon,0,1,0,2,1612242000,1612242000,1
EdragonPro,0,1,0,1,1624680000,1624680000,1
Bc187,0,1,0,1,1585454400,1585454400,1
LowerSpecial,0,1,0,1,1600747200,1600747200,1
funkofages,0,1,0,18,1586836800,1586836800,1
solnushka,1,0,81,0,1599192000,1599192000,1
aguyataplace,0,1,0,3,1585108800,1585108800,1
balancedrock,0,1,0,3,1569211200,1569211200,1
JumboMcCloony,0,1,0,11,1580101200,1580101200,1
WaldoPirata,0,1,0,1,1608526800,1608526800,1
skytale11,0,1,0,2,1549170000,1549170000,1
Neon_Phenom,0,1,0,-5,1607576400,1607576400,1
aegonnova,1,0,5038,0,1563422400,1563422400,1
MaagicMushies,0,1,0,3,1592539200,1592539200,1
FranklinCognito,0,1,0,12,1585195200,1585195200,1
Street_festival_485,0,1,0,7,1608526800,1608526800,1
6sidenerd,0,1,0,2,1608181200,1608181200,1
faah-mulan,0,1,0,12,1569384000,1569384000,1
BlackDahliaMuckduck,0,1,0,1,1588305600,1588305600,1
Rude_Patience,1,0,13629,0,1603944000,1603944000,1
11equals7,0,1,0,1,1554782400,1554782400,1
Mythman1066,0,1,0,1,1579064400,1579064400,1
asa-kitty,0,1,0,3,1601956800,1601956800,1
Buck_Johnson_MD,0,1,0,2,1607403600,1607403600,1
illietheboatman,0,1,0,1,1603512000,1603512000,1
whiskey-michael,0,1,0,14,1603684800,1603684800,1
xtenzzive,0,1,0,1,1568692800,1568692800,1
afterburner9,0,1,0,11,1598155200,1598155200,1
catonaleash,0,1,0,7,1573448400,1573448400,1
7winters7springs,1,0,7,0,1592712000,1592712000,1
Bhop48,0,1,0,13,1588305600,1588305600,1
Sidvirtuous,0,1,0,3,1611896400,1611896400,1
ruubi_,0,1,0,1,1601870400,1601870400,1
incomplete-sentanc,0,1,0,2,1566014400,1566014400,1
avonsays,0,1,0,13,1557201600,1557201600,1
dollhousing,0,1,0,13,1595736000,1595736000,1
Free2BMe80,0,1,0,8,1562212800,1562212800,1
Malv3rde,1,0,33,0,1574485200,1574485200,1
IreJay,0,1,0,2,1608094800,1608094800,1
madbaby6669,0,1,0,1,1576386000,1576386000,1
Tmak805,0,1,0,-5,1566014400,1566014400,1
JDaws23,0,1,0,1,1585454400,1585454400,1
13darkice37,0,1,0,3,1602475200,1602475200,1
MonkeyMadness717,0,1,0,5,1600920000,1600920000,1
EthanRo14,0,1,0,2,1605243600,1605243600,1
lilzthepillz,0,1,0,6,1606280400,1606280400,1
iridescent_essence,0,1,0,1,1604898000,1604898000,1
broke_boi1,0,1,0,6,1576731600,1576731600,1
NationaliseBathrooms,0,1,0,5,1605330000,1605330000,1
shrimplifi,0,1,0,1,1608354000,1608354000,1
Family_Shoe_Business,0,1,0,2,1611982800,1611982800,1
why-would-i-do-this,0,1,0,1,1600747200,1600747200,1
ActualWeed,0,1,0,1,1593921600,1593921600,1
cpecora,0,1,0,1,1608786000,1608786000,1
Interwebnets,0,1,0,7,1574571600,1574571600,1
dhdusysg,0,1,0,3,1592712000,1592712000,1
hardmeat99,0,1,0,1,1603512000,1603512000,1
killerfreak122,0,1,0,1,1559448000,1559448000,1
really3hotdogs,0,1,0,5,1601179200,1601179200,1
fowlaboi,0,1,0,2,1607576400,1607576400,1
colinmurphy2,0,1,0,1,1600660800,1600660800,1
Hostile-Herpie,0,1,0,75,1606453200,1606453200,1
MrBacon30895,0,1,0,17,1602820800,1602820800,1
bb_ricardo,0,1,0,19,1597550400,1597550400,1
vicszasz,0,1,0,6,1549342800,1549342800,1
Never_Guilty,1,0,56,0,1571371200,1571371200,1
NintendosBitch,0,1,0,1,1611464400,1611464400,1
Trev_N7,0,1,0,1,1561780800,1561780800,1
rakkquiem,0,1,0,8,1593403200,1593403200,1
sweArsAuCe,0,1,0,1,1612069200,1612069200,1
GladBekje,0,1,0,21,1598673600,1598673600,1
ImHoopi,0,1,0,15,1600920000,1600920000,1
Clear-Intention-5161,0,1,0,1,1608267600,1608267600,1
McDreads,0,1,0,11,1602561600,1602561600,1
sm0kie420,0,1,0,435,1584676800,1584676800,1
jeffesaurusrex,0,1,0,2,1568606400,1568606400,1
Bosombuddies,0,1,0,8,1596600000,1596600000,1
Arkanis106,0,1,0,1,1607835600,1607835600,1
Arthur944,0,1,0,-2,1601352000,1601352000,1
Hm022187,0,1,0,24,1577768400,1577768400,1
Elioyeet,0,1,0,1,1598328000,1598328000,1
goldfisheet,0,1,0,4,1592798400,1592798400,1
Whiskerwisp,0,1,0,2,1589860800,1589860800,1
idkidc69,0,1,0,-1,1579064400,1579064400,1
pandathumbs17,0,1,0,3,1612069200,1612069200,1
sexadmin,0,1,0,1,1594958400,1594958400,1
swap-it-again,1,0,18,0,1601352000,1601352000,1
beerbellybegone,1,0,175,0,1603857600,1603857600,1
LateNightHobbit,0,1,0,1,1607835600,1607835600,1
rKkgpTIjIPzf,0,1,0,2,1579582800,1579582800,1
riceismyname,0,1,0,1,1568347200,1568347200,1
coconutberrypeach,1,0,85,0,1568865600,1568865600,1
rieba9,0,1,0,9,1607922000,1607922000,1
EarthWarrior3,0,1,0,3,1607576400,1607576400,1
EmperorClydeFrog,0,1,0,5,1603512000,1603512000,1
TurdboCharged,0,1,0,5,1593835200,1593835200,1
TheAluminumGuru,0,1,0,2,1587528000,1587528000,1
dknoelke,1,0,0,0,1600833600,1600833600,1
tarynevelyn,0,1,0,9,1606539600,1606539600,1
SMallery,0,1,0,11,1607749200,1607749200,1
Jambi-the-Golden,0,1,0,1,1604203200,1604203200,1
je-suis-un-toaster,0,1,0,2,1606712400,1606712400,1
anon0002019,0,1,0,41,1606539600,1606539600,1
Hyznor,0,1,0,1,1390626000,1390626000,1
AceBuddy,0,1,0,10,1546405200,1546405200,1
rovekarl,0,1,0,4,1589601600,1589601600,1
essentialliberty,0,1,0,1,1605589200,1605589200,1
mpmclachlen,1,0,147,0,1599192000,1599192000,1
idiotnevadageologist,0,1,0,10,1572321600,1572321600,1
MaidMarien,1,0,25,0,1583211600,1583211600,1
Forcistus,0,1,0,2,1600660800,1600660800,1
milkandtv,0,1,0,1,1555473600,1555473600,1
penguin-attack,0,1,0,1,1606885200,1606885200,1
Jnvadpjf,0,1,0,2,1591243200,1591243200,1
matroosoft,0,1,0,-6,1592625600,1592625600,1
ileikchocolatemeelk,1,0,242,0,1598932800,1598932800,1
swashinator,0,1,0,1,1567051200,1567051200,1
KnackTheFirst,0,1,0,1,1550552400,1550552400,1
BettieRage77,0,1,0,1,1605589200,1605589200,1
prisonerofazkabants,0,1,0,4,1603598400,1603598400,1
admirlj,0,1,0,1,1606885200,1606885200,1
dragonfang12321,0,1,0,11,1578891600,1578891600,1
sooncool,0,1,0,1,1607749200,1607749200,1
Catsarenotreptilians,0,1,0,1,1607576400,1607576400,1
m4hlie,0,1,0,2,1595217600,1595217600,1
julesnemo,1,0,11,0,1606885200,1606885200,1
Ben_johnston,0,1,0,46,1561262400,1561262400,1
Mods_R_Alt_Right,0,1,0,15,1590552000,1590552000,1
ShaRo_,0,1,0,1,1594353600,1594353600,1
nekoyasha,0,1,0,2,1596254400,1596254400,1
beefcirtains,0,1,0,-6,1569124800,1569124800,1
zelda_alarie,0,1,0,13,1551502800,1551502800,1
crownjewel82,0,1,0,2,1584417600,1584417600,1
Monsur_Ausuhnom,0,1,0,1,1591243200,1591243200,1
Demonseedii,0,1,0,1,1569124800,1569124800,1
rottencoreonion,1,0,494,0,1586232000,1586232000,1
Totality-Infinity,0,1,0,1,1477972800,1477972800,1
Overlord1317,0,1,0,12,1597636800,1597636800,1
inkdrops,0,1,0,7,1594440000,1594440000,1
NilbogResident1,0,1,0,9,1603425600,1603425600,1
Extra_Intro_Version,0,1,0,3,1564113600,1564113600,1
kittenlikeasmallcat,1,0,47,0,1611723600,1611723600,1
ssuarez0,0,1,0,4,1577854800,1577854800,1
lggIes,0,1,0,1,1591243200,1591243200,1
hotwheelearl,0,1,0,8,1572062400,1572062400,1
Ricky_Rollin,0,1,0,1,1585454400,1585454400,1
rdh2121,0,1,0,-17,1596686400,1596686400,1
bum_leg,0,1,0,-6,1595908800,1595908800,1
ArkanBachistrate,0,1,0,8,1600747200,1600747200,1
So_Edgy_I_Cut_Myself,0,1,0,1,1601611200,1601611200,1
hippie_chic_jen,0,1,0,1,1591329600,1591329600,1
CaktusJacklynn,0,1,0,4,1555041600,1555041600,1
not_enough_weed,0,1,0,12,1583643600,1583643600,1
DavidMasonBO2,0,1,0,-7,1599883200,1599883200,1
botwasnotanimposter,0,1,0,1,1600833600,1600833600,1
parkerparker22,0,1,0,4,1593662400,1593662400,1
Aspiringcatlady_5,0,1,0,1,1594180800,1594180800,1
Abraculax,0,1,0,0,1600228800,1600228800,1
lrp347,0,1,0,4,1604203200,1604203200,1
twotall88,0,1,0,1,1582693200,1582693200,1
CONCONLEBONBON,0,1,0,9,1608958800,1608958800,1
Pocketpine,0,1,0,3,1602820800,1602820800,1
quaintlyspoken,0,1,0,9,1592107200,1592107200,1
Carlos----Danger,0,1,0,-23,1607576400,1607576400,1
Axonlink,0,1,0,1,1603512000,1603512000,1
Turband,0,1,0,29,1590120000,1590120000,1
SquareRutabagas,0,1,0,-11,1591502400,1591502400,1
Alive_Ad_3925,0,1,0,6,1600574400,1600574400,1
kaoron,0,1,0,7,1574312400,1574312400,1
KnowMatter,0,1,0,4,1593748800,1593748800,1
OceanRaver,0,1,0,37,1579582800,1579582800,1
lolitslauren2017,0,1,0,4,1587441600,1587441600,1
TopRamen713,0,1,0,1,1571889600,1571889600,1
moscow69mitch420,0,1,0,1,1576818000,1576818000,1
MichelleDeaEst,0,1,0,1,1579755600,1579755600,1
m3ankiti3,0,1,0,9,1598500800,1598500800,1
maxkmiller,0,1,0,1,1578373200,1578373200,1
unzexpress,0,1,0,3,1581915600,1581915600,1
watercolorheart,0,1,0,2,1585454400,1585454400,1
Friendship_Errywhere,0,1,0,2,1606626000,1606626000,1
OJ_with_No_Pulp,0,1,0,4,1607144400,1607144400,1
danielbojangle,0,1,0,-2,1603512000,1603512000,1
JasperTheVagrant,0,1,0,7,1594440000,1594440000,1
hunterwbrown,0,1,0,-3,1603512000,1603512000,1
DeusExMachinaOverdue,0,1,0,5,1601438400,1601438400,1
vapezon,0,1,0,2,1428638400,1428638400,1
Slight_Side1600,0,1,0,0,1622174400,1622174400,1
keigan2,0,1,0,1,1579064400,1579064400,1
averyellowestick,0,1,0,3,1581224400,1581224400,1
chooogan,0,1,0,1,1605848400,1605848400,1
lindenaaron1,0,1,0,2,1607662800,1607662800,1
samnd743,0,1,0,2,1606539600,1606539600,1
saltysalamanderscent,0,1,0,3,1604638800,1604638800,1
M3ntallyDiseas3d,0,1,0,6,1607922000,1607922000,1
fishy_commishy,0,1,0,-2,1603512000,1603512000,1
adgeal,0,1,0,3,1576904400,1576904400,1
AamIRBhuRA,0,1,0,1,1602043200,1602043200,1
Love_Freckles,0,1,0,9,1609045200,1609045200,1
paxrasmussen,0,1,0,16,1593057600,1593057600,1
nedy08,0,1,0,1,1555992000,1555992000,1
kristopher_123,0,1,0,3,1603944000,1603944000,1
indigoparadox,0,1,0,14,1584331200,1584331200,1
IIIRuin,0,1,0,2,1608440400,1608440400,1
Crispapplestrudel,0,1,0,4,1608786000,1608786000,1
Ok_Set3743,0,1,0,1,1597377600,1597377600,1
its331am,0,1,0,-3,1583125200,1583125200,1
SoMuchForSubtle,0,1,0,3,1579323600,1579323600,1
UnknownEntity00000,0,1,0,2,1612069200,1612069200,1
hozzofficial,0,1,0,-17,1608613200,1608613200,1
yabaibai,0,1,0,102,1583726400,1583726400,1
AstridItesm,0,1,0,16,1594958400,1594958400,1
amos72,0,1,0,4,1591675200,1591675200,1
mirlitonade,0,1,0,0,1602388800,1602388800,1
brokensoftserve,1,0,2,0,1607403600,1607403600,1
fflagg664,0,1,0,8,1585454400,1585454400,1
Wise_turtle,0,1,0,1,1607662800,1607662800,1
ccactus62308,0,1,0,2,1605589200,1605589200,1
inverse_wsb,0,1,0,2,1593057600,1593057600,1
MalHeartsNutmeg,0,1,0,-3,1585454400,1585454400,1
Brogan2020,0,1,0,1,1612069200,1612069200,1
Nidcron,0,1,0,1,1608786000,1608786000,1
Gjboock,0,1,0,1,1591329600,1591329600,1
beeroftherat,0,1,0,19,1601784000,1601784000,1
paprika32,1,0,1,0,1580878800,1580878800,1
daltonbuchs28,0,1,0,-3,1585454400,1585454400,1
me_better,0,1,0,2,1586404800,1586404800,1
Kaiaislandarcade,0,1,0,1,1595649600,1595649600,1
Zenith2017,0,1,0,12,1612155600,1612155600,1
Jplara90,0,1,0,1,1607317200,1607317200,1
bazinganarchist,0,1,0,6,1578286800,1578286800,1
letmylifebemine,1,0,22,0,1573707600,1573707600,1
Adrakt,0,1,0,-1,1595217600,1595217600,1
WdntYouLikeToKnw,0,1,0,2,1588737600,1588737600,1
_370HSSV_,0,1,0,1,1608526800,1608526800,1
TGRummy,0,1,0,2,1612155600,1612155600,1
raulrsaco,0,1,0,6,1605070800,1605070800,1
_scubasteve,0,1,0,3,1578373200,1578373200,1
bluquark41685,0,1,0,22,1612155600,1612155600,1
duke12a,0,1,0,6,1578891600,1578891600,1
purpulish-gum,0,1,0,3,1596945600,1596945600,1
SergioP8577,0,1,0,2,1570334400,1570334400,1
yoyocool1000,0,1,0,-1,1606885200,1606885200,1
kcwelsch,0,1,0,37,1586836800,1586836800,1
nstudios,0,1,0,2,1582779600,1582779600,1
CannaKingdom0705,0,1,0,5,1607490000,1607490000,1
Aurelius18,0,1,0,7,1600747200,1600747200,1
TheAmazingDoggo,0,1,0,25,1597809600,1597809600,1
Rimmii,1,0,1,0,1600660800,1600660800,1
Tundra14,0,1,0,4,1607230800,1607230800,1
LewisOfAranda,0,1,0,2,1612069200,1612069200,1
clinicalpathology,0,1,0,1,1545454800,1545454800,1
NavyAnchor03,0,1,0,2,1605070800,1605070800,1
Diehardpizza,0,1,0,1,1604379600,1604379600,1
Cautious-Pound,1,0,1,0,1585972800,1585972800,1
jodiethedemonpig,0,1,0,1,1580706000,1580706000,1
bc4284,0,1,0,1,1606626000,1606626000,1
DryPrion,0,1,0,1,1607922000,1607922000,1
ManslaughterMary,0,1,0,2,1575608400,1575608400,1
Rum____Ham,0,1,0,1,1603512000,1603512000,1
Southern2002,0,1,0,7,1603425600,1603425600,1
edgysperg,0,1,0,1,1594785600,1594785600,1
loduc,0,1,0,2,1569729600,1569729600,1
NickJolter,0,1,0,3,1587960000,1587960000,1
511mev,0,1,0,12,1587441600,1587441600,1
Leander_Olinski,0,1,0,1,1594353600,1594353600,1
NursingGrimTown,0,1,0,6,1611810000,1611810000,1
AdoptedAsian_,0,1,0,1,1598760000,1598760000,1
pygmyjesus,0,1,0,-4,1582779600,1582779600,1
klawrence93,0,1,0,2,1608267600,1608267600,1
goobernooble,0,1,0,6,1603512000,1603512000,1
eastaccwill,0,1,0,2,1605589200,1605589200,1
nearl19,0,1,0,10,1560571200,1560571200,1
this_isafleshprison,0,1,0,1,1595217600,1595217600,1
avendogrija,0,1,0,1,1596859200,1596859200,1
grandeicedcovfefe,0,1,0,25,1560484800,1560484800,1
hair_account,0,1,0,4,1592884800,1592884800,1
ladycielphantomhive,0,1,0,14,1605157200,1605157200,1
Hot-Error,0,1,0,2,1604984400,1604984400,1
philosphizeinit,0,1,0,16,1597032000,1597032000,1
ViciousMihael,0,1,0,7,1609218000,1609218000,1
PinBot1138,0,1,0,-1,1579323600,1579323600,1
Rise-Up_My-Brother,0,1,0,2,1607662800,1607662800,1
Dsuperchef,0,1,0,1,1603425600,1603425600,1
Wolfgang1991,0,1,0,1,1608699600,1608699600,1
Mark30177,0,1,0,1,1606971600,1606971600,1
sar0809,0,1,0,1,1571803200,1571803200,1
AIADR,0,1,0,2,1605243600,1605243600,1
Drsec66,0,1,0,-2,1612069200,1612069200,1
phoenix2448,0,1,0,4,1584158400,1584158400,1
Psychopathics666,0,1,0,1,1605675600,1605675600,1
DoodlingDaughter,0,1,0,8,1609045200,1609045200,1
SimDestroyer,0,1,0,2,1584590400,1584590400,1
TheREALUncleJoe,0,1,0,2,1580446800,1580446800,1
Meatwareboi,0,1,0,16,1607835600,1607835600,1
GaGmBr,1,0,39,0,1579842000,1579842000,1
4206969420696942069,0,1,0,1,1604379600,1604379600,1
dogfightdruid,0,1,0,7,1604811600,1604811600,1
college_cinephile,1,0,246,0,1579582800,1579582800,1
AreYouFreakingJoking,0,1,0,5,1578114000,1578114000,1
immaculatelyfruities,0,1,0,34,1611982800,1611982800,1
NicolaGiga,0,1,0,22,1604725200,1604725200,1
motherofmanycats,0,1,0,23,1607749200,1607749200,1
ItsTheNuge,0,1,0,2,1606885200,1606885200,1
Mcdangerousss,0,1,0,4,1588824000,1588824000,1
Vindaloo-Sauce,0,1,0,15,1569988800,1569988800,1
link-corrector-bot,0,1,0,1,1524196800,1524196800,1
Sasquatch126,0,1,0,18,1596945600,1596945600,1
SomeJackass2020,0,1,0,13,1596513600,1596513600,1
Thorainger,0,1,0,0,1608181200,1608181200,1
strawberryjacuzzis,0,1,0,25,1572321600,1572321600,1
noximbeats,0,1,0,12,1577509200,1577509200,1
AnabolicNEET,0,1,0,2,1584590400,1584590400,1
Gynoid_being,0,1,0,1,1618632000,1618632000,1
AGamerDraws,0,1,0,2,1603684800,1603684800,1
youngvenus,0,1,0,24,1594872000,1594872000,1
CntrBlnc,0,1,0,8,1593057600,1593057600,1
Daviditamon,0,1,0,1,1596513600,1596513600,1
BassSolo,0,1,0,-2,1576299600,1576299600,1
alienalgen94,0,1,0,1,1574917200,1574917200,1
Ronthebear01,0,1,0,3,1604293200,1604293200,1
PdxPhoenixActual,0,1,0,7,1609304400,1609304400,1
SaltyBonham,0,1,0,1,1605243600,1605243600,1
jmkirsch,0,1,0,1,1585454400,1585454400,1
spacehicks,0,1,0,1,1605070800,1605070800,1
bluex2012,0,1,0,3,1579237200,1579237200,1
EmptyPin,0,1,0,7,1541044800,1541044800,1
pnwpdxgreen,0,1,0,2,1602475200,1602475200,1
TimothyCNorris,0,1,0,26,1572235200,1572235200,1
mr_miserablefuck,0,1,0,3,1584936000,1584936000,1
TuiAndLa,0,1,0,29,1555646400,1555646400,1
nosympathyforpolice,0,1,0,15,1599710400,1599710400,1
thosearecoolbeans,0,1,0,9,1608526800,1608526800,1
giegling,0,1,0,2,1546664400,1546664400,1
matcheteman,0,1,0,-3,1608440400,1608440400,1
javamickey,0,1,0,4,1597464000,1597464000,1
Estragonia,0,1,0,6,1572667200,1572667200,1
Least_Pace1344,0,1,0,15,1600401600,1600401600,1
blahquaker,0,1,0,29,1598932800,1598932800,1
Various-Mushroom-341,0,1,0,0,1622779200,1622779200,1
Healter-Skelter,0,1,0,7,1589860800,1589860800,1
Bigred489,0,1,0,1,1598932800,1598932800,1
sestrenger,1,0,63,0,1601611200,1601611200,1
Youllneverbegr8,0,1,0,2,1591156800,1591156800,1
jessicatface,0,1,0,19,1580274000,1580274000,1
Jujugatame,0,1,0,-1,1611982800,1611982800,1
usriusclark,0,1,0,1,1603512000,1603512000,1
oldyellowtruck,0,1,0,3,1611982800,1611982800,1
MattReedly,0,1,0,6,1607662800,1607662800,1
kex,0,1,0,4,1608958800,1608958800,1
PurpleMango7,0,1,0,1,1600574400,1600574400,1
El-Papa-Sote,0,1,0,3,1590638400,1590638400,1
extrasassplease,0,1,0,14,1585454400,1585454400,1
wizard_sugar,0,1,0,1,1563249600,1563249600,1
Helloissame,0,1,0,1,1575435600,1575435600,1
cosmicwitchball,0,1,0,3,1569643200,1569643200,1
user-name-less,0,1,0,1,1611896400,1611896400,1
Strange0rbit,0,1,0,1,1603512000,1603512000,1
hjub,0,1,0,1,1607749200,1607749200,1
maddylikessoccerr,0,1,0,5,1598414400,1598414400,1
Alchino23,0,1,0,1,1608267600,1608267600,1
aPeaceOfAdam,0,1,0,4,1580360400,1580360400,1
Genuinelytricked,0,1,0,5,1579669200,1579669200,1
mgcsrl,0,1,0,17,1574312400,1574312400,1
thissubisokay,0,1,0,2,1608094800,1608094800,1
bigroundofapplause,0,1,0,2,1600747200,1600747200,1
asianabsinthe,0,1,0,42,1561608000,1561608000,1
gayer_disaster,0,1,0,2,1599537600,1599537600,1
lgmringo,0,1,0,2,1574744400,1574744400,1
Extreemwisse,0,1,0,5,1600488000,1600488000,1
somebodyscyst,0,1,0,11,1574744400,1574744400,1
schmalexandra,0,1,0,3,1573621200,1573621200,1
lift_fit,0,1,0,-5,1589860800,1589860800,1
Hippieswererightpod,0,1,0,1,1588651200,1588651200,1
LeagueOfLeagues,0,1,0,14,1607144400,1607144400,1
IMACTHEBEAST,0,1,0,4,1606626000,1606626000,1
Homo-Maximus,0,1,0,3,1596772800,1596772800,1
OMGALEX,0,1,0,1,1582779600,1582779600,1
DownvoteALot,0,1,0,0,1594872000,1594872000,1
jcc10,0,1,0,3,1565496000,1565496000,1
HuntTheHunter12,0,1,0,8,1539835200,1539835200,1
D4rk_unicorn,0,1,0,3,1577422800,1577422800,1
Subversive_Noise,0,1,0,2,1588651200,1588651200,1
cunctatrix,0,1,0,3,1557115200,1557115200,1
weisstheiss,0,1,0,16,1585627200,1585627200,1
rickardpercy,0,1,0,6,1575262800,1575262800,1
Kie_ra,0,1,0,19,1559620800,1559620800,1
jaypat9,0,1,0,2,1590724800,1590724800,1
Keiuu,0,1,0,1,1608613200,1608613200,1
drajgreen,0,1,0,1,1585454400,1585454400,1
badrockpuns,0,1,0,1,1607317200,1607317200,1
M0JALA,0,1,0,5,1608613200,1608613200,1
ohhh-nooo,0,1,0,8,1601524800,1601524800,1
MonokuroMonkey,0,1,0,6,1592625600,1592625600,1
valorboop,0,1,0,1,1608872400,1608872400,1
Chocolateismy,0,1,0,4,1595908800,1595908800,1
Jacktropolis,0,1,0,8,1597550400,1597550400,1
Boden,0,1,0,18,1575867600,1575867600,1
Dirjel,0,1,0,22,1604984400,1604984400,1
1000Calories,0,1,0,0,1604552400,1604552400,1
useit923,0,1,0,1,1605589200,1605589200,1
lalolanda2,0,1,0,3,1596945600,1596945600,1
OddJackfruit6,0,1,0,22,1606971600,1606971600,1
colcardaki,0,1,0,39,1606626000,1606626000,1
-confinedmind,0,1,0,7,1599969600,1599969600,1
cochorol,0,1,0,1,1608872400,1608872400,1
BigTimeTimmyJim86,0,1,0,1,1608267600,1608267600,1
KodiakUltimate,0,1,0,2,1605070800,1605070800,1
danyo3,0,1,0,21,1605070800,1605070800,1
ItsAContam,0,1,0,2,1573794000,1573794000,1
rmellos,0,1,0,1,1573448400,1573448400,1
Mahmoud-Hibiki,0,1,0,7,1539921600,1539921600,1
TitillatingTittyLady,1,0,20,0,1598587200,1598587200,1
NihilisticAngst,0,1,0,5,1608786000,1608786000,1
DukeHesher,0,1,0,1,1575781200,1575781200,1
helpmeindisguise,0,1,0,10,1608094800,1608094800,1
dem0n0cracy,0,1,0,1,1574226000,1574226000,1
KingAngeli,0,1,0,1,1571889600,1571889600,1
chaipear,0,1,0,24,1572321600,1572321600,1
BeardedManKid,0,1,0,1,1581570000,1581570000,1
HipstaBarista,1,0,22,0,1546664400,1546664400,1
jov34,0,1,0,1,1606971600,1606971600,1
TylerJNA,0,1,0,2,1601524800,1601524800,1
dragosconst,0,1,0,1,1576731600,1576731600,1
Loogoo,0,1,0,1,1608872400,1608872400,1
notyogrannysgrandkid,0,1,0,1,1605934800,1605934800,1
Leather-Balls,0,1,0,1,1606626000,1606626000,1
christonabike_,0,1,0,6,1558584000,1558584000,1
jenboghel,0,1,0,9,1603512000,1603512000,1
Grandoph,0,1,0,237,1580101200,1580101200,1
Gods_chosen_dildo,0,1,0,3,1603598400,1603598400,1
legendary-banana,0,1,0,1,1614488400,1614488400,1
Hot_Willingness_1911,0,1,0,2,1602734400,1602734400,1
Mondonodo,0,1,0,2,1602820800,1602820800,1
spaceanomoly,0,1,0,21,1594526400,1594526400,1
Manofchalk,0,1,0,12,1606453200,1606453200,1
HomeAlonePigeonNo3,0,1,0,4,1594267200,1594267200,1
DidYouFall4It,0,1,0,41,1571371200,1571371200,1
stephensmg,0,1,0,1,1608872400,1608872400,1
19SkaZu91,0,1,0,2,1581051600,1581051600,1
HadalCusayb,0,1,0,8,1591243200,1591243200,1
leftsmile3,0,1,0,1,1608786000,1608786000,1
livingcode,0,1,0,7,1605502800,1605502800,1
Chris-raegho,0,1,0,3,1582779600,1582779600,1
thecelloman,0,1,0,65,1596686400,1596686400,1
IlIlllIIIIlIllllllll,0,1,0,15,1580274000,1580274000,1
JigsawMistress,0,1,0,1,1599969600,1599969600,1
Magicplz,0,1,0,2,1580792400,1580792400,1
Mr_Epimetheus,0,1,0,11,1597464000,1597464000,1
z1lard,0,1,0,1,1606626000,1606626000,1
MEEPERZZZZZ,0,1,0,3,1602216000,1602216000,1
Ijatsu,0,1,0,1,1549170000,1549170000,1
jalapenny,0,1,0,5,1581138000,1581138000,1
danibug,0,1,0,30,1590984000,1590984000,1
ResonantMango,0,1,0,1,1603339200,1603339200,1
ouei224,1,0,7,0,1606366800,1606366800,1
J134N,0,1,0,1,1577509200,1577509200,1
s0cks_nz,0,1,0,2,1604898000,1604898000,1
leanintomyside,0,1,0,1,1592971200,1592971200,1
Stigona,0,1,0,3,1585454400,1585454400,1
TheBountyHunterIX,0,1,0,2,1565323200,1565323200,1
i_have_covid_19,1,0,12,0,1585022400,1585022400,1
7dhebx,0,1,0,1,1608786000,1608786000,1
Pastel_Queen_of_Hell,0,1,0,62,1597377600,1597377600,1
moon_booty,0,1,0,1,1589860800,1589860800,1
NovelChest,0,1,0,3,1539835200,1539835200,1
Witness369,0,1,0,1,1583643600,1583643600,1
JustTheFatsMaam,0,1,0,6,1599883200,1599883200,1
logicannullata,0,1,0,1,1608008400,1608008400,1
Froggytwot,0,1,0,5,1603512000,1603512000,1
moonsociety,0,1,0,5,1602561600,1602561600,1
big_wendigo,0,1,0,4,1608354000,1608354000,1
itsbobs,0,1,0,3,1604466000,1604466000,1
Chateaupineraie,0,1,0,1,1609304400,1609304400,1
kermitdafrog667,0,1,0,2,1602648000,1602648000,1
D_Beats,0,1,0,3,1598932800,1598932800,1
amazingbehaviourist,0,1,0,26,1590033600,1590033600,1
Call_Me_Refu,0,1,0,8,1574139600,1574139600,1
__Madara_Uchiha__,0,1,0,1,1619582400,1619582400,1
RedErin,0,1,0,5,1390366800,1390366800,1
Steven-Cossey,0,1,0,3,1600660800,1600660800,1
sadiebhabie,0,1,0,5,1602561600,1602561600,1
SpiritDonkey,0,1,0,2,1594785600,1594785600,1
wdkkmpz,1,0,64,0,1562040000,1562040000,1
christopherl572,0,1,0,61,1607317200,1607317200,1
Freiling,0,1,0,14,1571803200,1571803200,1
lost-plateau-sigma,0,1,0,3,1608008400,1608008400,1
Mighty_Porg,0,1,0,1,1596859200,1596859200,1
slowpokerface,0,1,0,1,1538107200,1538107200,1
moondeli,0,1,0,1,1598846400,1598846400,1
SpartanPhi,0,1,0,7,1576386000,1576386000,1
toastymrkrispy,1,0,135,0,1591934400,1591934400,1
LumierreBronte,0,1,0,1,1613106000,1613106000,1
Wellyaknowidunno,0,1,0,2,1596081600,1596081600,1
tferrada24,1,0,80,0,1601092800,1601092800,1
Ali_Ryan,0,1,0,1,1607317200,1607317200,1
Chrristoaivalis,1,0,32,0,1555819200,1555819200,1
Lapsos_de_Lucidez,1,0,119,0,1575954000,1575954000,1
dyegb0311,0,1,0,-2,1598760000,1598760000,1
krustyskrab,0,1,0,3,1582779600,1582779600,1
HauntingSalamander62,0,1,0,1,1598068800,1598068800,1
nuclearheadspace,0,1,0,1,1594872000,1594872000,1
iliketoeatfoodnomnom,0,1,0,19,1608699600,1608699600,1
IJustLikePlants,0,1,0,2,1591243200,1591243200,1
hypercube33,0,1,0,1,1585627200,1585627200,1
LisaInSF,0,1,0,9,1563854400,1563854400,1
norolinda,0,1,0,4,1604552400,1604552400,1
Keranan37,0,1,0,1,1598328000,1598328000,1
FlukeCoins,0,1,0,1,1597723200,1597723200,1
RyanMUFC,0,1,0,42,1547355600,1547355600,1
noizu,0,1,0,1,1588392000,1588392000,1
aquintana,0,1,0,1,1585454400,1585454400,1
5269636b417374,0,1,0,11,1602129600,1602129600,1
Rikou336,0,1,0,2,1600747200,1600747200,1
Milosmilk,0,1,0,1,1605070800,1605070800,1
Johnmunch85,0,1,0,10,1607490000,1607490000,1
FortyTwoBrainCells,0,1,0,1,1608872400,1608872400,1
ClarityEsq,0,1,0,14,1595476800,1595476800,1
gooddeath,0,1,0,25,1574485200,1574485200,1
charleschaser,0,1,0,3,1603598400,1603598400,1
blueeyedconcrete,0,1,0,3,1596600000,1596600000,1
Joyst1q,0,1,0,1,1603512000,1603512000,1
positivecatz,0,1,0,36,1602475200,1602475200,1
Illiechick,0,1,0,1,1569988800,1569988800,1
cyanydeez,0,1,0,16,1584676800,1584676800,1
Cpt_Katt,0,1,0,2,1551848400,1551848400,1
ChewieBee,0,1,0,1,1589947200,1589947200,1
Exact-Delivery2119,0,1,0,1,1602043200,1602043200,1
satsumable,0,1,0,2,1598414400,1598414400,1
MarioDimkovski99,1,0,1,0,1591934400,1591934400,1
ShadowBlades4451,0,1,0,4,1561348800,1561348800,1
Keemsel,0,1,0,1,1611982800,1611982800,1
jeniwreni,0,1,0,1,1589860800,1589860800,1
SnooBooks53,1,0,28,0,1603944000,1603944000,1
nrd170,0,1,0,1,1606021200,1606021200,1
mattaniahhh,0,1,0,2,1605589200,1605589200,1
bugg925,0,1,0,5,1584763200,1584763200,1
MooCowLMFAO,0,1,0,1,1605070800,1605070800,1
ThinkInterest,0,1,0,1,1603512000,1603512000,1
John-of-Us,1,0,263,0,1608786000,1608786000,1
TheWordShaker,0,1,0,5,1604811600,1604811600,1
JoeyThePantz,0,1,0,1,1604379600,1604379600,1
Obbita,0,1,0,4,1597896000,1597896000,1
kingbagle,0,1,0,1,1608786000,1608786000,1
Unlikely-Public,1,0,221,0,1579755600,1579755600,1
isobelella,0,1,0,1,1565150400,1565150400,1
SoDamnGeneric,0,1,0,1,1598673600,1598673600,1
cridhebriste,0,1,0,3,1590120000,1590120000,1
RugglesIV,1,0,8,0,1601092800,1601092800,1
t3cblaze,0,1,0,1,1601352000,1601352000,1
amateurBokonist,0,1,0,2,1582693200,1582693200,1
hyperhurricanrana,0,1,0,5,1581051600,1581051600,1
FireShoob,0,1,0,3,1605070800,1605070800,1
Dogememesroasted,0,1,0,1,1598760000,1598760000,1
siddhantthesharma,0,1,0,1,1598500800,1598500800,1
_sumit_rana,1,0,0,0,1609131600,1609131600,1
ChargingElephant,0,1,0,-1,1550293200,1550293200,1
UpstairsHistorical44,0,1,0,6,1606712400,1606712400,1
-I0N-,0,1,0,26,1588132800,1588132800,1
SuchACommonBird,0,1,0,32,1606021200,1606021200,1
Fadi500,0,1,0,1,1602475200,1602475200,1
MrKewii,0,1,0,2,1606107600,1606107600,1
ralmama,0,1,0,58,1600574400,1600574400,1
AadeeMoien,0,1,0,0,1604379600,1604379600,1
omnitions,0,1,0,1,1608267600,1608267600,1
thosememes,0,1,0,2,1594785600,1594785600,1
Fennily,0,1,0,2,1612155600,1612155600,1
Ok_Replacement_7365,0,1,0,3,1597982400,1597982400,1
Mech_Kid,0,1,0,11,1598846400,1598846400,1
elblakay,0,1,0,0,1597723200,1597723200,1
itiswonderwoman,0,1,0,3,1592884800,1592884800,1
Insane_Artist,0,1,0,1,1605848400,1605848400,1
Stuckinasmallbox,0,1,0,31,1597896000,1597896000,1
terrazzomarmo,0,1,0,5,1607576400,1607576400,1
immiserablebutimtryi,0,1,0,9,1553486400,1553486400,1
uvaspina1,0,1,0,1,1600574400,1600574400,1
Mr_Greavous,0,1,0,10,1603684800,1603684800,1
Dangerjayne,0,1,0,1,1592366400,1592366400,1
linaasvs,0,1,0,28,1572580800,1572580800,1
tailoredlifestyleco,0,1,0,1,1579496400,1579496400,1
ReactsWithWords,0,1,0,22,1597032000,1597032000,1
Lerquer,0,1,0,2,1561521600,1561521600,1
plex06730,0,1,0,12,1582347600,1582347600,1
rty96chr,0,1,0,3,1599105600,1599105600,1
RosesFurTu,0,1,0,4,1573362000,1573362000,1
wantinit,0,1,0,1,1608699600,1608699600,1
ashizzzle,0,1,0,4,1593748800,1593748800,1
gchaudh2,0,1,0,6,1606626000,1606626000,1
FairyTrainerLaura,0,1,0,40,1548392400,1548392400,1
nyunaii,0,1,0,16,1558843200,1558843200,1
bgngbg,1,0,789,0,1600401600,1600401600,1
adderallballs,0,1,0,1,1572494400,1572494400,1
vatnalilja_,0,1,0,7,1606712400,1606712400,1
CNCvegatable,0,1,0,18,1577768400,1577768400,1
kulmthestatusquo,0,1,0,2,1607835600,1607835600,1
galactic-goat,1,0,44,0,1606021200,1606021200,1
Mr_Smartypants,0,1,0,6,1607576400,1607576400,1
Smooth_Creme,0,1,0,6,1609045200,1609045200,1
daother-guy,1,0,7,0,1565928000,1565928000,1
Princibalities,0,1,0,-3,1571976000,1571976000,1
Ferndust,0,1,0,2,1620446400,1620446400,1
galaxpsyche,0,1,0,19,1579928400,1579928400,1
Jakojenhh,0,1,0,2,1572235200,1572235200,1
MrEMannington,0,1,0,9,1599883200,1599883200,1
c_stics,0,1,0,3,1604379600,1604379600,1
hotsausce01,0,1,0,0,1582779600,1582779600,1
baz1688,0,1,0,6,1577336400,1577336400,1
PayYoSelf,0,1,0,1,1542258000,1542258000,1
Sobyv,0,1,0,1,1578459600,1578459600,1
MisterD00d,0,1,0,3,1603598400,1603598400,1
TheCrimsonDuchess,0,1,0,7,1608613200,1608613200,1
hypexcherry,0,1,0,8,1564891200,1564891200,1
formicatile,0,1,0,-1,1589860800,1589860800,1
ohboieherewego,0,1,0,4,1608699600,1608699600,1
Gorge_Formby,0,1,0,1,1605502800,1605502800,1
tinyblackberry6,0,1,0,1,1605070800,1605070800,1
Angrymarge,0,1,0,29,1598155200,1598155200,1
_harro_,0,1,0,1,1567569600,1567569600,1
aliensvsdinosaurs,0,1,0,1,1509249600,1509249600,1
securedigi,0,1,0,29,1609390800,1609390800,1
nostadumbass,0,1,0,2,1601265600,1601265600,1
mirelinha,0,1,0,1,1606021200,1606021200,1
wadech,0,1,0,4,1595563200,1595563200,1
EriAnnB,0,1,0,11,1585540800,1585540800,1
AbjectThought,0,1,0,6,1608008400,1608008400,1
hutacars,0,1,0,1,1594267200,1594267200,1
Godisdeadbutimnot,0,1,0,1,1604638800,1604638800,1
Hammer384,0,1,0,15,1573016400,1573016400,1
Snowcle,1,0,102,0,1596686400,1596686400,1
sunconjunctpluto,0,1,0,2,1602475200,1602475200,1
L4NN-1312,0,1,0,1,1601352000,1601352000,1
amanofshadows,0,1,0,5,1580446800,1580446800,1
JVwaterpolo,0,1,0,4,1598155200,1598155200,1
DOCTORE2,0,1,0,3,1600574400,1600574400,1
WaylonJenningsJr,0,1,0,-5,1571544000,1571544000,1
Bliss266,0,1,0,-6,1599019200,1599019200,1
messybottom101,0,1,0,1,1569643200,1569643200,1
ramboy18,0,1,0,2,1590033600,1590033600,1
eddiefiv,0,1,0,5,1588737600,1588737600,1
Magic_8_Ball_Of_Fun,0,1,0,9,1572148800,1572148800,1
production-values,0,1,0,2,1608699600,1608699600,1
Black_Hipster,0,1,0,3,1576818000,1576818000,1
ColoredGhost,0,1,0,1,1607058000,1607058000,1
Negative_Telephone_2,0,1,0,2,1606712400,1606712400,1
neanderthalensis,0,1,0,2,1600920000,1600920000,1
LifeisDankiThink,0,1,0,34,1597118400,1597118400,1
Nick_________,0,1,0,16,1602475200,1602475200,1
LameBiology,0,1,0,9,1604811600,1604811600,1
pdxcar,0,1,0,4,1597636800,1597636800,1
CyranoYoshi,0,1,0,9,1604379600,1604379600,1
pinkdiva53,0,1,0,10,1582952400,1582952400,1
e5janisse,0,1,0,2,1566446400,1566446400,1
dfjkl32as,0,1,0,4,1578459600,1578459600,1
tasmaniansemidevil,0,1,0,1,1591243200,1591243200,1
neukjedemoeder,0,1,0,1,1592798400,1592798400,1
SuSp3cT333,0,1,0,2,1599192000,1599192000,1
Lemonion,0,1,0,40,1597982400,1597982400,1
DubioTheDubious,0,1,0,2,1605934800,1605934800,1
Aneeki,0,1,0,1,1606280400,1606280400,1
Oo_mr_mann_oO,0,1,0,3,1590552000,1590552000,1
supernerd2000,0,1,0,27,1585454400,1585454400,1
tickleKC,0,1,0,1,1582779600,1582779600,1
lookatmybuttress,0,1,0,12,1571544000,1571544000,1
tubebox,0,1,0,1,1577941200,1577941200,1
Psychological-Ad5025,0,1,0,2,1606885200,1606885200,1
jenncertainty,0,1,0,4,1605762000,1605762000,1
ambuchar,1,0,0,0,1456635600,1456635600,1
krsteeve,0,1,0,1,1551157200,1551157200,1
Murasame-dono,0,1,0,10,1588132800,1588132800,1
13or31,0,1,0,3,1596427200,1596427200,1
revcasy,0,1,0,10,1542776400,1542776400,1
jenovakitty,0,1,0,3,1603598400,1603598400,1
unteal,0,1,0,2,1603598400,1603598400,1
7ittlePP,0,1,0,3,1603684800,1603684800,1
Newnustart,0,1,0,3,1582606800,1582606800,1
OldmanChompski,0,1,0,52,1608958800,1608958800,1
UnluckyCycle,0,1,0,1,1609390800,1609390800,1
2cool2hear,0,1,0,3,1566100800,1566100800,1
meow_mix42,0,1,0,10,1590033600,1590033600,1
EmilyTheCityBurner,0,1,0,3,1593576000,1593576000,1
dangshnizzle,0,1,0,1,1587009600,1587009600,1
takesthebiscuit,0,1,0,14,1598760000,1598760000,1
AstroturfReddit,0,1,0,8,1607835600,1607835600,1
owielukey,0,1,0,6,1592366400,1592366400,1
Psychic_Saboteur115,0,1,0,4,1599537600,1599537600,1
hellodingo,0,1,0,13,1551243600,1551243600,1
Rayoque,0,1,0,2,1565150400,1565150400,1
UUtch,0,1,0,1,1598760000,1598760000,1
porkchop808,0,1,0,3,1582261200,1582261200,1
nimpostor,0,1,0,1,1596772800,1596772800,1
lofi_and_chill,0,1,0,1,1612069200,1612069200,1
Gamiac,0,1,0,5,1585454400,1585454400,1
Notaspooon,0,1,0,4,1573362000,1573362000,1
Juniperarrow2,0,1,0,73,1606885200,1606885200,1
Grimarillion,0,1,0,6,1576558800,1576558800,1
Jar-Jar-Fett,0,1,0,1,1576645200,1576645200,1
Astolfo_is_Best,0,1,0,-12,1585454400,1585454400,1
ranger51,0,1,0,8,1596340800,1596340800,1
jatue7,0,1,0,1,1560225600,1560225600,1
KingSalto,0,1,0,1,1606194000,1606194000,1
Streuselboi69,0,1,0,1,1606626000,1606626000,1
stephendt,0,1,0,-1,1571976000,1571976000,1
pconwell,0,1,0,2,1605589200,1605589200,1
Tadeuthr,0,1,0,30,1594094400,1594094400,1
kembik,0,1,0,0,1608699600,1608699600,1
ParryGallister,0,1,0,3,1599451200,1599451200,1
HugsHeal,0,1,0,1,1569211200,1569211200,1
DeScepter,0,1,0,1,1607058000,1607058000,1
KindaAGoodPerson,0,1,0,1,1634702400,1634702400,1
itsmeseeks,0,1,0,5,1600833600,1600833600,1
jackux1257,0,1,0,1,1582088400,1582088400,1
koala_loves_penguin,0,1,0,1,1593748800,1593748800,1
purpleskirt,0,1,0,3,1601265600,1601265600,1
jtobin85,0,1,0,-6,1606539600,1606539600,1
HalflinsLeaf,0,1,0,-1,1599624000,1599624000,1
SquishyLemonss,0,1,0,23,1585108800,1585108800,1
wi1lywonak,0,1,0,2,1566446400,1566446400,1
williamobj,0,1,0,3,1594612800,1594612800,1
throwaway13480135,1,0,8,0,1565928000,1565928000,1
TacoTacoma123,0,1,0,2,1571544000,1571544000,1
Trawrster,0,1,0,4,1561780800,1561780800,1
pederas111,1,0,109,0,1595131200,1595131200,1
mkov88,0,1,0,1,1562817600,1562817600,1
Niblick_Henbane,0,1,0,1,1608786000,1608786000,1
Alxmrlw,1,0,8543,0,1606194000,1606194000,1
Looneytune679,0,1,0,0,1588824000,1588824000,1
General_Tamura,0,1,0,1,1605589200,1605589200,1
SisterCara,0,1,0,1,1608267600,1608267600,1
-Fristy-,0,1,0,0,1603598400,1603598400,1
benlew,0,1,0,1,1594353600,1594353600,1
canaryellowsunshine,0,1,0,6,1573621200,1573621200,1
caucasianoddjob,0,1,0,1,1611810000,1611810000,1
krakatoa83,0,1,0,1,1606626000,1606626000,1
rinneganadrian,0,1,0,1,1589860800,1589860800,1
TyrTwiceForVictory,0,1,0,3,1596168000,1596168000,1
biolabskc,0,1,0,2,1600833600,1600833600,1
EuronGreyjoy1995,0,1,0,2,1607230800,1607230800,1
chris1096,0,1,0,-1,1577682000,1577682000,1
leggomydamneggo,0,1,0,2,1600660800,1600660800,1
big_al11,1,0,25,0,1477540800,1477540800,1
The-Jong-Dong,0,1,0,1,1606626000,1606626000,1
favillesco,0,1,0,27,1597377600,1597377600,1
spiralnotebook,0,1,0,3,1598846400,1598846400,1
VegAnarchistCommie,1,0,6,0,1481086800,1481086800,1
aftereveryoneelse,0,1,0,1,1582779600,1582779600,1
HighnLow8,0,1,0,23,1597636800,1597636800,1
wafflebunny,0,1,0,11,1596254400,1596254400,1
tinysugarmilk,0,1,0,3,1599105600,1599105600,1
KakarotSSJ4,0,1,0,1,1603598400,1603598400,1
ookyou,0,1,0,74,1605070800,1605070800,1
SexyEmuLegs,0,1,0,6,1580533200,1580533200,1
Heffries,0,1,0,-7,1567051200,1567051200,1
Whothehellissam,0,1,0,1,1599796800,1599796800,1
Question-mark-kick,0,1,0,1,1585886400,1585886400,1
xpageprox,0,1,0,2,1591416000,1591416000,1
ILogItAll,0,1,0,2,1585540800,1585540800,1
Beamrunner_Ka-Tet,0,1,0,1,1585368000,1585368000,1
FirstGlare,0,1,0,-1,1581224400,1581224400,1
Major-Front,0,1,0,1,1606626000,1606626000,1
YeltsinYerMouth,0,1,0,6,1592712000,1592712000,1
3EyedDuck,0,1,0,13,1578459600,1578459600,1
if0rg0t48,0,1,0,3,1576386000,1576386000,1
kylorensgrandfather,0,1,0,2,1637643600,1637643600,1
Ashdzj,0,1,0,1,1612933200,1612933200,1
clever712,0,1,0,32,1578027600,1578027600,1
Wraithstorm,0,1,0,3,1603512000,1603512000,1
saucylegs,0,1,0,10,1606626000,1606626000,1
Chromattix,0,1,0,5,1570420800,1570420800,1
IWantToBeEmily,0,1,0,2,1577682000,1577682000,1
PMmeHairyForearms,0,1,0,1,1611896400,1611896400,1
poo2225,0,1,0,1,1594785600,1594785600,1
nowaijosr,0,1,0,2,1603512000,1603512000,1
lostliterature,0,1,0,3,1587009600,1587009600,1
Panzer_Kommandant_,0,1,0,4,1596513600,1596513600,1
vital_brevity,0,1,0,10,1594699200,1594699200,1
KingSmoke9,0,1,0,2,1608613200,1608613200,1
The_Level_15,0,1,0,50,1585454400,1585454400,1
TheFantasticAspic,0,1,0,4,1605589200,1605589200,1
lionistyy,0,1,0,3,1583125200,1583125200,1
enotonom,0,1,0,7,1596772800,1596772800,1
Pants49,0,1,0,2,1608872400,1608872400,1
GastricOdin24,0,1,0,5,1595304000,1595304000,1
nanobitcoin,0,1,0,1,1556683200,1556683200,1
Apart-Number-3736,1,0,17,0,1602043200,1602043200,1
BasicPainting5,0,1,0,35,1579755600,1579755600,1
spacegibberish,0,1,0,35,1594267200,1594267200,1
sapphicvioletskies,1,0,16,0,1606712400,1606712400,1
BashfulAxolotl,0,1,0,27,1546664400,1546664400,1
WhiskeyKisses7221,0,1,0,2,1603771200,1603771200,1
BobTehCat,0,1,0,5,1587441600,1587441600,1
toggleme1,0,1,0,-4,1554523200,1554523200,1
gHHqdm5a4UySnUFM,0,1,0,9,1576645200,1576645200,1
soupvsjonez,0,1,0,0,1607576400,1607576400,1
BLOCKEDBYJAMESS,0,1,0,1,1594008000,1594008000,1
its_dizzle,0,1,0,2,1593835200,1593835200,1
dingfurtz,0,1,0,8,1594267200,1594267200,1
Raul_bitchboi,0,1,0,18,1604811600,1604811600,1
tyghhhfg,0,1,0,1,1597032000,1597032000,1
SpiritOfSpite,0,1,0,1,1573621200,1573621200,1
0livesarenasty,0,1,0,20,1592280000,1592280000,1
Eugene_Sandugey,0,1,0,1,1608267600,1608267600,1
anarchocowboyism,0,1,0,4,1598500800,1598500800,1
maugust09,0,1,0,3,1611723600,1611723600,1
Blakon13,0,1,0,50,1573016400,1573016400,1
yazalama,0,1,0,1,1591243200,1591243200,1
ChineseAstroturfer,0,1,0,7,1596859200,1596859200,1
bowmans1993,0,1,0,1,1600660800,1600660800,1
oregiel,0,1,0,6,1603598400,1603598400,1
h3ineka,0,1,0,0,1634529600,1634529600,1
popcornfart,0,1,0,35,1591243200,1591243200,1
C1oudspine,0,1,0,1,1605934800,1605934800,1
deg662032,0,1,0,2,1609131600,1609131600,1
hector22x,0,1,0,3,1609304400,1609304400,1
Gloria-in-Morte,0,1,0,3,1597550400,1597550400,1
akirakurusuakajoker,0,1,0,1,1602475200,1602475200,1
Ilovefuturama89,0,1,0,8,1595217600,1595217600,1
fearwontstopme,0,1,0,36,1606626000,1606626000,1
BigBadBolshevik,0,1,0,5,1593144000,1593144000,1
Accurate_Background6,1,0,3,0,1607662800,1607662800,1
loimprevisto,0,1,0,1,1608786000,1608786000,1
magsoup,0,1,0,5,1574312400,1574312400,1
EnormousHughMungus,0,1,0,-2,1597118400,1597118400,1
No_volvere,0,1,0,14,1593230400,1593230400,1
gunnerwolf,1,0,285,0,1593489600,1593489600,1
halibitch,0,1,0,156,1602993600,1602993600,1
curlyjoe696,0,1,0,3,1606626000,1606626000,1
IMA_BLACKSTAR,0,1,0,2,1596772800,1596772800,1
bobtgrnailman,0,1,0,6,1584244800,1584244800,1
Mesafather,0,1,0,1,1601870400,1601870400,1
Thief_in-the_night,0,1,0,4,1604116800,1604116800,1
CrackGear,0,1,0,1,1598760000,1598760000,1
Csherman92,0,1,0,1,1597723200,1597723200,1
zUltimateRedditor,0,1,0,1,1602820800,1602820800,1
purpledivaaa6,0,1,0,4,1593403200,1593403200,1
Bros-Before-Navajos,0,1,0,1,1585454400,1585454400,1
RainbowUngodly,0,1,0,9,1612155600,1612155600,1
CornucopiaOfDystopia,0,1,0,12,1559188800,1559188800,1
pokemoneinstein,0,1,0,2,1598587200,1598587200,1
MHCKat,0,1,0,6,1607317200,1607317200,1
Guapoton-i,0,1,0,4,1574139600,1574139600,1
dawgdawg3000,0,1,0,1,1600056000,1600056000,1
Itchy-Contribution-9,0,1,0,1,1609650000,1609650000,1
protrudingnipples,0,1,0,-1,1591761600,1591761600,1
mackwright91,0,1,0,1,1605848400,1605848400,1
Dreams518,0,1,0,2,1605070800,1605070800,1
ThisOldPhony,0,1,0,1,1605589200,1605589200,1
gnosticycle,0,1,0,3,1590465600,1590465600,1
Tigga-tigga-tigga,0,1,0,6,1600056000,1600056000,1
flexifelicis,0,1,0,14,1602475200,1602475200,1
Guttermouth11111,0,1,0,1,1604203200,1604203200,1
RightfulChaos,0,1,0,1,1608267600,1608267600,1
theboldgobolder,0,1,0,1,1604898000,1604898000,1
JollyRanchurs,0,1,0,1,1607662800,1607662800,1
redaphid,0,1,0,1,1605070800,1605070800,1
nashagain,0,1,0,1,1606626000,1606626000,1
-jz-,0,1,0,-1,1582779600,1582779600,1
GreedyCity,0,1,0,3,1611896400,1611896400,1
regwrit,0,1,0,7,1547096400,1547096400,1
Fedoraflipmaster,0,1,0,1,1596427200,1596427200,1
Tallsmarthandsome,0,1,0,1,1563076800,1563076800,1
thepsychedelicsound,0,1,0,17,1604898000,1604898000,1
plaaya,0,1,0,4,1599278400,1599278400,1
Urabus555,0,1,0,-1,1604030400,1604030400,1
knoble12,0,1,0,3,1603598400,1603598400,1
antoniv1,0,1,0,5,1590465600,1590465600,1
eliaspowers,0,1,0,4,1607749200,1607749200,1
pecklepuff,0,1,0,1,1591329600,1591329600,1
crouchendyachtclub,0,1,0,1,1605589200,1605589200,1
I_CAPE_RUNTS,0,1,0,3,1572753600,1572753600,1
okapidaddy,0,1,0,5,1570075200,1570075200,1
AZCrustPup,0,1,0,5,1611810000,1611810000,1
WorthCheesecake7381,0,1,0,1,1608786000,1608786000,1
mondaysbest,0,1,0,1,1608267600,1608267600,1
CrazyDuck123,0,1,0,5,1569988800,1569988800,1
erinthematrix,0,1,0,1,1606712400,1606712400,1
liko,0,1,0,16,1574658000,1574658000,1
knightsmarian,0,1,0,2,1548997200,1548997200,1
punchybot,0,1,0,1,1591156800,1591156800,1
labez,1,0,4,0,1588737600,1588737600,1
vrryhaevy,0,1,0,56,1604293200,1604293200,1
ElliotIsRami,0,1,0,6,1588737600,1588737600,1
duckduckseduce,0,1,0,1,1576645200,1576645200,1
bungholio99,0,1,0,1,1591243200,1591243200,1
StormRealistic8161,0,1,0,26,1608786000,1608786000,1
yeetmaster_mb2,0,1,0,2,1589515200,1589515200,1
ramffl,0,1,0,3,1601352000,1601352000,1
freightshooker,0,1,0,0,1578373200,1578373200,1
KeyGenetics,0,1,0,1,1607749200,1607749200,1
Cyberiauxin,0,1,0,12,1571976000,1571976000,1
dorfcally,0,1,0,4,1576472400,1576472400,1
midnight_rebirth,0,1,0,1,1608613200,1608613200,1
silly_booboo,0,1,0,1,1585713600,1585713600,1
Derkxxx,0,1,0,1,1636084800,1636084800,1
sts816,0,1,0,5,1611896400,1611896400,1
Zach202020,0,1,0,2,1603598400,1603598400,1
datdirtyboi21,0,1,0,16,1601179200,1601179200,1
kitchenwitchin,0,1,0,2,1609304400,1609304400,1
temdittiesohyeah,0,1,0,3,1593316800,1593316800,1
GeneralRuckus81,0,1,0,15,1602648000,1602648000,1
WesTuggs,1,0,25,0,1608354000,1608354000,1
Old_Spoon,0,1,0,1,1607835600,1607835600,1
Party_With_Porkins,0,1,0,6,1576386000,1576386000,1
TheDiscoJew,0,1,0,1,1606971600,1606971600,1
Percle,0,1,0,-2,1567310400,1567310400,1
l_i_l_i_l_i,0,1,0,5,1597032000,1597032000,1
ohsiouxsieQ,0,1,0,52,1536984000,1536984000,1
BasilGreen,0,1,0,7,1606626000,1606626000,1
SeekingMyEnd,0,1,0,1,1599969600,1599969600,1
bigwillystyle5252,0,1,0,3,1599537600,1599537600,1
SirrGalehaut,0,1,0,1,1590811200,1590811200,1
Firrox,0,1,0,3,1584763200,1584763200,1
keyboard-sexual,0,1,0,14,1605589200,1605589200,1
OcarinaofChime,0,1,0,-22,1609218000,1609218000,1
KCCCellist,1,0,10,0,1574658000,1574658000,1
HelloGail,0,1,0,2,1598760000,1598760000,1
bradvstheworld,0,1,0,1,1604030400,1604030400,1
Rosedale-Metals,0,1,0,1,1602302400,1602302400,1
mrkaramazov86,0,1,0,-3,1573534800,1573534800,1
infinitelyystrange,1,0,78,0,1557028800,1557028800,1
Smegma_Sommelier,0,1,0,44,1584763200,1584763200,1
mourronic,0,1,0,1,1603512000,1603512000,1
Yaroze,0,1,0,6,1574139600,1574139600,1
TheyAreNotMyMonkeys,0,1,0,5,1583643600,1583643600,1
zouss,0,1,0,11,1581570000,1581570000,1
ShootMore3s,0,1,0,7,1592971200,1592971200,1
Battle_Biscuits,0,1,0,2,1606280400,1606280400,1
espresso_speck,0,1,0,14,1611723600,1611723600,1
Zerokx,0,1,0,9,1569470400,1569470400,1
benjaminhutton216,0,1,0,7,1578286800,1578286800,1
GrinningCatBus,0,1,0,9,1590552000,1590552000,1
MariosStacheTickles,0,1,0,5,1602820800,1602820800,1
Greghundred,0,1,0,1,1580533200,1580533200,1
qaz1qaz1QAZ,0,1,0,6,1599710400,1599710400,1
Frightfulnessless,1,0,9,0,1600056000,1600056000,1
BurritoTheBoy,0,1,0,2,1611896400,1611896400,1
PaulGu1220,0,1,0,0,1609304400,1609304400,1
Thrillhouse-14,0,1,0,24,1589947200,1589947200,1
AlexHerndon1,0,1,0,1,1584244800,1584244800,1
PattieMcCakes,0,1,0,1,1526443200,1526443200,1
youbrokemycool,1,0,1,0,1576558800,1576558800,1
day_drinking_,0,1,0,14,1609304400,1609304400,1
CapitanMorgan305,0,1,0,7,1592884800,1592884800,1
Nerknack,0,1,0,1,1594699200,1594699200,1
SeniorStrawHat,0,1,0,0,1608267600,1608267600,1
lornaalis,0,1,0,1,1608872400,1608872400,1
ardfark,0,1,0,1,1603598400,1603598400,1
MegaManectrc,0,1,0,2,1589169600,1589169600,1
kitten_binoculars,0,1,0,9,1584763200,1584763200,1
keepusernamesecret,0,1,0,6,1611896400,1611896400,1
lilyslider,0,1,0,2,1596945600,1596945600,1
Ok-with-Existing,0,1,0,1,1575262800,1575262800,1
HoChiCityMinh,1,0,56,0,1570852800,1570852800,1
MrXero,0,1,0,1,1608526800,1608526800,1
vintagegarrison,0,1,0,2,1605589200,1605589200,1
fatzinpantz,0,1,0,1,1588478400,1588478400,1
lifterpuller1,0,1,0,-16,1573448400,1573448400,1
CRKmahaha,0,1,0,3,1598328000,1598328000,1
DankAquaPupper,0,1,0,3,1575781200,1575781200,1
TMKF2,0,1,0,7,1577941200,1577941200,1
scentedtrashbag,0,1,0,1,1592193600,1592193600,1
floghdraki,0,1,0,4,1611982800,1611982800,1
TropicaniaResident,0,1,0,22,1591243200,1591243200,1
GetSkied15,0,1,0,2,1602820800,1602820800,1
olliletonsaari,0,1,0,2,1584763200,1584763200,1
Farfromfud,0,1,0,2,1601870400,1601870400,1
wsp424,0,1,0,69,1607576400,1607576400,1
fallbondler,0,1,0,6,1608958800,1608958800,1
RealNerdEthan,0,1,0,3,1567569600,1567569600,1
m_7NCq_39Mj_z4_,1,0,1,0,1455512400,1455512400,1
Ghosted67,0,1,0,2,1576990800,1576990800,1
DrStrangeBalls,0,1,0,19,1586836800,1586836800,1
roadkillsanta,0,1,0,1,1595476800,1595476800,1
Healthmy,1,0,0,0,1604030400,1604030400,1
stovetopzzz,0,1,0,2,1557547200,1557547200,1
Mortegro545,0,1,0,1,1585454400,1585454400,1
getnshafted,0,1,0,1,1573621200,1573621200,1
vote100binary,0,1,0,4,1598500800,1598500800,1
Poneill9690,0,1,0,3,1583125200,1583125200,1
Ok_Champion_7944,0,1,0,1,1606021200,1606021200,1
YaxYaxx,0,1,0,0,1582779600,1582779600,1
mehawhaw,1,0,49,0,1556510400,1556510400,1
Herpderp654321,0,1,0,-13,1575176400,1575176400,1
bladershah,0,1,0,5,1589342400,1589342400,1
reddit01234543210,0,1,0,-16,1572321600,1572321600,1
Kontakr,0,1,0,16,1607749200,1607749200,1
Aventador777,0,1,0,-20,1569297600,1569297600,1
karpatika,0,1,0,1,1575003600,1575003600,1
BedHopeful,1,0,260,0,1599710400,1599710400,1
twinkledinkley,0,1,0,1,1612069200,1612069200,1
truenorth195,0,1,0,-16,1608354000,1608354000,1
Wopperlayouts,0,1,0,7,1570248000,1570248000,1
Moytta,0,1,0,18,1590897600,1590897600,1
Routerbad,0,1,0,1,1552449600,1552449600,1
jsparker43,0,1,0,2,1608267600,1608267600,1
Infin1ty,0,1,0,-14,1598760000,1598760000,1
PettyEmbezzlement,0,1,0,1,1573534800,1573534800,1
claudelegreat,1,0,897,0,1594008000,1594008000,1
Protopunkz,0,1,0,-1,1606539600,1606539600,1
bubsies,0,1,0,69,1575867600,1575867600,1
Foolbish,0,1,0,3,1598068800,1598068800,1
ICodeGorilla,0,1,0,5,1600228800,1600228800,1
icecoldpopsicle,0,1,0,2,1612155600,1612155600,1
Sonn3rs,1,0,43,0,1583812800,1583812800,1
Imaginary_Two_2699,0,1,0,0,1603598400,1603598400,1
bluekaypierce,0,1,0,22,1591156800,1591156800,1
Avbhb,0,1,0,1,1612069200,1612069200,1
Papagoatzi,0,1,0,1,1573621200,1573621200,1
_penseroso_,0,1,0,7,1600228800,1600228800,1
laminatedlama,0,1,0,2,1590638400,1590638400,1
indyogre,0,1,0,19,1592366400,1592366400,1
gentlewins,0,1,0,1,1605848400,1605848400,1
shinobi189,0,1,0,0,1589774400,1589774400,1
Crxssfire123,1,0,4,0,1602129600,1602129600,1
dimi3ja,0,1,0,1,1606626000,1606626000,1
Premguin,0,1,0,11,1578546000,1578546000,1
cbreitigan,0,1,0,34,1609304400,1609304400,1
thoreeyore99,0,1,0,14,1575781200,1575781200,1
CuriousPerson1500,0,1,0,18,1609131600,1609131600,1
AcceptableHuman0,0,1,0,42,1604116800,1604116800,1
Poop_On_A_Loop,0,1,0,-1,1601352000,1601352000,1
dreggn0g,0,1,0,7,1571371200,1571371200,1
sassysquatch007,0,1,0,11,1604811600,1604811600,1
Shampoocat,0,1,0,10,1556251200,1556251200,1
AlmightyGnasher,0,1,0,0,1605589200,1605589200,1
hurkle,0,1,0,5,1480827600,1480827600,1
B_G_X,1,0,17,0,1579582800,1579582800,1
degeneratefur,0,1,0,1,1571889600,1571889600,1
CalicoJack1496,0,1,0,1,1609131600,1609131600,1
ecksxdiegh,0,1,0,21,1594353600,1594353600,1
Nimeni_0,0,1,0,4,1602302400,1602302400,1
justinsayin,0,1,0,3,1578978000,1578978000,1
BobArdKor,0,1,0,3,1576040400,1576040400,1
jooes,0,1,0,21,1607403600,1607403600,1
slydon75,0,1,0,3,1581224400,1581224400,1
CaptainMonkeyJack,0,1,0,1,1607662800,1607662800,1
Tedfordshire,0,1,0,1,1609131600,1609131600,1
Nashiaidan,0,1,0,17,1605675600,1605675600,1
beans_94,0,1,0,1,1606798800,1606798800,1
Ill_Quarter_1208,0,1,0,11,1606194000,1606194000,1
Ashangu,0,1,0,4,1601352000,1601352000,1
Ckstap,0,1,0,3,1596859200,1596859200,1
skunckunk,0,1,0,-6,1608526800,1608526800,1
Puzzleheaded_Ad233,0,1,0,1,1605157200,1605157200,1
Neutral_man_,1,0,516,0,1606971600,1606971600,1
OkayAmountOfCowbell,0,1,0,1,1598760000,1598760000,1
memeloving69er,0,1,0,1,1591243200,1591243200,1
clamodity,0,1,0,6,1598760000,1598760000,1
bookmantea,0,1,0,1,1577422800,1577422800,1
RagingtonSteel,0,1,0,1,1643173200,1643173200,1
katedc18,0,1,0,1,1598328000,1598328000,1
Rtrnr,0,1,0,0,1578891600,1578891600,1
etherealcerral,0,1,0,13,1596600000,1596600000,1
AccomplishedOnion405,0,1,0,39,1612155600,1612155600,1
shurfire,0,1,0,12,1585454400,1585454400,1
demoniclionfish,0,1,0,2,1571889600,1571889600,1
TechWOP,0,1,0,3,1594008000,1594008000,1
JOEYMAMI2015,0,1,0,1,1589860800,1589860800,1
Rometeo19,0,1,0,1,1602734400,1602734400,1
MadScience29,0,1,0,17,1608958800,1608958800,1
han-kk,0,1,0,3,1564372800,1564372800,1
notpoopman,0,1,0,1,1591675200,1591675200,1
uniquendividual,0,1,0,3,1600574400,1600574400,1
REAP3R80,0,1,0,1,1599624000,1599624000,1
MiniEquine,0,1,0,2,1585454400,1585454400,1
ThePleasantFlight,0,1,0,2,1605502800,1605502800,1
smadams,0,1,0,117,1608440400,1608440400,1
candykitchen,0,1,0,1,1611896400,1611896400,1
light_blue_crayon,0,1,0,1,1608440400,1608440400,1
RiptideRookie,0,1,0,4,1582088400,1582088400,1
Kgwalter,0,1,0,24,1599796800,1599796800,1
asiscoe,0,1,0,10,1585281600,1585281600,1
Dreadsock,0,1,0,63,1580274000,1580274000,1
connmanb,0,1,0,-10,1585022400,1585022400,1
spudicous,0,1,0,2,1604379600,1604379600,1
kysien,0,1,0,5,1609304400,1609304400,1
sexstains,1,0,6,0,1588564800,1588564800,1
budispro,0,1,0,3,1611982800,1611982800,1
Whataretheplayoffs,0,1,0,17,1606885200,1606885200,1
americaispussy,0,1,0,2,1611982800,1611982800,1
asap-bitcoin,0,1,0,2,1600574400,1600574400,1
officialukuleleboy,0,1,0,1,1575608400,1575608400,1
I_try_to_talk_to_you,0,1,0,1,1599883200,1599883200,1
TheBigMilkThing,0,1,0,11,1561435200,1561435200,1
Ridiculisk1,0,1,0,1,1586491200,1586491200,1
yddilaluap,0,1,0,7,1583726400,1583726400,1
major84,0,1,0,8,1580619600,1580619600,1
phalencrow,0,1,0,54,1607922000,1607922000,1
Diggie1225,0,1,0,2,1574226000,1574226000,1
nd20,1,0,70,0,1579842000,1579842000,1
Vartry,0,1,0,9,1593662400,1593662400,1
Ubiquity4321,0,1,0,5,1590120000,1590120000,1
Uncertain_aquarian,0,1,0,8,1608354000,1608354000,1
veritron,0,1,0,6,1598414400,1598414400,1
myfreenagsiea,0,1,0,1,1546578000,1546578000,1
hypermadirish,0,1,0,2,1607835600,1607835600,1
shamazabraham,1,0,1,0,1599364800,1599364800,1
dmifflin21,0,1,0,1,1603598400,1603598400,1
dkh1638,0,1,0,1,1585454400,1585454400,1
kaizenmonty,0,1,0,3,1602388800,1602388800,1
NotAGingerMidget,0,1,0,1,1591243200,1591243200,1
memento_moria,0,1,0,8,1600488000,1600488000,1
PM_ME_88_FACTS,1,0,216,0,1583211600,1583211600,1
dickenheim,0,1,0,1,1611982800,1611982800,1
metalsonic2,0,1,0,6,1607922000,1607922000,1
RolletRogue,0,1,0,1,1599192000,1599192000,1
cdawg145236,0,1,0,7,1577336400,1577336400,1
ksumirei,0,1,0,1,1582434000,1582434000,1
ArcticEagerness,0,1,0,1,1608872400,1608872400,1
SenseiObvious,0,1,0,4,1605502800,1605502800,1
AReallyNiceGarden,0,1,0,4,1576904400,1576904400,1
LambdaMagnus,0,1,0,2,1611982800,1611982800,1
OwlOtherwise,0,1,0,1,1601870400,1601870400,1
what-distance-tho,0,1,0,3,1551070800,1551070800,1
DRDeMello,0,1,0,1,1603598400,1603598400,1
2cents_sniper,0,1,0,9,1563336000,1563336000,1
420sound,0,1,0,1,1602216000,1602216000,1
BecauseIamBatman1,0,1,0,2,1608267600,1608267600,1
nani714,0,1,0,1,1609218000,1609218000,1
finlyboo,0,1,0,27,1598846400,1598846400,1
-Siptah,0,1,0,1,1607576400,1607576400,1
FartButtFace69420,0,1,0,1,1606539600,1606539600,1
Bojimakola,0,1,0,3,1604293200,1604293200,1
asimov23,0,1,0,1,1572148800,1572148800,1
jen2280,0,1,0,1,1572494400,1572494400,1
hero_to_g_row,0,1,0,2,1566187200,1566187200,1
kneighphaen,0,1,0,58,1596168000,1596168000,1
DynTuko,0,1,0,3,1559102400,1559102400,1
disasterpokemon,0,1,0,1,1608699600,1608699600,1
milkshake_assault,0,1,0,16,1602820800,1602820800,1
underscorewarrior,0,1,0,4,1588392000,1588392000,1
handheldmirror,0,1,0,2,1586491200,1586491200,1
AdmiralGoatx,0,1,0,1,1597204800,1597204800,1
Cerealusyy,0,1,0,-4,1594353600,1594353600,1
lt-chaos,0,1,0,9,1612069200,1612069200,1
AntisocialShay,0,1,0,9,1597896000,1597896000,1
TheConfusingWords,0,1,0,5,1570420800,1570420800,1
paltsosse,0,1,0,8,1589601600,1589601600,1
ceejthemoonman,0,1,0,1,1548219600,1548219600,1
residentfoconformity,0,1,0,6,1592280000,1592280000,1
Lucky_Lunatic,0,1,0,14,1595131200,1595131200,1
bishopsanspants,0,1,0,7,1600488000,1600488000,1
fortyonexx,0,1,0,15,1587614400,1587614400,1
Noxage_88,0,1,0,6,1606626000,1606626000,1
KillaVNilla,0,1,0,1,1608526800,1608526800,1
Sportyj,0,1,0,3,1599796800,1599796800,1
anxiousturtle92,0,1,0,9,1568952000,1568952000,1
StAugustine94,0,1,0,1,1573534800,1573534800,1
SasparillaTango,0,1,0,29,1606539600,1606539600,1
Roxerg,0,1,0,26,1590897600,1590897600,1
Samreen111,1,0,1,0,1603512000,1603512000,1
ImaBlessing,0,1,0,1,1570075200,1570075200,1
pennispancakes,0,1,0,9,1593662400,1593662400,1
Zezion,0,1,0,-7,1611982800,1611982800,1
carebearSeaman,0,1,0,-2,1597723200,1597723200,1
SmackChad,0,1,0,1,1589860800,1589860800,1
SrpskaZemlja,0,1,0,3,1606539600,1606539600,1
ThaKatWhisperer,0,1,0,1,1574658000,1574658000,1
Peonard,0,1,0,5,1595476800,1595476800,1
toworkistosuffer3,0,1,0,6,1572667200,1572667200,1
Frequent-Proof,0,1,0,3,1595217600,1595217600,1
qui-bong-trim,0,1,0,-1,1587528000,1587528000,1
HitTheBaby,0,1,0,8,1580187600,1580187600,1
CuttlefishQuincunx,0,1,0,3,1590206400,1590206400,1
VicodinPie,0,1,0,1,1586145600,1586145600,1
Mai-Waif,1,0,222,0,1605157200,1605157200,1
apexpredator988,0,1,0,1,1598500800,1598500800,1
iusethings1,0,1,0,0,1608699600,1608699600,1
duffcannon,0,1,0,1,1585454400,1585454400,1
RetardedGit,0,1,0,69,1607230800,1607230800,1
wanze,0,1,0,9,1555128000,1555128000,1
peralta30,0,1,0,2,1609477200,1609477200,1
JamesHalloday,0,1,0,6,1596513600,1596513600,1
NotObviousOblivious,0,1,0,-12,1557460800,1557460800,1
PotatoTales,0,1,0,5,1599019200,1599019200,1
Garobo,0,1,0,1,1585454400,1585454400,1
Germ_MANG,0,1,0,4,1573707600,1573707600,1
LA_NorthernLight,0,1,0,2,1605848400,1605848400,1
HotAirBallonPilot,0,1,0,1,1607922000,1607922000,1
leerkind,0,1,0,26,1577336400,1577336400,1
PMmeupsidedownnudes,0,1,0,10,1497412800,1497412800,1
Available-File9494,0,1,0,1,1634529600,1634529600,1
No-Scrubs-Allowed,0,1,0,32,1571371200,1571371200,1
Gamerred101,0,1,0,0,1579064400,1579064400,1
T-RobUncaged,0,1,0,2,1597204800,1597204800,1
jenniferfox98,0,1,0,11,1591243200,1591243200,1
jdox_,0,1,0,5,1508644800,1508644800,1
jjkase,0,1,0,3,1601611200,1601611200,1
Strong-Context-1701q,0,1,0,1,1611982800,1611982800,1
waxymagee,0,1,0,27,1608526800,1608526800,1
silky73,0,1,0,1,1606021200,1606021200,1
XxSpruce_MoosexX,0,1,0,-10,1589515200,1589515200,1
sonofaclit,1,0,9,0,1594180800,1594180800,1
rawbrol,1,0,7,0,1564891200,1564891200,1
HowSalty,0,1,0,1,1613797200,1613797200,1
KH9l3b_228,0,1,0,3,1606194000,1606194000,1
dadisrad91,0,1,0,2,1605589200,1605589200,1
AutomationFutureNews,1,0,4,0,1455426000,1455426000,1
TreadOnThemAlt,0,1,0,6,1572580800,1572580800,1
Playinhooky,0,1,0,3,1570939200,1570939200,1
nibba-licka,0,1,0,2,1600920000,1600920000,1
sparklegoatt,0,1,0,3,1609390800,1609390800,1
Condor-Avenue,0,1,0,80,1608786000,1608786000,1
riot_avenue,0,1,0,2,1585540800,1585540800,1
Valahiru,0,1,0,3,1599796800,1599796800,1
Dani-Gold,0,1,0,5,1597982400,1597982400,1
DerpyGrooves,1,0,4,0,1390107600,1390107600,1
jankadank,0,1,0,-7,1573016400,1573016400,1
Onekid10,0,1,0,2,1594094400,1594094400,1
Upbeat_Post_5303,0,1,0,1,1608267600,1608267600,1
HasUnibrowWillTravel,0,1,0,3,1600574400,1600574400,1
genericdeveloper,0,1,0,1,1480136400,1480136400,1
MessedUpMix,0,1,0,9,1600056000,1600056000,1
lastdarknight,0,1,0,1,1599364800,1599364800,1
TheRealSlimSauske,0,1,0,0,1596772800,1596772800,1
lordhaul99,0,1,0,1,1588392000,1588392000,1
nikagda,0,1,0,-5,1576731600,1576731600,1
bigdish101,0,1,0,14,1607749200,1607749200,1
wanderlvv,0,1,0,2,1607317200,1607317200,1
rollierockie,0,1,0,2,1595908800,1595908800,1
ZipBeep,0,1,0,1,1586232000,1586232000,1
sirwes07,0,1,0,2,1580014800,1580014800,1
Parvidnil,1,0,44,0,1606453200,1606453200,1
jamsly7,1,0,720,0,1606021200,1606021200,1
Disaster_Manager,0,1,0,2,1584763200,1584763200,1
mododo-bbaby,0,1,0,1,1621137600,1621137600,1
teaandbreadandjam,0,1,0,3,1590120000,1590120000,1
Fred42096,0,1,0,16,1609304400,1609304400,1
WookiePleasureNoises,1,0,1066,0,1597809600,1597809600,1
IPCRESSFILE,0,1,0,-2,1589774400,1589774400,1
Dustin_Black,0,1,0,1,1602820800,1602820800,1
Takenforganite,0,1,0,8,1580101200,1580101200,1
NegativeNancy1066,0,1,0,2,1574226000,1574226000,1
beahave,1,0,18,0,1582606800,1582606800,1
saulgoodemon,0,1,0,1,1584158400,1584158400,1
TheMusicJunkie2019,0,1,0,2,1579150800,1579150800,1
bogroller69,0,1,0,2,1598846400,1598846400,1
Satranic,0,1,0,1,1592452800,1592452800,1
ctoatb,0,1,0,14,1584936000,1584936000,1
chrishannah,0,1,0,1,1607576400,1607576400,1
Portfolio_sc,0,1,0,1,1607576400,1607576400,1
magic_spurtle,0,1,0,10,1608440400,1608440400,1
AggregateAnomaly,0,1,0,4,1603512000,1603512000,1
ruforeal_qstnmark,0,1,0,85,1558843200,1558843200,1
pizzahandhold,0,1,0,2,1606539600,1606539600,1
BossHawgKing,0,1,0,1,1598673600,1598673600,1
incenseandpatchouli,0,1,0,2,1606280400,1606280400,1
Silvedl,0,1,0,1,1604379600,1604379600,1
benzOzneb,0,1,0,4,1572667200,1572667200,1
nearlyradiant,0,1,0,24,1603684800,1603684800,1
TheSovietRaccon,0,1,0,-5,1607576400,1607576400,1
NeatFool,0,1,0,16,1607749200,1607749200,1
QuasisLogic,0,1,0,2,1584676800,1584676800,1
GamerLove1,0,1,0,11,1611982800,1611982800,1
Flynnit,0,1,0,45,1591502400,1591502400,1
Dodood4,0,1,0,7,1580533200,1580533200,1
MakeWise,0,1,0,4,1534737600,1534737600,1
beefandweed,0,1,0,145,1603512000,1603512000,1
ValueYourOwnTime,0,1,0,1,1594180800,1594180800,1
SetYourGoals1,0,1,0,1,1600833600,1600833600,1
yukumizu,0,1,0,9,1602734400,1602734400,1
AwayThreadfin,0,1,0,-1,1607490000,1607490000,1
okl_k_,0,1,0,3,1574312400,1574312400,1
rustichoneycake,0,1,0,26,1602820800,1602820800,1
one9eight5,0,1,0,13,1599710400,1599710400,1
niemand012,0,1,0,8,1599537600,1599537600,1
floraldaddy,0,1,0,3,1582693200,1582693200,1
IncipientFury,0,1,0,14,1609131600,1609131600,1
SupersawLead,0,1,0,2,1574917200,1574917200,1
Dicethrower,0,1,0,62,1589860800,1589860800,1
TheGreatZarquon,0,1,0,25,1605675600,1605675600,1
kingk6969,0,1,0,3,1603512000,1603512000,1
Darkshad3,0,1,0,4,1477454400,1477454400,1
dosoya4538,0,1,0,-5,1592107200,1592107200,1
StyrkeSkalVandre,0,1,0,83,1583557200,1583557200,1
Ahnonimizz,1,0,21,0,1571371200,1571371200,1
therobnzb,0,1,0,2,1603512000,1603512000,1
Cyrano_Nose,0,1,0,1,1593316800,1593316800,1
jeffwee559,0,1,0,1,1603512000,1603512000,1
Leukothea,0,1,0,12,1588305600,1588305600,1
misterPurpleKiller,0,1,0,1,1596945600,1596945600,1
CasinoBlackNMild,0,1,0,5,1609304400,1609304400,1
MakeHimWorshiplife,1,0,1,0,1602388800,1602388800,1
geebanga,0,1,0,1,1603425600,1603425600,1
WhoThatGuy,0,1,0,21,1605243600,1605243600,1
bondorf,0,1,0,1,1588219200,1588219200,1
InnuendOwO,0,1,0,12,1603080000,1603080000,1
GudJokeMate,0,1,0,1,1600660800,1600660800,1
MellyMel916,0,1,0,1,1606626000,1606626000,1
Morbx,0,1,0,52,1582088400,1582088400,1
FoofieLeGoogoo,0,1,0,1,1581483600,1581483600,1
Nuckinfutzcat,0,1,0,14,1573189200,1573189200,1
mycatsnameiscat,0,1,0,8,1598241600,1598241600,1
ScrantonStrangler007,0,1,0,-1,1606712400,1606712400,1
TheStayHomeDad,0,1,0,1,1589947200,1589947200,1
bigly_jombo,0,1,0,24,1600660800,1600660800,1
Kailithnir,0,1,0,2,1591934400,1591934400,1
Blikelogan,0,1,0,31,1565755200,1565755200,1
bluegiraffe18,1,0,3209,0,1572235200,1572235200,1
jochem_m,0,1,0,20,1598760000,1598760000,1
Propie,0,1,0,1,1574139600,1574139600,1
graps,0,1,0,4,1600660800,1600660800,1
UpstairsInitiative,0,1,0,2,1580792400,1580792400,1
Varg_utan_Flock,0,1,0,125,1597809600,1597809600,1
nah_hann,0,1,0,3,1596513600,1596513600,1
road2rhodes,1,0,6,0,1596427200,1596427200,1
curiousape23,0,1,0,2,1550379600,1550379600,1
Dabanese1,0,1,0,1,1606539600,1606539600,1
NorthernThoth,0,1,0,1,1603512000,1603512000,1
newrandomusereu,0,1,0,33,1604811600,1604811600,1
twotoes89,0,1,0,-5,1584763200,1584763200,1
jwcrousiw,0,1,0,2,1607922000,1607922000,1
DroogMuster,0,1,0,1,1604466000,1604466000,1
Solofehr,0,1,0,1,1595131200,1595131200,1
bloodbubblegum,0,1,0,3,1583125200,1583125200,1
lotionm,0,1,0,2,1600660800,1600660800,1
Different-Evening-62,0,1,0,-8,1596081600,1596081600,1
humancat0,0,1,0,6,1590552000,1590552000,1
comradeconrad707,0,1,0,1,1600660800,1600660800,1
gobblecoque12,1,0,372,0,1596945600,1596945600,1
steingrrrl,0,1,0,23,1590120000,1590120000,1
HIGHrolling98,0,1,0,2,1608613200,1608613200,1
-Canton,0,1,0,2,1603080000,1603080000,1
Peac0ck69,0,1,0,1,1599019200,1599019200,1
CrapoBrapHouse,0,1,0,0,1561348800,1561348800,1
watersjustfine,1,0,1,0,1508990400,1508990400,1
olpmnbbvc,0,1,0,-1,1606280400,1606280400,1
RandallJasper,0,1,0,2,1599796800,1599796800,1
splooofed,0,1,0,3,1606453200,1606453200,1
Ffej16,0,1,0,9,1593921600,1593921600,1
Crushedbythelargecow,0,1,0,1,1575349200,1575349200,1
austasaurus03,0,1,0,-5,1578027600,1578027600,1
MrFlubman,0,1,0,5,1602820800,1602820800,1
blueceri,0,1,0,1,1608699600,1608699600,1
Airlessarc,0,1,0,8,1573362000,1573362000,1
elleareby,0,1,0,7,1587096000,1587096000,1
justgetinthebin,0,1,0,2,1591243200,1591243200,1
Sex_w_ur_mom,0,1,0,9,1585108800,1585108800,1
NapkinsUnite,0,1,0,7,1580706000,1580706000,1
troyboltonislife,0,1,0,1,1605243600,1605243600,1
sixteenHandles,0,1,0,2,1603425600,1603425600,1
papaj241,0,1,0,1,1576818000,1576818000,1
messystoner,0,1,0,1,1479963600,1479963600,1
bbiggyz,0,1,0,2,1602820800,1602820800,1
PM-Me-Ur-Plants,0,1,0,3,1602820800,1602820800,1
BoringNameGoesHere,0,1,0,3,1589860800,1589860800,1
Sudsmcgee,0,1,0,2,1611982800,1611982800,1
SanchoRojo,0,1,0,3,1567828800,1567828800,1
chap820,1,0,84,0,1570420800,1570420800,1
Eruthor,0,1,0,1,1604466000,1604466000,1
211logos,0,1,0,2,1586232000,1586232000,1
Jon-Rave,0,1,0,2,1600833600,1600833600,1
Felistoria,0,1,0,-1,1581138000,1581138000,1
PeppeLePoint,0,1,0,9,1548738000,1548738000,1
MrRagewater,0,1,0,1,1589860800,1589860800,1
Snaxia,0,1,0,6,1594008000,1594008000,1
Sriracha_Pickle,1,0,20,0,1574139600,1574139600,1
moologist,1,0,145,0,1606280400,1606280400,1
straight_to_10_jfc,0,1,0,8,1585627200,1585627200,1
Argon717,0,1,0,22,1569211200,1569211200,1
RobertBorden,0,1,0,23,1574658000,1574658000,1
20thcenturyman,0,1,0,1,1591243200,1591243200,1
freakout_178,0,1,0,13,1562212800,1562212800,1
litacruz,0,1,0,30,1592193600,1592193600,1
No_Zoup,0,1,0,1,1580878800,1580878800,1
Kazuma126,0,1,0,2,1600315200,1600315200,1
i_sit_weird_ok,0,1,0,3,1553140800,1553140800,1
WhaTaMessUveMade,1,0,9,0,1596772800,1596772800,1
Pearl_the_5th,0,1,0,1,1567742400,1567742400,1
wwleaf,0,1,0,0,1587268800,1587268800,1
Flownyte,0,1,0,10,1602475200,1602475200,1
bordje,0,1,0,1,1595736000,1595736000,1
ieneco01,1,0,22,0,1588132800,1588132800,1
hondaddict,0,1,0,1,1591156800,1591156800,1
TenderfootGungi,0,1,0,1,1585454400,1585454400,1
FazonSabat,1,0,34,0,1572843600,1572843600,1
doasisaynotasyoudo,0,1,0,21,1607403600,1607403600,1
doebogan,0,1,0,1,1593662400,1593662400,1
Imposssiblename,0,1,0,13,1606453200,1606453200,1
Mwstriker98,0,1,0,4,1568347200,1568347200,1
Roty117,0,1,0,5,1589515200,1589515200,1
WannabeMoonKnight,0,1,0,16,1566878400,1566878400,1
gttm2019,0,1,0,1,1612069200,1612069200,1
ThatGaelicName,0,1,0,3,1603598400,1603598400,1
kittlesnboots,0,1,0,14,1584158400,1584158400,1
iLLDrDope,0,1,0,36,1601438400,1601438400,1
goldentamarindo,0,1,0,1,1605675600,1605675600,1
OneEyedEyehole,0,1,0,11,1605330000,1605330000,1
globalgreg,1,0,83,0,1604466000,1604466000,1
LeonTriskiii,0,1,0,15,1600142400,1600142400,1
TheRavenMan88,0,1,0,-7,1569124800,1569124800,1
chet_brosley,0,1,0,26,1576558800,1576558800,1
zacattack62,0,1,0,22,1591675200,1591675200,1
Busterx8,0,1,0,15,1600488000,1600488000,1
holdyourdevil,0,1,0,9,1599537600,1599537600,1
Davidala03,0,1,0,1,1600920000,1600920000,1
Lieke_,0,1,0,3,1600228800,1600228800,1
sea_dragon_,0,1,0,3,1600228800,1600228800,1
CantKmsOutOfGuilt,0,1,0,1,1548392400,1548392400,1
s0ft_,0,1,0,19,1567483200,1567483200,1
dannycake,0,1,0,15,1580360400,1580360400,1
onyx_z,0,1,0,4,1605762000,1605762000,1
djv1nc3,0,1,0,3,1570852800,1570852800,1
EthanFH,0,1,0,1,1600056000,1600056000,1
bluelektra979,0,1,0,2,1597118400,1597118400,1
HoppouChan,0,1,0,5,1607662800,1607662800,1
PirandelloKruger723,0,1,0,75,1608440400,1608440400,1
granola-square,1,0,190,0,1600747200,1600747200,1
Truman2,0,1,0,-35,1577336400,1577336400,1
stpfun,0,1,0,5,1588737600,1588737600,1
deathbunnyy,0,1,0,1,1608699600,1608699600,1
MagicHobbes,0,1,0,5,1572235200,1572235200,1
oingochungobungo,0,1,0,45,1584504000,1584504000,1
minkju,0,1,0,1,1607662800,1607662800,1
salamalander,0,1,0,0,1608181200,1608181200,1
DaDoobyDobby,0,1,0,14,1582952400,1582952400,1
TheNetherlandDwarf,0,1,0,88,1577336400,1577336400,1
ShivasIrons983E,0,1,0,3,1591329600,1591329600,1
WrathLover,0,1,0,2,1599364800,1599364800,1
retribute,0,1,0,2,1609131600,1609131600,1
bezzerwizzer,0,1,0,25,1605070800,1605070800,1
trxr_1,1,0,73,0,1557720000,1557720000,1
FaulerLeo,0,1,0,19,1604203200,1604203200,1
Bignou,0,1,0,1,1602820800,1602820800,1
Abnormal-Aboriginal,0,1,0,2,1596859200,1596859200,1
ClockworkEyelash,0,1,0,28,1569816000,1569816000,1
computerquip,0,1,0,2,1608699600,1608699600,1
TheMightyWizardKing,0,1,0,42,1590379200,1590379200,1
LightningCog,1,0,264,0,1609218000,1609218000,1
therussiancommander,0,1,0,1,1588651200,1588651200,1
burrnr,0,1,0,1,1581656400,1581656400,1
Godumn322,0,1,0,0,1545368400,1545368400,1
MagicalGhostMango,0,1,0,19,1597723200,1597723200,1
BeUnconventional,0,1,0,2,1605675600,1605675600,1
Magic-Heads-Sidekick,0,1,0,-1,1585454400,1585454400,1
Naedlus,0,1,0,6,1578891600,1578891600,1
TheAdefted,0,1,0,1,1597723200,1597723200,1
egoslaves,0,1,0,4,1574226000,1574226000,1
da_funcooker,0,1,0,3,1591243200,1591243200,1
Whatyatalkinabeee,0,1,0,-17,1592366400,1592366400,1
Highlander-Jay,0,1,0,20,1609390800,1609390800,1
TheMysticalBaconTree,0,1,0,1,1598846400,1598846400,1
blutfuer,0,1,0,1,1586059200,1586059200,1
defnotajedi,0,1,0,1,1606626000,1606626000,1
ucdebz,0,1,0,1,1606626000,1606626000,1
L1nkT0m3TV,0,1,0,0,1579755600,1579755600,1
Hope-External,0,1,0,1,1603166400,1603166400,1
FullVinceMode,0,1,0,1,1600488000,1600488000,1
BugNation,0,1,0,12,1600747200,1600747200,1
wintrycliffside,0,1,0,1,1606539600,1606539600,1
Spanglertastic,0,1,0,1,1605070800,1605070800,1
puli_paradise,0,1,0,8,1612155600,1612155600,1
Boopdelahoop,0,1,0,1,1602648000,1602648000,1
dachautblitz,0,1,0,1,1599192000,1599192000,1
Newyorker0023,0,1,0,1,1608699600,1608699600,1
BrennanannerB,0,1,0,92,1576558800,1576558800,1
Allen4083,0,1,0,2,1606539600,1606539600,1
MagnificentClock,0,1,0,-1,1577595600,1577595600,1
Thehungandonly,0,1,0,2,1582779600,1582779600,1
Nahuatl_19650,0,1,0,1,1603512000,1603512000,1
tree6363,0,1,0,1,1579669200,1579669200,1
Xewern,0,1,0,2,1589256000,1589256000,1
themaskedugly,0,1,0,8,1602820800,1602820800,1
Beoch1527,0,1,0,2,1584331200,1584331200,1
barjam,0,1,0,1,1602820800,1602820800,1
theasianzeus,0,1,0,4,1605157200,1605157200,1
Arimarie55,0,1,0,2,1562212800,1562212800,1
nonoqt,0,1,0,4,1608699600,1608699600,1
donthavearealaccount,0,1,0,1,1606539600,1606539600,1
kelldricked,0,1,0,2,1597723200,1597723200,1
Arturion,0,1,0,6,1592193600,1592193600,1
trickerthesquirrel,0,1,0,1,1608699600,1608699600,1
justnope_2,0,1,0,4,1552276800,1552276800,1
rizkirisk95,0,1,0,2,1548651600,1548651600,1
IstillBsk8N,0,1,0,16,1598500800,1598500800,1
iwasdoingtasks,0,1,0,4,1606539600,1606539600,1
personwriter,0,1,0,11,1595908800,1595908800,1
ullsn,1,0,47,0,1550725200,1550725200,1
zanthir,0,1,0,18,1582520400,1582520400,1
I-dont-trust-myself,0,1,0,19,1601352000,1601352000,1
sj_nayal83r,0,1,0,1,1607922000,1607922000,1
i-walkonthewildside,0,1,0,4,1573621200,1573621200,1
thejynxed,0,1,0,-2,1582952400,1582952400,1
Locke4815162342,0,1,0,5,1600056000,1600056000,1
GunmanClive,0,1,0,4,1586145600,1586145600,1
redhedd,0,1,0,35,1585108800,1585108800,1
simoncea,0,1,0,59,1583643600,1583643600,1
hometownrival,0,1,0,15,1605502800,1605502800,1
Ein_Death,1,0,73,0,1596081600,1596081600,1
cauldron_bubble,0,1,0,1,1584676800,1584676800,1
Unboxyourmail,0,1,0,7,1593316800,1593316800,1
medney,0,1,0,13,1570420800,1570420800,1
Egeates,0,1,0,6,1607922000,1607922000,1
linkshund,0,1,0,1,1604811600,1604811600,1
badassite,0,1,0,11,1605502800,1605502800,1
safeconsequence,0,1,0,8,1602129600,1602129600,1
riskywhiskey077,0,1,0,1,1604984400,1604984400,1
Cantfrickingthink,1,0,14,0,1611982800,1611982800,1
UrbanMilk,0,1,0,9,1587355200,1587355200,1
LYZ3RDK33NG,0,1,0,3,1584244800,1584244800,1
bituinSpace707,0,1,0,1,1612155600,1612155600,1
Thewhitelight___,0,1,0,0,1621742400,1621742400,1
Feeling_Insect,0,1,0,1,1603339200,1603339200,1
SilkyJohnson666,0,1,0,-7,1577336400,1577336400,1
broganjones,0,1,0,1,1596772800,1596772800,1
KidRed,0,1,0,4,1604116800,1604116800,1
lalinoir,0,1,0,63,1604898000,1604898000,1
pissdrinker32,0,1,0,3,1604898000,1604898000,1
lukemartin2015,0,1,0,3,1599796800,1599796800,1
Therealdoctor,0,1,0,-1,1606626000,1606626000,1
CarryNoWeight,0,1,0,3,1608872400,1608872400,1
space_dogmobile,0,1,0,2,1582174800,1582174800,1
achilleantrash,0,1,0,7,1607662800,1607662800,1
amorecolorfulworld,0,1,0,2,1585540800,1585540800,1
Major_Ziggy,0,1,0,21,1605675600,1605675600,1
radrunner1,0,1,0,2,1607490000,1607490000,1
danonbrez,0,1,0,1,1570075200,1570075200,1
ExperimentNo7,0,1,0,13,1593748800,1593748800,1
jgoden,0,1,0,3,1595649600,1595649600,1
BlondFaith,0,1,0,1,1591243200,1591243200,1
SaigaExpress,0,1,0,2,1600833600,1600833600,1
BuckminsterDomes,0,1,0,3,1597032000,1597032000,1
ArseGranola,0,1,0,1,1605589200,1605589200,1
SnoutAndTalons,0,1,0,1,1565150400,1565150400,1
szthesquid,0,1,0,1,1591243200,1591243200,1
Neferpatra,0,1,0,1,1606626000,1606626000,1
BillMagicguy,0,1,0,-8,1599019200,1599019200,1
asphere8,0,1,0,1,1572667200,1572667200,1
iwearwetsocks,0,1,0,-7,1603512000,1603512000,1
ShiddyWidow,0,1,0,2,1608267600,1608267600,1
MilkOnAStick,1,0,0,0,1607317200,1607317200,1
HickyBill,0,1,0,-2,1612155600,1612155600,1
LaughingSerpent,0,1,0,5,1595908800,1595908800,1
NoAd1762,0,1,0,2,1606280400,1606280400,1
naughty_zoot_,0,1,0,17,1605589200,1605589200,1
DryCatShit,0,1,0,5,1596600000,1596600000,1
LaughingRochelle,0,1,0,9,1575608400,1575608400,1
Barthep,0,1,0,15,1567396800,1567396800,1
erikjohoba,0,1,0,3,1609304400,1609304400,1
the_internal_the,0,1,0,11,1609045200,1609045200,1
mainaccount35,0,1,0,3,1611982800,1611982800,1
Doosmo,0,1,0,1,1598414400,1598414400,1
OrgasmicBiscuit,0,1,0,3,1601870400,1601870400,1
tinyricksanchezC137,0,1,0,20,1561953600,1561953600,1
frolf_grisbee,0,1,0,2,1606021200,1606021200,1
vdvxvbv,0,1,0,2,1574398800,1574398800,1
soulsurviv0r,0,1,0,-7,1571112000,1571112000,1
winazoid,0,1,0,7,1596081600,1596081600,1
undecidedquestion,0,1,0,40,1584244800,1584244800,1
nohaircantbair,0,1,0,6,1593489600,1593489600,1
rusticjuice,0,1,0,1,1574053200,1574053200,1
Kim_Jong_Dong,0,1,0,20,1546923600,1546923600,1
420gitgudorDIE,0,1,0,4,1579323600,1579323600,1
weJTyhKckvNd,0,1,0,-12,1606539600,1606539600,1
Nixin72,0,1,0,10,1595390400,1595390400,1
Important-Emergency8,0,1,0,5,1608181200,1608181200,1
NatakuNox,0,1,0,1,1607835600,1607835600,1
donnydelicious,0,1,0,12,1604811600,1604811600,1
Dresden89,0,1,0,11,1576472400,1576472400,1
JCD_1999,0,1,0,1,1569124800,1569124800,1
sexycolonelsanders,0,1,0,18,1598760000,1598760000,1
Power-Orc,0,1,0,2,1575608400,1575608400,1
jimihendrixflyingv,0,1,0,102,1606712400,1606712400,1
Commander-Grammar,0,1,0,6,1578373200,1578373200,1
ThePutinator69,1,0,25,0,1609218000,1609218000,1
kyleronsmom,0,1,0,3,1580706000,1580706000,1
Cummunism69,1,0,0,0,1582261200,1582261200,1
butlerlee,0,1,0,1,1579669200,1579669200,1
Cyphecx,0,1,0,-1,1604116800,1604116800,1
TimMakesThings,0,1,0,2,1585454400,1585454400,1
OmenBlooded,0,1,0,1,1600056000,1600056000,1
RandomUser-_--__-,0,1,0,5,1591329600,1591329600,1
Tybis,0,1,0,6,1603512000,1603512000,1
CubbyNINJA,0,1,0,0,1578286800,1578286800,1
turbocrat,0,1,0,4,1574485200,1574485200,1
ToneWanderer,0,1,0,3,1598932800,1598932800,1
beheldcrawdad,0,1,0,3,1598673600,1598673600,1
Fitzy564,0,1,0,1,1607403600,1607403600,1
bhjgj,0,1,0,2,1608008400,1608008400,1
vekeso,0,1,0,3,1570075200,1570075200,1
monkey_cosmonaut,0,1,0,3,1600488000,1600488000,1
why_rob_y,0,1,0,0,1592107200,1592107200,1
tuberosum,0,1,0,5,1602820800,1602820800,1
McKeon1921,0,1,0,5,1608526800,1608526800,1
dre_bot,0,1,0,14,1574139600,1574139600,1
Corsiush_D,0,1,0,16,1564718400,1564718400,1
ShivanMarauder,0,1,0,5,1603512000,1603512000,1
CentralAdmin,0,1,0,7,1597982400,1597982400,1
payphonepirate,0,1,0,2,1573534800,1573534800,1
MonsterMarge,0,1,0,2,1597982400,1597982400,1
AbbreviationsCool891,0,1,0,5,1605762000,1605762000,1
Ivangood2,0,1,0,25,1606712400,1606712400,1
KanhyeEast,0,1,0,1,1600056000,1600056000,1
DillBagner,0,1,0,-1,1597032000,1597032000,1
theironfist29,0,1,0,8,1605070800,1605070800,1
joshieecs,0,1,0,80,1554868800,1554868800,1
nandiem,0,1,0,9,1583470800,1583470800,1
PoopMasterSwag,0,1,0,1,1599624000,1599624000,1
mfagan,0,1,0,6,1608094800,1608094800,1
Hot-Pretzel,0,1,0,5,1589515200,1589515200,1
raykele1,0,1,0,4,1575608400,1575608400,1
davepol,0,1,0,20,1567569600,1567569600,1
Vancouver_Pride,0,1,0,5,1580446800,1580446800,1
StarksFTW,0,1,0,15,1603512000,1603512000,1
DeadThreadLurker,0,1,0,8,1521691200,1521691200,1
SolarMoth,0,1,0,2,1603512000,1603512000,1
BloodyViper,0,1,0,1,1601006400,1601006400,1
Tulip_Blossom,0,1,0,2,1571630400,1571630400,1
BMOstolemywife,0,1,0,5,1603512000,1603512000,1
LordBlackDragon,1,0,7,0,1599364800,1599364800,1
honeywhiskygirl,0,1,0,15,1608440400,1608440400,1
c13e7e55,0,1,0,15,1563163200,1563163200,1
stickysamosa,0,1,0,7,1594958400,1594958400,1
genericMaker,0,1,0,2,1609563600,1609563600,1
louis7972,0,1,0,10,1577422800,1577422800,1
ritamorgan,0,1,0,10,1565323200,1565323200,1
Mansu_4_u,0,1,0,17,1585022400,1585022400,1
garmur99,0,1,0,5,1571371200,1571371200,1
LaunchPad_DC,0,1,0,1,1605589200,1605589200,1
hiddencrustysock,0,1,0,1,1565841600,1565841600,1
EshCo,0,1,0,33,1567569600,1567569600,1
DeltaWhiskey141,0,1,0,1,1608526800,1608526800,1
ExcaliburClarent,0,1,0,23,1592625600,1592625600,1
ThaneduFife,0,1,0,7,1551416400,1551416400,1
prestonbrownlow,0,1,0,-6,1607576400,1607576400,1
redgears,0,1,0,3,1593576000,1593576000,1
Cthulhu_Caller,0,1,0,54,1584504000,1584504000,1
Crazychemist_2,0,1,0,5,1555387200,1555387200,1
i-like-tortoises,1,0,1,0,1601179200,1601179200,1
TheGruesomeTwosome,0,1,0,7,1607230800,1607230800,1
soufatlantasanta,0,1,0,1,1607835600,1607835600,1
apachebearpizzachief,0,1,0,0,1577336400,1577336400,1
nombernine,0,1,0,4,1559707200,1559707200,1
middleagegay,0,1,0,6,1598846400,1598846400,1
LeeroyJenkinssssss,0,1,0,3,1582779600,1582779600,1
FlyEaglesFly1996,0,1,0,-27,1593403200,1593403200,1
InjectingMyNuts,0,1,0,20,1604116800,1604116800,1
momosinthedojo,0,1,0,3,1432180800,1432180800,1
ozythemandias,0,1,0,1,1604030400,1604030400,1
-Thomas_Jefferson-,0,1,0,33,1550206800,1550206800,1
-_-Edit_Deleted-_-,0,1,0,2,1591329600,1591329600,1
Felixo22,0,1,0,1,1596859200,1596859200,1
Sprengladung,0,1,0,-5,1554955200,1554955200,1
GoldcoinforRosey,0,1,0,0,1608613200,1608613200,1
AssaultLemming,0,1,0,6,1583211600,1583211600,1
a-winter,0,1,0,12,1581397200,1581397200,1
Labour-Abolitionist,1,0,35,0,1561953600,1561953600,1
hike_4_fun,0,1,0,11,1603512000,1603512000,1
patjd,0,1,0,3,1594958400,1594958400,1
limitz,0,1,0,5,1574053200,1574053200,1
GenericWomanFigure,0,1,0,2,1588996800,1588996800,1
BernieGotLessVotes,0,1,0,-14,1573016400,1573016400,1
anatoliy0813,0,1,0,3,1606626000,1606626000,1
satanic-surfer,0,1,0,16,1602302400,1602302400,1
TinnyOctopus,0,1,0,5,1569988800,1569988800,1
NAQURATOR,0,1,0,5,1592798400,1592798400,1
marz791,0,1,0,1,1603512000,1603512000,1
mold713,0,1,0,2,1597118400,1597118400,1
ryckae,0,1,0,2,1570939200,1570939200,1
panadera_,0,1,0,6,1602043200,1602043200,1
WallflowerOnTheBrink,0,1,0,4,1582779600,1582779600,1
anotherlibertarian,0,1,0,-2,1580101200,1580101200,1
ImmaterialPossession,0,1,0,16,1569124800,1569124800,1
HoneyMustardFan,0,1,0,6,1560312000,1560312000,1
pedritoml,0,1,0,2,1591243200,1591243200,1
divineqc,0,1,0,1,1607317200,1607317200,1
jmf337,0,1,0,1,1603425600,1603425600,1
annieoakley11,0,1,0,2,1599537600,1599537600,1
emtheory09,0,1,0,4,1603512000,1603512000,1
uncle2018sam2,0,1,0,2,1599883200,1599883200,1
vanessamdo,0,1,0,5,1567569600,1567569600,1
totallynotliamneeson,0,1,0,64,1606539600,1606539600,1
Connorfahn,0,1,0,13,1598932800,1598932800,1
ijustwanttobemyse1f,0,1,0,1,1599710400,1599710400,1
JimmyWu21,0,1,0,9,1589947200,1589947200,1
HappyAngron,0,1,0,0,1601352000,1601352000,1
RagnarStonefist,0,1,0,3,1582779600,1582779600,1
Muesky6969,0,1,0,8,1589342400,1589342400,1
UnluckyBaseball2,0,1,0,-18,1577682000,1577682000,1
gregfromjersey,0,1,0,-1,1604030400,1604030400,1
MuscleManRyan,0,1,0,4,1585713600,1585713600,1
Vasectomio,1,0,191,0,1607576400,1607576400,1
keppp,0,1,0,12,1607403600,1607403600,1
whataboutface,0,1,0,3,1599364800,1599364800,1
LACOOLGUY,0,1,0,20,1561435200,1561435200,1
Afinkawan,0,1,0,1,1636434000,1636434000,1
NikothePom,0,1,0,83,1607403600,1607403600,1
JasmineNikoleB,0,1,0,2,1600228800,1600228800,1
Scoobies_Doobies,0,1,0,4,1604552400,1604552400,1
wanderinginsom,1,0,1,0,1607662800,1607662800,1
thebongman,0,1,0,1,1576731600,1576731600,1
NikiNaks,0,1,0,4,1553140800,1553140800,1
SkyAdministrative970,0,1,0,3,1635307200,1635307200,1
UpvoteDownvoteHelper,0,1,0,-2,1573448400,1573448400,1
Trgnv3,0,1,0,2,1603512000,1603512000,1
SAT2Amazonguy,0,1,0,3,1603425600,1603425600,1
Oblodo,0,1,0,1,1608267600,1608267600,1
anoiing,0,1,0,-3,1584590400,1584590400,1
Sure-Ad7730,0,1,0,1,1598846400,1598846400,1
-crema-,0,1,0,1,1573880400,1573880400,1
Kabada,0,1,0,3,1599710400,1599710400,1
intplusone_Carl,0,1,0,3,1555905600,1555905600,1
TheophrastusBombast,0,1,0,11,1597636800,1597636800,1
InvadingBacon,0,1,0,24,1603512000,1603512000,1
Absol1234,0,1,0,3,1548738000,1548738000,1
HelsKitchin,0,1,0,43,1562644800,1562644800,1
PanicAK,0,1,0,3,1585454400,1585454400,1
tj2271,0,1,0,10,1582174800,1582174800,1
Arseraper,0,1,0,12,1598068800,1598068800,1
isntherD_,0,1,0,47,1587960000,1587960000,1
gentlephish01,0,1,0,7,1585886400,1585886400,1
CommanderAGL,0,1,0,4,1591243200,1591243200,1
sassysenpai69,0,1,0,3,1557979200,1557979200,1
tigerandlamb,0,1,0,14,1578373200,1578373200,1
Moofooist765,0,1,0,1,1582779600,1582779600,1
danschneider13,0,1,0,1,1587441600,1587441600,1
CrazyKiller5150,0,1,0,5,1540872000,1540872000,1
Mike_Hunty,0,1,0,6,1603512000,1603512000,1
HocusPocusYo,0,1,0,204,1604725200,1604725200,1
ShamefulWatching,0,1,0,58,1553486400,1553486400,1
naughtius,0,1,0,-6,1584763200,1584763200,1
vespanewbie,0,1,0,1,1612069200,1612069200,1
honeyapple55,1,0,5,0,1605502800,1605502800,1
Jamortt,0,1,0,25,1585454400,1585454400,1
PetreckStere,0,1,0,5,1608181200,1608181200,1
Scrombus,0,1,0,5,1572321600,1572321600,1
cosmatic79,0,1,0,1,1593403200,1593403200,1
Waffles_and_Waffles,0,1,0,1,1608267600,1608267600,1
skeleton334,0,1,0,1,1608354000,1608354000,1
jhunter68,0,1,0,3,1544331600,1544331600,1
Bl00dRa1n,0,1,0,1,1606539600,1606539600,1
haHUha88888a,0,1,0,0,1591329600,1591329600,1
robmelo,0,1,0,55,1605070800,1605070800,1
Fecklessnz,0,1,0,3,1574658000,1574658000,1
Vorosh,0,1,0,2,1599624000,1599624000,1
Busman123,0,1,0,10,1609045200,1609045200,1
tirmintr,0,1,0,0,1556596800,1556596800,1
buccarue,0,1,0,5,1605934800,1605934800,1
Coughodemon,0,1,0,1,1608267600,1608267600,1
valentinegirl81,0,1,0,7,1580360400,1580360400,1
Noahendless,0,1,0,1,1574312400,1574312400,1
obsessedroach,0,1,0,5,1583125200,1583125200,1
meatball402,0,1,0,2,1599019200,1599019200,1
JaceMasood,0,1,0,9,1585195200,1585195200,1
NewTubeReview,0,1,0,-118,1572321600,1572321600,1
garrettstrootlol,1,0,775,0,1607144400,1607144400,1
celestial1,0,1,0,9,1550293200,1550293200,1
erasedgod,0,1,0,16,1575349200,1575349200,1
MeatyBuns,0,1,0,1,1572235200,1572235200,1
JethroMcClintock,0,1,0,4,1606539600,1606539600,1
SadOstrich5244,0,1,0,2,1602820800,1602820800,1
Nu7s,0,1,0,3,1608267600,1608267600,1
SeamusMichael,0,1,0,1,1585454400,1585454400,1
phillytimd,0,1,0,1,1582779600,1582779600,1
kalx21,0,1,0,7,1607230800,1607230800,1
freeshavocadew,0,1,0,2,1605157200,1605157200,1
RudyOliveira,0,1,0,5,1582693200,1582693200,1
DebiMoonfae,0,1,0,4,1603512000,1603512000,1
unnamed61,0,1,0,1,1598760000,1598760000,1
JadedAlready,0,1,0,12,1598068800,1598068800,1
fried0kree,0,1,0,7,1607922000,1607922000,1
OG_PapaSid,0,1,0,1,1603512000,1603512000,1
beatprodLive,1,0,1,0,1601006400,1601006400,1
Neckbeard_Prime,0,1,0,1,1596859200,1596859200,1
cryptohobo,0,1,0,8,1592193600,1592193600,1
TyChris2,0,1,0,15,1593748800,1593748800,1
Arcas0,0,1,0,9,1595390400,1595390400,1
Aboth27,0,1,0,-1,1572843600,1572843600,1
CruckCruck,0,1,0,3,1564545600,1564545600,1
zwemmen,0,1,0,16,1581397200,1581397200,1
zentrist369,0,1,0,5,1608181200,1608181200,1
Pecansrme,0,1,0,16,1541044800,1541044800,1
tcgarraty,0,1,0,2,1605675600,1605675600,1
retrop125,0,1,0,1,1605589200,1605589200,1
ngqhoangtrung,0,1,0,2,1606885200,1606885200,1
s1lentrob83266,0,1,0,2,1585454400,1585454400,1
socrateaseee,0,1,0,1,1579150800,1579150800,1
YooBitches,0,1,0,3,1612155600,1612155600,1
bazib,0,1,0,7,1601697600,1601697600,1
ConnivingCucumber,0,1,0,19,1588651200,1588651200,1
RainbowEffingDash,0,1,0,1,1539921600,1539921600,1
Dr-Kolplex,0,1,0,15,1569988800,1569988800,1
clueless_typographer,0,1,0,3,1579150800,1579150800,1
FatBaldBeardedGuy,0,1,0,68,1584590400,1584590400,1
bernitek,0,1,0,23,1569902400,1569902400,1
BirthdaySong,0,1,0,1,1571630400,1571630400,1
kgocunt,1,0,16,0,1599192000,1599192000,1
KimKazin,0,1,0,3,1586750400,1586750400,1
Ineedmorebread,0,1,0,1,1582261200,1582261200,1
barkymalarkey,0,1,0,5,1590379200,1590379200,1
moobearsayneigh,0,1,0,5,1603598400,1603598400,1
PCMDave,0,1,0,5,1606453200,1606453200,1
grignardsreagent,0,1,0,13,1595217600,1595217600,1
Mnemonic22,0,1,0,1,1606021200,1606021200,1
bunnyandtheholograms,0,1,0,2,1604898000,1604898000,1
DarZhubal,0,1,0,2,1602820800,1602820800,1
alchademy,1,0,27,0,1566100800,1566100800,1
1_Metric_Hitler,0,1,0,25,1588478400,1588478400,1
KiroLegend27,0,1,0,1,1583211600,1583211600,1
XmossflowerX,0,1,0,1,1591243200,1591243200,1
TheCozyStretch,0,1,0,8,1607230800,1607230800,1
keell,0,1,0,2,1573707600,1573707600,1
jordensjunger,0,1,0,1,1570248000,1570248000,1
mmecca,0,1,0,2,1548651600,1548651600,1
alpineeeeee,0,1,0,19,1572494400,1572494400,1
Jubachi99,0,1,0,1,1603512000,1603512000,1
1Defective,0,1,0,3,1596254400,1596254400,1
ykzdropdead,0,1,0,3,1556683200,1556683200,1
gofigure85,0,1,0,1,1607403600,1607403600,1
Iuviuv,0,1,0,-7,1580360400,1580360400,1
pinkfootthegoose,0,1,0,2,1605157200,1605157200,1
CynicalAbe,0,1,0,2,1607576400,1607576400,1
Kkronolov,0,1,0,-1,1577854800,1577854800,1
EricFromOuterSpace,1,0,19,0,1586145600,1586145600,1
goldieLL,1,0,14,0,1449205200,1449205200,1
Rincewind-the-wizard,0,1,0,14,1571025600,1571025600,1
JiggaDo,0,1,0,-23,1587096000,1587096000,1
ReadSomeTheory,0,1,0,186,1608699600,1608699600,1
EducationalResult8,0,1,0,1,1594526400,1594526400,1
Trogladyte123,0,1,0,2,1608526800,1608526800,1
supermark64,0,1,0,0,1589342400,1589342400,1
bp_kcc,0,1,0,1,1608872400,1608872400,1
carolfuckinbaskin,0,1,0,7,1598155200,1598155200,1
charlesdieter,0,1,0,1,1603512000,1603512000,1
xraytedfilms,0,1,0,3,1580274000,1580274000,1
gruelfakerr,0,1,0,1,1574917200,1574917200,1
Past_Economist6278,0,1,0,1,1605589200,1605589200,1
izzystn,0,1,0,-1,1606626000,1606626000,1
thalexander,0,1,0,20,1568520000,1568520000,1
Big-Mozz,0,1,0,15,1599105600,1599105600,1
nextgentacos123,0,1,0,2,1556683200,1556683200,1
Arebee936,0,1,0,26,1590120000,1590120000,1
MJ167,0,1,0,33,1590897600,1590897600,1
Vapecat420,0,1,0,-11,1607317200,1607317200,1
SlaveLaborMods,0,1,0,2,1589860800,1589860800,1
omfgbecky,0,1,0,19,1606971600,1606971600,1
Grenciae,0,1,0,1,1609045200,1609045200,1
PrettyFlame,0,1,0,5,1603512000,1603512000,1
beefyshortfatdick,0,1,0,1,1578286800,1578286800,1
GenericUsername030,0,1,0,1,1605589200,1605589200,1
IrraticalOne,0,1,0,5,1571371200,1571371200,1
hoppy1972,0,1,0,4,1608699600,1608699600,1
Ambitious-Junket-954,0,1,0,7,1608786000,1608786000,1
JustaHappyWanderer,0,1,0,1,1602734400,1602734400,1
maygoosetah,0,1,0,1,1597896000,1597896000,1
thewizardofazz,0,1,0,7,1590206400,1590206400,1
Journei05,0,1,0,2,1591156800,1591156800,1
endoire,0,1,0,2,1603512000,1603512000,1
ItsMrQ,0,1,0,1,1605934800,1605934800,1
Frequent-Context-183,0,1,0,1,1634961600,1634961600,1
vilced,1,0,1937,0,1601611200,1601611200,1
parkinsonblack,0,1,0,1,1605589200,1605589200,1
NutellaSquirrel,0,1,0,16,1594353600,1594353600,1
NahautlExile,0,1,0,1,1605157200,1605157200,1
Superman_47,0,1,0,2,1603598400,1603598400,1
Altruistic_Housing,0,1,0,2,1595563200,1595563200,1
join__ruqqus,0,1,0,1,1612069200,1612069200,1
United-Left,0,1,0,1,1606626000,1606626000,1
BenCelotil,0,1,0,0,1600660800,1600660800,1
the_very_sad_giraffe,0,1,0,1,1599451200,1599451200,1
Lightning-Dust,0,1,0,1,1606885200,1606885200,1
theun-chosen,0,1,0,-1,1586404800,1586404800,1
pretty-fucking-dumb,0,1,0,1,1608440400,1608440400,1
tmdblya,0,1,0,88,1588392000,1588392000,1
Beneficial_Sock_9668,0,1,0,-55,1607576400,1607576400,1
Sir_Puffles,0,1,0,4,1584244800,1584244800,1
ZebraTheWPrincess,0,1,0,2,1611896400,1611896400,1
Upstart55,0,1,0,3,1578286800,1578286800,1
Shambala36,0,1,0,3,1600228800,1600228800,1
Stanstudly,0,1,0,1,1600056000,1600056000,1
frozenbrorito,0,1,0,8,1582693200,1582693200,1
Evanje53,0,1,0,1,1589947200,1589947200,1
newluna,0,1,0,1,1606366800,1606366800,1
analdelrey-,0,1,0,1,1605416400,1605416400,1
FewFinger0,0,1,0,1,1590033600,1590033600,1
Slowlyblowme,0,1,0,20,1604984400,1604984400,1
Hugehogbeast1,0,1,0,1,1573102800,1573102800,1
BrokenBaron,0,1,0,17,1582088400,1582088400,1
Naesme,0,1,0,1,1611982800,1611982800,1
PM_YOUR__SMALL_BOOBS,0,1,0,1,1594785600,1594785600,1
pimento_patriot,0,1,0,2,1578891600,1578891600,1
PigsWalkUpright,0,1,0,-1,1589860800,1589860800,1
billjames1685,0,1,0,4,1607144400,1607144400,1
Hammer_police,0,1,0,3,1599105600,1599105600,1
Bulky-Stranger,0,1,0,2,1599019200,1599019200,1
withoutherspirit,0,1,0,1,1592193600,1592193600,1
ilovemypug96,0,1,0,71,1606539600,1606539600,1
ddc6644,0,1,0,14,1555819200,1555819200,1
firstdeuce,0,1,0,2,1606107600,1606107600,1
kiddrekt,0,1,0,-1,1609477200,1609477200,1
toodog,0,1,0,1,1577422800,1577422800,1
Aushwango,0,1,0,10,1593489600,1593489600,1
StillMixin,0,1,0,1,1569211200,1569211200,1
vveiner,0,1,0,7,1588910400,1588910400,1
Jugz123,0,1,0,2,1590292800,1590292800,1
hipsteradonis,0,1,0,2,1595217600,1595217600,1
greenpicklewater,1,0,90,0,1611982800,1611982800,1
KareemGreen,0,1,0,1,1557547200,1557547200,1
Breakmyback4U,1,0,16,0,1605675600,1605675600,1
GoodGuyBadMan1914,0,1,0,-1,1604379600,1604379600,1
Arjuno_,0,1,0,5,1575262800,1575262800,1
sodangbutthurt,0,1,0,1,1591329600,1591329600,1
Alabama_Whorley,0,1,0,57,1606021200,1606021200,1
Technologhee,0,1,0,1,1609131600,1609131600,1
ScarletCarsonRose,0,1,0,57,1589860800,1589860800,1
Shukrat,0,1,0,14,1573362000,1573362000,1
Frnklfrwsr,0,1,0,1,1605070800,1605070800,1
iluvgrits420,0,1,0,6,1600660800,1600660800,1
madsyth,1,0,108,0,1582866000,1582866000,1
specterofsandersism,0,1,0,7,1514696400,1514696400,1
SamanthaLoridelon,0,1,0,7,1573102800,1573102800,1
OIlberger,0,1,0,2,1542344400,1542344400,1
redm00n99,0,1,0,0,1575694800,1575694800,1
redtempledown2020,0,1,0,-2,1607490000,1607490000,1
whateveridckillme,1,0,12,0,1566705600,1566705600,1
scalyblue,0,1,0,-1,1581224400,1581224400,1
realdealreel9,0,1,0,2,1603080000,1603080000,1
gooch_norris,0,1,0,5,1606280400,1606280400,1
matthebastage,0,1,0,2,1609218000,1609218000,1
Barkonian,0,1,0,0,1589688000,1589688000,1
sm0lbear,0,1,0,3,1609131600,1609131600,1
DMBeer,0,1,0,7,1608440400,1608440400,1
HammerAndTHICCLE,0,1,0,4,1579582800,1579582800,1
Akitabuddy,0,1,0,1,1602993600,1602993600,1
gummycarnival,0,1,0,26,1568692800,1568692800,1
Thuglife07,0,1,0,1,1611982800,1611982800,1
societybot,0,1,0,1,1539921600,1539921600,1
cranberry--,0,1,0,15,1572930000,1572930000,1
lahema,0,1,0,5,1611810000,1611810000,1
Faque_The_Power,0,1,0,1,1597550400,1597550400,1
CompetitiveRick,0,1,0,2,1581138000,1581138000,1
SXLightning,0,1,0,6,1599019200,1599019200,1
Chef_Seth,0,1,0,1,1595908800,1595908800,1
loureedfromthegrave,0,1,0,10,1608181200,1608181200,1
therhinojenson,0,1,0,6,1603252800,1603252800,1
4n0n0m7s,0,1,0,8,1577422800,1577422800,1
Kurichii,0,1,0,78,1594785600,1594785600,1
DrothReloaded,0,1,0,1,1572321600,1572321600,1
d0gO5,0,1,0,1,1606626000,1606626000,1
AdorableHorror,0,1,0,2,1554696000,1554696000,1
Kale8888,0,1,0,3,1603598400,1603598400,1
The_Sad_Penguin,0,1,0,8,1567656000,1567656000,1
Tuscumbia,0,1,0,-52,1574917200,1574917200,1
LeftHandYoga,0,1,0,1,1585972800,1585972800,1
sospeso,0,1,0,1,1606626000,1606626000,1
niftyshellsuit,0,1,0,27,1602475200,1602475200,1
HelmetTesterTJ,0,1,0,23,1605589200,1605589200,1
dude_wheres_my_fries,0,1,0,9,1592452800,1592452800,1
KindCow,0,1,0,2,1607317200,1607317200,1
robstrr320,0,1,0,-4,1606626000,1606626000,1
erephaon,0,1,0,6,1578632400,1578632400,1
TheWordsILiveBy,0,1,0,2,1605589200,1605589200,1
sprinkled_toast,0,1,0,1,1608613200,1608613200,1
RVA2DC,0,1,0,1,1585454400,1585454400,1
marc-home,0,1,0,4,1588478400,1588478400,1
Underrepair,0,1,0,2,1538625600,1538625600,1
MightDiscombobulated,0,1,0,1,1609390800,1609390800,1
ibraheemovich7,0,1,0,1,1601870400,1601870400,1
TehJimmyy,0,1,0,2,1636779600,1636779600,1
flawy12,0,1,0,0,1594353600,1594353600,1
SonnyHaze,0,1,0,1,1604030400,1604030400,1
mmaisfixed,0,1,0,1,1604466000,1604466000,1
shitsandfarts,0,1,0,9,1609304400,1609304400,1
itbeingsummer,0,1,0,29,1561435200,1561435200,1
jameygates,0,1,0,2,1567656000,1567656000,1
JALLways,0,1,0,23,1561694400,1561694400,1
thebluegoo,0,1,0,68,1545368400,1545368400,1
Throwthisaway512,0,1,0,40,1595390400,1595390400,1
two_eyed_man,0,1,0,1,1588392000,1588392000,1
HankFish,0,1,0,-26,1603252800,1603252800,1
RainaElf,0,1,0,43,1600660800,1600660800,1
paper_lover,0,1,0,3,1602302400,1602302400,1
tweakfreaksqueak,0,1,0,1,1598932800,1598932800,1
1vam,0,1,0,13,1606712400,1606712400,1
-I-D-G-A-F-,0,1,0,19,1580878800,1580878800,1
reeeeeee1818,0,1,0,-1,1598760000,1598760000,1
yahwell,0,1,0,2,1606021200,1606021200,1
AsianMoocowFromSpace,0,1,0,10,1608872400,1608872400,1
wellofworlds,0,1,0,1,1608267600,1608267600,1
IcarusReams,0,1,0,-11,1549688400,1549688400,1
trikillr42,0,1,0,19,1591243200,1591243200,1
poopootheshoe,0,1,0,1,1600660800,1600660800,1
mavajo,0,1,0,13,1611896400,1611896400,1
Whizbang2300,0,1,0,5,1588046400,1588046400,1
2cookieparties,0,1,0,10,1584590400,1584590400,1
pedr0a1,0,1,0,1,1607662800,1607662800,1
randomuserweewoo,0,1,0,12,1599624000,1599624000,1
DralliagNairod,0,1,0,1,1609304400,1609304400,1
Hotkow,0,1,0,11,1598500800,1598500800,1
yelsuo,0,1,0,1,1573966800,1573966800,1
deeweekelia,0,1,0,38,1563422400,1563422400,1
TheGrandMan10,0,1,0,46,1602302400,1602302400,1
Badass_moose,0,1,0,111,1571630400,1571630400,1
panictolovers,0,1,0,4,1571889600,1571889600,1
distes,0,1,0,1,1591416000,1591416000,1
LuckyMuckyDucky,0,1,0,21,1559275200,1559275200,1
Salimdadreamm,0,1,0,1,1599796800,1599796800,1
JealousGuy1,0,1,0,7,1601524800,1601524800,1
sumnaa56,0,1,0,1,1603598400,1603598400,1
SerahTheLioness,0,1,0,1,1579755600,1579755600,1
youre_obama,0,1,0,3,1607403600,1607403600,1
tommyct614,0,1,0,3,1602129600,1602129600,1
Rhueless,0,1,0,0,1609390800,1609390800,1
AntiqueLeading2,0,1,0,1,1605243600,1605243600,1
Chroma-7,0,1,0,2,1574139600,1574139600,1
eyeswithoutaface-_-,0,1,0,2,1581224400,1581224400,1
thedude691569,0,1,0,3,1606712400,1606712400,1
Trivius,0,1,0,2,1598760000,1598760000,1
garbageplay,0,1,0,6,1585454400,1585454400,1
aiforev,0,1,0,1,1583125200,1583125200,1
MeanOldMatt,0,1,0,1,1608267600,1608267600,1
terravinum,0,1,0,2,1602388800,1602388800,1
DesignerAccount,0,1,0,3,1608181200,1608181200,1
T_Supra_Saiyan,0,1,0,1,1557288000,1557288000,1
underscoredoh,0,1,0,15,1584072000,1584072000,1
Spartan_100,0,1,0,67,1567310400,1567310400,1
Rabbitary,0,1,0,22,1561780800,1561780800,1
SpecOpsAlpha,0,1,0,3,1567828800,1567828800,1
fridayfresh,0,1,0,1,1605157200,1605157200,1
MellOJ3ll0,0,1,0,1,1584158400,1584158400,1
EarningAttorney,0,1,0,-9,1588651200,1588651200,1
leggomahaggro,0,1,0,19,1584072000,1584072000,1
grab_grab_the_haddok,0,1,0,5,1597896000,1597896000,1
ClessxAlghazanth,0,1,0,38,1583812800,1583812800,1
DeraxBlaze,0,1,0,1,1595390400,1595390400,1
napjerks,0,1,0,2,1540440000,1540440000,1
Kritten12,0,1,0,5,1606885200,1606885200,1
saygt,0,1,0,2,1543294800,1543294800,1
Little_Mac_Main,0,1,0,1,1589342400,1589342400,1
Theballfondler,1,0,30,0,1575694800,1575694800,1
BambooManiacal,0,1,0,4,1603512000,1603512000,1
hot2tubesocks,0,1,0,3,1607835600,1607835600,1
Maxwell10206,0,1,0,2,1586404800,1586404800,1
watsagoodusername,0,1,0,1,1605589200,1605589200,1
Infamous_Wrap,0,1,0,3,1608267600,1608267600,1
rubey419,0,1,0,1,1600574400,1600574400,1
GioDesa,0,1,0,24,1560484800,1560484800,1
Spekter1754,0,1,0,54,1585022400,1585022400,1
AscendantArtist,1,0,310,0,1592539200,1592539200,1
khashayBZ,0,1,0,2,1596859200,1596859200,1
theresmel,0,1,0,5,1587614400,1587614400,1
Cemilyplayyy,0,1,0,0,1573102800,1573102800,1
dingman58,0,1,0,2,1604030400,1604030400,1
Soren_Camus1905,0,1,0,1,1585454400,1585454400,1
Black_n_RedBanner,0,1,0,12,1601265600,1601265600,1
Double_Lingonberry98,0,1,0,2,1604466000,1604466000,1
redamed929292,0,1,0,1,1602734400,1602734400,1
mandatoryplaytime,0,1,0,2,1585627200,1585627200,1
VODA54,0,1,0,1,1575435600,1575435600,1
NaCheezIt,0,1,0,1,1585454400,1585454400,1
King_Harold54,0,1,0,1,1603512000,1603512000,1
tendu-or-do-not,0,1,0,5,1581051600,1581051600,1
Lulltimer,0,1,0,1,1608526800,1608526800,1
MrLadrillo,0,1,0,1,1577163600,1577163600,1
Milk_of_Oats,0,1,0,3,1592452800,1592452800,1
Jfuentes6,0,1,0,4,1606798800,1606798800,1
Dankinater,0,1,0,1,1603512000,1603512000,1
xittditdyid,0,1,0,188,1602043200,1602043200,1
NotMyThrowAwayMyMain,0,1,0,1,1599969600,1599969600,1
misztra,0,1,0,14,1589601600,1589601600,1
SupCuz1234,0,1,0,8,1594353600,1594353600,1
CurrentVolume3,0,1,0,2,1584158400,1584158400,1
StonedApe77,0,1,0,47,1608526800,1608526800,1
EbAbDbGbBbeb,0,1,0,2,1605502800,1605502800,1
matX34,0,1,0,272,1600228800,1600228800,1
XavTheMighty,0,1,0,2,1609304400,1609304400,1
jjeinn-tae,0,1,0,4,1597550400,1597550400,1
OtterKay,0,1,0,5,1581224400,1581224400,1
ZenRaven7X,0,1,0,1,1606971600,1606971600,1
sandesh2k17,0,1,0,12,1605589200,1605589200,1
leelunarwhal,1,0,21,0,1607749200,1607749200,1
lasagnaoffilth,0,1,0,2,1596513600,1596513600,1
beefpatty1,1,0,26,0,1571112000,1571112000,1
mrsi21,0,1,0,1,1576818000,1576818000,1
Isaeu,0,1,0,1,1562817600,1562817600,1
PiperSlays,0,1,0,6,1564804800,1564804800,1
bbqsauzze,0,1,0,2,1592884800,1592884800,1
veryexpensivefood,0,1,0,3,1580792400,1580792400,1
MaceWindu_Cheeks,0,1,0,1,1591329600,1591329600,1
Outofbodyfetus,0,1,0,1,1573448400,1573448400,1
WrongDetective,0,1,0,3,1592280000,1592280000,1
MKolacz,0,1,0,1,1582434000,1582434000,1
DarkZyyde_,0,1,0,1,1603512000,1603512000,1
McRazzles,0,1,0,6,1595563200,1595563200,1
BIGGIEFRY_BCU,0,1,0,139,1601438400,1601438400,1
DeepTooth5,0,1,0,1,1588219200,1588219200,1
super_fast_guy,0,1,0,18,1603512000,1603512000,1
madridgalactico,0,1,0,12,1605070800,1605070800,1
runningwambats,0,1,0,2,1574917200,1574917200,1
Cifer88,0,1,0,1,1576213200,1576213200,1
PerpetualDreamer78,1,0,44,0,1592884800,1592884800,1
megaroni26,0,1,0,7,1571976000,1571976000,1
Live-D8,0,1,0,1,1600228800,1600228800,1
emilequimper,0,1,0,14,1608786000,1608786000,1
mistymountainhoppp,0,1,0,70,1566100800,1566100800,1
JesseJump108,0,1,0,9,1601352000,1601352000,1
4bakedeagles,0,1,0,1,1611982800,1611982800,1
Moarde,0,1,0,3,1607835600,1607835600,1
Nokipeura,0,1,0,6,1609045200,1609045200,1
frog-the-mossiest,0,1,0,1,1606971600,1606971600,1
beattheblock,0,1,0,-1,1603512000,1603512000,1
orionorionor,0,1,0,5,1560052800,1560052800,1
mindofingotsandgyres,0,1,0,8,1532577600,1532577600,1
kristopherg11,0,1,0,27,1604984400,1604984400,1
dolphone,0,1,0,6,1550293200,1550293200,1
braziliandarkness,0,1,0,2,1598241600,1598241600,1
dakotawhiebe,0,1,0,8,1607403600,1607403600,1
kintrash413,0,1,0,2,1590897600,1590897600,1
pingmig,0,1,0,4,1592798400,1592798400,1
well___nani,0,1,0,2,1575262800,1575262800,1
crempsen,0,1,0,1,1634443200,1634443200,1
Harukkai,0,1,0,3,1585627200,1585627200,1
snake_hips_jake,0,1,0,1,1604811600,1604811600,1
theYmbus,0,1,0,26,1606194000,1606194000,1
FirstDavid,0,1,0,0,1606021200,1606021200,1
Dartagnan_w_Powers,1,0,6,0,1608267600,1608267600,1
Jiopaba,0,1,0,1,1609131600,1609131600,1
cantstopseeing13,0,1,0,1,1608267600,1608267600,1
Drex_Can,0,1,0,8,1603512000,1603512000,1
wheresmygerble,0,1,0,2,1602820800,1602820800,1
smirkis,0,1,0,2,1598846400,1598846400,1
snowminty,0,1,0,5,1607490000,1607490000,1
wasuremono_,0,1,0,1,1589947200,1589947200,1
LordReginald69,0,1,0,1,1608872400,1608872400,1
westernbacon,0,1,0,8,1589515200,1589515200,1
ALurkerForcedToLogin,0,1,0,18,1603512000,1603512000,1
CostiveFlicker,0,1,0,11,1555473600,1555473600,1
_ToastyToaster_,0,1,0,3,1572667200,1572667200,1
Lvl25eevee,0,1,0,2,1605070800,1605070800,1
smushedfacedogs,1,0,5612,0,1603339200,1603339200,1
BMTaeZer,0,1,0,1,1589342400,1589342400,1
homernc,1,0,20,0,1611982800,1611982800,1
mistyweavers,0,1,0,3,1593403200,1593403200,1
MurdochMurdoch88,0,1,0,-4,1579755600,1579755600,1
RaizenIX,0,1,0,2,1611982800,1611982800,1
wijotan,0,1,0,2,1595476800,1595476800,1
shibbernuclear,0,1,0,2,1598155200,1598155200,1
Zaenok,0,1,0,23,1562817600,1562817600,1
External-Spirit-30,0,1,0,10,1608181200,1608181200,1
TheraKoon,0,1,0,0,1586923200,1586923200,1
coda-allrests,0,1,0,5,1601179200,1601179200,1
d1gital_bath,0,1,0,2,1607144400,1607144400,1
tubee_the,0,1,0,4,1612069200,1612069200,1
noahaalilio,0,1,0,1,1600660800,1600660800,1
iSthetic,0,1,0,25,1609045200,1609045200,1
philly_beans,0,1,0,10,1558238400,1558238400,1
Trapakeet,0,1,0,26,1606194000,1606194000,1
iliketreesndcats,0,1,0,10,1589601600,1589601600,1
TableTheBill,0,1,0,1,1596600000,1596600000,1
mwest0411,0,1,0,-9,1567656000,1567656000,1
munster1588,0,1,0,15,1574744400,1574744400,1
Matador32,0,1,0,7,1604984400,1604984400,1
Davydicus1,0,1,0,38,1608440400,1608440400,1
Katie1230,0,1,0,1,1595649600,1595649600,1
35791369,0,1,0,306,1603512000,1603512000,1
sheep2theslaughter,0,1,0,5,1594353600,1594353600,1
JeamBim,0,1,0,1,1608786000,1608786000,1
ctrl-alt-etc,0,1,0,9,1606539600,1606539600,1
AmericanReason,0,1,0,1,1604984400,1604984400,1
eduardog3000,0,1,0,15,1582261200,1582261200,1
Tacticalstoner,0,1,0,1,1608267600,1608267600,1
Comrad_Khal,0,1,0,58,1602648000,1602648000,1
TiniroX,0,1,0,35,1597982400,1597982400,1
ribald_jester,0,1,0,1,1592193600,1592193600,1
Pyrotica,0,1,0,15,1591243200,1591243200,1
masterkirby999,0,1,0,23,1604030400,1604030400,1
lord_EarlGray,1,0,15,0,1576990800,1576990800,1
sande150,0,1,0,32,1596168000,1596168000,1
RaboTrout,0,1,0,52,1557115200,1557115200,1
Theovanikan,0,1,0,4,1596859200,1596859200,1
coopmander513,0,1,0,4,1562299200,1562299200,1
GoldenInfrared,0,1,0,29,1581829200,1581829200,1
SabreDancer,0,1,0,2,1585454400,1585454400,1
ChrunedMacaroon,0,1,0,0,1599537600,1599537600,1
causes_moral_panics,0,1,0,27,1602043200,1602043200,1
fishshake,0,1,0,17,1609477200,1609477200,1
awesomefutureperfect,0,1,0,12,1584244800,1584244800,1
inappropriatelycool,0,1,0,2,1615698000,1615698000,1
federally,0,1,0,-9,1600747200,1600747200,1
flippingypsy,0,1,0,17,1578114000,1578114000,1
BiggysSmokes,0,1,0,1,1603425600,1603425600,1
whale_cocks,0,1,0,114,1601265600,1601265600,1
freckledinosaur,0,1,0,11,1570939200,1570939200,1
Pataflafla5,0,1,0,2,1603598400,1603598400,1
harajukufallout,0,1,0,1,1569470400,1569470400,1
TheWrongTap,0,1,0,56,1607576400,1607576400,1
Kirkaaa,0,1,0,13,1605589200,1605589200,1
ILaughAtMe,0,1,0,1,1599451200,1599451200,1
knochenzy,0,1,0,5,1608094800,1608094800,1
Redditbad7646,0,1,0,2,1604203200,1604203200,1
berekin556,0,1,0,-1,1608267600,1608267600,1
NegativeBall2,0,1,0,-9,1587096000,1587096000,1
Morph445,0,1,0,4,1601784000,1601784000,1
Shuffulbot,0,1,0,2,1569384000,1569384000,1
kninja115,1,0,62,0,1596686400,1596686400,1
itssamo1,0,1,0,26,1608526800,1608526800,1
hotcobbler,0,1,0,7,1601870400,1601870400,1
geomagus,0,1,0,55,1560657600,1560657600,1
Mythirdusernameis,0,1,0,8,1589342400,1589342400,1
AlienSexualAbuse,0,1,0,2,1599019200,1599019200,1
mrtherussian,0,1,0,4,1611896400,1611896400,1
p00pyship,0,1,0,6,1591243200,1591243200,1
FrenchOnionDouche,0,1,0,1,1601524800,1601524800,1
Coldicemage22,0,1,0,1,1546405200,1546405200,1
Negs01,0,1,0,1,1603512000,1603512000,1
milo_dino,0,1,0,1,1599969600,1599969600,1
Blitzerman,0,1,0,35,1604984400,1604984400,1
ItzKellieDoll,0,1,0,2,1602129600,1602129600,1
NakedJaked,0,1,0,21,1576386000,1576386000,1
AluminiumAlmaMater,0,1,0,9,1591934400,1591934400,1
ShitterShatter17,1,0,1,0,1606366800,1606366800,1
jakebdb,0,1,0,4,1573016400,1573016400,1
dhruvbzw,0,1,0,2,1593748800,1593748800,1
BaDRaZ24,0,1,0,1,1585454400,1585454400,1
usedcondomssince1969,0,1,0,2,1592280000,1592280000,1
ratsta,0,1,0,2,1608613200,1608613200,1
aow4u5w,0,1,0,1,1603512000,1603512000,1
applepie27,0,1,0,5,1578546000,1578546000,1
lilsunnybee,0,1,0,2,1407211200,1407211200,1
Scobinaj,0,1,0,1,1602475200,1602475200,1
penmail,0,1,0,1,1612069200,1612069200,1
Coco_nut8729,0,1,0,3,1602907200,1602907200,1
SecondWind15215,0,1,0,1,1605243600,1605243600,1
neurologicalRad,0,1,0,12,1558843200,1558843200,1
Mad_Jack_McMadd,0,1,0,1,1578805200,1578805200,1
aut97230,0,1,0,2,1642827600,1642827600,1
ManaPeer,0,1,0,1,1601092800,1601092800,1
sanantoniosaucier,0,1,0,5,1603512000,1603512000,1
skiptheban,0,1,0,-3,1611982800,1611982800,1
Acceptable_Ad_885,0,1,0,0,1641186000,1641186000,1
MoistCucumber,0,1,0,1,1608267600,1608267600,1
BlackAndBipolar,0,1,0,12,1590379200,1590379200,1
lurkermadeanaccount,0,1,0,9,1608526800,1608526800,1
john4225,0,1,0,2,1591243200,1591243200,1
tuggyforme,0,1,0,37,1607922000,1607922000,1
ryanfrogz,0,1,0,4,1572408000,1572408000,1
FakeTakiInoue,0,1,0,8,1584158400,1584158400,1
BreachQRS,0,1,0,1,1608699600,1608699600,1
Redthemagnificent,0,1,0,3,1599969600,1599969600,1
eippihshrooms,0,1,0,3,1572667200,1572667200,1
MattyMonopoly,0,1,0,1,1605934800,1605934800,1
erakattack,0,1,0,1,1602993600,1602993600,1
MCMACDANOLDs,0,1,0,5,1606971600,1606971600,1
Ace123466,0,1,0,-1,1602129600,1602129600,1
PreviouslyRecent001,0,1,0,6,1591243200,1591243200,1
grapeflavoredsoup,0,1,0,4,1608526800,1608526800,1
JOBBO326,0,1,0,3,1611982800,1611982800,1
genius23sarcasm,0,1,0,4,1576645200,1576645200,1
SeaCamera4370,0,1,0,1,1603512000,1603512000,1
radicalllamas,1,0,11,0,1590465600,1590465600,1
Secret_Pudding1818,0,1,0,6,1607835600,1607835600,1
CleverBoyDX,0,1,0,1,1607749200,1607749200,1
CurryKid,1,0,0,0,1583726400,1583726400,1
loyroy,0,1,0,23,1582434000,1582434000,1
rossblanket,0,1,0,1,1578978000,1578978000,1
FieldsOfDreams4,0,1,0,23,1567051200,1567051200,1
ndork666,0,1,0,2,1550898000,1550898000,1
TheBiggestCarl23,0,1,0,-3,1596859200,1596859200,1
AntifaGrandWizard,0,1,0,15,1601784000,1601784000,1
lhjashdg98w2jjj,0,1,0,9,1593662400,1593662400,1
nbmathkid5,0,1,0,1,1600488000,1600488000,1
KattBlued,1,0,6,0,1579496400,1579496400,1
ADawg640,0,1,0,1,1584676800,1584676800,1
Im_manuel_cunt,0,1,0,3,1584676800,1584676800,1
nostr,0,1,0,1,1597377600,1597377600,1
six_feet_five,0,1,0,2,1552449600,1552449600,1
jimius,0,1,0,2,1584763200,1584763200,1
PaperPlaneChronicles,0,1,0,5,1605589200,1605589200,1
Blattsalat5000,0,1,0,2,1574312400,1574312400,1
FalloutFan2,0,1,0,3,1600833600,1600833600,1
JarradLee,0,1,0,1,1613970000,1613970000,1
AFairwelltoArms11,0,1,0,1,1605070800,1605070800,1
letimewizard,0,1,0,6,1549774800,1549774800,1
davetherave2108,0,1,0,5,1595736000,1595736000,1
purple_fish_of_doom,1,0,14,0,1604379600,1604379600,1
MEGALODONG,0,1,0,22,1600574400,1600574400,1
YieldingSweetblade,0,1,0,1,1571544000,1571544000,1
rozczochrana,0,1,0,1,1576126800,1576126800,1
Zeesguys,0,1,0,1,1607835600,1607835600,1
smackaroonial90,0,1,0,-1,1600660800,1600660800,1
ColdAsHeaven,0,1,0,1,1591329600,1591329600,1
BurgerAndHotdogs2123,0,1,0,9,1580619600,1580619600,1
Emcid1775,0,1,0,3,1598673600,1598673600,1
UpsetInterview,0,1,0,1,1606885200,1606885200,1
FreshlyChoppedMix,0,1,0,0,1583470800,1583470800,1
ButMessiDeservedIt,0,1,0,2,1604293200,1604293200,1
ahGeb7eelo,0,1,0,4,1597636800,1597636800,1
ryohazuki88,0,1,0,1,1585454400,1585454400,1
coszmo23,0,1,0,2,1602388800,1602388800,1
Buffh,1,0,5,0,1607403600,1607403600,1
TyphoidLarry,0,1,0,4,1589515200,1589515200,1
Percy0311,0,1,0,3,1602302400,1602302400,1
kissekhtak,0,1,0,7,1602043200,1602043200,1
PolishSwagDaddy,0,1,0,25,1582088400,1582088400,1
ItsJustATux,0,1,0,6,1573534800,1573534800,1
Sevencer,0,1,0,3,1596859200,1596859200,1
mcydees3254,0,1,0,6,1612069200,1612069200,1
Bangzilla45,0,1,0,4,1608267600,1608267600,1
bigrise00,0,1,0,-5,1563940800,1563940800,1
FaDe_Flamez,0,1,0,1,1599710400,1599710400,1
Manakanda,0,1,0,8,1612069200,1612069200,1
minkxvanilli,0,1,0,6,1536811200,1536811200,1
itskaiman,0,1,0,5,1587528000,1587528000,1
capricat3,0,1,0,3,1582693200,1582693200,1
Hyzenthlayyyy,0,1,0,3,1608440400,1608440400,1
Aquafye,0,1,0,-4,1608872400,1608872400,1
Divinewiener,0,1,0,11,1607230800,1607230800,1
Merlin_Wycoff,0,1,0,18,1586059200,1586059200,1
bodybydada,0,1,0,1,1606021200,1606021200,1
capzi,0,1,0,1,1585454400,1585454400,1
coxiella_burnetii,0,1,0,1,1605243600,1605243600,1
Among_the_fallen,1,0,514,0,1587182400,1587182400,1
onthemile,0,1,0,3,1430193600,1430193600,1
FinancialNonGuru,0,1,0,1,1576818000,1576818000,1
NNitrogue,1,0,295,0,1561435200,1561435200,1
rilloroc,0,1,0,1,1604030400,1604030400,1
Mata187,0,1,0,0,1584331200,1584331200,1
bach2121,0,1,0,2,1611982800,1611982800,1
tremolobanshee,0,1,0,2,1583470800,1583470800,1
kronos9930,0,1,0,1,1577682000,1577682000,1
brbvengful,0,1,0,7,1588219200,1588219200,1
Red__B,0,1,0,13,1598673600,1598673600,1
DeusExMagikarpa,0,1,0,4,1585454400,1585454400,1
Bunny_abbot19,0,1,0,1,1603512000,1603512000,1
theothermuse,0,1,0,6,1566360000,1566360000,1
notokaycj,1,0,77,0,1576645200,1576645200,1
UrConsciousness,0,1,0,16,1605848400,1605848400,1
PlethoraOfFuckery,1,0,3,0,1606280400,1606280400,1
StevenTheSaint12,0,1,0,1,1560225600,1560225600,1
MajesticBlackberry8,0,1,0,205,1593662400,1593662400,1
mr_style_points,0,1,0,62,1574917200,1574917200,1
EasyPaustuh,0,1,0,4,1611982800,1611982800,1
AceKingSuited18,0,1,0,2,1598328000,1598328000,1
Aeroncastle,0,1,0,-1,1596686400,1596686400,1
throwintoj,1,0,35,0,1590724800,1590724800,1
Bossie965,0,1,0,1,1602302400,1602302400,1
Lawlcopt0r,0,1,0,-1,1554523200,1554523200,1
Squish765,0,1,0,1,1611205200,1611205200,1
FancyPaperDoll,0,1,0,1,1594440000,1594440000,1
fckwrk1917,1,0,54,0,1569729600,1569729600,1
beltloopstupid,1,0,0,0,1593576000,1593576000,1
alien-oracle,1,0,19,0,1604898000,1604898000,1
MrGopherWood,0,1,0,1,1586491200,1586491200,1
HolyPigshitBatman,0,1,0,1,1592280000,1592280000,1
beefucker1999,0,1,0,1,1586836800,1586836800,1
Teachtheworldinlove,0,1,0,1,1575262800,1575262800,1
OphrysAlba,0,1,0,1,1603512000,1603512000,1
BrandNewDei,1,0,1740,0,1611896400,1611896400,1
kuchisakeonaa,0,1,0,14,1587960000,1587960000,1
WindXero,0,1,0,5,1605502800,1605502800,1
TugaLusitano,0,1,0,2,1559016000,1559016000,1
rickychan1221,0,1,0,1,1603512000,1603512000,1
Hydrotanil,0,1,0,1,1625630400,1625630400,1
loafofconcrete,0,1,0,1,1610773200,1610773200,1
carpenter_96,0,1,0,8,1559188800,1559188800,1
Lifesucks89,0,1,0,1,1597982400,1597982400,1
_Y_divide,0,1,0,6,1569902400,1569902400,1
mrjiggyfly59960,0,1,0,1,1594785600,1594785600,1
ineedhelpwsims,0,1,0,3,1603425600,1603425600,1
Amadablaam74,0,1,0,6,1603425600,1603425600,1
Enterorexitidontcare,0,1,0,1,1556164800,1556164800,1
firecrackerinthehole,1,0,8,0,1606626000,1606626000,1
wheres_my_burrito_,0,1,0,12,1583643600,1583643600,1
adam__nicholas,0,1,0,2,1603598400,1603598400,1
canyouhearmeglob,0,1,0,6,1598328000,1598328000,1
SexualScavenger,0,1,0,6,1578027600,1578027600,1
Tuala08,0,1,0,2,1595304000,1595304000,1
SomberSundays,0,1,0,1,1584417600,1584417600,1
wageslave5439,0,1,0,30,1578891600,1578891600,1
Deathmelon6789,1,0,101,0,1606798800,1606798800,1
Zachbutastonernow,0,1,0,1,1612069200,1612069200,1
Allthewayamazin,0,1,0,1,1600920000,1600920000,1
ellie_bellie_boo,1,0,1921,0,1602907200,1602907200,1
MNMKandyKane,0,1,0,1,1598932800,1598932800,1
MrWake96,0,1,0,1,1579842000,1579842000,1
LetsGoBullyTheNerd,0,1,0,1,1590033600,1590033600,1
eddyathome,0,1,0,4,1598846400,1598846400,1
BlackMoonstorm,0,1,0,21,1571025600,1571025600,1
Casta-,0,1,0,3,1601697600,1601697600,1
phlebotomyourbottom,0,1,0,4,1562644800,1562644800,1
ItzToxiin,0,1,0,1,1612155600,1612155600,1
Grubazio,0,1,0,0,1572235200,1572235200,1
Rudoren,0,1,0,2,1556683200,1556683200,1
Toadie9622,0,1,0,-2,1566360000,1566360000,1
mrfreedayaz,0,1,0,1,1637211600,1637211600,1
2030CE,1,0,96,0,1596513600,1596513600,1
RyokoMasaki,0,1,0,1,1585454400,1585454400,1
KaizokuOu-ConDOriano,0,1,0,2,1594785600,1594785600,1
IbnKafir,0,1,0,0,1605589200,1605589200,1
itwontdie,0,1,0,-21,1601956800,1601956800,1
crc64,0,1,0,2,1596168000,1596168000,1
goatcapricorn,0,1,0,1,1589860800,1589860800,1
AtlasOS,0,1,0,42,1598846400,1598846400,1
MyNameThru,0,1,0,18,1598760000,1598760000,1
mycustomhotwheels,0,1,0,3,1599192000,1599192000,1
AffectionateEnergy70,0,1,0,2,1605502800,1605502800,1
IronFocus,0,1,0,27,1609390800,1609390800,1
Strupnick,0,1,0,-7,1546664400,1546664400,1
ZappfesConundrum,0,1,0,6,1609304400,1609304400,1
boogerboners,0,1,0,2,1609477200,1609477200,1
Katmanduof,0,1,0,1,1558670400,1558670400,1
skankordie,0,1,0,1,1576386000,1576386000,1
Garden_Of_My_Mind,0,1,0,16,1603512000,1603512000,1
jubjubbirdo,0,1,0,0,1606626000,1606626000,1
Statessideredditor,0,1,0,1,1597464000,1597464000,1
TheObservationalist,0,1,0,-22,1603944000,1603944000,1
Thubanshee,0,1,0,5,1571284800,1571284800,1
onlyforjazzmemes,0,1,0,1,1595476800,1595476800,1
Leiva-san,0,1,0,3,1606539600,1606539600,1
covid-1989,0,1,0,2,1605589200,1605589200,1
Draw-Matize_It,0,1,0,3,1555387200,1555387200,1
shouldbebabysitting,0,1,0,12,1595217600,1595217600,1
D2J5A3,0,1,0,15,1563249600,1563249600,1
lizzardwizard7,0,1,0,5,1587960000,1587960000,1
poltergeist007,0,1,0,1,1612069200,1612069200,1
ASD_And_Me,0,1,0,1,1572408000,1572408000,1
Foureyedlemon,1,0,127,0,1572930000,1572930000,1
jessicamenius,0,1,0,1,1602216000,1602216000,1
supersevket,0,1,0,16,1603771200,1603771200,1
Possible-Mousse-2172,0,1,0,1,1638766800,1638766800,1
syundeninethhousand,0,1,0,4,1598587200,1598587200,1
Gleeful_Robot,0,1,0,6,1576299600,1576299600,1
toprim,0,1,0,1,1585454400,1585454400,1
RealRosemaryBaby,0,1,0,-1,1589169600,1589169600,1
SomeAccountThatIs,0,1,0,2,1573362000,1573362000,1
Anarchist16,0,1,0,5,1539835200,1539835200,1
liz_dexia,0,1,0,118,1573102800,1573102800,1
whispermenudez,0,1,0,-3,1571716800,1571716800,1
chichidike993,0,1,0,2,1602216000,1602216000,1
404_error-_-,0,1,0,1,1603598400,1603598400,1
Kaneshadow,0,1,0,5,1598846400,1598846400,1
blue--blood,0,1,0,2,1565582400,1565582400,1
Choekroet,0,1,0,1,1604811600,1604811600,1
hadikhh,0,1,0,3,1585540800,1585540800,1
kanaboiiiii,1,0,0,0,1583812800,1583812800,1
HealMySoulPlz,0,1,0,11,1603598400,1603598400,1
Claptonisawesome,0,1,0,18,1603339200,1603339200,1
pmach04,0,1,0,3,1566446400,1566446400,1
WeirdCanary,0,1,0,2,1566705600,1566705600,1
BlubbaFLAYGZ98,0,1,0,1,1597982400,1597982400,1
spanish-fly,0,1,0,5,1589342400,1589342400,1
OverlordMimi,0,1,0,10,1598414400,1598414400,1
hexx117,0,1,0,-2,1596859200,1596859200,1
ExtremeOk5119,0,1,0,1,1604379600,1604379600,1
SigNG,0,1,0,0,1590033600,1590033600,1
DrewBlue2,0,1,0,18,1570766400,1570766400,1
WaycoKid1129,0,1,0,1,1608526800,1608526800,1
ries_9,0,1,0,1,1608267600,1608267600,1
JaysonH,0,1,0,3,1480568400,1480568400,1
Due_Cicada,0,1,0,32,1592452800,1592452800,1
mclagger6,0,1,0,2,1584417600,1584417600,1
Pink-Cupcake-Kitty,0,1,0,13,1608699600,1608699600,1
MushyFacedBastard,0,1,0,8,1594440000,1594440000,1
C0MRADE69,1,0,61,0,1604725200,1604725200,1
austrohorologium,0,1,0,1,1556510400,1556510400,1
PulseCaptive,0,1,0,1,1600660800,1600660800,1
MagicTurnip45,1,0,56,0,1583211600,1583211600,1
ABenevolentDespot,0,1,0,1,1597723200,1597723200,1
SPZX,0,1,0,3,1609131600,1609131600,1
Danyell619,0,1,0,3,1608958800,1608958800,1
ilona12,0,1,0,43,1581570000,1581570000,1
ZomBguy,0,1,0,3,1565496000,1565496000,1
MuadDib1942,0,1,0,1,1603512000,1603512000,1
gameratron,1,0,16,0,1398052800,1398052800,1
coronavirus100,1,0,10,0,1598846400,1598846400,1
trucker_56,0,1,0,1,1603080000,1603080000,1
exlaks,0,1,0,1,1571976000,1571976000,1
HeadCowGrazing,0,1,0,-9,1605502800,1605502800,1
SignalSafe,0,1,0,5,1590120000,1590120000,1
Nam_baby1968,0,1,0,1,1604030400,1604030400,1
Smokey_theBandit,0,1,0,8,1581829200,1581829200,1
filthpatrol,0,1,0,45,1586059200,1586059200,1
robinlovesrain,0,1,0,20,1570420800,1570420800,1
iFuckYouInTheAss,0,1,0,6,1583899200,1583899200,1
squirrel_rider,0,1,0,13,1586232000,1586232000,1
hablocomogringo,0,1,0,30,1569384000,1569384000,1
Scytodes_thoracica,0,1,0,11,1595995200,1595995200,1
flamingomobile,0,1,0,1,1581224400,1581224400,1
Draegoth_,0,1,0,0,1580101200,1580101200,1
falsehero67,1,0,13,0,1590379200,1590379200,1
MLLE123,1,0,411,0,1606539600,1606539600,1
-xioix-,0,1,0,5,1599969600,1599969600,1
messhead1,0,1,0,4,1583557200,1583557200,1
adammario6556,0,1,0,2,1607749200,1607749200,1
SanktBladius,0,1,0,89,1595217600,1595217600,1
FlirtyOwl,0,1,0,6,1609045200,1609045200,1
Jonathot-,0,1,0,6,1600228800,1600228800,1
SaltyBandido,0,1,0,1,1591070400,1591070400,1
idontappearmissing,0,1,0,0,1577336400,1577336400,1
Maujaq,0,1,0,2,1584158400,1584158400,1
EternityForest,0,1,0,2,1603512000,1603512000,1
JJAsond,0,1,0,1,1596859200,1596859200,1
tactlesshag,0,1,0,2,1582779600,1582779600,1
AceWithDog,0,1,0,1,1612069200,1612069200,1
teasers874992,0,1,0,-2,1603598400,1603598400,1
Algernons__Florist,0,1,0,10,1608872400,1608872400,1
fatdiscokid,0,1,0,-1,1607662800,1607662800,1
RobotEnthusiast,0,1,0,1,1572148800,1572148800,1
bitterlikecoffee345,0,1,0,1,1602475200,1602475200,1
avech,0,1,0,9,1612069200,1612069200,1
thefacemanzero,0,1,0,1,1607835600,1607835600,1
doritopeanut,0,1,0,1,1600833600,1600833600,1
CanadianCola,0,1,0,12,1595822400,1595822400,1
candidly1,0,1,0,1,1590120000,1590120000,1
wesves,0,1,0,2,1600142400,1600142400,1
cloveismycat,0,1,0,4,1599796800,1599796800,1
TheGiant1989,0,1,0,1,1603512000,1603512000,1
Mossybawlz,1,0,9,0,1603252800,1603252800,1
GaBeRockKing,0,1,0,6,1608094800,1608094800,1
TheGentlyUsedNapkin,0,1,0,10,1581224400,1581224400,1
D-List-Supervillian,0,1,0,1,1598760000,1598760000,1
Pls_add_more_reverb,0,1,0,9,1607662800,1607662800,1
maleia,0,1,0,5,1603598400,1603598400,1
prahSmadA,0,1,0,24,1586577600,1586577600,1
punishem1990,0,1,0,14,1608181200,1608181200,1
Xots1234,0,1,0,-6,1598500800,1598500800,1
BattleFarter,0,1,0,10,1594008000,1594008000,1
Highintheclouds420,0,1,0,1,1609045200,1609045200,1
3STRIPESLAV,0,1,0,5,1607922000,1607922000,1
Werecow919,0,1,0,1,1606021200,1606021200,1
KetordinaryDay,0,1,0,2,1608699600,1608699600,1
butterdrinker,0,1,0,1,1600747200,1600747200,1
Wrathful_Wrose,0,1,0,23,1586923200,1586923200,1
Jhavindrabanjade,0,1,0,6,1592539200,1592539200,1
klokkeblomst,0,1,0,2,1594785600,1594785600,1
Cyberman_,0,1,0,9,1575781200,1575781200,1
fromkentucky,0,1,0,3,1604811600,1604811600,1
JuicyStein,0,1,0,46,1569297600,1569297600,1
mood-park,0,1,0,1,1607144400,1607144400,1
FlipNStack,1,0,69,0,1580965200,1580965200,1
hypnodrew,0,1,0,12,1578891600,1578891600,1
probablystoned6969,0,1,0,15,1582088400,1582088400,1
king_larry2897,0,1,0,4,1605243600,1605243600,1
st-ove,0,1,0,1,1572930000,1572930000,1
SousVideButt,1,0,26,0,1595908800,1595908800,1
nik0po,0,1,0,2,1555905600,1555905600,1
dustyreptile,0,1,0,3,1606626000,1606626000,1
50shadesofgreypupon,0,1,0,2,1571457600,1571457600,1
muffinTrees,0,1,0,1,1602129600,1602129600,1
josiffisoj,0,1,0,1,1601870400,1601870400,1
Emil8ner,1,0,590,0,1546491600,1546491600,1
500mgtylenolandabeer,0,1,0,-7,1574830800,1574830800,1
dichiejr,0,1,0,5,1611810000,1611810000,1
frostdriven,0,1,0,7,1605848400,1605848400,1
kingowolvz,0,1,0,1,1605589200,1605589200,1
Officially_Undead,0,1,0,1,1604116800,1604116800,1
Deadlifting_IT_Guy,0,1,0,4,1569384000,1569384000,1
TherealTechman86,0,1,0,4,1606021200,1606021200,1
AJD_24,0,1,0,1,1597377600,1597377600,1
Ezavoor,0,1,0,1,1609045200,1609045200,1
dudeishere247,0,1,0,25,1600747200,1600747200,1
DiamondPeripheral,0,1,0,2,1595390400,1595390400,1
1-10-11-100,0,1,0,2,1604811600,1604811600,1
killersinarhur,0,1,0,9,1600315200,1600315200,1
TheTendieBandit,0,1,0,23,1597464000,1597464000,1
jazzyfatnastees,0,1,0,7,1607922000,1607922000,1
largeprinter,0,1,0,8,1522728000,1522728000,1
brilliscool,0,1,0,1,1603512000,1603512000,1
Ubunti,0,1,0,1,1608699600,1608699600,1
reflexiveblue,0,1,0,2,1602820800,1602820800,1
smishNelson,0,1,0,5,1606539600,1606539600,1
albnasc,1,0,1,0,1605589200,1605589200,1
plantasia-rpg,0,1,0,11,1611896400,1611896400,1
Mikesizachrist,0,1,0,1,1599105600,1599105600,1
scarletuba,0,1,0,4,1609218000,1609218000,1
VoliBeast,0,1,0,20,1557892800,1557892800,1
Orbital777,0,1,0,-18,1603944000,1603944000,1
Samclifton44,0,1,0,2,1562126400,1562126400,1
IUsedToHaveMoreHair,0,1,0,10,1584676800,1584676800,1
Rhydsdh,0,1,0,1,1598846400,1598846400,1
werelock,0,1,0,9,1593662400,1593662400,1
sammy4prez,0,1,0,2,1601265600,1601265600,1
IZY53,0,1,0,2,1602129600,1602129600,1
Jarl-Ballin-,0,1,0,1,1602907200,1602907200,1
kozy138,0,1,0,4,1607576400,1607576400,1
true_karma,0,1,0,14,1593662400,1593662400,1
sadlechooza,0,1,0,2,1603080000,1603080000,1
artarcheryhorses,0,1,0,8,1560052800,1560052800,1
bateatingchink,0,1,0,1,1591329600,1591329600,1
warsendkiss1945,1,0,26,0,1595995200,1595995200,1
blue-velvet-bunny,0,1,0,3,1587096000,1587096000,1
NorthernTurnip,0,1,0,1,1571025600,1571025600,1
Hideki_Mojo,0,1,0,3,1572843600,1572843600,1
obviousfakeperson,0,1,0,17,1576472400,1576472400,1
Throwaway01742819,0,1,0,2,1611982800,1611982800,1
RevolutionaryImpact9,0,1,0,1,1581138000,1581138000,1
rieldilpikl,0,1,0,3,1604379600,1604379600,1
Chips580,0,1,0,-10,1604293200,1604293200,1
bigdaddychainsaw,0,1,0,1,1605848400,1605848400,1
Davidcopsafeel,0,1,0,6,1600228800,1600228800,1
Ljoseph54,0,1,0,1,1579237200,1579237200,1
Augmension,0,1,0,19,1568260800,1568260800,1
eoaaosz,0,1,0,1,1599883200,1599883200,1
BigTentBiden,0,1,0,10,1603512000,1603512000,1
MaenHoffiCoffi,0,1,0,-1,1585022400,1585022400,1
aicaramb_a,1,0,64,0,1570939200,1570939200,1
rnavstar,0,1,0,3,1603512000,1603512000,1
The_Bigg_D,0,1,0,-10,1579669200,1579669200,1
GonzoBabe,0,1,0,29,1608699600,1608699600,1
Pritzker,0,1,0,2,1561262400,1561262400,1
Lesteross,0,1,0,3,1596772800,1596772800,1
user_3399,0,1,0,1,1582174800,1582174800,1
EveningBrownie,0,1,0,2,1551589200,1551589200,1
jamthewither,0,1,0,-1,1599883200,1599883200,1
KyrosXIII,0,1,0,2,1605675600,1605675600,1
fille_hideuse,0,1,0,1,1608613200,1608613200,1
Minimum-Future,1,0,2,0,1582952400,1582952400,1
destroyood_,0,1,0,8,1574226000,1574226000,1
Tyemak,1,0,191,0,1602043200,1602043200,1
Nefilim314,0,1,0,4,1597896000,1597896000,1
S_W_JagermanJensen_1,0,1,0,1,1591243200,1591243200,1
sleepylies,0,1,0,3,1605848400,1605848400,1
reach_for_the_bleach,0,1,0,2,1595908800,1595908800,1
justtryingtosurvive9,0,1,0,15,1606626000,1606626000,1
former_torenstraat,0,1,0,2,1607230800,1607230800,1
Nosferatii,0,1,0,3,1564977600,1564977600,1
hahanooneknowsimhere,0,1,0,47,1608354000,1608354000,1
Heisenasperg,0,1,0,3,1587614400,1587614400,1
SearMeteor,0,1,0,18,1593662400,1593662400,1
TFK_LH,0,1,0,1,1596168000,1596168000,1
WindowsXP2,0,1,0,12,1592107200,1592107200,1
Tami_tami,1,0,525,0,1563163200,1563163200,1
thescribe2077,0,1,0,21,1586664000,1586664000,1
fergalopolis,0,1,0,17,1605589200,1605589200,1
nooneknowsmehereeee,0,1,0,2,1584676800,1584676800,1
CoreyH213,0,1,0,1,1603512000,1603512000,1
n0mad911,0,1,0,-4,1600660800,1600660800,1
eLMilkdude,0,1,0,1,1585368000,1585368000,1
flan22,1,0,966,0,1580187600,1580187600,1
butunago,0,1,0,3,1598414400,1598414400,1
WhatTheHellLmao,1,0,193,0,1581397200,1581397200,1
jorgren,0,1,0,3,1600747200,1600747200,1
DejaV42,0,1,0,2,1603944000,1603944000,1
Dearg-Uisce,0,1,0,5,1557460800,1557460800,1
Capt_scratchy_bear,0,1,0,4,1593662400,1593662400,1
traveling_mage,0,1,0,1,1642741200,1642741200,1
capnapalm,0,1,0,-7,1598587200,1598587200,1
jl250,0,1,0,-3,1569988800,1569988800,1
armwulf,0,1,0,1,1612155600,1612155600,1
trash_time,0,1,0,1,1611982800,1611982800,1
jelly-senpai,0,1,0,5,1585454400,1585454400,1
Beef1776,0,1,0,-2,1591243200,1591243200,1
maubremin,1,0,1,0,1456635600,1456635600,1
ColourSteel,0,1,0,1,1573275600,1573275600,1
Kaky01n,0,1,0,1,1593921600,1593921600,1
Thompithompa,0,1,0,1,1611982800,1611982800,1
knows_secrets,0,1,0,1,1591243200,1591243200,1
Average_Viewer,0,1,0,1,1599537600,1599537600,1
Jade-Balfour,0,1,0,11,1592884800,1592884800,1
irishitaliancroat,0,1,0,1,1607576400,1607576400,1
Zazzseltzer2,0,1,0,0,1599969600,1599969600,1
yomjoseki,0,1,0,10,1611982800,1611982800,1
johnsnowking36,0,1,0,12,1595476800,1595476800,1
Taco_Gunslinger,0,1,0,-8,1576386000,1576386000,1
mfdane,0,1,0,4,1596513600,1596513600,1
Holybananas666,0,1,0,29,1594267200,1594267200,1
BigMemeBoi17,0,1,0,3,1572148800,1572148800,1
Dempski,0,1,0,16,1587614400,1587614400,1
DefinitelyHorny4U,0,1,0,1,1606539600,1606539600,1
stevethed,0,1,0,3,1571889600,1571889600,1
_DarthVaper420,0,1,0,1,1584936000,1584936000,1
KiloShotz,0,1,0,2,1605070800,1605070800,1
MexicanReformist,0,1,0,9,1603512000,1603512000,1
Aiming_to_help,0,1,0,3,1604984400,1604984400,1
Burner2611,0,1,0,2,1607490000,1607490000,1
King-Sassafrass,0,1,0,4,1578286800,1578286800,1
PSawyer10250,0,1,0,1,1603512000,1603512000,1
Spenge,0,1,0,1,1597118400,1597118400,1
urbansong,0,1,0,-2,1591243200,1591243200,1
Yeetyak,0,1,0,7,1581915600,1581915600,1
Toasty_Owl,0,1,0,-49,1599969600,1599969600,1
PricklyGoober,0,1,0,1,1595217600,1595217600,1
Mandarin_Budgie,0,1,0,6,1600660800,1600660800,1
preserumsteve,0,1,0,8,1576386000,1576386000,1
666-Wendigo-666,0,1,0,3,1607835600,1607835600,1
battyryder,0,1,0,70,1596340800,1596340800,1
sdm5062,0,1,0,2,1580878800,1580878800,1
The_Semiramis,0,1,0,2,1605934800,1605934800,1
BangBlueRazz,0,1,0,1,1585454400,1585454400,1
bloopscoopdiddlydoop,0,1,0,4,1567828800,1567828800,1
GIINGANiNjA,0,1,0,3,1602734400,1602734400,1
dontbuyanylogos,0,1,0,1,1598587200,1598587200,1
RayneNacht,0,1,0,1,1585454400,1585454400,1
richinteriorworld,0,1,0,23,1587096000,1587096000,1
PharaohCleocatra,1,0,4,0,1587009600,1587009600,1
Maplefrix,0,1,0,10,1605762000,1605762000,1
succubus-slayer,0,1,0,0,1606626000,1606626000,1
MisterSophisticated,0,1,0,13,1577941200,1577941200,1
3dprintedthingies,0,1,0,21,1603598400,1603598400,1
Comfortable-Ad-9231,0,1,0,1,1607922000,1607922000,1
splash_splash_jetski,1,0,23,0,1594785600,1594785600,1
AceGamer92,0,1,0,23,1591761600,1591761600,1
PhD_Salt,0,1,0,-2,1600747200,1600747200,1
helpmytonguehurts,0,1,0,4,1573189200,1573189200,1
Prince-Link,0,1,0,6,1606021200,1606021200,1
WellSaltySweetPotato,0,1,0,6,1608094800,1608094800,1
cinco-de-man,0,1,0,1,1608267600,1608267600,1
the_alt_fright,1,0,23,0,1596168000,1596168000,1
YeetFishYeet,0,1,0,-3,1608699600,1608699600,1
fuzzygondola,0,1,0,130,1604379600,1604379600,1
Exekiel,0,1,0,1,1604811600,1604811600,1
CodeRed_R,0,1,0,2,1567915200,1567915200,1
xAllonsy_Geronimox,0,1,0,1,1577768400,1577768400,1
occasionallaughs,1,0,226,0,1599537600,1599537600,1
brokkoli,0,1,0,-12,1599969600,1599969600,1
luftgekuhlt91,0,1,0,1,1591675200,1591675200,1
NecessaryShort,0,1,0,0,1599364800,1599364800,1
bastardlymans,1,0,18,0,1594958400,1594958400,1
boredbelgian,1,0,1942,0,1607317200,1607317200,1
3windows,0,1,0,1,1608872400,1608872400,1
StaircaseGenius,0,1,0,1,1584763200,1584763200,1
notacockatoo,0,1,0,1,1599796800,1599796800,1
Vast-Curiousity,0,1,0,1,1608440400,1608440400,1
replica619,0,1,0,2,1607230800,1607230800,1
whatafattroll,0,1,0,26,1606971600,1606971600,1
Americanprep,0,1,0,1,1612069200,1612069200,1
fuzzo,0,1,0,2,1553227200,1553227200,1
SocialMediaElitist,1,0,4,0,1595304000,1595304000,1
Graepian0,0,1,0,-8,1555646400,1555646400,1
SufficientRace,0,1,0,1,1580360400,1580360400,1
TheUnbannable2,0,1,0,1,1604466000,1604466000,1
DoubleDivination,0,1,0,3,1596340800,1596340800,1
lazyDoctor69,0,1,0,1,1545022800,1545022800,1
chalv22,0,1,0,-16,1566446400,1566446400,1
RadSpaceWizard,0,1,0,1,1609218000,1609218000,1
iflyagaric,0,1,0,3,1588219200,1588219200,1
pathatter,0,1,0,3,1597291200,1597291200,1
Hookherbackup,0,1,0,4,1603598400,1603598400,1
cosmicjoke-,0,1,0,5,1593230400,1593230400,1
Blackbeerdo,0,1,0,1,1586836800,1586836800,1
everythingsadildo,0,1,0,3,1581224400,1581224400,1
MyFartsSmellLike,0,1,0,-2,1570161600,1570161600,1
Greifinn89,0,1,0,5,1601265600,1601265600,1
rodentsofdisbelief,0,1,0,1,1601006400,1601006400,1
_john_universe_,0,1,0,8,1605157200,1605157200,1
celinehoeforlife,0,1,0,44,1607317200,1607317200,1
Past-Inspector-1871,0,1,0,1,1601956800,1601956800,1
aarontminded,0,1,0,1,1608267600,1608267600,1
takitaki555,0,1,0,3,1574053200,1574053200,1
anetarrr,0,1,0,10,1603166400,1603166400,1
ofvaluerloveandtime,0,1,0,7,1609477200,1609477200,1
toothless2014,0,1,0,2,1586577600,1586577600,1
Wolfpacker76,0,1,0,-1,1585454400,1585454400,1
DominckDicacco,0,1,0,2,1597118400,1597118400,1
thuy_chan,0,1,0,1,1580101200,1580101200,1
Thelastkakapo10101,0,1,0,3,1581224400,1581224400,1
FattMlagg69,0,1,0,1,1608440400,1608440400,1
TheDylorean,0,1,0,3,1579410000,1579410000,1
dreamo95,1,0,907,0,1550206800,1550206800,1
Flashmax305,0,1,0,2,1582088400,1582088400,1
orangine22,0,1,0,2,1580187600,1580187600,1
toysmith,0,1,0,10,1551589200,1551589200,1
fruitydollers69,0,1,0,0,1604379600,1604379600,1
conivway,1,0,10,0,1570852800,1570852800,1
TheShrimpIsLimp,0,1,0,1,1591243200,1591243200,1
SpcK,0,1,0,3,1585108800,1585108800,1
WarAccomplished8842,0,1,0,1,1603512000,1603512000,1
leavemealoneimdead,0,1,0,2,1596859200,1596859200,1
Mr_Tiggywinkle,0,1,0,5,1607230800,1607230800,1
rdh78ct,0,1,0,7,1570248000,1570248000,1
Aeris_24,0,1,0,1,1580274000,1580274000,1
razmon,0,1,0,11,1582088400,1582088400,1
halosos,0,1,0,2,1583038800,1583038800,1
Sai1r,0,1,0,2,1576645200,1576645200,1
gominokouhai,0,1,0,4,1601611200,1601611200,1
ZombieClassics3001,1,0,9,0,1608440400,1608440400,1
zakkazzakkaz,0,1,0,6,1561176000,1561176000,1
TheUnwillingOne,0,1,0,11,1587960000,1587960000,1
MyBrainisMe,0,1,0,30,1605934800,1605934800,1
deathfletcher,0,1,0,14,1571025600,1571025600,1
queensnow725,0,1,0,4,1574398800,1574398800,1
VikingPreacher,0,1,0,0,1605330000,1605330000,1
Goatus_OQueef,0,1,0,41,1598760000,1598760000,1
CreamSodaIsBestSoda,0,1,0,46,1596686400,1596686400,1
WheatLad,0,1,0,6,1534737600,1534737600,1
Moondoggie,0,1,0,5,1595995200,1595995200,1
WolfPlayz294,0,1,0,-15,1606885200,1606885200,1
darknightnoir,0,1,0,0,1593662400,1593662400,1
qona,1,0,4027,0,1568347200,1568347200,1
HunterGaming,0,1,0,4,1606712400,1606712400,1
WavyWavy007,0,1,0,5,1605762000,1605762000,1
ImaginePoop,0,1,0,1,1607922000,1607922000,1
Osterion,0,1,0,1,1553140800,1553140800,1
Skagritch,0,1,0,3,1611982800,1611982800,1
smartprotestusa,1,0,3,0,1595304000,1595304000,1
InertKat,0,1,0,6,1611637200,1611637200,1
fickle_jess,0,1,0,3,1608699600,1608699600,1
DeathcampEnthusiast,0,1,0,6,1605589200,1605589200,1
Readeandrew,0,1,0,5,1606539600,1606539600,1
Bevin_Kanks,0,1,0,1,1592107200,1592107200,1
adan200,0,1,0,1,1620878400,1620878400,1
tcqueen,1,0,11,0,1609304400,1609304400,1
makeski25,0,1,0,22,1575781200,1575781200,1
niloc3,0,1,0,-6,1598328000,1598328000,1
jackst10,0,1,0,1,1592798400,1592798400,1
slothscantswim,0,1,0,1,1634270400,1634270400,1
GBSsurvivor,0,1,0,1,1592884800,1592884800,1
vanderlylecryy,0,1,0,1,1605502800,1605502800,1
ClintonDsouza,0,1,0,8,1589601600,1589601600,1
snow_traveler,0,1,0,1,1600401600,1600401600,1
Bella1904,1,0,33,0,1560916800,1560916800,1
queertreks,0,1,0,20,1566446400,1566446400,1
brumor69,0,1,0,33,1599796800,1599796800,1
CapitanBanhammer,0,1,0,3,1582693200,1582693200,1
mayth3n,0,1,0,3,1567569600,1567569600,1
Chankomcgraw,0,1,0,1,1607922000,1607922000,1
Flux85,0,1,0,1,1602129600,1602129600,1
saito200,0,1,0,9,1587268800,1587268800,1
Trans-tastic,0,1,0,30,1585195200,1585195200,1
VinnydaHorse,0,1,0,2,1608872400,1608872400,1
glass_ants,0,1,0,1,1584504000,1584504000,1
Death2Reddit,0,1,0,1,1607403600,1607403600,1
corona_virus20,0,1,0,2,1601870400,1601870400,1
NewFuturist,0,1,0,18,1599192000,1599192000,1
Caeloviator,1,0,84,0,1583470800,1583470800,1
Krystaphonix,0,1,0,1,1605416400,1605416400,1
booleanfreud,0,1,0,2,1603598400,1603598400,1
Na3s,0,1,0,3,1606539600,1606539600,1
BaxterVoice,0,1,0,3,1609218000,1609218000,1
HailPaymon,0,1,0,1,1577336400,1577336400,1
Venar303,0,1,0,4,1559620800,1559620800,1
unearthlyred,0,1,0,2,1608958800,1608958800,1
Kaiisim,0,1,0,2,1599019200,1599019200,1
evildeadedd,0,1,0,2,1592712000,1592712000,1
pretty_honest_guy,0,1,0,1,1587787200,1587787200,1
DotColonSlashSlash,0,1,0,2,1585454400,1585454400,1
auntsemen,0,1,0,5,1575349200,1575349200,1
LunarNight,0,1,0,4,1606539600,1606539600,1
jetsetninjacat,0,1,0,2,1603512000,1603512000,1
DogsBaIIs,0,1,0,5,1611896400,1611896400,1
PantherAZ,0,1,0,-3,1598760000,1598760000,1
ellzuz,0,1,0,1,1578373200,1578373200,1
Mander2019,0,1,0,3,1579669200,1579669200,1
T3rkish,0,1,0,5,1576299600,1576299600,1
drawlsy,0,1,0,10,1569211200,1569211200,1
pastysparkle,0,1,0,1,1594440000,1594440000,1
VegenaiseJesus,0,1,0,2,1601611200,1601611200,1
VforFALGSC,0,1,0,2,1572494400,1572494400,1
JTBKnuggetsauce,0,1,0,11,1593057600,1593057600,1
VilleKivinen,0,1,0,-2,1608699600,1608699600,1
onlyartist6,1,0,48,0,1603080000,1603080000,1
RapMonicker,0,1,0,249,1606712400,1606712400,1
MLMoonShots,0,1,0,1,1613192400,1613192400,1
Nematic_,0,1,0,-4,1575781200,1575781200,1
Twidge912,0,1,0,3,1607662800,1607662800,1
newttoot,0,1,0,18,1562472000,1562472000,1
Yuleogy,0,1,0,1,1554609600,1554609600,1
Guhforthemoney,0,1,0,1,1607576400,1607576400,1
NinjaAmbush,0,1,0,4,1608267600,1608267600,1
Lucky-3-,0,1,0,2,1603598400,1603598400,1
Seeker1995,0,1,0,1,1596254400,1596254400,1
Mistress_Jedana,0,1,0,2,1575522000,1575522000,1
BobbleDick,0,1,0,23,1594440000,1594440000,1
chaosking121,0,1,0,-13,1555387200,1555387200,1
NoUsername000000,0,1,0,-10,1595563200,1595563200,1
IAmARussianTrollAMA,0,1,0,5,1551675600,1551675600,1
MandyMisplaced,0,1,0,6,1601438400,1601438400,1
wellalbrighty,0,1,0,1,1589947200,1589947200,1
shreddedruins,0,1,0,2,1573534800,1573534800,1
cincystudent,0,1,0,105,1592971200,1592971200,1
cooldude581,0,1,0,2,1553140800,1553140800,1
QueenWho,0,1,0,4,1549602000,1549602000,1
SpenKick,0,1,0,3,1593921600,1593921600,1
pickleweaseldik,0,1,0,1,1608267600,1608267600,1
qnir2504,0,1,0,8,1579582800,1579582800,1
patsky,0,1,0,11,1585454400,1585454400,1
careerdbs,0,1,0,1,1607662800,1607662800,1
vigilani,0,1,0,5,1597896000,1597896000,1
minionmehappy,0,1,0,1,1590638400,1590638400,1
unsharpenedpoint,0,1,0,11,1598414400,1598414400,1
KinfDave,0,1,0,1,1582779600,1582779600,1
AlwaysSpeakTruth,0,1,0,8,1606712400,1606712400,1
Rikkas_Top_Fan,0,1,0,3,1605848400,1605848400,1
DrunkenGarfield,1,0,14,0,1572753600,1572753600,1
VerumFalsum,0,1,0,-1,1579064400,1579064400,1
FawFawtyFaw,0,1,0,1,1580274000,1580274000,1
gianlaurentis,0,1,0,15,1607576400,1607576400,1
neetrobot,0,1,0,3,1546491600,1546491600,1
thekidwiththefa,0,1,0,34,1589860800,1589860800,1
u_forgotboutdaold_me,0,1,0,-2,1573707600,1573707600,1
nickhollidayco,1,0,717,0,1595390400,1595390400,1
shoto9000,0,1,0,41,1547182800,1547182800,1
midlifewannabe,0,1,0,-7,1584763200,1584763200,1
NERDWebStudio,0,1,0,0,1591156800,1591156800,1
MajereOne,1,0,852,0,1598587200,1598587200,1
ladayen,0,1,0,33,1577336400,1577336400,1
somkkeshav555,0,1,0,1,1605157200,1605157200,1
ChicksDigPugs,0,1,0,0,1585454400,1585454400,1
nosliw_pilf,0,1,0,4,1601438400,1601438400,1
van_strife,0,1,0,3,1590897600,1590897600,1
newbornbliss,0,1,0,1,1598846400,1598846400,1
Dinaryor_Zenciti,0,1,0,2,1576904400,1576904400,1
dreamaboutdeath,0,1,0,3,1559620800,1559620800,1
snapwillow,0,1,0,1,1590120000,1590120000,1
Victorian_Astronaut,0,1,0,14,1580965200,1580965200,1
BEARS_BE_SCARY_MAN,0,1,0,-11,1585454400,1585454400,1
dyspverbre,1,0,1,0,1456635600,1456635600,1
max1599,0,1,0,4,1612069200,1612069200,1
free_is_free76,0,1,0,-4,1572235200,1572235200,1
NiceCheetah,0,1,0,88,1592884800,1592884800,1
lame_fake_news,0,1,0,6,1607662800,1607662800,1
HairyMetal,0,1,0,4,1578114000,1578114000,1
BrowardStoner,0,1,0,3,1584072000,1584072000,1
clomclom,0,1,0,18,1596513600,1596513600,1
TrundIe,0,1,0,5,1581570000,1581570000,1
KescarteDeJudica,0,1,0,2,1556337600,1556337600,1
Sniffylocket,0,1,0,1,1562299200,1562299200,1
Pauladanielle,0,1,0,13,1575176400,1575176400,1
DabbyDabber710,0,1,0,3,1604293200,1604293200,1
rudebii,0,1,0,2,1603512000,1603512000,1
moonandmtn,0,1,0,7,1607490000,1607490000,1
diphenhydrapeen,0,1,0,1,1563508800,1563508800,1
zamzam84,0,1,0,24,1601870400,1601870400,1
JustSomeBlondeBitch,0,1,0,27,1608699600,1608699600,1
ames98517_qq,1,0,1,0,1441425600,1441425600,1
Jameson1780,0,1,0,-6,1601524800,1601524800,1
HWR3057,0,1,0,1,1576645200,1576645200,1
kill3rkitty45,0,1,0,2,1577768400,1577768400,1
sb1862,1,0,0,0,1594958400,1594958400,1
flawlesshumanbean,0,1,0,1,1596340800,1596340800,1
snuggleallthekitties,0,1,0,2,1606539600,1606539600,1
APT69420,0,1,0,-3,1605502800,1605502800,1
Gaadoooouchee,0,1,0,7,1583211600,1583211600,1
Legendary_FDA,0,1,0,3,1584936000,1584936000,1
-Esper-,0,1,0,1,1609390800,1609390800,1
Ilvi,0,1,0,8,1563508800,1563508800,1
dinosaur_coding,0,1,0,13,1597982400,1597982400,1
Dogbeast,0,1,0,-1,1578373200,1578373200,1
eannb,0,1,0,4,1574053200,1574053200,1
memory_of_a_high,0,1,0,5,1606539600,1606539600,1
AlmostGoodEnough69,0,1,0,-1,1611982800,1611982800,1
LordAbendroth,0,1,0,1,1588996800,1588996800,1
Punkychipsahoy27,0,1,0,8,1599019200,1599019200,1
wtf785,1,0,19,0,1579842000,1579842000,1
Fishwithadeagle,0,1,0,7,1585454400,1585454400,1
TheOmniGlow,0,1,0,117,1588824000,1588824000,1
simbapande,0,1,0,8,1576731600,1576731600,1
thesportinglife,0,1,0,1,1589169600,1589169600,1
st3inbeiss,0,1,0,15,1565064000,1565064000,1
deadseaskrulls,0,1,0,5,1607403600,1607403600,1
queen_panic,0,1,0,12,1572667200,1572667200,1
tetrified,0,1,0,16,1605416400,1605416400,1
CelticElessar,0,1,0,368,1606971600,1606971600,1
WorseForWere,0,1,0,1,1606626000,1606626000,1
ciyaresh,0,1,0,2,1605589200,1605589200,1
Homelesslama,0,1,0,7,1550898000,1550898000,1
sausagepart,0,1,0,1,1605589200,1605589200,1
Spaceman1986,0,1,0,19,1569038400,1569038400,1
bopdaddy420,0,1,0,0,1603598400,1603598400,1
Helipilot22,0,1,0,6,1549342800,1549342800,1
shiny_octopus,1,0,357,0,1608008400,1608008400,1
Similar_Mess,0,1,0,3,1603598400,1603598400,1
MaxDanger69,0,1,0,-12,1584676800,1584676800,1
PM_Me_Your_Mouthhole,0,1,0,8,1591243200,1591243200,1
anothertwist,0,1,0,148,1601179200,1601179200,1
chitti-robot,0,1,0,-11,1604116800,1604116800,1
OSTSarahB,0,1,0,1,1609218000,1609218000,1
Top-Length5279,1,0,5,0,1608354000,1608354000,1
PM_ME_PICS_OF_HANDS,0,1,0,2,1570507200,1570507200,1
Chaotic_Useless,0,1,0,1,1598500800,1598500800,1
ashergerbilmaster,0,1,0,112,1592798400,1592798400,1
kloudykat,0,1,0,3,1604203200,1604203200,1
RapistDwarf,0,1,0,1,1556769600,1556769600,1
gmaOH,0,1,0,15,1597809600,1597809600,1
UnplugYourMind,0,1,0,15,1599537600,1599537600,1
Arik-Ironlatch,0,1,0,1,1598760000,1598760000,1
PopiEyy,0,1,0,-7,1608699600,1608699600,1
cubgerish,0,1,0,1,1582088400,1582088400,1
Marlinspikesailor,0,1,0,1,1592625600,1592625600,1
Metal-Panda,0,1,0,1,1609650000,1609650000,1
noobule,0,1,0,9,1585022400,1585022400,1
jacksonhinklebtoc,1,0,164,0,1593057600,1593057600,1
ProgressiveWoman,0,1,0,1,1573362000,1573362000,1
Malara62,0,1,0,10,1600142400,1600142400,1
cementedminds,0,1,0,1,1602129600,1602129600,1
bohanmyl,0,1,0,4,1585454400,1585454400,1
Doxoco,0,1,0,1,1574744400,1574744400,1
Nception_AnInsideJob,0,1,0,1,1608786000,1608786000,1
rynvincible,0,1,0,21,1607922000,1607922000,1
Shaggy0291,0,1,0,1,1582088400,1582088400,1
BruderKumar,1,0,442,0,1574485200,1574485200,1
2323andme,0,1,0,8,1567828800,1567828800,1
i_wnat_die,0,1,0,1,1558065600,1558065600,1
another_indiehead,0,1,0,2,1585627200,1585627200,1
coraseaborne,0,1,0,26,1560052800,1560052800,1
Thekilldevilhill,0,1,0,4,1576645200,1576645200,1
Rainbowcloud_,0,1,0,9,1608958800,1608958800,1
gaberich,0,1,0,1,1609304400,1609304400,1
isitAliens,0,1,0,0,1571803200,1571803200,1
anonmaku,0,1,0,1,1597118400,1597118400,1
Tactharon14,0,1,0,12,1576904400,1576904400,1
AshesMcRaven,0,1,0,7,1584763200,1584763200,1
Sir9toes,0,1,0,10,1549774800,1549774800,1
sillysorbet,1,0,5,0,1556424000,1556424000,1
amathie,0,1,0,1,1600315200,1600315200,1
iowhat,0,1,0,7,1596340800,1596340800,1
Paradigmkick,0,1,0,2,1556683200,1556683200,1
Dry_Pomegranate_1366,0,1,0,1,1607144400,1607144400,1
Annappa7,1,0,39,0,1594526400,1594526400,1
joe_dih,0,1,0,2,1603771200,1603771200,1
the_stalking_walrus,0,1,0,4,1607144400,1607144400,1
ivan774,0,1,0,3,1603857600,1603857600,1
Spartansniper,0,1,0,0,1571803200,1571803200,1
Sumisu18,0,1,0,1,1573621200,1573621200,1
cykelpedal,0,1,0,1,1605589200,1605589200,1
DreamsicleSwirl,0,1,0,5,1609304400,1609304400,1
andthenjsaid,0,1,0,2,1556078400,1556078400,1
pdabaker,0,1,0,1,1591329600,1591329600,1
niktemadur,0,1,0,1,1606626000,1606626000,1
Borichancho,0,1,0,1,1598932800,1598932800,1
The-Doom-Bringer,0,1,0,27,1584676800,1584676800,1
nate0515,0,1,0,2,1598068800,1598068800,1
Spaceman1stClass,0,1,0,2,1554868800,1554868800,1
BigGreenPeen,0,1,0,2,1612069200,1612069200,1
ThrashSurf,0,1,0,1,1543122000,1543122000,1
binb5213,1,0,650,0,1597118400,1597118400,1
SocktheMonkey,0,1,0,3,1573189200,1573189200,1
Cheer_for_corona,0,1,0,21,1595736000,1595736000,1
Nwsamurai,0,1,0,3,1599883200,1599883200,1
thatcleans13,0,1,0,2,1594440000,1594440000,1
Rusian_Bot,1,0,0,0,1565236800,1565236800,1
qcityhammer,0,1,0,17,1603512000,1603512000,1
vix0,1,0,38,0,1590638400,1590638400,1
underpressuretoparty,1,0,49,0,1611896400,1611896400,1
rm_-rf_slashstar,0,1,0,6,1604379600,1604379600,1
xxscorps,0,1,0,8,1569816000,1569816000,1
Custaslibrium,0,1,0,1,1593835200,1593835200,1
Thurkagord,0,1,0,22,1566792000,1566792000,1
SSJ_Dubs,0,1,0,3,1603684800,1603684800,1
DaTree3,0,1,0,19,1590379200,1590379200,1
bdlukerr,1,0,3,0,1607662800,1607662800,1
obnoxiouscomment,0,1,0,38,1584244800,1584244800,1
arcaneangel1,0,1,0,6,1582779600,1582779600,1
Radoen,0,1,0,-20,1575435600,1575435600,1
Hot-pocket-kid,0,1,0,0,1589083200,1589083200,1
taylormatt19,0,1,0,11,1563249600,1563249600,1
bombayblue,0,1,0,2,1591243200,1591243200,1
mgumscott,0,1,0,1,1608613200,1608613200,1
Dupree9973,0,1,0,-4,1602561600,1602561600,1
Slyde1988,0,1,0,1,1611982800,1611982800,1
mrGuar,0,1,0,-3,1605589200,1605589200,1
FertileCactus,0,1,0,1,1591329600,1591329600,1
RaveyWavey,0,1,0,2,1585454400,1585454400,1
haragoshi,0,1,0,1,1599796800,1599796800,1
COVID_IS_A_SHAM,1,0,97,0,1602475200,1602475200,1
Tier_Z,0,1,0,15,1612155600,1612155600,1
imares,0,1,0,1,1571889600,1571889600,1
luci_nebunu,0,1,0,2,1605502800,1605502800,1
AvengedTurtleFold,0,1,0,4,1596859200,1596859200,1
welcometothewierdkid,0,1,0,19,1597032000,1597032000,1
Low_Cancel_8684,0,1,0,1,1612069200,1612069200,1
lyra_silver,0,1,0,4,1603512000,1603512000,1
caseysmith80,0,1,0,3,1601870400,1601870400,1
kimchitits,0,1,0,2,1603512000,1603512000,1
d_jozzy,0,1,0,1,1634961600,1634961600,1
Dogfishhead789,0,1,0,1,1605589200,1605589200,1
philosopher217,1,0,62,0,1553313600,1553313600,1
TheEnchantedHunters,0,1,0,3,1603080000,1603080000,1
KontraKode,0,1,0,13,1547787600,1547787600,1
Verdant_Void,0,1,0,2,1611032400,1611032400,1
OhShitSonSon,0,1,0,0,1582088400,1582088400,1
SverhU,0,1,0,2,1605589200,1605589200,1
simmonslemons,0,1,0,3,1560484800,1560484800,1
cachiga12334487,0,1,0,1,1593921600,1593921600,1
zeluki,0,1,0,2,1575349200,1575349200,1
fAuLsBaLls,0,1,0,9,1548651600,1548651600,1
jhuskindle,0,1,0,4,1580101200,1580101200,1
Madscantakeabeating,0,1,0,1,1605762000,1605762000,1
flankse,0,1,0,174,1605589200,1605589200,1
NoIdeasSorry,0,1,0,11,1581224400,1581224400,1
JurJur,0,1,0,11,1563768000,1563768000,1
TrickyPG,0,1,0,3,1602043200,1602043200,1
Spacedude2187,0,1,0,1,1585108800,1585108800,1
that-will-do-piggle,0,1,0,3,1606712400,1606712400,1
HipHipJorge20NY,0,1,0,1,1599796800,1599796800,1
Zemeny,0,1,0,2,1601611200,1601611200,1
Lost-Function,1,0,17,0,1581570000,1581570000,1
Pretty-Ad-8533,0,1,0,2,1607317200,1607317200,1
actuallyz,0,1,0,79,1612069200,1612069200,1
KeldorEternia,0,1,0,29,1579410000,1579410000,1
reindoe12,0,1,0,2,1589860800,1589860800,1
Jegon-,0,1,0,2,1608872400,1608872400,1
cuemusicandlights,1,0,571,0,1569124800,1569124800,1
pumpkindufy,0,1,0,2,1600574400,1600574400,1
vanessa00010,0,1,0,2,1571716800,1571716800,1
Repulsive_Cancel2087,0,1,0,1,1608267600,1608267600,1
BashyHugo,0,1,0,4,1598760000,1598760000,1
IsraelZulu,1,0,1,0,1606194000,1606194000,1
BardaArmy,0,1,0,180,1605934800,1605934800,1
SaladChef,0,1,0,110,1595822400,1595822400,1
Anthoyne_Baratheon,1,0,14,0,1609304400,1609304400,1
tw_eee_d,0,1,0,8,1609218000,1609218000,1
BossanovaGreed,0,1,0,17,1573102800,1573102800,1
NazBol91,0,1,0,1,1582174800,1582174800,1
Zwibli,0,1,0,1,1606626000,1606626000,1
shinobipopcorn,0,1,0,15,1572148800,1572148800,1
DrinkingZima,0,1,0,0,1584763200,1584763200,1
Nochtilus,0,1,0,10,1602129600,1602129600,1
monkeylovesfire,0,1,0,9,1552622400,1552622400,1
hahanerds,0,1,0,1,1591329600,1591329600,1
galaxystarboss,0,1,0,53,1608699600,1608699600,1
WoodpeckerNo7581,0,1,0,1,1608267600,1608267600,1
LordYorric,0,1,0,10,1608267600,1608267600,1
mup_wave,0,1,0,1,1602129600,1602129600,1
Gabe_H_Cuod_,1,0,33,0,1601870400,1601870400,1
ArnoldNorris,0,1,0,-1,1608699600,1608699600,1
Fuzzyfrog420,0,1,0,6,1587096000,1587096000,1
ohnoquarantineee,0,1,0,3,1590033600,1590033600,1
Newsthief2,0,1,0,-1,1546405200,1546405200,1
WithOrgasmicFury,0,1,0,1,1606626000,1606626000,1
whitenoiseminis,0,1,0,267,1587009600,1587009600,1
Mission-Tie-5636,0,1,0,2,1604379600,1604379600,1
pjgf,0,1,0,2,1584244800,1584244800,1
starzuuuu,0,1,0,5,1603252800,1603252800,1
tuerk,0,1,0,7,1556510400,1556510400,1
WhatWouldJediDo,0,1,0,1,1608872400,1608872400,1
Pauhoihoi,0,1,0,5,1604984400,1604984400,1
babyhalloween,0,1,0,48,1605157200,1605157200,1
aetolica,0,1,0,2,1597291200,1597291200,1
IchEssEstrich,0,1,0,74,1608872400,1608872400,1
Stove-Top-Steve,0,1,0,2,1603512000,1603512000,1
liamblair87,0,1,0,3,1553313600,1553313600,1
NarutosBigBallsack,0,1,0,1,1608699600,1608699600,1
eggshellent,0,1,0,4,1589169600,1589169600,1
PoopEater10,0,1,0,24,1589256000,1589256000,1
benzobabie,0,1,0,14,1601956800,1601956800,1
HerbYergler,0,1,0,12,1578978000,1578978000,1
IMewco,0,1,0,5,1602907200,1602907200,1
DogObsessed94,0,1,0,8,1607058000,1607058000,1
InternationalBook501,0,1,0,1,1625025600,1625025600,1
Are_You_Coming_Up,0,1,0,0,1604116800,1604116800,1
oddella,0,1,0,1,1607835600,1607835600,1
NeonHairbrush,0,1,0,4,1578373200,1578373200,1
idontknowmyname84,0,1,0,3,1603598400,1603598400,1
Vagabond_Monroe,0,1,0,-6,1576645200,1576645200,1
SmallAsPluto,0,1,0,1,1602648000,1602648000,1
IndelibleFudge,0,1,0,27,1582347600,1582347600,1
Coronal_Data,0,1,0,5,1589083200,1589083200,1
DraugrLivesMatter,0,1,0,3,1611982800,1611982800,1
Chrispy8534,0,1,0,5,1603252800,1603252800,1
Lemonmuffing,0,1,0,6,1604984400,1604984400,1
saggysnatcher,0,1,0,0,1574053200,1574053200,1
Vectivus_61,0,1,0,2,1606021200,1606021200,1
master-chief242,0,1,0,1,1585454400,1585454400,1
histrante,0,1,0,2,1599019200,1599019200,1
Just_A_Pop_Tart,0,1,0,2,1566964800,1566964800,1
wh17,0,1,0,2,1589342400,1589342400,1
Enlerto76,0,1,0,1,1606366800,1606366800,1
LurkyLurks04982,0,1,0,6,1605589200,1605589200,1
Tyster20,0,1,0,1,1591070400,1591070400,1
pacifiedicecream,1,0,195,0,1606366800,1606366800,1
ghettithatspaghetti,0,1,0,-7,1579237200,1579237200,1
world_citizen7,0,1,0,1,1557201600,1557201600,1
lubbin604,0,1,0,1,1606626000,1606626000,1
Powerpython,0,1,0,8,1572408000,1572408000,1
Em101597,0,1,0,2,1573794000,1573794000,1
Pokemontriforce,0,1,0,10,1597982400,1597982400,1
birdbrained76,1,0,6,0,1601611200,1601611200,1
Working-nightmare,0,1,0,1,1605589200,1605589200,1
worldsdumbestman,0,1,0,1,1572843600,1572843600,1
shikamaru1ooo,0,1,0,3,1575003600,1575003600,1
Angkasa_Studio,1,0,70,0,1606626000,1606626000,1
Rsthrowaway256,0,1,0,1,1608786000,1608786000,1
treehouseladder,0,1,0,9,1600315200,1600315200,1
linux-nerd,0,1,0,2,1606021200,1606021200,1
Historical_Fact,0,1,0,5,1603512000,1603512000,1
Ihateasshats,0,1,0,1,1602734400,1602734400,1
thatswhattaysaid,0,1,0,1,1605157200,1605157200,1
Justsometerrible,0,1,0,16,1543122000,1543122000,1
nosiriamadreamer,0,1,0,8,1598846400,1598846400,1
skywheel93,0,1,0,1,1607662800,1607662800,1
jellyear,0,1,0,1,1571889600,1571889600,1
OneWittleWee-Wee,0,1,0,25,1609390800,1609390800,1
jimothybobcooter,0,1,0,-2,1591675200,1591675200,1
Kylegs17,0,1,0,1,1605502800,1605502800,1
TrumpetPapi,0,1,0,2,1609390800,1609390800,1
z_vlad,0,1,0,1,1610686800,1610686800,1
sgguitarist94,0,1,0,1,1605243600,1605243600,1
itchybutt29,0,1,0,1,1603512000,1603512000,1
halo_throwaway,0,1,0,89,1567310400,1567310400,1
Def_NotBoredAtWork,0,1,0,5,1602475200,1602475200,1
N4CCA,0,1,0,6,1594612800,1594612800,1
Hazeri,0,1,0,24,1569124800,1569124800,1
ucvcxc,0,1,0,6,1597291200,1597291200,1
pnutbutr5leepie5,1,0,63,0,1596772800,1596772800,1
jwilliams72,0,1,0,7,1546405200,1546405200,1
ColinHalter,0,1,0,1,1575349200,1575349200,1
fuckbombcore,0,1,0,0,1594267200,1594267200,1
Aaronsmiff,0,1,0,14,1576126800,1576126800,1
wowgamesarefun,0,1,0,4,1596513600,1596513600,1
kissedmusic,0,1,0,10,1577941200,1577941200,1
cumlord_tittyfuck,0,1,0,2,1563508800,1563508800,1
PiratusInteruptus,0,1,0,0,1589947200,1589947200,1
melliott90,0,1,0,3,1598932800,1598932800,1
_throawayplop_,0,1,0,3,1464580800,1464580800,1
dio-3,0,1,0,10,1584590400,1584590400,1
saadx71,1,0,2,0,1595563200,1595563200,1
nullisvoid,0,1,0,1,1597723200,1597723200,1
Allisontrans,0,1,0,12,1595131200,1595131200,1
trululaso,0,1,0,3,1549342800,1549342800,1
Jxshy12,0,1,0,71,1605157200,1605157200,1
Lydianod,0,1,0,5,1607230800,1607230800,1
AngelicVI,0,1,0,1,1607403600,1607403600,1
LeonTrig,0,1,0,10,1572408000,1572408000,1
Megaflorch,0,1,0,2,1606539600,1606539600,1
JosephMeach,0,1,0,3,1599451200,1599451200,1
mikevem,0,1,0,-3,1603598400,1603598400,1
WEEJEETHELEEGEE,0,1,0,3,1601956800,1601956800,1
Myllicent,0,1,0,17,1600574400,1600574400,1
sweat119,0,1,0,20,1606626000,1606626000,1
ballzak0206,0,1,0,4,1589860800,1589860800,1
walkertxrg,0,1,0,1,1584763200,1584763200,1
ModernSlavesClockIn,0,1,0,1,1603598400,1603598400,1
NebelVanDushmer,0,1,0,1,1589947200,1589947200,1
InternetLumberjack,0,1,0,2,1574312400,1574312400,1
Funklestein,0,1,0,-4,1609131600,1609131600,1
Timely_Dirt,0,1,0,1,1584590400,1584590400,1
Esham1237,0,1,0,1,1608786000,1608786000,1
HurricaneBatman,0,1,0,3,1604379600,1604379600,1
Alcaeus89,0,1,0,1,1513918800,1513918800,1
The-Fox-Says,0,1,0,1,1605070800,1605070800,1
MaraEmerald,0,1,0,2,1597809600,1597809600,1
Wumpus2003,0,1,0,12,1585022400,1585022400,1
Pokeputin,0,1,0,1,1607922000,1607922000,1
Apple_butters12,0,1,0,5,1593057600,1593057600,1
Choice-Software,0,1,0,2,1587528000,1587528000,1
MZ_swaggo,0,1,0,4,1582002000,1582002000,1
Jodom87,0,1,0,1,1591156800,1591156800,1
rmbzbrenden,0,1,0,-9,1601870400,1601870400,1
Spingebill1812Part3,0,1,0,3,1590465600,1590465600,1
TheMightyWaffle,0,1,0,2,1584158400,1584158400,1
jjjjll3754,0,1,0,2,1598760000,1598760000,1
Mattreddit760,0,1,0,2,1581915600,1581915600,1
Throw0140,0,1,0,1,1591502400,1591502400,1
MotorButterscotch,0,1,0,1,1576645200,1576645200,1
NibAttackArt,1,0,4,0,1584331200,1584331200,1
bi11ytheg0at,0,1,0,5,1575349200,1575349200,1
DoItRiight,0,1,0,1,1598846400,1598846400,1
Truegamerdude,0,1,0,2,1601956800,1601956800,1
ryeguyrides_,0,1,0,1,1605589200,1605589200,1
mandasaurrr,0,1,0,1,1589860800,1589860800,1
BigPawh,0,1,0,6,1603598400,1603598400,1
ProdigyMidnight,0,1,0,1,1592798400,1592798400,1
the_Athenian_Enigma,0,1,0,2,1585800000,1585800000,1
mikezulu90,0,1,0,1,1605589200,1605589200,1
teblor,0,1,0,5,1567051200,1567051200,1
Jeremiahtheprincess,0,1,0,1,1602302400,1602302400,1
mwm91,0,1,0,4,1582779600,1582779600,1
glasswalker,0,1,0,1,1594612800,1594612800,1
notcreative7788,0,1,0,5,1591329600,1591329600,1
Waldo414,0,1,0,1,1608267600,1608267600,1
Zen_Badger,0,1,0,2,1580101200,1580101200,1
mollyleejames,0,1,0,1,1601352000,1601352000,1
wormholeTaco,0,1,0,135,1574571600,1574571600,1
smileyjunction,1,0,33,0,1538625600,1538625600,1
Dylantheshoe,0,1,0,6,1606021200,1606021200,1
justnoyellow,0,1,0,8,1592280000,1592280000,1
nictytan,0,1,0,9,1574830800,1574830800,1
NlGGABIGPENIS3,0,1,0,2,1609390800,1609390800,1
kamikageyami,0,1,0,3,1579150800,1579150800,1
Spider4Hire,0,1,0,1,1589947200,1589947200,1
TheGoodOldCoder,0,1,0,-3,1605934800,1605934800,1
godofpie,0,1,0,48,1577509200,1577509200,1
spindlecork,0,1,0,2,1605934800,1605934800,1
EmotionSuccessful345,0,1,0,1,1603512000,1603512000,1
braujo,0,1,0,8,1602129600,1602129600,1
involceli,0,1,0,14,1603512000,1603512000,1
Bossez,0,1,0,3,1583985600,1583985600,1
aaandbconsulting,0,1,0,1,1591329600,1591329600,1
ShortPreciseEasy,0,1,0,4,1576386000,1576386000,1
Deltadragonoid225,0,1,0,0,1582779600,1582779600,1
velvetbladeofapathy,0,1,0,1,1591243200,1591243200,1
Itwasallahdream,1,0,33,0,1594958400,1594958400,1
jbwalton7,0,1,0,0,1600228800,1600228800,1
odlebees,0,1,0,3,1584244800,1584244800,1
WhatDoesThatDoAgain,0,1,0,2,1582952400,1582952400,1
onlymarquis,0,1,0,2,1583211600,1583211600,1
thoptergifts,0,1,0,6,1606453200,1606453200,1
SirDeeznuts,0,1,0,1,1605243600,1605243600,1
Tsitsiripitsitsiri,0,1,0,1,1579064400,1579064400,1
17219640,0,1,0,-29,1584504000,1584504000,1
TrumpPnisTiny,1,0,53,0,1597377600,1597377600,1
Carrie195,0,1,0,2,1594440000,1594440000,1
improbablyonthepot,0,1,0,2,1584936000,1584936000,1
preyingmantis11,0,1,0,6,1597809600,1597809600,1
skooz1383,0,1,0,29,1603684800,1603684800,1
xkikue,0,1,0,1,1585454400,1585454400,1
No_Principle_5177,0,1,0,1,1602648000,1602648000,1
puck411,0,1,0,0,1603512000,1603512000,1
pellets,0,1,0,1,1598068800,1598068800,1
fire2374,0,1,0,17,1608613200,1608613200,1
icyauq,0,1,0,4,1583643600,1583643600,1
Hereforpowerwashing,0,1,0,3,1611982800,1611982800,1
trapp2504,0,1,0,1,1576558800,1576558800,1
Truffluscious,0,1,0,1,1635480000,1635480000,1
chachasloot,0,1,0,40,1606539600,1606539600,1
Colon-Blo,0,1,0,2,1593748800,1593748800,1
shobbsy,0,1,0,3,1591934400,1591934400,1
sabayoub,0,1,0,23,1566532800,1566532800,1
miffekke,1,0,12,0,1527912000,1527912000,1
AnalMayonnaise,0,1,0,4,1559188800,1559188800,1
DaSlowMotionPimpSlap,0,1,0,1,1592452800,1592452800,1
FantasticElk,0,1,0,3,1612069200,1612069200,1
cloutgod666,0,1,0,2,1578805200,1578805200,1
Jessi30,0,1,0,11,1543294800,1543294800,1
Drunk_Dwarf,0,1,0,93,1603512000,1603512000,1
jempai,0,1,0,2,1606626000,1606626000,1
Mountain-Research,1,0,8,0,1579150800,1579150800,1
Bumblebee_assassin,0,1,0,4,1575435600,1575435600,1
SAGNUTZ,0,1,0,1,1605589200,1605589200,1
DismalRespect,0,1,0,7,1593489600,1593489600,1
Tayssti,0,1,0,53,1569988800,1569988800,1
greatwhitehuntr,0,1,0,14,1602734400,1602734400,1
nigeltuffnell,0,1,0,1,1611982800,1611982800,1
swen72,0,1,0,2,1608786000,1608786000,1
Skkruff,0,1,0,4,1598068800,1598068800,1
ShutupJulie,0,1,0,2,1594353600,1594353600,1
callingallplotters,1,0,10,0,1575781200,1575781200,1
rt262,0,1,0,4,1584936000,1584936000,1
HoldExciting7551,0,1,0,5,1605589200,1605589200,1
TastyItalianPie,0,1,0,5,1557288000,1557288000,1
BillOfArimathea,0,1,0,3,1607922000,1607922000,1
LogicalEmotion7,0,1,0,7,1600142400,1600142400,1
paywallpiker,1,0,65,0,1605243600,1605243600,1
iforgotagain_tf,0,1,0,3,1608440400,1608440400,1
Mareks,0,1,0,-1,1596427200,1596427200,1
villianous_entropy,0,1,0,1,1605416400,1605416400,1
c_ferox,0,1,0,1,1604811600,1604811600,1
orangemanbad2020-,0,1,0,1,1601352000,1601352000,1
npfrnr,0,1,0,18,1559707200,1559707200,1
IthinkImanegg,0,1,0,2,1606971600,1606971600,1
wbrooksga,0,1,0,2,1605070800,1605070800,1
RussianEnthusiast,0,1,0,10,1607662800,1607662800,1
savetheseeds7,0,1,0,-1,1591243200,1591243200,1
silkymitts_toptits,0,1,0,42,1562644800,1562644800,1
_kernel-panic_,0,1,0,2,1577509200,1577509200,1
Schoupen,0,1,0,2,1582088400,1582088400,1
leisure_browsing,0,1,0,98,1580101200,1580101200,1
strongermilk,0,1,0,4,1604293200,1604293200,1
Golgothan10,0,1,0,-6,1590033600,1590033600,1
Al_Timmiter,0,1,0,3,1561348800,1561348800,1
teniaava,0,1,0,11,1577422800,1577422800,1
Baneandy,0,1,0,1,1595908800,1595908800,1
SnooRegrets6104,0,1,0,1,1600747200,1600747200,1
yubgjottrrfbjii,0,1,0,-4,1581656400,1581656400,1
ricar321,0,1,0,3,1608958800,1608958800,1
prqlosh,1,0,1,0,1552881600,1552881600,1
ZedCorner,0,1,0,31,1608440400,1608440400,1
InfiniteAvarice,0,1,0,1,1606626000,1606626000,1
anotherana,0,1,0,5,1580878800,1580878800,1
baevard,0,1,0,16,1574571600,1574571600,1
UncleJohnsBandito,0,1,0,39,1604984400,1604984400,1
Signal-Commercial,0,1,0,-2,1605934800,1605934800,1
miseryside,0,1,0,2,1609390800,1609390800,1
ZinZorius312,0,1,0,0,1603512000,1603512000,1
Fletch_e_Fletch,0,1,0,11,1608786000,1608786000,1
ringu68,0,1,0,3,1573534800,1573534800,1
Gr4Fi,1,0,16,0,1589256000,1589256000,1
Overitallforyears,0,1,0,2,1611896400,1611896400,1
dayton-dangler,0,1,0,1,1601870400,1601870400,1
CatSoda500,0,1,0,1,1588996800,1588996800,1
calmboi4life,0,1,0,1,1608526800,1608526800,1
MidnightChocolare42,0,1,0,1,1636434000,1636434000,1
-Tastydactyl-,0,1,0,3,1585454400,1585454400,1
seunghyong,0,1,0,2,1588305600,1588305600,1
Grillbrik,0,1,0,3,1604811600,1604811600,1
run____dmt,0,1,0,7,1596772800,1596772800,1
Traskk01,0,1,0,3,1581915600,1581915600,1
Timwi,0,1,0,13,1548651600,1548651600,1
XYAgain,0,1,0,5,1591934400,1591934400,1
rad2themax,0,1,0,3,1608354000,1608354000,1
tylerjanez666,0,1,0,5,1602043200,1602043200,1
RicknMorty93,1,0,14,0,1577077200,1577077200,1
abayparak,0,1,0,1,1608872400,1608872400,1
rftaylor26,0,1,0,4,1603512000,1603512000,1
Abogachi,0,1,0,6,1553572800,1553572800,1
Perceptes,0,1,0,-8,1561608000,1561608000,1
gifv-bot,0,1,0,1,1551157200,1551157200,1
My_Dude_Whats_Up,0,1,0,3,1545800400,1545800400,1
EvilOverlord95,0,1,0,13,1578286800,1578286800,1
OknotKo,0,1,0,2,1584158400,1584158400,1
bb-jmm,0,1,0,-2,1592798400,1592798400,1
AcidHead1312,0,1,0,10,1595217600,1595217600,1
dineshdb,0,1,0,1,1569038400,1569038400,1
SawdustSparky,0,1,0,1,1606539600,1606539600,1
Nukima11,0,1,0,1,1593835200,1593835200,1
Nickyfyrre,0,1,0,2,1605762000,1605762000,1
davdev,0,1,0,3,1606366800,1606366800,1
badsolid,0,1,0,1,1572494400,1572494400,1
TurdWaterMagee,0,1,0,362,1597464000,1597464000,1
CialisForCereal,0,1,0,1,1609390800,1609390800,1
MadMike2421,0,1,0,8,1608786000,1608786000,1
Squidy_The_Druid,0,1,0,-23,1583470800,1583470800,1
eleanor_vance,0,1,0,41,1596168000,1596168000,1
banjovial1,0,1,0,61,1570852800,1570852800,1
nick_3344,0,1,0,2,1607662800,1607662800,1
Collinnn7,0,1,0,24,1607749200,1607749200,1
foxontherox,0,1,0,3,1601352000,1601352000,1
Estevaozinho,0,1,0,7,1601179200,1601179200,1
jmshaker,0,1,0,6,1576731600,1576731600,1
a-single-aids,0,1,0,1,1604379600,1604379600,1
ProbablyInadvisable,0,1,0,28,1570766400,1570766400,1
rusty_ear,0,1,0,0,1598760000,1598760000,1
AlwaysCommentsYes,0,1,0,1,1623038400,1623038400,1
scaredhorrorqueer,0,1,0,31,1580101200,1580101200,1
SneaksinBackDoor,0,1,0,1,1603512000,1603512000,1
roskatili,0,1,0,1,1603684800,1603684800,1
IronMikeJonez,0,1,0,1,1618718400,1618718400,1
YungWhetScissors,0,1,0,1,1615438800,1615438800,1
CorrectMyBadGrammar,0,1,0,36,1579150800,1579150800,1
gezginorman,0,1,0,14,1598328000,1598328000,1
baumpop,0,1,0,-4,1604552400,1604552400,1
gzintu,0,1,0,1,1600228800,1600228800,1
flowerycoward,0,1,0,1,1561953600,1561953600,1
webrem01,0,1,0,1,1585108800,1585108800,1
barsoapguy,0,1,0,-2,1596513600,1596513600,1
_Ocean_Machine_,0,1,0,7,1609045200,1609045200,1
Still_Day,0,1,0,3,1580533200,1580533200,1
spacecyborg,1,0,57,0,1532577600,1532577600,1
Invalid_Specimen,0,1,0,18,1575176400,1575176400,1
nosportsosourdough,0,1,0,9,1605848400,1605848400,1
Redditadminsaregey,0,1,0,5,1582088400,1582088400,1
k9centipede,0,1,0,32,1598846400,1598846400,1
PollyannaPenny,0,1,0,1,1607576400,1607576400,1
dreamer273,0,1,0,6,1562299200,1562299200,1
MonkAndCanatella,0,1,0,1,1605243600,1605243600,1
2t3093202,0,1,0,1,1591243200,1591243200,1
Ambiguous_Cat_Hat,0,1,0,9,1586577600,1586577600,1
letitrollpanda,0,1,0,2,1601352000,1601352000,1
John_-_Galt,0,1,0,2,1554436800,1554436800,1
DO_NOT_RESUREKT,0,1,0,4,1587268800,1587268800,1
AForestPath,0,1,0,51,1608094800,1608094800,1
HeavyMetalGoat,0,1,0,-2,1583899200,1583899200,1
EQOA_Fanatic,0,1,0,1,1614315600,1614315600,1
Zzoozz11,0,1,0,4,1570334400,1570334400,1
paperplasticrock,0,1,0,3,1574139600,1574139600,1
LinaIsLoveley,1,0,24,0,1591675200,1591675200,1
Warhawk_1,0,1,0,2,1554523200,1554523200,1
sorgan71,0,1,0,1,1591156800,1591156800,1
southside_sue,1,0,3,0,1592798400,1592798400,1
errorblankfield,0,1,0,11,1584676800,1584676800,1
Voikona,0,1,0,16,1587873600,1587873600,1
pickledpipids,0,1,0,1,1604379600,1604379600,1
Ginger_Badger,0,1,0,1,1587268800,1587268800,1
Guppy60,0,1,0,3,1591848000,1591848000,1
fonyboy,0,1,0,2,1606539600,1606539600,1
systematico,0,1,0,4,1574571600,1574571600,1
kobrakalmani,0,1,0,3,1554264000,1554264000,1
LooseWetCheeks,0,1,0,1,1585108800,1585108800,1
ContentShop,0,1,0,4,1558497600,1558497600,1
dead_labour,0,1,0,-2,1548478800,1548478800,1
touchfeel,1,0,20,0,1611810000,1611810000,1
MarcusFree,0,1,0,2,1591329600,1591329600,1
Foxwildernes,0,1,0,-1,1606539600,1606539600,1
spidermonkey12345,0,1,0,6,1583643600,1583643600,1
420weed_adict,0,1,0,-18,1605934800,1605934800,1
M5lara,0,1,0,2,1574398800,1574398800,1
samthekid108,0,1,0,1,1585454400,1585454400,1
VladimirBuufin,0,1,0,1,1608440400,1608440400,1
Druinix,0,1,0,12,1595390400,1595390400,1
brelior,0,1,0,3,1570248000,1570248000,1
Pogobong,0,1,0,10,1577941200,1577941200,1
McCallister,0,1,0,2,1556251200,1556251200,1
RingGiver,0,1,0,2,1559448000,1559448000,1
StrategyHog,0,1,0,31,1579323600,1579323600,1
covrep,0,1,0,0,1605762000,1605762000,1
BiggestEgg,0,1,0,1,1590638400,1590638400,1
Khalil8991,0,1,0,5,1573621200,1573621200,1
Tough_Rhubarb_3126,0,1,0,3,1603598400,1603598400,1
Xer0lith,0,1,0,1,1584417600,1584417600,1
eni0011,0,1,0,16,1575435600,1575435600,1
Dolmeister24,0,1,0,1,1607576400,1607576400,1
kei0145,0,1,0,1,1607058000,1607058000,1
deflateddefeated,1,0,35,0,1591416000,1591416000,1
acstorer,1,0,1,0,1456549200,1456549200,1
playful_pachyderm,0,1,0,2,1556596800,1556596800,1
theGunslinger94,0,1,0,1,1571112000,1571112000,1
CatchAlbright,0,1,0,4,1606539600,1606539600,1
Deablo96,0,1,0,1,1608699600,1608699600,1
EvilLemur4,0,1,0,1,1602475200,1602475200,1
_Deekus_,0,1,0,2,1606626000,1606626000,1
JasonRevelation,0,1,0,1,1603684800,1603684800,1
castleofwar,0,1,0,1,1600747200,1600747200,1
CrashingWhips,0,1,0,0,1598241600,1598241600,1
HaoYan85,0,1,0,5,1599969600,1599969600,1
Zokhanov,0,1,0,2,1582347600,1582347600,1
mezzclizcx,0,1,0,1,1550379600,1550379600,1
BlandTomato,0,1,0,0,1603512000,1603512000,1
rindcorp,0,1,0,4,1582174800,1582174800,1
supercaloebarbadensi,0,1,0,3,1598068800,1598068800,1
meep_meep_creep,0,1,0,6,1560744000,1560744000,1
snoring_is_sexy,0,1,0,0,1593316800,1593316800,1
whizkerbiscuit,0,1,0,422,1602388800,1602388800,1
Myis,0,1,0,3,1551675600,1551675600,1
kbne8136,0,1,0,3,1515387600,1515387600,1
CosbyAndTheJuice,0,1,0,-7,1606021200,1606021200,1
Stephen_Hawkins,0,1,0,12,1577422800,1577422800,1
KarathSolus,0,1,0,4,1605589200,1605589200,1
unavoidably_canadian,0,1,0,1,1600574400,1600574400,1
bellasahbella,0,1,0,30,1580446800,1580446800,1
aaliya-marie,0,1,0,2,1603512000,1603512000,1
dbhalberg,0,1,0,1,1579064400,1579064400,1
five7off,0,1,0,2,1603512000,1603512000,1
ipissonrebelgraves-,0,1,0,1,1599105600,1599105600,1
TetrisMcKenna,0,1,0,2,1600228800,1600228800,1
the_never_mind,0,1,0,-2,1592107200,1592107200,1
oktwentyfive,0,1,0,1,1605848400,1605848400,1
burneracct21,0,1,0,3,1593835200,1593835200,1
sideaccountguy,0,1,0,14,1605589200,1605589200,1
wickedweaver345,0,1,0,2,1599796800,1599796800,1
Beldor,0,1,0,2,1603512000,1603512000,1
Jervis_TheOddOne,0,1,0,0,1591329600,1591329600,1
justsomematteblack,0,1,0,3,1608613200,1608613200,1
0odalolly,0,1,0,1,1603598400,1603598400,1
BobSagetOoosh,0,1,0,1,1562731200,1562731200,1
peanutbuttertheif,0,1,0,3,1559275200,1559275200,1
gundealsgopnik,0,1,0,1,1603512000,1603512000,1
chrisblink182,0,1,0,1,1608786000,1608786000,1
Tenien,0,1,0,1,1591156800,1591156800,1
G-H-O-S-T,0,1,0,14,1581138000,1581138000,1
Environmental_Owl231,0,1,0,2,1612069200,1612069200,1
Bathroomious,0,1,0,2,1581915600,1581915600,1
MrHelloBye,0,1,0,22,1595476800,1595476800,1
beepBipBopBoopBup,0,1,0,10,1607576400,1607576400,1
DarwinsMonkeyOne,0,1,0,21,1591502400,1591502400,1
Thrwawayrandoasshole,0,1,0,1,1578632400,1578632400,1
Northsole16,0,1,0,7,1576645200,1576645200,1
Francophone1,0,1,0,2,1605416400,1605416400,1
DJMu3L,0,1,0,12,1564200000,1564200000,1
Eaxl94,0,1,0,7,1588219200,1588219200,1
sgkorina,0,1,0,8,1606539600,1606539600,1
desacralize,0,1,0,7,1603425600,1603425600,1
svullenballe,0,1,0,1,1562299200,1562299200,1
GreenRanger4POTUS,0,1,0,-7,1587873600,1587873600,1
TellerOfLongStories,0,1,0,4,1556424000,1556424000,1
jarroddibell,0,1,0,2,1594872000,1594872000,1
linkanight,0,1,0,22,1595822400,1595822400,1
BeagleWorld,0,1,0,3,1587614400,1587614400,1
SigaVa,0,1,0,0,1581224400,1581224400,1
miraakismydaddy,1,0,23,0,1582606800,1582606800,1
Bulgref,0,1,0,1,1597636800,1597636800,1
FaroutEagle,0,1,0,-19,1609390800,1609390800,1
TheShyGuys,0,1,0,3,1569124800,1569124800,1
dogmeat1981,0,1,0,1,1572494400,1572494400,1
barebarehere,0,1,0,2,1582779600,1582779600,1
Lilithiumandias,0,1,0,17,1605675600,1605675600,1
EmpunktAtze,0,1,0,1,1605070800,1605070800,1
Apprehensive_Text,0,1,0,1,1570420800,1570420800,1
economixed,0,1,0,3,1596859200,1596859200,1
eternalgreeng,0,1,0,1,1572843600,1572843600,1
thatdilf,0,1,0,1,1566792000,1566792000,1
37sucksballs,0,1,0,1,1601352000,1601352000,1
goldeean,0,1,0,1,1587096000,1587096000,1
datches89,0,1,0,3,1584158400,1584158400,1
throwitawey111,0,1,0,30,1604811600,1604811600,1
random_redditor_05,0,1,0,1,1583470800,1583470800,1
Yeti-inspaghetti,1,0,390,0,1583557200,1583557200,1
act_surprised,0,1,0,7,1578114000,1578114000,1
forcollegelol,0,1,0,1,1619755200,1619755200,1
rab-byte,0,1,0,79,1559016000,1559016000,1
chintu_8484,0,1,0,2,1599624000,1599624000,1
cockandb0lls,0,1,0,1,1605934800,1605934800,1
SpinPhysicians,0,1,0,10,1599451200,1599451200,1
TheCoolerSeiver,0,1,0,1,1603512000,1603512000,1
dingledangleboys,0,1,0,3,1591416000,1591416000,1
nondualthinking,0,1,0,10,1540958400,1540958400,1
Kadinator,0,1,0,1,1592798400,1592798400,1
BillyBigCancer9000,0,1,0,0,1601438400,1601438400,1
Innoculos,0,1,0,1,1602561600,1602561600,1
SnowBunnyEinar,0,1,0,1,1603512000,1603512000,1
willyj_3,0,1,0,1,1598760000,1598760000,1
askforthewolfman,0,1,0,2,1608094800,1608094800,1
BearBL,0,1,0,6,1599278400,1599278400,1
eighteennorth,0,1,0,1,1609390800,1609390800,1
Throwaway4755743,1,0,8,0,1586059200,1586059200,1
PlagueChef,0,1,0,2,1604293200,1604293200,1
thefloatingpoint,0,1,0,2,1599796800,1599796800,1
gameline443,0,1,0,0,1605070800,1605070800,1
im_nice_trust_me,0,1,0,3,1575262800,1575262800,1
BeansWorther,0,1,0,2,1594267200,1594267200,1
Billiam-Shakespeare,0,1,0,2,1605502800,1605502800,1
AnOGUsername,0,1,0,-1,1606626000,1606626000,1
_yourstruly,1,0,9,0,1601611200,1601611200,1
iloveokashi,0,1,0,2,1609045200,1609045200,1
32tfy,1,0,39,0,1499054400,1499054400,1
no1elseisdointhis,1,0,13,0,1603080000,1603080000,1
Truthamania,0,1,0,1,1603512000,1603512000,1
suitandcry,0,1,0,1,1591934400,1591934400,1
xxxn00bslay3rxxx,0,1,0,1,1600747200,1600747200,1
pineapple-midwife,0,1,0,48,1604293200,1604293200,1
MiserereMeiImperator,0,1,0,3,1607835600,1607835600,1
MarkingMan,0,1,0,7,1598760000,1598760000,1
OutlawJessie,0,1,0,1,1581397200,1581397200,1
Monbro1,0,1,0,4,1579064400,1579064400,1
krashmo,0,1,0,4,1611896400,1611896400,1
enterprisebestgirl,0,1,0,68,1604203200,1604203200,1
foe-slat-nem,0,1,0,-4,1605330000,1605330000,1
MacTheBeastLee,0,1,0,2,1607749200,1607749200,1
Keepcalmandbakeon,0,1,0,13,1611810000,1611810000,1
ernsehe,0,1,0,29,1572148800,1572148800,1
LaVidaYokel,0,1,0,10,1602043200,1602043200,1
redgreenblue5978,0,1,0,3,1607576400,1607576400,1
vicariouscheese,0,1,0,1,1604030400,1604030400,1
IcyHooligan,0,1,0,4,1594612800,1594612800,1
MTS2021,0,1,0,1,1582952400,1582952400,1
scoutsout71,0,1,0,3,1600056000,1600056000,1
friedsweetpatotie,0,1,0,3,1600488000,1600488000,1
liquidnitrogentakes,0,1,0,1,1572667200,1572667200,1
Dokterrock,0,1,0,24,1559620800,1559620800,1
Mrdingawing,0,1,0,1,1562990400,1562990400,1
BojackWorseman13,0,1,0,5,1643259600,1643259600,1
tastycakes13,0,1,0,19,1597550400,1597550400,1
Truewit_,0,1,0,63,1609131600,1609131600,1
LobsterSauce420,0,1,0,6,1569902400,1569902400,1
GmailMachine,0,1,0,1,1574226000,1574226000,1
Pr0_Laps3,0,1,0,32,1598068800,1598068800,1
_masterofnone_,0,1,0,3,1600315200,1600315200,1
theveryfiber,0,1,0,7,1591329600,1591329600,1
RedBeard695,0,1,0,7,1572580800,1572580800,1
givemesweaters,0,1,0,40,1602820800,1602820800,1
mike_sl,0,1,0,25,1603512000,1603512000,1
Haflingers,1,0,27,0,1580014800,1580014800,1
IntrovertedSpace,0,1,0,13,1584072000,1584072000,1
HebrewBear808,0,1,0,1,1603512000,1603512000,1
Makzemann,0,1,0,6,1589601600,1589601600,1
Shoddy_Day,0,1,0,1,1577422800,1577422800,1
Lucktar,0,1,0,17,1600574400,1600574400,1
evillover2020,0,1,0,0,1593316800,1593316800,1
hopesmeels,0,1,0,6,1571976000,1571976000,1
Kubrickian75,0,1,0,1,1604725200,1604725200,1
DrMatt73,0,1,0,4,1608872400,1608872400,1
Little-Helper,0,1,0,2,1603512000,1603512000,1
GeminiiQueen24,0,1,0,4,1609390800,1609390800,1
squarechilli,0,1,0,1,1615266000,1615266000,1
nandeEbisu,0,1,0,36,1573707600,1573707600,1
stitchinspace,0,1,0,4,1599537600,1599537600,1
quacktheskye,0,1,0,1,1571544000,1571544000,1
lol_lsc_1234,1,0,0,0,1583557200,1583557200,1
catpiss_backpack,0,1,0,0,1600574400,1600574400,1
CaptThunderThighs,0,1,0,3,1605934800,1605934800,1
exo_42069,0,1,0,2,1581310800,1581310800,1
KeyTrouble,0,1,0,9,1572843600,1572843600,1
gated73,0,1,0,1,1559188800,1559188800,1
redcubes,0,1,0,9,1607835600,1607835600,1
Homebench,0,1,0,2,1563163200,1563163200,1
REDX459,0,1,0,2,1578978000,1578978000,1
tomastaz,0,1,0,0,1593662400,1593662400,1
jnux,0,1,0,4,1600574400,1600574400,1
Jacobin_Revolt,0,1,0,157,1584072000,1584072000,1
mafck,0,1,0,-14,1585022400,1585022400,1
GrandComfortable9,0,1,0,8,1594612800,1594612800,1
lovemysnuggles,0,1,0,27,1598068800,1598068800,1
construction_zone,0,1,0,5,1605934800,1605934800,1
meme_mixtape,0,1,0,15,1554696000,1554696000,1
World_Navel,0,1,0,2,1603512000,1603512000,1
acnhberry,0,1,0,1,1591761600,1591761600,1
D3adlywithap3n,0,1,0,11,1606798800,1606798800,1
danthedustbin,0,1,0,3,1597204800,1597204800,1
MetadonDrelle,0,1,0,1,1568606400,1568606400,1
edwartica,0,1,0,2,1605589200,1605589200,1
plumcove,0,1,0,7,1559188800,1559188800,1
drunkguy691,0,1,0,2,1571544000,1571544000,1
namtok_muu,0,1,0,4,1591502400,1591502400,1
atapeworm12,0,1,0,1,1603512000,1603512000,1
goo_goo_gajoob,0,1,0,2,1601524800,1601524800,1
raosahabreddits,0,1,0,3,1607835600,1607835600,1
ThePersonYouHate,0,1,0,4,1584590400,1584590400,1
jkh77,0,1,0,1,1605243600,1605243600,1
4bh4y51ngh,0,1,0,1,1601179200,1601179200,1
Lexi_Banner,0,1,0,1,1604379600,1604379600,1
SheepishWino,0,1,0,1,1531108800,1531108800,1
amriescott,0,1,0,8,1584158400,1584158400,1
AliceIo,0,1,0,4,1596340800,1596340800,1
PoopingInPittsburgh,0,1,0,8,1598328000,1598328000,1
anotherguy252,0,1,0,2,1585195200,1585195200,1
Atticus_Grinch_,1,0,4756,0,1582606800,1582606800,1
Sigur024,1,0,8,0,1575262800,1575262800,1
GreatRedCatTheThird,0,1,0,7,1587441600,1587441600,1
TepidConclusion,0,1,0,1,1557720000,1557720000,1
-sorry-not-sorry-,0,1,0,1,1603684800,1603684800,1
westachilles,0,1,0,2,1603598400,1603598400,1
FiFoNiTo,0,1,0,3,1570939200,1570939200,1
cakenaow,0,1,0,1,1567137600,1567137600,1
imbeingcyberstalked,1,0,33,0,1551157200,1551157200,1
foolskiss,0,1,0,20,1598155200,1598155200,1
zomb1e-dust,0,1,0,9,1581483600,1581483600,1
SchnickFitzel147,0,1,0,7,1567656000,1567656000,1
zacisawhale,0,1,0,1,1600660800,1600660800,1
pitchinloafs,0,1,0,22,1602820800,1602820800,1
crysas64,0,1,0,2,1576904400,1576904400,1
bot-ama,0,1,0,8,1573621200,1573621200,1
chef2sandwich,1,0,15,0,1596254400,1596254400,1
BloodMoonTea,0,1,0,-4,1562126400,1562126400,1
Advicespice,0,1,0,1,1593057600,1593057600,1
curiouslycaroline,0,1,0,4,1598414400,1598414400,1
jonnydvibes,0,1,0,2,1592193600,1592193600,1
AccomplishedBid9461,0,1,0,1,1638162000,1638162000,1
albumindreams,0,1,0,3,1546405200,1546405200,1
Subarunicycle,0,1,0,44,1609390800,1609390800,1
GetxQuoted,0,1,0,0,1608008400,1608008400,1
SaltwaterJesus,0,1,0,8,1601611200,1601611200,1
eeeBs,0,1,0,6,1606539600,1606539600,1
Doktor_Einlauf,0,1,0,2,1594440000,1594440000,1
majortom1989,0,1,0,16,1607490000,1607490000,1
Conceited_Duckling,0,1,0,964,1598846400,1598846400,1
smashlysmashes,0,1,0,87,1577336400,1577336400,1
HeHeWaa,0,1,0,3,1581656400,1581656400,1
ThexJakester,0,1,0,10,1608094800,1608094800,1
Demz_Boycott,0,1,0,3,1582779600,1582779600,1
monkey-2020,0,1,0,1,1635912000,1635912000,1
LameGuest3000,0,1,0,90,1595476800,1595476800,1
UpUpDnDnLRLRBA,0,1,0,5,1595995200,1595995200,1
sipoloco,0,1,0,45,1604984400,1604984400,1
Intentiional_typo,0,1,0,-1,1574830800,1574830800,1
Nimdeldun,0,1,0,2,1564286400,1564286400,1
thizzellar,0,1,0,21,1601870400,1601870400,1
All1sL0st,0,1,0,1,1607835600,1607835600,1
postmemesorgitbanned,0,1,0,-12,1591329600,1591329600,1
The_mouthfeel,0,1,0,5,1587441600,1587441600,1
throwforward666,0,1,0,3,1585454400,1585454400,1
talish2000,0,1,0,1,1599796800,1599796800,1
OttoTheAndalusian,0,1,0,1,1604466000,1604466000,1
NaCl_Sailor,0,1,0,29,1604379600,1604379600,1
playingwithcrayons,0,1,0,1,1537416000,1537416000,1
Xa-B-ier,0,1,0,36,1603684800,1603684800,1
mocogatu,0,1,0,1,1606712400,1606712400,1
Goodkall,0,1,0,1,1591243200,1591243200,1
Everybodysbastard,0,1,0,1,1598414400,1598414400,1
pericyte,0,1,0,1,1598673600,1598673600,1
pandie0o0,0,1,0,8,1602907200,1602907200,1
FreudsPoorAnus,0,1,0,2,1597982400,1597982400,1
Popthatkernal,0,1,0,0,1601870400,1601870400,1
muttly_muse20,0,1,0,23,1574053200,1574053200,1
The_Moon_Piece,0,1,0,8,1585540800,1585540800,1
vieilfrance,0,1,0,6,1608181200,1608181200,1
Deanothedino,0,1,0,12,1585972800,1585972800,1
squirrelsonacid,0,1,0,22,1594008000,1594008000,1
SkepticDrinker,0,1,0,1,1608526800,1608526800,1
oreganolawyer,0,1,0,1,1638766800,1638766800,1
stupidlatentnothing,0,1,0,1,1600747200,1600747200,1
vaporsynth,1,0,28,0,1607922000,1607922000,1
mentosorangemint,1,0,20,0,1595476800,1595476800,1
you-have-aids,0,1,0,1,1597204800,1597204800,1
functionlife,0,1,0,2,1599710400,1599710400,1
midlifesuicide,0,1,0,1,1577595600,1577595600,1
sTrekker11,0,1,0,11,1608181200,1608181200,1
azula-eat-my-pussy,0,1,0,1,1599710400,1599710400,1
HapticGloves,0,1,0,6,1605589200,1605589200,1
endure-endy-2,0,1,0,4,1604293200,1604293200,1
zensnapple,0,1,0,1,1611982800,1611982800,1
KhoaticKitty,0,1,0,37,1581656400,1581656400,1
Deschain_1919,0,1,0,1,1612328400,1612328400,1
Derpyderpderpdurr,0,1,0,3,1578286800,1578286800,1
thewarondrugsisalie,0,1,0,2,1608440400,1608440400,1
Macchiato99,0,1,0,2,1617940800,1617940800,1
CeeGee_GeeGee,0,1,0,1,1606539600,1606539600,1
curious_glimmertool,0,1,0,7,1597377600,1597377600,1
stevyjo832,1,0,0,0,1550466000,1550466000,1
the-janitor1,0,1,0,1,1585454400,1585454400,1
Inception_Bwah,0,1,0,1,1608267600,1608267600,1
Slif3rrsm,0,1,0,3,1606453200,1606453200,1
Wryyy_,0,1,0,29,1582606800,1582606800,1
watchedkettle,0,1,0,1,1596600000,1596600000,1
PM_UR_NIPPLE_PICS,0,1,0,3,1578891600,1578891600,1
BedriT,0,1,0,1,1557720000,1557720000,1
deathwilldie,0,1,0,14,1572843600,1572843600,1
099uyx,0,1,0,9,1608267600,1608267600,1
bombermonk,0,1,0,1,1605070800,1605070800,1
RandyDinglefart,0,1,0,36,1584158400,1584158400,1
bassdrumer2,0,1,0,1,1601352000,1601352000,1
sh4rkf4rt,0,1,0,3,1607922000,1607922000,1
Eiovas,0,1,0,3,1599710400,1599710400,1
Kawaii-Bismarck,0,1,0,7,1577422800,1577422800,1
FOXDuneRider,0,1,0,31,1605589200,1605589200,1
KingWormKilroy,0,1,0,45,1570420800,1570420800,1
sapphluid,0,1,0,4,1608786000,1608786000,1
TeenagedVernacular,0,1,0,3,1605070800,1605070800,1
EowynJane,0,1,0,1,1606021200,1606021200,1
br4d137,0,1,0,37,1584676800,1584676800,1
bozeke,0,1,0,7,1603512000,1603512000,1
segaselsky,0,1,0,1,1580014800,1580014800,1
padredejolly,0,1,0,11,1603771200,1603771200,1
Extesht,0,1,0,-1,1584763200,1584763200,1
war_crime_billy,0,1,0,-4,1608786000,1608786000,1
Rappe,0,1,0,1,1579842000,1579842000,1
sideninjas,0,1,0,222,1584936000,1584936000,1
19DanTheMan92,0,1,0,1,1573534800,1573534800,1
All_Work_All_Play,0,1,0,-3,1566014400,1566014400,1
ICantGetAway,0,1,0,5,1600574400,1600574400,1
PlaidAndGlad,0,1,0,2,1588996800,1588996800,1
OneSpicyTesticle,0,1,0,35,1603512000,1603512000,1
poomaw,1,0,55,0,1605848400,1605848400,1
DoomsdayRabbit,0,1,0,3,1602388800,1602388800,1
AncientAdamos,0,1,0,7,1575435600,1575435600,1
litterboxtvfan,0,1,0,2,1598068800,1598068800,1
shiznicklestix,0,1,0,10,1594353600,1594353600,1
6ThePrisoner,0,1,0,2,1584417600,1584417600,1
genjiskillerbum,0,1,0,11,1576386000,1576386000,1
RowRepresentative811,0,1,0,2,1606453200,1606453200,1
AbandonedArts,0,1,0,1,1564200000,1564200000,1
Baecorn,0,1,0,11,1546664400,1546664400,1
BlakePackers413,0,1,0,7,1600833600,1600833600,1
Mgshamster,0,1,0,5,1605589200,1605589200,1
Nedula,1,0,16,0,1605502800,1605502800,1
4domas,0,1,0,2,1609304400,1609304400,1
CarguyN54,0,1,0,0,1608526800,1608526800,1
ExitCircle,0,1,0,1,1560312000,1560312000,1
clean_it_janny,0,1,0,3,1593230400,1593230400,1
Dima239,0,1,0,1,1598760000,1598760000,1
Bartoolina,0,1,0,3,1569211200,1569211200,1
Magical593,0,1,0,8,1600920000,1600920000,1
SuratCharteredBank,0,1,0,7,1597723200,1597723200,1
whoresarerentals,0,1,0,3,1573448400,1573448400,1
___Doc,0,1,0,3,1600228800,1600228800,1
ok_ill_shut_up,0,1,0,1,1608526800,1608526800,1
SickofReincarnating,0,1,0,2,1587096000,1587096000,1
GeeHarveyOswald,0,1,0,-7,1583899200,1583899200,1
QuinndianaJonez,0,1,0,-2,1606539600,1606539600,1
siriuslyinsane,0,1,0,3,1590379200,1590379200,1
Mildo,0,1,0,6,1595217600,1595217600,1
Paradoxa77,0,1,0,2,1601956800,1601956800,1
BeRealistic01,0,1,0,1,1573362000,1573362000,1
ColonelWormhat,0,1,0,1,1576213200,1576213200,1
MCKoleman,0,1,0,1,1606626000,1606626000,1
tornapartbymachines,1,0,9,0,1598846400,1598846400,1
facts_my_guyy,0,1,0,22,1606453200,1606453200,1
davidrobot,1,0,2,0,1602043200,1602043200,1
BaconBoozer,1,0,0,0,1594008000,1594008000,1
DedGuyhai,0,1,0,1,1601352000,1601352000,1
answer4bojackthrow,0,1,0,57,1564977600,1564977600,1
OppressGamerz,0,1,0,36,1606539600,1606539600,1
6RevlisDrol9,0,1,0,4,1606626000,1606626000,1
sunburn95,0,1,0,3,1608786000,1608786000,1
crepesblinis,1,0,10,0,1587873600,1587873600,1
---gabers---,0,1,0,3,1607749200,1607749200,1
meatloaf_man,0,1,0,1,1598846400,1598846400,1
ibanglalaki,0,1,0,-15,1580619600,1580619600,1
rarity101x,0,1,0,1,1609045200,1609045200,1
Baby1121996,0,1,0,2,1567483200,1567483200,1
bFlatCreative,0,1,0,3,1567656000,1567656000,1
needsumcoke,0,1,0,9,1601524800,1601524800,1
usedallmypowerups,0,1,0,1,1594699200,1594699200,1
Usernome1,0,1,0,19,1567051200,1567051200,1
BullyFU,0,1,0,2,1581310800,1581310800,1
fakeorigami,0,1,0,3,1606712400,1606712400,1
cy6nu5,0,1,0,2,1609045200,1609045200,1
Vadersays,0,1,0,1,1555300800,1555300800,1
Rayketh,0,1,0,3,1592107200,1592107200,1
ViiDic,0,1,0,3,1608526800,1608526800,1
BurntOkie,0,1,0,20,1570507200,1570507200,1
oilpaintstains,0,1,0,1,1602388800,1602388800,1
InfernalHibiscus,0,1,0,1,1608526800,1608526800,1
NatalyaElina,0,1,0,2,1584504000,1584504000,1
ShePottsey,0,1,0,1,1598068800,1598068800,1
RockyMoose,0,1,0,1,1551243600,1551243600,1
Throatqueenv,0,1,0,1,1612155600,1612155600,1
FakeCraig,0,1,0,1,1577682000,1577682000,1
bahnmiexe,0,1,0,13,1587873600,1587873600,1
Novale,0,1,0,2,1584849600,1584849600,1
zarifex,0,1,0,4,1607403600,1607403600,1
NotCausedManatee,0,1,0,0,1572148800,1572148800,1
jls916,0,1,0,20,1585886400,1585886400,1
lovelyspaceprincess,1,0,127,0,1580792400,1580792400,1
quarantinevalley,0,1,0,1,1589860800,1589860800,1
Review_My_Cucumber,0,1,0,2,1564977600,1564977600,1
BearNoseHook,0,1,0,1,1578459600,1578459600,1
the_collective_hole,1,0,5,0,1605934800,1605934800,1
alecrazec,0,1,0,2,1598846400,1598846400,1
0wlBear916,0,1,0,9,1601784000,1601784000,1
Chameleonpolice,0,1,0,10,1589342400,1589342400,1
srsly_its_so_ez,0,1,0,4,1571889600,1571889600,1
telos-,0,1,0,12,1573189200,1573189200,1
TightOlive,0,1,0,12,1588305600,1588305600,1
seiga08,0,1,0,1,1578027600,1578027600,1
Joshslayerr,0,1,0,5,1605589200,1605589200,1
ThaDankchief,0,1,0,2,1605070800,1605070800,1
economemer,0,1,0,37,1589688000,1589688000,1
hbk88888888,0,1,0,8,1572753600,1572753600,1
tdwata,0,1,0,2,1611982800,1611982800,1
SnooSketches6409,0,1,0,1,1608181200,1608181200,1
redd9,0,1,0,1,1570939200,1570939200,1
top_koala,0,1,0,5,1584244800,1584244800,1
lexerlol,0,1,0,1,1601092800,1601092800,1
gswane,0,1,0,12,1593057600,1593057600,1
Ykcepok,0,1,0,-2,1601265600,1601265600,1
MinimumComfortable,0,1,0,9,1599883200,1599883200,1
MoedysseusRex,0,1,0,6,1602388800,1602388800,1
NikoTaco02,0,1,0,29,1576558800,1576558800,1
AssociationIcy7562,1,0,53,0,1607662800,1607662800,1
Mashed_Catato,0,1,0,3,1607835600,1607835600,1
PM_me_dat_Poutine,0,1,0,4,1551157200,1551157200,1
ahhhhhwut,0,1,0,112,1606971600,1606971600,1
MagentaHawk,0,1,0,17,1597982400,1597982400,1
StygianBiohazard,0,1,0,3,1608008400,1608008400,1
DeeSkwared,0,1,0,3,1583211600,1583211600,1
schoolgirlcoolgirl,0,1,0,149,1575954000,1575954000,1
TheReflectingGoddess,0,1,0,8,1576904400,1576904400,1
Severaxe,0,1,0,2,1579410000,1579410000,1
TPDeathMagnetic,0,1,0,4,1551934800,1551934800,1
sdgbta,0,1,0,1,1549170000,1549170000,1
dressedandconfused,0,1,0,3,1600056000,1600056000,1
assassin414,0,1,0,1,1569211200,1569211200,1
tagusa,0,1,0,2,1578114000,1578114000,1
jking94,0,1,0,2,1598241600,1598241600,1
Leppystyle123,0,1,0,1,1608440400,1608440400,1
theboyyousaw,0,1,0,3,1579669200,1579669200,1
PetiteMutant,0,1,0,2,1578459600,1578459600,1
ihavenobusinesshere7,0,1,0,24,1607317200,1607317200,1
DebScully,0,1,0,1,1578546000,1578546000,1
bemery96,0,1,0,3,1569124800,1569124800,1
FishZaddy,1,0,24,0,1602734400,1602734400,1
CuratorOfYourDreams,0,1,0,3,1588046400,1588046400,1
RobbieNorfolk,0,1,0,4,1584676800,1584676800,1
sardonicjesus,0,1,0,7,1555041600,1555041600,1
Powderitis2,0,1,0,-4,1605589200,1605589200,1
Dolffin222,0,1,0,35,1604898000,1604898000,1
maygreene,0,1,0,2,1560744000,1560744000,1
bored-as-shit,0,1,0,0,1611982800,1611982800,1
Shining_Lights,0,1,0,4,1585454400,1585454400,1
MulitpassMax,0,1,0,1,1600660800,1600660800,1
mrmhc54,0,1,0,-7,1607835600,1607835600,1
MRkramer6262,0,1,0,0,1595390400,1595390400,1
bobnine,0,1,0,2,1582693200,1582693200,1
Mikluu,0,1,0,5,1594872000,1594872000,1
No-ScopePope,0,1,0,5,1595563200,1595563200,1
Mennerheim,0,1,0,5,1604030400,1604030400,1
twavis11,0,1,0,8,1608440400,1608440400,1
Omega_Warlord,0,1,0,1,1605934800,1605934800,1
IkeaMonkeyCoat,0,1,0,4,1605502800,1605502800,1
bakutehbandit,0,1,0,2,1604203200,1604203200,1
DaedZealot,0,1,0,2,1601611200,1601611200,1
AdLow4358,1,0,17,0,1599796800,1599796800,1
granbolinaboom,0,1,0,1,1590120000,1590120000,1
FinFanNoBinBan,0,1,0,1,1572062400,1572062400,1
saarlac,0,1,0,2,1578286800,1578286800,1
goddamnbestfriend,0,1,0,1,1561003200,1561003200,1
ymmiT7o2,0,1,0,5,1570161600,1570161600,1
ShaggyClover,0,1,0,1,1584504000,1584504000,1
Johnnybravo60025,0,1,0,4,1601870400,1601870400,1
Khanstant,0,1,0,3,1605070800,1605070800,1
IDontGetSexualJokes,0,1,0,3,1591243200,1591243200,1
boywiththedogtattoo,0,1,0,9,1566100800,1566100800,1
SerinitySW,0,1,0,19,1594699200,1594699200,1
punkr0x,0,1,0,8,1587960000,1587960000,1
fremeer,0,1,0,6,1591156800,1591156800,1
YolanonReddit,0,1,0,1,1600574400,1600574400,1
lesbian_czar,0,1,0,18,1589860800,1589860800,1
LessQQmoarstfu,0,1,0,127,1603512000,1603512000,1
xxravindraxx,0,1,0,2,1577854800,1577854800,1
Galudarasa,0,1,0,34,1598155200,1598155200,1
Anthonok,0,1,0,1,1585454400,1585454400,1
United-Citezen,0,1,0,1,1554609600,1554609600,1
schmon,0,1,0,6,1608872400,1608872400,1
bunny_buritto,0,1,0,6,1582779600,1582779600,1
12398120379872461,0,1,0,5,1600574400,1600574400,1
plumzki,0,1,0,2,1603598400,1603598400,1
Skalette,1,0,113,0,1577077200,1577077200,1
Broseidonathon,0,1,0,5,1606453200,1606453200,1
klkaaa,0,1,0,3,1605330000,1605330000,1
JHaragin,0,1,0,5,1607403600,1607403600,1
CiaranGames,0,1,0,4,1583038800,1583038800,1
HRELast,0,1,0,17,1572753600,1572753600,1
bayougirl,0,1,0,11,1592280000,1592280000,1
Gubekochi,0,1,0,1,1600228800,1600228800,1
unwrapped-cocks,0,1,0,3,1597982400,1597982400,1
Starkidof9,0,1,0,2,1605762000,1605762000,1
Maga4lifeshutitdown,0,1,0,1,1565928000,1565928000,1
L31j0nA,0,1,0,2,1571630400,1571630400,1
HorseNamedClompy,0,1,0,2,1605589200,1605589200,1
TrackingHappiness,1,0,23,0,1541131200,1541131200,1
Madmac05,0,1,0,5,1582779600,1582779600,1
Unique_Name1,0,1,0,0,1551070800,1551070800,1
Catfish-Number3,0,1,0,1,1606712400,1606712400,1
Jimmy_R_Ustler,0,1,0,1,1603512000,1603512000,1
AdricGod,0,1,0,2,1555300800,1555300800,1
Midgard1,0,1,0,2,1570420800,1570420800,1
icanhazace,1,0,54,0,1606885200,1606885200,1
Letsgobaby97,0,1,0,1,1600920000,1600920000,1
pjs1975,0,1,0,8,1491796800,1491796800,1
chaibb,0,1,0,1,1608267600,1608267600,1
BrentleTheGentle,0,1,0,6,1564200000,1564200000,1
magnoliasmanor,0,1,0,12,1598760000,1598760000,1
coffee_hound,0,1,0,9,1601611200,1601611200,1
singularityguy2029,0,1,0,0,1577854800,1577854800,1
Benmurr,0,1,0,1,1608786000,1608786000,1
MsLoreG,0,1,0,5,1570593600,1570593600,1
slav-slut,0,1,0,15,1602907200,1602907200,1
GelatinousStand,0,1,0,12,1602734400,1602734400,1
Whiskey_Baron,0,1,0,-2,1599364800,1599364800,1
clamsmasher,0,1,0,13,1574917200,1574917200,1
NuggetsandBeans,0,1,0,8,1585022400,1585022400,1
fraggn_aut,0,1,0,1,1592107200,1592107200,1
r_o_a_c_h,0,1,0,66,1598587200,1598587200,1
Ravic13,0,1,0,1,1585454400,1585454400,1
EpicWorld1000,0,1,0,1,1577595600,1577595600,1
IHeardItOnAPodcast,0,1,0,8,1579150800,1579150800,1
ENTree93,0,1,0,1,1604379600,1604379600,1
familiarCatch,0,1,0,3,1593835200,1593835200,1
ar_torius,0,1,0,2,1584936000,1584936000,1
maxjosephwheeler,0,1,0,-2,1591243200,1591243200,1
PotentialInside0,0,1,0,1,1600574400,1600574400,1
winniedebs,0,1,0,53,1565150400,1565150400,1
skweebop,0,1,0,1,1601352000,1601352000,1
Kalappianer,0,1,0,1,1606971600,1606971600,1
Diddlemyloins,0,1,0,1,1603684800,1603684800,1
Acsion,0,1,0,10,1606453200,1606453200,1
aysurcouf,0,1,0,15,1605589200,1605589200,1
valarauca14,0,1,0,2,1599796800,1599796800,1
TheKhun,0,1,0,1,1608786000,1608786000,1
Groverd,0,1,0,6,1608958800,1608958800,1
skyforgesteel,0,1,0,3,1608526800,1608526800,1
TheDuckOfSerenno,0,1,0,1,1599192000,1599192000,1
laix_,0,1,0,22,1561262400,1561262400,1
gmalagon2529,0,1,0,3,1598932800,1598932800,1
imbyath,0,1,0,10,1555646400,1555646400,1
GrimGremory,0,1,0,1,1605589200,1605589200,1
8stringtheory,0,1,0,4,1604811600,1604811600,1
lap215,1,0,2,0,1591761600,1591761600,1
EmancipatedFish,0,1,0,9,1612155600,1612155600,1
clam_bake88,0,1,0,1,1601179200,1601179200,1
d3mez,0,1,0,1,1567569600,1567569600,1
imsquare177,0,1,0,3,1593403200,1593403200,1
A_1239798,1,0,2,0,1596600000,1596600000,1
Wreckedem144,1,0,18,0,1546578000,1546578000,1
Jabulon,0,1,0,1,1591329600,1591329600,1
the_other_pickle,0,1,0,2,1593835200,1593835200,1
Maximo9000,0,1,0,6,1612069200,1612069200,1
GreenEggs_And_Cam,0,1,0,24,1606971600,1606971600,1
Only-slightlyneutral,0,1,0,3,1609304400,1609304400,1
usamabinfartin,0,1,0,1,1608526800,1608526800,1
pdotbdotr_11,0,1,0,1,1606971600,1606971600,1
amala2620,0,1,0,63,1594008000,1594008000,1
Bryan_rabid,0,1,0,3,1581483600,1581483600,1
whynotyeetith,0,1,0,13,1607662800,1607662800,1
sootoor,0,1,0,2,1612069200,1612069200,1
fluffmuffin21,0,1,0,2,1585368000,1585368000,1
MercutiaShiva,0,1,0,2,1607835600,1607835600,1
RandyRalph02,0,1,0,1,1605330000,1605330000,1
Jamiquest,0,1,0,1,1595304000,1595304000,1
Fineapple26,0,1,0,2,1601697600,1601697600,1
beemize,0,1,0,3,1556510400,1556510400,1
Dingus-McSmartypants,0,1,0,18,1563422400,1563422400,1
CryptoKing25,0,1,0,5,1608613200,1608613200,1
SantaOMG,0,1,0,3,1584417600,1584417600,1
TheMoogy,0,1,0,1,1608267600,1608267600,1
FertBerte,0,1,0,6,1603425600,1603425600,1
-Mytharia-,0,1,0,3,1579064400,1579064400,1
Dolphintorpedo,0,1,0,3,1594267200,1594267200,1
nova17x,0,1,0,99,1600401600,1600401600,1
Gavroche_Lives,0,1,0,1,1603512000,1603512000,1
JusticeOmen,0,1,0,6,1587096000,1587096000,1
darth_revan900414,0,1,0,2,1594353600,1594353600,1
Daltonxz,0,1,0,1,1576040400,1576040400,1
jiyeonsgorgethighs,0,1,0,129,1572494400,1572494400,1
skylerwhiteisawhore,0,1,0,52,1608526800,1608526800,1
Louderthanmyweed,0,1,0,6,1562731200,1562731200,1
OsMagum,0,1,0,-21,1607576400,1607576400,1
TheInactiveWall,0,1,0,1,1591243200,1591243200,1
njackson2020,0,1,0,1,1603512000,1603512000,1
Regex00,1,0,28,0,1606539600,1606539600,1
tighthypercurve,0,1,0,1,1593489600,1593489600,1
crackzilla94,0,1,0,-1,1598760000,1598760000,1
zaph239,1,0,102,0,1585022400,1585022400,1
dinnerbellding,0,1,0,2,1571284800,1571284800,1
RobLoach,0,1,0,20,1587268800,1587268800,1
The_DiCaprio_Code,0,1,0,10,1594872000,1594872000,1
Chiba8,1,0,24,0,1607317200,1607317200,1
voncornhole2,0,1,0,1,1612155600,1612155600,1
mr_chip,0,1,0,8,1581138000,1581138000,1
TrickyKnight77,0,1,0,2,1609131600,1609131600,1
dontaskme5746,0,1,0,1,1585454400,1585454400,1
YouCanBreatheNow,0,1,0,13,1609131600,1609131600,1
moomerator,0,1,0,3,1591243200,1591243200,1
Malwavee,1,0,24,0,1602216000,1602216000,1
methlabz,0,1,0,1,1593921600,1593921600,1
KOKOABUNNY,0,1,0,1,1603512000,1603512000,1
Charistoph,0,1,0,4,1578805200,1578805200,1
LonelyTex,0,1,0,1,1598846400,1598846400,1
The_truth_may_hurt,0,1,0,1,1612069200,1612069200,1
11ftw,0,1,0,2,1608872400,1608872400,1
N8-K47,0,1,0,4,1584676800,1584676800,1
Pbtpbtpbt257,1,0,28,0,1573794000,1573794000,1
ForcibleBlackhead,0,1,0,-4,1606971600,1606971600,1
Dungeoneer2001,0,1,0,8,1574139600,1574139600,1
h820n,1,0,17,0,1591761600,1591761600,1
RoundRevolutionary58,0,1,0,6,1611982800,1611982800,1
DeaddyRuxpin,0,1,0,17,1595131200,1595131200,1
jakeeighties,0,1,0,2,1601265600,1601265600,1
slithery_snek,0,1,0,2,1578459600,1578459600,1
still_gonna_send_it,0,1,0,3,1575522000,1575522000,1
sphericaldiagnoal,0,1,0,1,1580446800,1580446800,1
theworldisnotquiet,0,1,0,13,1611982800,1611982800,1
PCPrincess,0,1,0,8,1576818000,1576818000,1
Chuckms,0,1,0,1,1582174800,1582174800,1
BakingSota,0,1,0,27,1553832000,1553832000,1
Knytemare44,0,1,0,1,1608267600,1608267600,1
SUBZEROXXL,0,1,0,6,1607835600,1607835600,1
throoooowaway7,0,1,0,1,1593316800,1593316800,1
athehack,0,1,0,5,1607230800,1607230800,1
SuperBenMan,0,1,0,8,1599796800,1599796800,1
badcatjack,0,1,0,2,1605589200,1605589200,1
Freedom-snek,0,1,0,3,1580965200,1580965200,1
Ryvitt,0,1,0,2,1583384400,1583384400,1
B3yondL,0,1,0,2,1591243200,1591243200,1
kittycowww,0,1,0,4,1560571200,1560571200,1
stonercereal,0,1,0,3,1598155200,1598155200,1
paperd,0,1,0,18,1603512000,1603512000,1
khafra,0,1,0,10,1584158400,1584158400,1
Tylendal,0,1,0,13,1585454400,1585454400,1
Themanwithoutaplan_9,0,1,0,1,1608267600,1608267600,1
kodeak,0,1,0,32,1576386000,1576386000,1
dropitlikeitshot,0,1,0,28,1584417600,1584417600,1
BoozeClooze92,0,1,0,2,1585886400,1585886400,1
thunderup_14,0,1,0,33,1607922000,1607922000,1
WarCrySamurai,0,1,0,1,1600488000,1600488000,1
Demarinshi01,0,1,0,1,1575781200,1575781200,1
Karaoke725,0,1,0,25,1568433600,1568433600,1
Talkin-bout,1,0,15,0,1595044800,1595044800,1
mehmehmehmeh58,0,1,0,6,1603512000,1603512000,1
Idkthrowmeawayplease,0,1,0,1,1603512000,1603512000,1
evernapping,0,1,0,4,1606107600,1606107600,1
cops_throat_my_cock,0,1,0,14,1576558800,1576558800,1
VF206,0,1,0,7,1576386000,1576386000,1
kalibabka,1,0,262,0,1599278400,1599278400,1
rightwing27,0,1,0,5,1575608400,1575608400,1
HugeBumHead,0,1,0,3,1607490000,1607490000,1
zamardii12,0,1,0,1,1591243200,1591243200,1
eggbert_thophthysis,1,0,82,0,1593316800,1593316800,1
shadow247,0,1,0,1,1605589200,1605589200,1
Slammybutt,0,1,0,1,1603512000,1603512000,1
StudyOfWumbo3,0,1,0,9,1605070800,1605070800,1
conejodemuerte,0,1,0,1,1589947200,1589947200,1
InsanityConsuming,0,1,0,1,1541912400,1541912400,1
pbghikes,0,1,0,6,1586404800,1586404800,1
kaklaw,0,1,0,1,1568260800,1568260800,1
msvideos234,0,1,0,3,1600574400,1600574400,1
SeductiveTrain,0,1,0,2,1585454400,1585454400,1
elitesense,0,1,0,2,1605157200,1605157200,1
PatrickD2019,0,1,0,1,1567396800,1567396800,1
nitevid,0,1,0,0,1607403600,1607403600,1
Gorhaloth,0,1,0,3,1572667200,1572667200,1
josh4050,0,1,0,-2,1591243200,1591243200,1
Woodrow1701,0,1,0,1,1598760000,1598760000,1
tmlaisygb,1,0,18,0,1597377600,1597377600,1
Str8_0uttaRehab,0,1,0,21,1591329600,1591329600,1
pamann42,0,1,0,5,1600488000,1600488000,1
katiehatesyoumaybe,0,1,0,2,1606971600,1606971600,1
schwarzstattbraun,0,1,0,2,1611982800,1611982800,1
DrWermActualWerm,0,1,0,15,1603598400,1603598400,1
zz_ziaco,0,1,0,3,1573102800,1573102800,1
proddante9k,0,1,0,2,1603857600,1603857600,1
ShaderzXC,0,1,0,1,1606626000,1606626000,1
havoc313,0,1,0,0,1606280400,1606280400,1
Modsblow,0,1,0,4,1600574400,1600574400,1
Thoron_Blaster,0,1,0,2,1589860800,1589860800,1
NaniBott,0,1,0,4,1612155600,1612155600,1
TheGuysOfConcern,0,1,0,1,1603944000,1603944000,1
Esco-Alfresco,0,1,0,2,1611982800,1611982800,1
SmallGStacks,1,0,1,0,1582866000,1582866000,1
Rhumbler,0,1,0,5,1599969600,1599969600,1
BaconOfDaeodon,0,1,0,2,1585281600,1585281600,1
borzboiz,0,1,0,10,1592280000,1592280000,1
roastytoastykitty,0,1,0,1,1560398400,1560398400,1
CrazyTeapot156,0,1,0,2,1548997200,1548997200,1
MrPwndabear,0,1,0,3,1604203200,1604203200,1
OhWalter,0,1,0,10,1596772800,1596772800,1
MushroomsInTheAttic,0,1,0,1,1604638800,1604638800,1
Despises_the_dishes,0,1,0,2,1608267600,1608267600,1
auniqueusername199,0,1,0,3,1598846400,1598846400,1
poopybagel,0,1,0,7,1595390400,1595390400,1
leathery_bread,0,1,0,3,1599019200,1599019200,1
Novnocie1234,0,1,0,1,1608872400,1608872400,1
witheringsyncopation,0,1,0,1,1586318400,1586318400,1
zesty-veluuish,0,1,0,1,1608613200,1608613200,1
SlurpCoke,0,1,0,1,1598846400,1598846400,1
phoenixrawr,0,1,0,1,1579064400,1579064400,1
TheeMiilkMaan,0,1,0,-6,1605243600,1605243600,1
cycleoflyfeforce,0,1,0,-1,1591156800,1591156800,1
Positive0,0,1,0,6,1608181200,1608181200,1
shmough,0,1,0,1,1591243200,1591243200,1
Cleverusername531,0,1,0,1,1634270400,1634270400,1
zizosky21,0,1,0,0,1603684800,1603684800,1
satanmat2,0,1,0,12,1594785600,1594785600,1
_burn_loot_murder,0,1,0,0,1599451200,1599451200,1
weaselswarm,0,1,0,1,1603512000,1603512000,1
sub-hunter,0,1,0,7,1589601600,1589601600,1
CapablePerformance,0,1,0,8,1598846400,1598846400,1
thepigvomit,0,1,0,-1,1582779600,1582779600,1
cschmidt1991,0,1,0,1,1608267600,1608267600,1
Anon_TheDireWolf,0,1,0,3,1574571600,1574571600,1
KarlMarx_ka_Climax,1,0,27,0,1612069200,1612069200,1
Horstt,0,1,0,15,1572235200,1572235200,1
PsylentOn3,0,1,0,5,1560657600,1560657600,1
FroyoStatus9876,0,1,0,9,1603252800,1603252800,1
SatanV3,0,1,0,1,1580965200,1580965200,1
cyoobvertex,0,1,0,3,1582520400,1582520400,1
ShipWithoutAStorm,0,1,0,14,1611982800,1611982800,1
hello_specific_ocean,0,1,0,5,1535515200,1535515200,1
DistortedCrag,0,1,0,1,1578373200,1578373200,1
bobbyboi17,0,1,0,1,1603512000,1603512000,1
WarchiefServant,0,1,0,-3,1571976000,1571976000,1
CaptainUnderpantsROC,0,1,0,1,1589860800,1589860800,1
JackfruitIcy471,1,0,7,0,1591243200,1591243200,1
bcornels,0,1,0,4,1537416000,1537416000,1
chethlenic,0,1,0,3,1586577600,1586577600,1
UWCG,0,1,0,3,1594440000,1594440000,1
cmp2810,0,1,0,5,1580360400,1580360400,1
lifeofvirgo,0,1,0,4,1591243200,1591243200,1
Ward3nAction,0,1,0,5,1582606800,1582606800,1
SegergationNow,0,1,0,-3,1600228800,1600228800,1
ilostmyjobtoday,0,1,0,2,1605157200,1605157200,1
Throwawayuser626,0,1,0,1,1612155600,1612155600,1
tehkeizer,0,1,0,-4,1579150800,1579150800,1
xblackout_,0,1,0,13,1572235200,1572235200,1
monicagellerr,0,1,0,2,1574139600,1574139600,1
dudewasup111,1,0,96,0,1602043200,1602043200,1
mattchis,0,1,0,3,1601611200,1601611200,1
PrestonMonteWest,1,0,15,0,1585540800,1585540800,1
Sheazier1983,0,1,0,10,1592366400,1592366400,1
beardedheathen,0,1,0,1,1575349200,1575349200,1
EatriceHI,0,1,0,2,1603512000,1603512000,1
sfguy86,0,1,0,8,1594958400,1594958400,1
iodinequeen,1,0,10,0,1582520400,1582520400,1
9th-Chair,0,1,0,3,1600833600,1600833600,1
Miqln,0,1,0,13,1573275600,1573275600,1
lilfrankievert,0,1,0,1,1582088400,1582088400,1
Factor-Patient,1,0,290,0,1604030400,1604030400,1
Roygreem,0,1,0,7,1606366800,1606366800,1
Zebedee85,0,1,0,1,1591243200,1591243200,1
itzcarol,0,1,0,4,1579496400,1579496400,1
ChrisBCreme,0,1,0,5,1575522000,1575522000,1
cookiemonstar1234,0,1,0,22,1604293200,1604293200,1
ggbblouis,0,1,0,2,1591329600,1591329600,1
snowmanvi,0,1,0,1,1585454400,1585454400,1
SmarTeePants,0,1,0,55,1602648000,1602648000,1
niogyn,0,1,0,3,1603512000,1603512000,1
fixationed,1,0,407,0,1596945600,1596945600,1
MadScienceIntern,0,1,0,3,1601265600,1601265600,1
doomsday3131,0,1,0,2,1606885200,1606885200,1
throwawayinthetrash3,0,1,0,5,1602820800,1602820800,1
Cinannom,0,1,0,6,1602907200,1602907200,1
napoleonfrench36,0,1,0,0,1581310800,1581310800,1
youmostofall,0,1,0,35,1606021200,1606021200,1
mrcenary,0,1,0,2,1609477200,1609477200,1
FBI-BOT-17,0,1,0,1,1607662800,1607662800,1
hamsters-thesis,0,1,0,1,1554177600,1554177600,1
FranksBestToeKnife,0,1,0,5,1578891600,1578891600,1
M-A-S-C,0,1,0,6,1557979200,1557979200,1
icon58,0,1,0,2,1599364800,1599364800,1
Roidciraptor,0,1,0,-1,1517893200,1517893200,1
Anagnorsis,0,1,0,6,1603598400,1603598400,1
quinnlovespooh,0,1,0,4,1585108800,1585108800,1
Oniros_DW,0,1,0,1,1593057600,1593057600,1
Cinaedus_Perversus,0,1,0,76,1606626000,1606626000,1
LeftoutLacey,0,1,0,9,1592884800,1592884800,1
DdaidD,1,0,56,0,1593662400,1593662400,1
Lyaid,0,1,0,13,1597291200,1597291200,1
DerekYeeter69420,0,1,0,3,1590120000,1590120000,1
LostInRealityForever,0,1,0,1,1635393600,1635393600,1
Cptcodfish,0,1,0,6,1585886400,1585886400,1
zooboos,0,1,0,2,1599537600,1599537600,1
PM_Me_Oliver_Hart,0,1,0,2,1584763200,1584763200,1
nixiedust,0,1,0,4,1596772800,1596772800,1
Porktastic42,0,1,0,1,1590033600,1590033600,1
umdhockey17,0,1,0,2,1590379200,1590379200,1
ButterForDaKhorneCob,0,1,0,26,1573448400,1573448400,1
rhyshaldane,0,1,0,6,1547787600,1547787600,1
cavelioness,0,1,0,2,1551330000,1551330000,1
8inchmcgee,0,1,0,1,1573621200,1573621200,1
youre_handsome,0,1,0,1,1585454400,1585454400,1
DopeFiendDramaQueen,0,1,0,39,1572667200,1572667200,1
DMball,0,1,0,1,1563508800,1563508800,1
aahinxtone,0,1,0,1,1593144000,1593144000,1
elderscrollroller,0,1,0,22,1605502800,1605502800,1
OnlyPicklehead,0,1,0,1,1603598400,1603598400,1
GneissGeologist3,0,1,0,15,1606194000,1606194000,1
lizaluc,0,1,0,2,1592798400,1592798400,1
bunky1971,0,1,0,21,1556078400,1556078400,1
the-ace,1,0,18,0,1585540800,1585540800,1
baronvoncash,0,1,0,3,1598760000,1598760000,1
brokethekid,0,1,0,122,1604898000,1604898000,1
PolyDorf,0,1,0,1,1602388800,1602388800,1
therealmothdust,0,1,0,3,1611810000,1611810000,1
vivi273,0,1,0,2,1603598400,1603598400,1
coolbeb,0,1,0,2,1598328000,1598328000,1
Markasaurius,0,1,0,-1,1605848400,1605848400,1
nothing-nothing-not,0,1,0,2,1594612800,1594612800,1
BobJWHenderson,0,1,0,5,1555128000,1555128000,1
Hurricanejudy00,0,1,0,2,1578978000,1578978000,1
shiny-bear,0,1,0,13,1608354000,1608354000,1
gramslamx,0,1,0,2,1604293200,1604293200,1
Retconnn,0,1,0,1,1593921600,1593921600,1
Uakari_Monkey,0,1,0,1,1550552400,1550552400,1
Sanity-Manatee,0,1,0,14,1588046400,1588046400,1
galosheswild,0,1,0,2,1582174800,1582174800,1
Thiago_MRX,0,1,0,1,1612155600,1612155600,1
bluewolfhudson,0,1,0,1,1608613200,1608613200,1
00100101011010,0,1,0,-15,1608872400,1608872400,1
h0nest_Bender,0,1,0,1,1606021200,1606021200,1
molzo92,0,1,0,5,1600574400,1600574400,1
mmarcevanss,1,0,3,0,1597550400,1597550400,1
consecutive_Pizza,0,1,0,3,1600920000,1600920000,1
thekingoftherodeo,0,1,0,2,1603598400,1603598400,1
fekumama,1,0,170,0,1594785600,1594785600,1
sinna-bunz,0,1,0,5,1586404800,1586404800,1
Zlaysmen,1,0,121,0,1602043200,1602043200,1
DarthElevator,0,1,0,1,1611982800,1611982800,1
Lambdaleth,0,1,0,1,1603339200,1603339200,1
bitter-optimist,0,1,0,-7,1612155600,1612155600,1
Simplysalted,0,1,0,3,1605934800,1605934800,1
kyguylostinthecity,0,1,0,2,1608008400,1608008400,1
candsastle,0,1,0,-6,1601352000,1601352000,1
Angel89411,0,1,0,1,1603512000,1603512000,1
Muad_Dib_of_Arrakis,0,1,0,23,1576990800,1576990800,1
Zergnase,0,1,0,15,1608872400,1608872400,1
ninjerpurgan,0,1,0,-5,1599710400,1599710400,1
404178,0,1,0,19,1600833600,1600833600,1
mleugh,0,1,0,1,1584849600,1584849600,1
WallyKundera,0,1,0,6,1606366800,1606366800,1
crispleader,0,1,0,52,1596686400,1596686400,1
Useful-Community-914,0,1,0,1,1605589200,1605589200,1
iamareptilianalien,0,1,0,4,1603252800,1603252800,1
Kuixoticelixer,0,1,0,16,1608613200,1608613200,1
FuckOff_Johnny,0,1,0,9,1586145600,1586145600,1
fenixnoctis,0,1,0,0,1606626000,1606626000,1
Brilliant_Delay_8891,0,1,0,1,1606626000,1606626000,1
mahindra27,0,1,0,2,1605070800,1605070800,1
Jaded_27,0,1,0,1,1603598400,1603598400,1
ISB00,0,1,0,1,1642741200,1642741200,1
CertifiedAutism,0,1,0,4,1603598400,1603598400,1
ToastedMilkEggs,0,1,0,11,1554436800,1554436800,1
ThatBookishChick,0,1,0,2,1607749200,1607749200,1
triddy42,0,1,0,11,1604116800,1604116800,1
OccamsToothpaste,0,1,0,1,1602475200,1602475200,1
phryan,0,1,0,6,1604379600,1604379600,1
sudosussudio,0,1,0,23,1589428800,1589428800,1
A-Piece-of-Milk,0,1,0,0,1595390400,1595390400,1
eternal_anguish,0,1,0,4,1560052800,1560052800,1
Kar8tchris,1,0,122,0,1570075200,1570075200,1
Drew808,1,0,55,0,1596340800,1596340800,1
longci,0,1,0,1,1604116800,1604116800,1
penis-penis_penis,0,1,0,4,1588737600,1588737600,1
elaravi,0,1,0,69,1567137600,1567137600,1
6b6b9,0,1,0,1,1610859600,1610859600,1
yurituran,0,1,0,7,1608440400,1608440400,1
Leucurus,0,1,0,20,1599796800,1599796800,1
ask_around,0,1,0,2,1594008000,1594008000,1
Steamstash,0,1,0,1,1580101200,1580101200,1
TengoOnTheTimpani,0,1,0,1,1603512000,1603512000,1
Doctor_Deepthroat_MD,0,1,0,1,1608872400,1608872400,1
MisterMajorKappa,0,1,0,1,1603598400,1603598400,1
BuiltToSpinback,0,1,0,5,1557028800,1557028800,1
UnsubstantiatedClaim,0,1,0,12,1605589200,1605589200,1
Spectrum_16,0,1,0,23,1590811200,1590811200,1
Digitaljunker,0,1,0,26,1584331200,1584331200,1
professionalnuisance,0,1,0,23,1604030400,1604030400,1
gkjffkdhkfdd,0,1,0,-9,1606539600,1606539600,1
friendofpyrex,0,1,0,17,1593230400,1593230400,1
DJ_BlackBeard,0,1,0,2,1558152000,1558152000,1
throwawaygirl5816,0,1,0,30,1608872400,1608872400,1
lovelylil22,0,1,0,4,1597118400,1597118400,1
TheSparkHasRisen,0,1,0,2,1570161600,1570161600,1
huge_seal,0,1,0,2,1582779600,1582779600,1
Cheezba11,0,1,0,3,1570852800,1570852800,1
armyabc,0,1,0,2,1598673600,1598673600,1
DoADollopWithDipshit,0,1,0,0,1585454400,1585454400,1
WhatInTarNathan,0,1,0,1,1593144000,1593144000,1
blumoon138,0,1,0,1,1603512000,1603512000,1
WhyHeLO_THeRE_SIR,0,1,0,5,1602907200,1602907200,1
D34TH2C0MM135,0,1,0,-2,1601179200,1601179200,1
OhSnapsItsStonks,0,1,0,2,1604898000,1604898000,1
knotatmypost,0,1,0,119,1604379600,1604379600,1
onlyreginav,0,1,0,3,1606712400,1606712400,1
01010100011100100,0,1,0,3,1587009600,1587009600,1
josephnapoleon,0,1,0,1,1599192000,1599192000,1
finmarketingbiz,0,1,0,2,1607230800,1607230800,1
JohanBroad,0,1,0,4,1602820800,1602820800,1
Yamonomics,0,1,0,1,1584763200,1584763200,1
Amazona86,0,1,0,41,1593576000,1593576000,1
moon-drag0n,0,1,0,1,1591243200,1591243200,1
nervinex,0,1,0,1,1598414400,1598414400,1
HOBbitDAY,0,1,0,3,1601524800,1601524800,1
TheGreatDeadFoolio,0,1,0,2,1587096000,1587096000,1
Maeygun,0,1,0,2,1608094800,1608094800,1
chillychar,0,1,0,1,1603512000,1603512000,1
thefunkiechicken,0,1,0,2,1582779600,1582779600,1
PrimaxAUS,0,1,0,1,1580792400,1580792400,1
krappithyme,0,1,0,2,1606194000,1606194000,1
nargles-plz,0,1,0,19,1605502800,1605502800,1
ZFG_OnlyHitmarkers,0,1,0,15,1582261200,1582261200,1
Rerollife,0,1,0,-4,1601179200,1601179200,1
derpmeme,0,1,0,1,1604030400,1604030400,1
l84agig,0,1,0,1,1606021200,1606021200,1
CertainUncertainty11,0,1,0,1,1606021200,1606021200,1
long_legged_twat,0,1,0,1,1598155200,1598155200,1
mtriad,0,1,0,1,1605589200,1605589200,1
Nutjobfun,0,1,0,29,1587268800,1587268800,1
420toiletpaper69,0,1,0,2,1596081600,1596081600,1
Jones2182,0,1,0,-39,1600747200,1600747200,1
FettuccineCannon,0,1,0,1,1608526800,1608526800,1
Gleebaa,0,1,0,31,1574053200,1574053200,1
Professional-Dragon,0,1,0,5,1553227200,1553227200,1
Danielle082,0,1,0,5,1602129600,1602129600,1
JuniorFister,0,1,0,2,1608267600,1608267600,1
ThaGarden,0,1,0,6,1600920000,1600920000,1
untildeathcel,0,1,0,76,1603512000,1603512000,1
ifelseandor,0,1,0,1,1598760000,1598760000,1
im_from_9gag,0,1,0,10,1567742400,1567742400,1
Mopso,0,1,0,1,1577768400,1577768400,1
MayoMania,0,1,0,3,1603080000,1603080000,1
copperdyke,0,1,0,4,1572843600,1572843600,1
cgtdream,0,1,0,0,1603512000,1603512000,1
antbitch,0,1,0,16,1552107600,1552107600,1
licth123,0,1,0,1,1602907200,1602907200,1
Soccermum1311,0,1,0,2,1600833600,1600833600,1
HouseMusicLover1998,0,1,0,1,1577336400,1577336400,1
micshastu,0,1,0,2,1606626000,1606626000,1
IroquoisPliskine,0,1,0,20,1568174400,1568174400,1
GardenBetter,0,1,0,20,1603512000,1603512000,1
spacefrost,0,1,0,2,1606626000,1606626000,1
space_doe,0,1,0,7,1589169600,1589169600,1
ognarMOR,0,1,0,1,1597636800,1597636800,1
nervous_cusswords,0,1,0,8,1609131600,1609131600,1
Bubalub37,0,1,0,1,1608267600,1608267600,1
e-53e,0,1,0,6,1587441600,1587441600,1
Throwra67296,0,1,0,1,1605157200,1605157200,1
Psyker101,0,1,0,3,1573448400,1573448400,1
nuvainat,0,1,0,7,1585281600,1585281600,1
J-L-Picard,0,1,0,7,1557288000,1557288000,1
SomeYogurt4,0,1,0,3,1584158400,1584158400,1
jetherington,0,1,0,1,1555646400,1555646400,1
JamesBlitz00,0,1,0,1,1582779600,1582779600,1
psychonaughty2020,0,1,0,3,1580360400,1580360400,1
nursekazim,0,1,0,1,1600574400,1600574400,1
RRFedora13,0,1,0,3,1580014800,1580014800,1
qwikmaffs,0,1,0,1,1591243200,1591243200,1
Stevenpoke12,0,1,0,1,1606626000,1606626000,1
acccra,0,1,0,1,1542862800,1542862800,1
svFrannieC,0,1,0,1,1600574400,1600574400,1
zrag123,0,1,0,2,1578200400,1578200400,1
OysterKultGA,0,1,0,1,1580792400,1580792400,1
GetBuckets13,0,1,0,2,1568260800,1568260800,1
nospecialorders,0,1,0,2,1599883200,1599883200,1
TraditioCatholica,1,0,5,0,1606885200,1606885200,1
wageslave09543,1,0,10,0,1574658000,1574658000,1
marsh_bird,0,1,0,2,1608526800,1608526800,1
BootySmackahah,0,1,0,0,1578978000,1578978000,1
Karvast,0,1,0,3,1603512000,1603512000,1
loushkof,0,1,0,9,1606626000,1606626000,1
ineedenlightment,0,1,0,48,1607662800,1607662800,1
chelonioidea,0,1,0,4,1606539600,1606539600,1
Afitz93,0,1,0,1,1599451200,1599451200,1
drivesalincoln,0,1,0,4,1604898000,1604898000,1
Buttskank10,0,1,0,1,1604898000,1604898000,1
Closer-To-The-Heart,0,1,0,6,1589169600,1589169600,1
Hre0,0,1,0,55,1606539600,1606539600,1
ektachrome_,0,1,0,8,1578114000,1578114000,1
Neoh330,0,1,0,1,1603512000,1603512000,1
ElAburrito,0,1,0,-22,1606626000,1606626000,1
EpicRedditWarrior,0,1,0,0,1600401600,1600401600,1
SonofRaymond,0,1,0,4,1574571600,1574571600,1
alyraptor,0,1,0,5,1602648000,1602648000,1
MrPumpkin_Eater,0,1,0,1,1596859200,1596859200,1
-Pergopa-,0,1,0,-1,1603598400,1603598400,1
SpanishIntuition,0,1,0,0,1575435600,1575435600,1
xexnaxex,0,1,0,14,1602475200,1602475200,1
lucas_is_batman,0,1,0,2,1586059200,1586059200,1
hereforthedoom,0,1,0,0,1585108800,1585108800,1
larahw,0,1,0,10,1560830400,1560830400,1
0b01000101,0,1,0,5,1607662800,1607662800,1
teadrinkersunite,0,1,0,1,1594094400,1594094400,1
dirtjesus,0,1,0,-1,1590984000,1590984000,1
frostymargaritafan,0,1,0,1,1597032000,1597032000,1
Yellow_Tiger1,1,0,4,0,1536206400,1536206400,1
konevp,0,1,0,3,1560398400,1560398400,1
meepcheese,0,1,0,9,1605848400,1605848400,1
ShitTalkingAlt980,0,1,0,4,1582693200,1582693200,1
LambWalton320,0,1,0,2,1607662800,1607662800,1
Magnolia_Mystery,0,1,0,3,1606712400,1606712400,1
Epiphan3,0,1,0,17,1578373200,1578373200,1
TAFKATheBear,0,1,0,2,1607749200,1607749200,1
PapaSock,0,1,0,1,1573534800,1573534800,1
Obviously_A_Troll_69,0,1,0,1,1585454400,1585454400,1
juandelakarite,0,1,0,21,1563940800,1563940800,1
schmee42,1,0,8,0,1595476800,1595476800,1
jkd43,0,1,0,4,1565668800,1565668800,1
TakeTheB8Please,0,1,0,1,1572235200,1572235200,1
uttplug,0,1,0,9,1546318800,1546318800,1
LetsStartFlame,0,1,0,1,1540872000,1540872000,1
tub0crisco,0,1,0,1,1604030400,1604030400,1
SupermAndrew1,0,1,0,5,1605934800,1605934800,1
fmj93,0,1,0,3,1562731200,1562731200,1
Teetseremoonia,0,1,0,0,1595649600,1595649600,1
poetkillah,0,1,0,0,1553486400,1553486400,1
verhovniPan,0,1,0,5,1598068800,1598068800,1
SuicidalPilot,0,1,0,58,1578027600,1578027600,1
psychedelic_garbage,0,1,0,4,1575262800,1575262800,1
Mr_Anderson17,0,1,0,5,1596168000,1596168000,1
cokewithsatan,0,1,0,1,1588737600,1588737600,1
yava_lovelace,1,0,35,0,1603425600,1603425600,1
VincenteRoman,0,1,0,2,1591156800,1591156800,1
xeazlouro,0,1,0,1,1570420800,1570420800,1
LionWalker_Eyre,0,1,0,2,1588824000,1588824000,1
UnemploymentForAll,0,1,0,11,1582434000,1582434000,1
lord_allonymous,0,1,0,18,1597809600,1597809600,1
bluetundra123,0,1,0,1,1611982800,1611982800,1
Adghnm,0,1,0,6,1595649600,1595649600,1
kudzusuzi,0,1,0,9,1597464000,1597464000,1
HelpImOutside,0,1,0,57,1553832000,1553832000,1
BGL911,0,1,0,1,1605934800,1605934800,1
Dubs13151,0,1,0,5,1639803600,1639803600,1
yesimneet,0,1,0,1,1560830400,1560830400,1
Nimbus20000620,0,1,0,1,1639630800,1639630800,1
Sirenic_P1,0,1,0,-16,1605934800,1605934800,1
alaskandarthwader111,1,0,31,0,1596081600,1596081600,1
edmundexley,0,1,0,13,1603425600,1603425600,1
exquisiteliltart,0,1,0,12,1596600000,1596600000,1
summadeez,0,1,0,2,1608440400,1608440400,1
LousyTiming,0,1,0,2,1593748800,1593748800,1
Syl_gurl,0,1,0,1,1608267600,1608267600,1
MannyK46IND,0,1,0,1,1597550400,1597550400,1
Wheredog,1,0,52,0,1586491200,1586491200,1
VB_YTP,0,1,0,3,1554955200,1554955200,1
monsieurpommefrites,0,1,0,15,1600660800,1600660800,1
THR33THIRTYTHR33,0,1,0,3,1589342400,1589342400,1
disquete,0,1,0,2,1550293200,1550293200,1
kmart_shopper,0,1,0,-8,1580619600,1580619600,1
hatchconsonline,0,1,0,1,1578891600,1578891600,1
SaveThemKillYourself,0,1,0,90,1574398800,1574398800,1
dottyparker,1,0,3135,0,1605589200,1605589200,1
BigGStacks,1,0,19,0,1581656400,1581656400,1
lefrm,0,1,0,3,1605243600,1605243600,1
FracturedButWhole18,1,0,61,0,1570680000,1570680000,1
ember297,0,1,0,11,1608699600,1608699600,1
BabyLegsDeadpool,0,1,0,12,1572148800,1572148800,1
Trillip,0,1,0,1,1605157200,1605157200,1
Emma_Kay,0,1,0,15,1580792400,1580792400,1
CyLoke,1,0,20,0,1480050000,1480050000,1
KennaPeaches,0,1,0,1,1603512000,1603512000,1
LucubrateIsh,0,1,0,5,1603512000,1603512000,1
YoureARealCunt,0,1,0,1,1598673600,1598673600,1
SoulDestroyer2,1,0,29,0,1607144400,1607144400,1
LummyTum,1,0,28,0,1591416000,1591416000,1
poopy_toaster,0,1,0,1,1602388800,1602388800,1
codered99999,0,1,0,25,1572062400,1572062400,1
This_ManU67,0,1,0,0,1585454400,1585454400,1
mattchboxx4life,0,1,0,-1,1585454400,1585454400,1
Lostvision,0,1,0,1,1584763200,1584763200,1
bigitimac,0,1,0,2,1607490000,1607490000,1
Ironman0412,0,1,0,1,1607317200,1607317200,1
cryscros,1,0,65,0,1573534800,1573534800,1
nobodybutnohead,1,0,76,0,1563336000,1563336000,1
JordanLikeAStone,0,1,0,8,1596600000,1596600000,1
MinusPi1,0,1,0,1,1616126400,1616126400,1
RBCsavage,0,1,0,12,1604293200,1604293200,1
Fr1toBand1to,0,1,0,21,1590379200,1590379200,1
Velexria,0,1,0,2,1584590400,1584590400,1
morysh,0,1,0,3,1594699200,1594699200,1
Mad_Nekomancer,0,1,0,3,1604466000,1604466000,1
DoctorSteve,0,1,0,9,1577595600,1577595600,1
IzmoMI,0,1,0,1,1607749200,1607749200,1
lesbiancomrade,1,0,9,0,1568779200,1568779200,1
brickstyle,0,1,0,1,1603080000,1603080000,1
Moosi0815,1,0,97,0,1544331600,1544331600,1
FASTHANDY,0,1,0,17,1602388800,1602388800,1
Professional-Bath733,0,1,0,2,1598846400,1598846400,1
PM_ME_YOUR_KATARINA,0,1,0,6,1589860800,1589860800,1
KetchupIsABeverage,0,1,0,18,1550552400,1550552400,1
phenoum,0,1,0,6,1572148800,1572148800,1
Vercyx,0,1,0,2,1605157200,1605157200,1
DenaliRaven,0,1,0,1,1607403600,1607403600,1
mrbead12,0,1,0,1,1589860800,1589860800,1
Freix_,1,0,172,0,1573880400,1573880400,1
Barron_Cyber,0,1,0,2,1571976000,1571976000,1
yrusogey,0,1,0,1,1576645200,1576645200,1
cutthroat_x90,0,1,0,1,1585454400,1585454400,1
EngineerGator,0,1,0,2,1592280000,1592280000,1
Zelda_is_Dead,0,1,0,1,1585108800,1585108800,1
superbrochill,0,1,0,2,1598673600,1598673600,1
courtappoint,0,1,0,2,1589169600,1589169600,1
EightOffHitLure,0,1,0,1,1585454400,1585454400,1
InternetStoleMyLife,0,1,0,1,1599969600,1599969600,1
ArYuProudOMeNowDaddy,0,1,0,230,1571544000,1571544000,1
snazzybud,0,1,0,3,1606280400,1606280400,1
somewhitekid93,0,1,0,3,1607922000,1607922000,1
Ice-and-Iron,0,1,0,1,1606021200,1606021200,1
Nrksbullet,0,1,0,0,1602129600,1602129600,1
lorenasreyna,0,1,0,3,1605762000,1605762000,1
xeurox,0,1,0,3,1585627200,1585627200,1
Distortedhideaway,0,1,0,1,1590033600,1590033600,1
MIKE-WAZOWSKIS-COCK,0,1,0,2,1577077200,1577077200,1
almondbutter_kae,1,0,58,0,1603684800,1603684800,1
toadbabe,0,1,0,1,1608526800,1608526800,1
JotunBlod,0,1,0,3,1583384400,1583384400,1
Brocklesocks,0,1,0,8,1603598400,1603598400,1
WeekendJPOW,0,1,0,25,1588824000,1588824000,1
hcriB,0,1,0,4,1600574400,1600574400,1
sorashinigami,0,1,0,3,1607662800,1607662800,1
diabloplayer375,0,1,0,4,1592539200,1592539200,1
randimthrowawyaccont,0,1,0,3,1580792400,1580792400,1
Kamandant_luftwaffle,0,1,0,13,1561089600,1561089600,1
Lilliaal,0,1,0,12,1596427200,1596427200,1
ArgonGryphon,0,1,0,10,1582606800,1582606800,1
Averen,0,1,0,0,1591156800,1591156800,1
Highgear1,0,1,0,81,1604203200,1604203200,1
_rrljr,0,1,0,8,1545022800,1545022800,1
piahdndizgab,0,1,0,1,1576645200,1576645200,1
WitchWhoCleans,0,1,0,1,1574312400,1574312400,1
gallomusicmx,0,1,0,14,1608613200,1608613200,1
Lem0nek0,0,1,0,2,1588046400,1588046400,1
MirSatellite,1,0,14,0,1601870400,1601870400,1
ItsLinc,0,1,0,5,1568174400,1568174400,1
Alpha-Bella,0,1,0,10,1597118400,1597118400,1
nitrocoldbrew_,0,1,0,18,1601784000,1601784000,1
camus-is-absurd,0,1,0,3,1587268800,1587268800,1
Hattshire,0,1,0,1,1539921600,1539921600,1
funkadunkle,0,1,0,13,1612069200,1612069200,1
PoundCakeFan,0,1,0,1,1603512000,1603512000,1
grolaw,0,1,0,119,1597636800,1597636800,1
Peppermintsnbars,0,1,0,1,1642222800,1642222800,1
WiderStance,0,1,0,7,1574917200,1574917200,1
Vhsrex,0,1,0,1,1600574400,1600574400,1
secondorthirddraft,0,1,0,40,1579064400,1579064400,1
thephantomduke,0,1,0,0,1596600000,1596600000,1
illShy,0,1,0,15,1601092800,1601092800,1
afeatheroftruth,0,1,0,1,1542258000,1542258000,1
newbegginings2020,0,1,0,6,1588132800,1588132800,1
AsilHey,0,1,0,3,1584331200,1584331200,1
AmericanLink,0,1,0,2,1598760000,1598760000,1
TheBrizey,0,1,0,3,1566705600,1566705600,1
gamercer,0,1,0,-5,1589601600,1589601600,1
vampire-weekend-,0,1,0,1,1603512000,1603512000,1
Caffeine_Cowpies,0,1,0,49,1608613200,1608613200,1
forgotten_airbender,0,1,0,1,1592798400,1592798400,1
Pescador1,0,1,0,2,1570766400,1570766400,1
the-arcane-manifesto,1,0,29,0,1606107600,1606107600,1
numbrr,0,1,0,1,1575262800,1575262800,1
AlphaOmega85,0,1,0,1,1589947200,1589947200,1
EvocativeAxis,0,1,0,-2,1602129600,1602129600,1
Faceai,0,1,0,-8,1605070800,1605070800,1
cowboikedd,0,1,0,5,1600747200,1600747200,1
PeepeepoopooXDXD,0,1,0,1,1608699600,1608699600,1
_lil_kennedy,1,0,0,0,1606798800,1606798800,1
Thrash625,0,1,0,1,1575435600,1575435600,1
Luluthe96,0,1,0,2,1609304400,1609304400,1
Diaperpooass,0,1,0,4,1603512000,1603512000,1
daniellebart3,0,1,0,1,1599796800,1599796800,1
TheCerberus14,0,1,0,1,1591329600,1591329600,1
0B00MSLANG0,0,1,0,1,1608267600,1608267600,1
xxGenXxx,0,1,0,1,1603512000,1603512000,1
NextMention10,1,0,67,0,1605070800,1605070800,1
CosmicPennyworth,0,1,0,2,1605070800,1605070800,1
Marihaaann,0,1,0,3,1600833600,1600833600,1
Nutter222,0,1,0,49,1611982800,1611982800,1
fuzzthegreatbambino,0,1,0,4,1588910400,1588910400,1
seattlemh,0,1,0,141,1597118400,1597118400,1
Randomuser726363,0,1,0,0,1607490000,1607490000,1
RanaktheGreen,0,1,0,2,1579669200,1579669200,1
JCreazy,0,1,0,-9,1598068800,1598068800,1
Canadian_Commentator,0,1,0,48,1608786000,1608786000,1
thegreat22,0,1,0,15,1596772800,1596772800,1
heavensgateworldwide,0,1,0,1,1634788800,1634788800,1
Debaser1984,0,1,0,12,1608181200,1608181200,1
Kelly_Louise,0,1,0,1,1577595600,1577595600,1
devilsletuspray,0,1,0,12,1587268800,1587268800,1
Mayaotak,1,0,67,0,1602561600,1602561600,1
peak_hwyl,0,1,0,5,1601352000,1601352000,1
SealClubbedSandwich,0,1,0,5,1591243200,1591243200,1
PrometheusTNO,0,1,0,-3,1584763200,1584763200,1
lorixle_laptop,0,1,0,3,1594958400,1594958400,1
branch455,0,1,0,4,1585627200,1585627200,1
chemistry_jokes47,0,1,0,6,1582261200,1582261200,1
damnselinstresses,1,0,22,0,1580274000,1580274000,1
Mr_Penible,0,1,0,1,1604898000,1604898000,1
Skinhidingbone,0,1,0,5,1548738000,1548738000,1
neutralwombat,0,1,0,1,1608958800,1608958800,1
captainfromhawkslane,0,1,0,4,1566360000,1566360000,1
thesquatz,0,1,0,2,1608872400,1608872400,1
misterthomska,0,1,0,1,1606366800,1606366800,1
Vyke-industries,0,1,0,1,1604379600,1604379600,1
questioningwas,1,0,5,0,1569124800,1569124800,1
Sam_Coolpants,0,1,0,19,1583812800,1583812800,1
tiggga---ninja,0,1,0,2,1600660800,1600660800,1
werdlyfe,0,1,0,2,1578978000,1578978000,1
JezminLychee,0,1,0,8,1587096000,1587096000,1
Jesse4Lyfe,0,1,0,5,1605070800,1605070800,1
Zen_Master_Foo,0,1,0,-2,1599883200,1599883200,1
ISHOTJAMC,0,1,0,3,1590379200,1590379200,1
StarSquash45,0,1,0,54,1596513600,1596513600,1
gowen2TN,0,1,0,3,1607403600,1607403600,1
a__boy,1,0,7,0,1593489600,1593489600,1
fague_doctor,0,1,0,2,1600142400,1600142400,1
d00der,0,1,0,3,1552536000,1552536000,1
kittynap415,0,1,0,2,1602820800,1602820800,1
fancygoldfishfrog,0,1,0,1,1580274000,1580274000,1
mattinva,0,1,0,3,1599624000,1599624000,1
xxmorg,0,1,0,13,1588132800,1588132800,1
Fresded4ty,0,1,0,3,1584590400,1584590400,1
Wendy972,0,1,0,1,1606021200,1606021200,1
Phelyckz,0,1,0,4,1606107600,1606107600,1
ham_solo,0,1,0,2,1602648000,1602648000,1
randomdudeReborn,0,1,0,0,1604116800,1604116800,1
qounqer,0,1,0,-12,1590379200,1590379200,1
BruisedToe,1,0,64,0,1595131200,1595131200,1
petataa,0,1,0,0,1585022400,1585022400,1
mullerjones,0,1,0,1,1608526800,1608526800,1
dogcatcombo,0,1,0,2,1585540800,1585540800,1
Ooftwaffe,0,1,0,11,1606712400,1606712400,1
Kapple7474,0,1,0,1,1573621200,1573621200,1
dontactlikeudontknow,0,1,0,18,1578027600,1578027600,1
ambivigilante,0,1,0,93,1604203200,1604203200,1
Jolly_radjur114,0,1,0,1,1602734400,1602734400,1
LadyDuckworthDuck,0,1,0,5,1599019200,1599019200,1
okolebot,0,1,0,1,1598587200,1598587200,1
FlashyConsequence,0,1,0,1,1604379600,1604379600,1
westbury2017,0,1,0,4,1601352000,1601352000,1
ThomasMaker,0,1,0,4,1599019200,1599019200,1
WhoElseButArty,0,1,0,13,1576558800,1576558800,1
sensual_rustle,0,1,0,1,1593057600,1593057600,1
DogLog88,0,1,0,3,1579150800,1579150800,1
Nothankiefrankie,0,1,0,27,1611982800,1611982800,1
bbandyka,0,1,0,1,1605070800,1605070800,1
Horsecaulking,1,0,527,0,1608354000,1608354000,1
barthqore,0,1,0,7,1597464000,1597464000,1
Plutonicuss,0,1,0,78,1580014800,1580014800,1
CombatWombat65,0,1,0,1,1603512000,1603512000,1
MiniChonk,0,1,0,11,1605675600,1605675600,1
Finna-Hit-That-Yeet,0,1,0,88,1575176400,1575176400,1
majestic7,0,1,0,25,1603598400,1603598400,1
Br0cSamson,0,1,0,-4,1581224400,1581224400,1
Quest_tothe_topshelf,0,1,0,0,1585454400,1585454400,1
wertyuo,0,1,0,23,1577854800,1577854800,1
eiksas,0,1,0,1,1598760000,1598760000,1
bipedwithtwohands,0,1,0,2,1589515200,1589515200,1
AaltoSax,0,1,0,1,1594872000,1594872000,1
christofish,0,1,0,6,1569297600,1569297600,1
Badjokechip,0,1,0,2,1594353600,1594353600,1
ThrowawayId289,1,0,39,0,1593230400,1593230400,1
ClockworkJim,0,1,0,1,1572494400,1572494400,1
brumby79,0,1,0,57,1599105600,1599105600,1
bobbyhill626,0,1,0,-6,1579150800,1579150800,1
sulayman2607,0,1,0,1,1576818000,1576818000,1
PlunderFlunder,0,1,0,-16,1595217600,1595217600,1
HateDeathRampage69,0,1,0,2,1603512000,1603512000,1
CrypticQuirk,0,1,0,11,1571457600,1571457600,1
Dolblathana,1,0,47,0,1605848400,1605848400,1
aequusnox,0,1,0,272,1608958800,1608958800,1
captobliviated,0,1,0,1,1591329600,1591329600,1
possumpopper,1,0,4,0,1606107600,1606107600,1
Vela4331,0,1,0,10,1605416400,1605416400,1
Taradil,1,0,23,0,1559880000,1559880000,1
aj_robinson26,0,1,0,-23,1549602000,1549602000,1
LocalInactivist,0,1,0,1,1598068800,1598068800,1
Shaywise,0,1,0,3,1604203200,1604203200,1
lomowuss,0,1,0,1,1580706000,1580706000,1
angleneri,1,0,11,0,1589601600,1589601600,1
pappapill,1,0,51,0,1560744000,1560744000,1
S-Domain,0,1,0,2,1609304400,1609304400,1
Dahbahdeedahbahdie,0,1,0,12,1568865600,1568865600,1
dirtydewss,1,0,10,0,1563595200,1563595200,1
Sowa7774,0,1,0,1,1577077200,1577077200,1
yo_tengo_gato,0,1,0,25,1606280400,1606280400,1
gentlemanidiot,0,1,0,2,1585454400,1585454400,1
bbbbbbbdbbbbbbbb,0,1,0,2,1605070800,1605070800,1
Rainman_Johnson,0,1,0,5,1590033600,1590033600,1
Noritzu,0,1,0,15,1608008400,1608008400,1
K00bear,1,0,328,0,1605243600,1605243600,1
vialent,0,1,0,15,1581310800,1581310800,1
nerotheus,0,1,0,6,1593835200,1593835200,1
UncleBHoles,0,1,0,3,1579410000,1579410000,1
butttoucher65,0,1,0,28,1550034000,1550034000,1
mycoguy97,1,0,25,0,1571716800,1571716800,1
MaddCricket,0,1,0,7,1604984400,1604984400,1
PromVulture,0,1,0,9,1593748800,1593748800,1
LinkTheBatman,0,1,0,2,1598932800,1598932800,1
inward_fart,0,1,0,4,1603080000,1603080000,1
Tohabath,0,1,0,-3,1580014800,1580014800,1
padrebusoni,0,1,0,2,1608526800,1608526800,1
Plastikmann,0,1,0,7,1597118400,1597118400,1
iamburglor,0,1,0,1,1608181200,1608181200,1
carreerModeDude,0,1,0,12,1611982800,1611982800,1
NotPornNoNo,0,1,0,-2,1609218000,1609218000,1
TargetHunter22,0,1,0,-10,1580101200,1580101200,1
karanahuja10,0,1,0,2,1551762000,1551762000,1
Poisongrape,0,1,0,2,1604898000,1604898000,1
tetthealien,0,1,0,10,1577250000,1577250000,1
dartmorth,0,1,0,7,1599796800,1599796800,1
425115239198,0,1,0,13,1592193600,1592193600,1
Reichiroo,0,1,0,3,1571889600,1571889600,1
PattyIce32,0,1,0,2,1591329600,1591329600,1
zoethought,1,0,37,0,1595649600,1595649600,1
GoliathBoneSnake,0,1,0,1,1597204800,1597204800,1
Fantail-Records,0,1,0,3,1575176400,1575176400,1
ChattyConfidence,0,1,0,3,1573794000,1573794000,1
minastirith1,0,1,0,8,1608786000,1608786000,1
WilliamSaidso,0,1,0,0,1607922000,1607922000,1
ProktosRS,0,1,0,8,1607144400,1607144400,1
rma66,0,1,0,2,1570161600,1570161600,1
fakenudesz,0,1,0,3,1609045200,1609045200,1
DocFossil,0,1,0,16,1577941200,1577941200,1
Womar23,0,1,0,5,1553400000,1553400000,1
localokie2360,0,1,0,1,1603512000,1603512000,1
TexanEle,0,1,0,3,1581483600,1581483600,1
Vegelin,0,1,0,2,1540094400,1540094400,1
Pseudynom,0,1,0,2,1602734400,1602734400,1
thejazminesage,0,1,0,197,1583038800,1583038800,1
asexual_bird,0,1,0,1,1579064400,1579064400,1
Lucaslith,0,1,0,1,1603512000,1603512000,1
WallyRose,0,1,0,3,1596513600,1596513600,1
SWAD42,0,1,0,1,1589256000,1589256000,1
thelividartist,0,1,0,1,1606712400,1606712400,1
DinerEnBlanc,0,1,0,2,1598846400,1598846400,1
Resident_Trouble6515,0,1,0,2,1612155600,1612155600,1
Mr_Horizon,0,1,0,1,1611205200,1611205200,1
AmoebaMan,0,1,0,0,1562731200,1562731200,1
hnet74,1,0,12,0,1585454400,1585454400,1
aryeh86,0,1,0,1,1608181200,1608181200,1
Kale8888H,0,1,0,1,1609304400,1609304400,1
19_smeljakis_86,0,1,0,2,1549515600,1549515600,1
thunderthighlasagna,0,1,0,84,1587614400,1587614400,1
I_OFFFER_YOU_THIS,0,1,0,1,1591588800,1591588800,1
bunniteeth,0,1,0,1,1605243600,1605243600,1
peejr,0,1,0,1,1585195200,1585195200,1
KittenWhispersnCandy,0,1,0,8,1587873600,1587873600,1
callipygousmom,0,1,0,15,1602820800,1602820800,1
Einherjer_97,0,1,0,6,1580014800,1580014800,1
lesser_solace,0,1,0,3,1603252800,1603252800,1
hollowhallow31,0,1,0,1,1593316800,1593316800,1
dida-xzy,0,1,0,6,1601784000,1601784000,1
Thtpurplestuff,0,1,0,-1,1589515200,1589515200,1
hoo_ya,0,1,0,1,1577422800,1577422800,1
ryanb-,0,1,0,-2,1578459600,1578459600,1
jkessle4,0,1,0,3,1599624000,1599624000,1
Jish1202,0,1,0,75,1587268800,1587268800,1
Zeke12344,0,1,0,-2,1608267600,1608267600,1
averagejanecitizen,0,1,0,5,1560916800,1560916800,1
xCaptainKiddx,1,0,225,0,1601611200,1601611200,1
The_Karma_Killer,0,1,0,1,1580187600,1580187600,1
you_cant_ban_me_mods,0,1,0,68,1557028800,1557028800,1
B--E--A--N,0,1,0,7,1598241600,1598241600,1
Opposite_Minute_7179,0,1,0,2,1642914000,1642914000,1
wrongtreeinfo,0,1,0,1,1611810000,1611810000,1
stk1818,0,1,0,1,1612069200,1612069200,1
mvppaulo,0,1,0,-24,1598328000,1598328000,1
reddit_mustbtrue,0,1,0,3,1584504000,1584504000,1
Falcon_128,0,1,0,4,1596168000,1596168000,1
YabbaDabbaP00,0,1,0,-9,1603598400,1603598400,1
BinLadenBComin,0,1,0,1,1578027600,1578027600,1
Bigboost92,0,1,0,5,1552622400,1552622400,1
SilverShrimp0,0,1,0,4,1579928400,1579928400,1
putsnakesinyourhair,0,1,0,23,1608094800,1608094800,1
torments6,0,1,0,1,1600574400,1600574400,1
cottonmouth_,0,1,0,7,1606712400,1606712400,1
SmittyPlug,0,1,0,1,1600574400,1600574400,1
ThatsNotADingo,0,1,0,5,1601956800,1601956800,1
Cheezewiz239,0,1,0,3,1585454400,1585454400,1
HiTzFrOmDaKiNe,0,1,0,6,1591243200,1591243200,1
noporesforlife,0,1,0,2,1600747200,1600747200,1
Hundredsenhundreds,0,1,0,2,1584331200,1584331200,1
Draagloem,0,1,0,113,1604203200,1604203200,1
Rando161803,0,1,0,4,1599624000,1599624000,1
thecakeisalie1013,0,1,0,0,1605589200,1605589200,1
781234567,0,1,0,1,1605589200,1605589200,1
CurtisHayfield,0,1,0,54,1605070800,1605070800,1
mattstorm360,0,1,0,1,1578114000,1578114000,1
arturoayasan,0,1,0,1,1603512000,1603512000,1
experts_never_lie,0,1,0,1,1559188800,1559188800,1
Last-Donut,0,1,0,1,1607490000,1607490000,1
lastpieceofpie,0,1,0,1,1609045200,1609045200,1
HenjaminFranklin,0,1,0,0,1561867200,1561867200,1
Morty_104,0,1,0,5,1612069200,1612069200,1
blueshoesrcool,0,1,0,2,1547960400,1547960400,1
AragornSnow,0,1,0,-7,1600660800,1600660800,1
MingusMingusMingu,0,1,0,7,1609304400,1609304400,1
Dreadlock_Hayzeus,0,1,0,1,1606626000,1606626000,1
rialucia,0,1,0,1,1563163200,1563163200,1
docbrown88,0,1,0,2,1595649600,1595649600,1
lame-changer,0,1,0,6,1589428800,1589428800,1
dogpromthreed,0,1,0,3,1567915200,1567915200,1
human-potato_hybrid,1,0,226,0,1574744400,1574744400,1
pohtahtohs,0,1,0,10,1608181200,1608181200,1
SaulGoodman-2,0,1,0,7,1605848400,1605848400,1
sunset_sergal,0,1,0,2,1597982400,1597982400,1
Trauma-Dolll,0,1,0,0,1601352000,1601352000,1
topqualitymeats,0,1,0,-1,1585540800,1585540800,1
stFrancisiscalling,0,1,0,1,1562385600,1562385600,1
Platinum247365,0,1,0,1,1561694400,1561694400,1
jollybot,0,1,0,26,1597550400,1597550400,1
qualcunoacasox,0,1,0,5,1607835600,1607835600,1
Payrus,0,1,0,2,1606712400,1606712400,1
CalamityJenX,0,1,0,1,1607144400,1607144400,1
BulbasaurBabu,0,1,0,17,1607317200,1607317200,1
vortextwo,0,1,0,3,1575522000,1575522000,1
reddititaly,0,1,0,1,1607230800,1607230800,1
TheYoungAcoustic,0,1,0,0,1571112000,1571112000,1
Dentka,0,1,0,-2,1600142400,1600142400,1
ryrythe3rd,0,1,0,0,1589169600,1589169600,1
oofnoa,0,1,0,11,1598673600,1598673600,1
balancingmyself,0,1,0,1,1606366800,1606366800,1
possumrfrend,1,0,72,0,1573016400,1573016400,1
williodillio,0,1,0,2,1578718800,1578718800,1
scorpiodragon,0,1,0,6,1573794000,1573794000,1
randyranderson13,0,1,0,2,1607317200,1607317200,1
SpaffWaffington,0,1,0,72,1611896400,1611896400,1
tedthedog_,0,1,0,6,1605243600,1605243600,1
Al25fcp,0,1,0,1,1611982800,1611982800,1
im-notme,1,0,25,0,1582693200,1582693200,1
LevenCTN,1,0,68,0,1597982400,1597982400,1
ChunksOWisdom,0,1,0,32,1573362000,1573362000,1
twounicorns,0,1,0,1,1595649600,1595649600,1
wolfio495,0,1,0,2,1593835200,1593835200,1
jade_sage,0,1,0,2,1609218000,1609218000,1
dingdongdudah,0,1,0,3,1596168000,1596168000,1
curlygoats,0,1,0,25,1606971600,1606971600,1
bills822,0,1,0,1,1603512000,1603512000,1
High_Flyers17,0,1,0,3,1603512000,1603512000,1
ass2ass,0,1,0,1,1611896400,1611896400,1
LiamNeesonsDad,0,1,0,2,1608267600,1608267600,1
Mikebyrneyadigg,0,1,0,29,1590379200,1590379200,1
Ekkolilia,0,1,0,2,1608354000,1608354000,1
InsertOxymoronHere,0,1,0,1,1582088400,1582088400,1
CuriousConfection,0,1,0,2,1594267200,1594267200,1
Headcap,0,1,0,14,1576386000,1576386000,1
veryvesuvius,0,1,0,2,1577250000,1577250000,1
pseudent,0,1,0,5,1578027600,1578027600,1
MyLittleShitPost,0,1,0,3,1600660800,1600660800,1
BriceConquers,0,1,0,-5,1607403600,1607403600,1
Chroneeze,0,1,0,11,1600574400,1600574400,1
bloodharry,0,1,0,3,1591761600,1591761600,1
Shawaii,0,1,0,5,1558584000,1558584000,1
SalsaDraugur,0,1,0,-3,1571544000,1571544000,1
jameson-neat,0,1,0,5,1599796800,1599796800,1
nyjets4life6,0,1,0,12,1601352000,1601352000,1
ThsNmHsNVwls,0,1,0,1,1589947200,1589947200,1
closedstudios,0,1,0,1,1600574400,1600574400,1
CinderChop,0,1,0,6,1587268800,1587268800,1
key2mydisaster,0,1,0,3,1588392000,1588392000,1
Tiffred,1,0,255,0,1557806400,1557806400,1
Palin_Sees_Russia,0,1,0,9,1585627200,1585627200,1
VNVDVI,0,1,0,6,1573534800,1573534800,1
antonmartinRIP,0,1,0,-7,1571112000,1571112000,1
The_Loudest_Fart,0,1,0,2,1603512000,1603512000,1
CyFox-yt,1,0,7,0,1588564800,1588564800,1
tiddieskin,0,1,0,2,1597464000,1597464000,1
Dougtheinfonut,0,1,0,1,1595822400,1595822400,1
PeppersHere,0,1,0,1,1571716800,1571716800,1
coocoomamajuju,0,1,0,8,1579582800,1579582800,1
REVEB_TAE_i,0,1,0,1,1585454400,1585454400,1
audiate_,0,1,0,1,1601956800,1601956800,1
chessmathster16,0,1,0,1,1590033600,1590033600,1
TryItOutAt2395,0,1,0,4,1607230800,1607230800,1
MakaveliTheDon831,0,1,0,7,1555905600,1555905600,1
nendsnoods,0,1,0,16,1588910400,1588910400,1
MountainKey4612,0,1,0,0,1604293200,1604293200,1
tezomby,0,1,0,1,1608008400,1608008400,1
Squalor-,0,1,0,38,1591243200,1591243200,1
4linosa,0,1,0,-1,1589860800,1589860800,1
hanhanbanan,0,1,0,1,1572930000,1572930000,1
alxmartin,0,1,0,25,1608181200,1608181200,1
dafangalator,0,1,0,3,1594699200,1594699200,1
BeExcellent,0,1,0,17,1554350400,1554350400,1
Indifferent_Tuber,0,1,0,2,1606280400,1606280400,1
Talrynn_Sorrowyn,0,1,0,1,1589947200,1589947200,1
YourCasualDude,0,1,0,7,1604984400,1604984400,1
Finger_Gunnz,0,1,0,-1,1604379600,1604379600,1
borderlinebacon,0,1,0,1,1584158400,1584158400,1
thecoasterboaster,1,0,13,0,1588219200,1588219200,1
TheVeil36,0,1,0,2,1605589200,1605589200,1
mytonguehurtsalot,0,1,0,2,1598932800,1598932800,1
heyimwalkinhere-,0,1,0,3,1598846400,1598846400,1
TugarWolve,0,1,0,1,1605848400,1605848400,1
threemo,0,1,0,-2,1591243200,1591243200,1
LagQuest,0,1,0,-4,1584763200,1584763200,1
saxymassagehands,0,1,0,24,1589256000,1589256000,1
fuckjapshit,0,1,0,1,1560484800,1560484800,1
hello_world_sorry,0,1,0,1,1585454400,1585454400,1
ama88,0,1,0,3,1599710400,1599710400,1
Ladyjulianne,0,1,0,1,1608008400,1608008400,1
palebluedot1988,0,1,0,15,1594785600,1594785600,1
Clarkson34,0,1,0,1,1611982800,1611982800,1
cherry_colas,0,1,0,14,1591329600,1591329600,1
goneharolding,0,1,0,17,1608526800,1608526800,1
Frostbrine,0,1,0,5,1601179200,1601179200,1
dicksrelated,0,1,0,3,1589860800,1589860800,1
Implement_Abject,0,1,0,1,1603512000,1603512000,1
Rileyswims,0,1,0,6,1603425600,1603425600,1
JobsWhereAreYou69,0,1,0,1,1600833600,1600833600,1
goteamventure42,0,1,0,4,1607317200,1607317200,1
Honeymaid,0,1,0,1,1576818000,1576818000,1
TheNextFeynman,0,1,0,2,1608699600,1608699600,1
throwdis12,0,1,0,1,1603512000,1603512000,1
Society_AfterZ,0,1,0,3,1606021200,1606021200,1
kopiCgahdai,0,1,0,2,1590292800,1590292800,1
Professional-Fee9214,0,1,0,3,1607490000,1607490000,1
vaiostation,0,1,0,2,1607662800,1607662800,1
coldestwinter-chill,0,1,0,5,1595131200,1595131200,1
GiraffeXL,0,1,0,33,1608526800,1608526800,1
Livie_Lovely,0,1,0,3,1585281600,1585281600,1
N8theSnake,0,1,0,2,1606712400,1606712400,1
EagleDarkX,0,1,0,1,1590120000,1590120000,1
J0J099,0,1,0,2,1600574400,1600574400,1
bloom_after_rain,0,1,0,28,1607835600,1607835600,1
0ddmanrush,0,1,0,-4,1585454400,1585454400,1
SevenDeadlyGentlemen,0,1,0,1,1606539600,1606539600,1
escape777,0,1,0,10,1609218000,1609218000,1
Fiveminutes26,0,1,0,1,1600574400,1600574400,1
gendpurr,0,1,0,2,1607230800,1607230800,1
Choyo,0,1,0,12,1585454400,1585454400,1
antney0615,0,1,0,1,1575954000,1575954000,1
seb0seven,0,1,0,7,1591243200,1591243200,1
JackMythos,0,1,0,25,1569816000,1569816000,1
FlavourThoughts,0,1,0,1,1612155600,1612155600,1
AlphaLove_,0,1,0,1,1585454400,1585454400,1
fallstand,0,1,0,1,1585454400,1585454400,1
HutchOne23,0,1,0,10,1606626000,1606626000,1
Slaterface,0,1,0,2,1592193600,1592193600,1
StriveTown,0,1,0,1,1600401600,1600401600,1
FilthyHookerSpit,0,1,0,6,1594526400,1594526400,1
ShiftySeagull,0,1,0,13,1599710400,1599710400,1
Switched_On_SNES,0,1,0,1,1602907200,1602907200,1
ArchangelIncsecurity,0,1,0,1,1600660800,1600660800,1
Morti_Macabre,0,1,0,5,1573534800,1573534800,1
hexsex0,0,1,0,1,1608008400,1608008400,1
Continental_Crisis,0,1,0,1,1584158400,1584158400,1
michealscott21,0,1,0,1,1560657600,1560657600,1
Winitfortheskipper,0,1,0,3,1586664000,1586664000,1
DinosaurDied,0,1,0,1,1579410000,1579410000,1
Ellohcin,0,1,0,14,1573362000,1573362000,1
DrRungo,0,1,0,2,1598414400,1598414400,1
415Legend,0,1,0,7,1588219200,1588219200,1
lionsling,0,1,0,6,1608613200,1608613200,1
osufan765,0,1,0,6,1583812800,1583812800,1
The_Despencer,0,1,0,13,1602561600,1602561600,1
neo-memeism,0,1,0,3,1566273600,1566273600,1
thwoorrpthereitis,0,1,0,1,1587182400,1587182400,1
TheModernNano,0,1,0,-3,1600315200,1600315200,1
hereforthecats27,0,1,0,12,1590638400,1590638400,1
uberjim,0,1,0,3,1598760000,1598760000,1
TheBishopPiece,0,1,0,1,1565323200,1565323200,1
dajjaliscoming,0,1,0,1,1600833600,1600833600,1
prettyponyz,0,1,0,1,1608267600,1608267600,1
MonkeySeetheMonkeyDo,0,1,0,1,1599019200,1599019200,1
Throwaway173749,0,1,0,2,1590638400,1590638400,1
takebackourcity,0,1,0,-1,1561867200,1561867200,1
Pickle_Slinger,0,1,0,1,1607576400,1607576400,1
formerlymq,0,1,0,1,1554350400,1554350400,1
artosa,0,1,0,5,1603598400,1603598400,1
existentialisttrash,0,1,0,3,1573189200,1573189200,1
ScarletSlicer,0,1,0,2,1591329600,1591329600,1
keynesisachad,0,1,0,3,1607662800,1607662800,1
Aruviel,0,1,0,0,1605675600,1605675600,1
thecementmixer,0,1,0,5,1600315200,1600315200,1
__removed__,0,1,0,1,1581138000,1581138000,1
colinag5,0,1,0,4,1605070800,1605070800,1
Napefrog,0,1,0,1,1575435600,1575435600,1
SAINGS-Nolls,0,1,0,3,1593921600,1593921600,1
SqurrelGuy,0,1,0,1,1612069200,1612069200,1
Mobile_Expert_8683,0,1,0,1,1603944000,1603944000,1
turdintheattic,0,1,0,2,1583643600,1583643600,1
ryanlansky,0,1,0,9,1606021200,1606021200,1
Scubawookie,0,1,0,1,1556596800,1556596800,1
Bojacksad,0,1,0,3,1605762000,1605762000,1
Moctezuma1,0,1,0,8,1584763200,1584763200,1
Nan0_Tc0,0,1,0,3,1607490000,1607490000,1
ChuDrebby,0,1,0,1,1611982800,1611982800,1
Ukr_dancing_mann,0,1,0,1,1583125200,1583125200,1
Morchinelli,1,0,139,0,1575435600,1575435600,1
Eyes-for-ellis,0,1,0,2,1590552000,1590552000,1
WimyWamWamWozl,0,1,0,3,1559275200,1559275200,1
IveKnownItAll,0,1,0,4,1586232000,1586232000,1
creeoer,0,1,0,0,1571544000,1571544000,1
KevinadianBacon,0,1,0,1,1604116800,1604116800,1
Toasty_kitty,0,1,0,11,1578027600,1578027600,1
curiouscat887,0,1,0,4,1600833600,1600833600,1
UnstoppablePhoenix,0,1,0,11,1585454400,1585454400,1
sugarxxfree,0,1,0,3,1544936400,1544936400,1
Kelderic,0,1,0,3,1602475200,1602475200,1
MasterOfBunnies,0,1,0,1,1591329600,1591329600,1
ImWaddlinHere,0,1,0,1,1600488000,1600488000,1
DavidGraeber,0,1,0,13,1532232000,1532232000,1
reddit69boi,0,1,0,1,1611982800,1611982800,1
GoldPickleFist,0,1,0,1,1605934800,1605934800,1
acmoder,0,1,0,7,1605502800,1605502800,1
mitchskaterr,0,1,0,2,1596945600,1596945600,1
JFK_WENT_AFK,0,1,0,13,1604293200,1604293200,1
AMFDevious,0,1,0,16,1592539200,1592539200,1
ObjectiveCelery,0,1,0,1,1604638800,1604638800,1
ZingertheWingdinger,0,1,0,18,1599451200,1599451200,1
NotSoBuffGuy,0,1,0,2,1608786000,1608786000,1
sounds-hot,0,1,0,5,1541653200,1541653200,1
IndividualMango,0,1,0,20,1604984400,1604984400,1
rollandfloor,0,1,0,1,1569643200,1569643200,1
gmwdim,0,1,0,5,1598328000,1598328000,1
Mihsan,0,1,0,5,1555905600,1555905600,1
NoNerdsZone,0,1,0,9,1580792400,1580792400,1
Idontwanttobebread,0,1,0,778,1603512000,1603512000,1
DankeMemeses,0,1,0,2,1637298000,1637298000,1
metooeither,0,1,0,3,1573362000,1573362000,1
Kurotan,0,1,0,1,1578373200,1578373200,1
tekjunky75,0,1,0,-9,1584763200,1584763200,1
halb7,0,1,0,4,1573621200,1573621200,1
_db_,0,1,0,1,1588478400,1588478400,1
Captain_Jokes,0,1,0,1,1603857600,1603857600,1
freakverse,0,1,0,5,1577163600,1577163600,1
soondot,0,1,0,4,1546405200,1546405200,1
peppebbb,0,1,0,-3,1597723200,1597723200,1
yidakichai,0,1,0,1,1609822800,1609822800,1
evizzle11,1,0,22,0,1606885200,1606885200,1
loamy,0,1,0,7,1561176000,1561176000,1
dykewithaspike,0,1,0,1,1573362000,1573362000,1
SexuallyHarassdPanda,0,1,0,14,1608267600,1608267600,1
Ritona,0,1,0,2,1551416400,1551416400,1
Chris_di_Modden,0,1,0,130,1590984000,1590984000,1
aggieof10,0,1,0,-4,1587355200,1587355200,1
guitarburst05,0,1,0,77,1591243200,1591243200,1
chonkehmonkeh,0,1,0,7,1603944000,1603944000,1
mikeymikeymikey1968,0,1,0,9,1565582400,1565582400,1
Bluazul,0,1,0,76,1594612800,1594612800,1
La_La_Bla,0,1,0,1,1583298000,1583298000,1
_Born_To_Be_Mild_,0,1,0,24,1565668800,1565668800,1
vydija2020,0,1,0,1,1587441600,1587441600,1
wowokbro,0,1,0,4,1596081600,1596081600,1
BrookOPW,0,1,0,1,1596859200,1596859200,1
MrTheArbiter,0,1,0,2,1603598400,1603598400,1
ThePleasantArea,0,1,0,2,1587355200,1587355200,1
sickofgreed,0,1,0,2,1602388800,1602388800,1
I_am_Nemo1,0,1,0,2,1577682000,1577682000,1
1673862739,0,1,0,-2,1584763200,1584763200,1
Beautiful-Start-2966,0,1,0,3,1635307200,1635307200,1
odisseusofgod,0,1,0,7,1602043200,1602043200,1
satanic_satanist,0,1,0,4,1573534800,1573534800,1
24602060451,1,0,88,0,1566273600,1566273600,1
_pm_me_your_holes_,0,1,0,6,1602648000,1602648000,1
HectoSexual,0,1,0,10,1573448400,1573448400,1
XIVMagnus,0,1,0,1,1598846400,1598846400,1
Samsterdam,0,1,0,-2,1606539600,1606539600,1
Altenugen,0,1,0,1,1614834000,1614834000,1
kitacpl,0,1,0,5,1578632400,1578632400,1
NiggBot_3000,0,1,0,2,1608872400,1608872400,1
pastanate,0,1,0,0,1571112000,1571112000,1
benderasfuck,0,1,0,-2,1581915600,1581915600,1
E-raticSamurai,0,1,0,1,1606539600,1606539600,1
Paydirt40,0,1,0,1,1608872400,1608872400,1
CrystalUranium,0,1,0,11,1580533200,1580533200,1
FeistyFrogger,0,1,0,2,1601352000,1601352000,1
blooms98,1,0,21,0,1605848400,1605848400,1
Frejasabel,0,1,0,33,1569816000,1569816000,1
Lonely_Jack,0,1,0,3,1611982800,1611982800,1
9centwhore,0,1,0,1,1572235200,1572235200,1
MediumProfessorX,0,1,0,3,1604379600,1604379600,1
Not_A_Trombone,0,1,0,14,1564027200,1564027200,1
superzavv,0,1,0,2,1610082000,1610082000,1
Customsjpop,0,1,0,7,1583470800,1583470800,1
jafhrdz,0,1,0,13,1612069200,1612069200,1
Bloodwolv,0,1,0,5,1608526800,1608526800,1
B6030,0,1,0,15,1581915600,1581915600,1
alexisbal,1,0,17,0,1607576400,1607576400,1
Yinzbag,0,1,0,1,1597809600,1597809600,1
Diels_Alder,0,1,0,1,1605589200,1605589200,1
thepurplehedgehog,0,1,0,4,1604379600,1604379600,1
MuensterHunter561,0,1,0,0,1603598400,1603598400,1
Agent47_,0,1,0,3,1589860800,1589860800,1
DustyCopain,0,1,0,6,1595822400,1595822400,1
micromoses,0,1,0,5,1604379600,1604379600,1
GN77,0,1,0,11,1569124800,1569124800,1
Voltage97,0,1,0,0,1601006400,1601006400,1
verooonica,0,1,0,2,1604552400,1604552400,1
fists_of_curry,0,1,0,2,1569643200,1569643200,1
blackswan2whiteswan,0,1,0,1,1578373200,1578373200,1
TheCrazedMadman,0,1,0,8,1572235200,1572235200,1
IGuesslllContribute,0,1,0,2,1606194000,1606194000,1
FogeyDotage,0,1,0,2,1602820800,1602820800,1
PleasingFungusBeetle,0,1,0,1,1561867200,1561867200,1
Jezza75,0,1,0,2,1605675600,1605675600,1
roothorick,0,1,0,1,1539921600,1539921600,1
WompWompIt,0,1,0,7,1582779600,1582779600,1
witchkizzle,0,1,0,5,1551416400,1551416400,1
Chojangles225,0,1,0,-1,1560916800,1560916800,1
bmatt17,0,1,0,34,1552194000,1552194000,1
IGNOREMETHATSFINETOO,0,1,0,3,1550725200,1550725200,1
spicyeggboi,0,1,0,3,1558843200,1558843200,1
skrubbadubdub,0,1,0,15,1589947200,1589947200,1
S3garcea,0,1,0,3,1608699600,1608699600,1
sundaylobotomist,0,1,0,2,1584676800,1584676800,1
rom_mintz,0,1,0,-6,1554955200,1554955200,1
majestic_tapir,0,1,0,8,1606539600,1606539600,1
BadgersDen,0,1,0,21,1547528400,1547528400,1
toscaninidacron,0,1,0,8,1577682000,1577682000,1
AndrewJackingJihad,0,1,0,9,1559275200,1559275200,1
_thegreatsaiyaman_,0,1,0,1,1556078400,1556078400,1
Xoxohopeann,0,1,0,5,1597982400,1597982400,1
_Abecedarius,0,1,0,6,1594094400,1594094400,1
DefendingLogic,0,1,0,1,1601179200,1601179200,1
SameAlternative,0,1,0,3,1600660800,1600660800,1
CjStaal,0,1,0,3,1571889600,1571889600,1
JustAnotherWalker109,1,0,364,0,1579669200,1579669200,1
PongeyTell,0,1,0,1,1592193600,1592193600,1
matt_peri,0,1,0,3,1571716800,1571716800,1
gootsganeeheesh,0,1,0,1,1611982800,1611982800,1
jrik23,0,1,0,5,1579669200,1579669200,1
casalis,0,1,0,2,1592193600,1592193600,1
michiganbarexam,0,1,0,3,1583298000,1583298000,1
30SomethingScouse,0,1,0,2,1600920000,1600920000,1
metalman42,0,1,0,67,1573880400,1573880400,1
Hickory_Dickory_Derp,0,1,0,1,1581742800,1581742800,1
tachyonxero,0,1,0,1,1598500800,1598500800,1
AndrewDevs,0,1,0,21,1561176000,1561176000,1
70octillion,0,1,0,2,1606280400,1606280400,1
Axel_Sandstorm,0,1,0,9,1599883200,1599883200,1
ShiverMeTimbres01,0,1,0,2,1591329600,1591329600,1
ukmitch86,0,1,0,1,1605934800,1605934800,1
quixote1889,0,1,0,18,1601438400,1601438400,1
simabo,0,1,0,1,1603512000,1603512000,1
wierd_husky,0,1,0,1,1605070800,1605070800,1
AlexisFR,0,1,0,2,1606539600,1606539600,1
i-fucked-my-gerbil,0,1,0,1,1605502800,1605502800,1
hypatiaunderground,1,0,6,0,1601006400,1601006400,1
starryobservatory,0,1,0,5,1570680000,1570680000,1
Keaoa,0,1,0,5,1598155200,1598155200,1
Plastic_Person,0,1,0,1,1599537600,1599537600,1
DumSpiroSpero3,0,1,0,3,1608786000,1608786000,1
powershirt,0,1,0,-1,1571544000,1571544000,1
999Crash999,0,1,0,4,1583211600,1583211600,1
QueenRaya,0,1,0,4,1603598400,1603598400,1
atreyukun,0,1,0,3,1612069200,1612069200,1
nedimhadzi,0,1,0,5,1572408000,1572408000,1
Proper_Distribution1,0,1,0,3,1601524800,1601524800,1
Jatbat53,1,0,1,0,1591329600,1591329600,1
Eyywassamattau,0,1,0,2,1605416400,1605416400,1
Booxcar,0,1,0,2,1603512000,1603512000,1
TheRubellaMan,1,0,0,0,1604811600,1604811600,1
Grett412,0,1,0,-15,1572667200,1572667200,1
pinkydolphins,0,1,0,-7,1575262800,1575262800,1
fadedsparkle,0,1,0,3,1593316800,1593316800,1
hitch00,0,1,0,1,1589342400,1589342400,1
johnmcdracula,0,1,0,3,1579755600,1579755600,1
Sixtesixx6,0,1,0,3,1606798800,1606798800,1
Gasonfires,0,1,0,2,1588737600,1588737600,1
HandsomeBeaker,0,1,0,1,1582693200,1582693200,1
Thisica,0,1,0,2,1605502800,1605502800,1
OrangeandMango,0,1,0,3,1609131600,1609131600,1
GreatAndSpacious,0,1,0,2,1573880400,1573880400,1
ifeelshamed,0,1,0,3,1585022400,1585022400,1
Delete_cat,0,1,0,3,1609218000,1609218000,1
chimp_numerone,0,1,0,2,1579582800,1579582800,1
CelesteB1998,1,0,484,0,1605934800,1605934800,1
Revrak,0,1,0,3,1606539600,1606539600,1
Storminski,0,1,0,1,1604379600,1604379600,1
fuckthislifeintheass,0,1,0,16,1585022400,1585022400,1
Talyyr0,0,1,0,2,1603252800,1603252800,1
x3XC4L1B3Rx,1,0,337,0,1588046400,1588046400,1
Intelligent-Basil,0,1,0,3,1585972800,1585972800,1
itealaich,0,1,0,11,1612155600,1612155600,1
WhyWouldHeLie,0,1,0,2,1607662800,1607662800,1
Bataclan2020,1,0,0,0,1605502800,1605502800,1
RedRadial,0,1,0,0,1582779600,1582779600,1
NormalClicheUsername,0,1,0,9,1605675600,1605675600,1
thromeaw4y,0,1,0,1,1581051600,1581051600,1
Waste_Ocelot_9884,0,1,0,1,1600660800,1600660800,1
Sorogon,0,1,0,3,1588132800,1588132800,1
cyberjusticewarrior,0,1,0,8,1596945600,1596945600,1
jrzenno,1,0,3,0,1594958400,1594958400,1
cymbalstack,1,0,35,0,1453698000,1453698000,1
HereToBeBlownAway,0,1,0,2,1584590400,1584590400,1
nkid299,0,1,0,12,1561780800,1561780800,1
throwaway-quitw33d,0,1,0,1,1576213200,1576213200,1
BrassOrchids,0,1,0,27,1562644800,1562644800,1
Dekker3D,0,1,0,5,1607922000,1607922000,1
babybubblenugget,0,1,0,22,1609477200,1609477200,1
P_Foot,0,1,0,1,1596772800,1596772800,1
No_Lock_6555,0,1,0,6,1600488000,1600488000,1
Rocflex,0,1,0,1,1591329600,1591329600,1
schwerpunk,0,1,0,8,1612069200,1612069200,1
sebas18199,0,1,0,1,1606885200,1606885200,1
giraffactory,0,1,0,37,1592798400,1592798400,1
alphamale123123123,0,1,0,7,1574571600,1574571600,1
sfwdabaccount,0,1,0,1,1595476800,1595476800,1
Eskoot195382,0,1,0,0,1597377600,1597377600,1
Plopita,0,1,0,3,1576386000,1576386000,1
Razgrizv,0,1,0,7,1603512000,1603512000,1
ALightSkyHue,0,1,0,1,1597464000,1597464000,1
MachoRussianVoice,0,1,0,32,1595649600,1595649600,1
ctrlplusZ,0,1,0,25,1562472000,1562472000,1
twitterisagooddog,0,1,0,-2,1582347600,1582347600,1
DeeGSE,0,1,0,58,1611896400,1611896400,1
bluelinewarri0r,0,1,0,1,1605243600,1605243600,1
EvenBetterCool,0,1,0,48,1606539600,1606539600,1
zerothelobbyboy,0,1,0,3,1604379600,1604379600,1
Adriss95,1,0,4783,0,1609131600,1609131600,1
Oburcuk,0,1,0,2,1593230400,1593230400,1
jenrose27,0,1,0,2,1569556800,1569556800,1
iridescent_turd,0,1,0,4,1611810000,1611810000,1
sevenmillionscarves,0,1,0,3,1594353600,1594353600,1
Xelonai,0,1,0,3,1590724800,1590724800,1
overachiever1516,0,1,0,12,1607835600,1607835600,1
XxShroomWizardxX,0,1,0,3,1603512000,1603512000,1
lucialunacy,0,1,0,6,1611810000,1611810000,1
TheBirbReturn,0,1,0,1,1576645200,1576645200,1
Mooway,0,1,0,7,1573016400,1573016400,1
Heretic_Chick,0,1,0,4,1578805200,1578805200,1
Domhnall05,0,1,0,-4,1598673600,1598673600,1
Lusy827,0,1,0,1,1592798400,1592798400,1
4lexanderthe,0,1,0,1,1585454400,1585454400,1
Spaztastic21,0,1,0,2,1608181200,1608181200,1
bumpybear,0,1,0,13,1599710400,1599710400,1
apeas,0,1,0,7,1605934800,1605934800,1
GreasyBud,0,1,0,5,1596772800,1596772800,1
Thankkratom,0,1,0,3,1603512000,1603512000,1
revicon,0,1,0,2,1569124800,1569124800,1
tilowiklund,0,1,0,2,1481432400,1481432400,1
WileyCoyote7,0,1,0,4,1608354000,1608354000,1
nestorishere,0,1,0,3,1612069200,1612069200,1
Souledex,0,1,0,21,1550638800,1550638800,1
NomenklaturaFTW,0,1,0,48,1599192000,1599192000,1
TheEpic5Miner,0,1,0,6,1599883200,1599883200,1
maybelazythrowaway,1,0,22,0,1573621200,1573621200,1
MarmalAIDs,0,1,0,-8,1549515600,1549515600,1
ContentChocolate,0,1,0,5,1561348800,1561348800,1
HoopOnPoop,0,1,0,6,1607403600,1607403600,1
mattrimcauthon,0,1,0,8,1584676800,1584676800,1
MisterLongboi,0,1,0,2,1603512000,1603512000,1
AdviceQueen1982,1,0,227,0,1594008000,1594008000,1
BreachedTicket,0,1,0,8,1597809600,1597809600,1
MartianCavenaut,0,1,0,-1,1608699600,1608699600,1
Oriks-Asks,0,1,0,6,1597809600,1597809600,1
golden-gorl,0,1,0,3,1591156800,1591156800,1
ThermaltakeLevel10GT,0,1,0,7,1606366800,1606366800,1
churrmander,0,1,0,5,1575954000,1575954000,1
thefrigginforest,0,1,0,2,1567224000,1567224000,1
RogueRain17,0,1,0,19,1604030400,1604030400,1
_tofs_,0,1,0,-3,1608267600,1608267600,1
Viennah_,0,1,0,12,1605330000,1605330000,1
giantssuck4ever,0,1,0,1,1606194000,1606194000,1
SecretDrawer81,0,1,0,4,1606453200,1606453200,1
hatep99,0,1,0,2,1579237200,1579237200,1
tdillard2933,0,1,0,-11,1578546000,1578546000,1
snoofy-noof,0,1,0,3,1605589200,1605589200,1
treacherous-dog,0,1,0,2,1604466000,1604466000,1
roxnsoxeh,0,1,0,21,1608354000,1608354000,1
lalaladka,0,1,0,1,1607490000,1607490000,1
ayIouis,0,1,0,1,1636347600,1636347600,1
motorsizzle,0,1,0,22,1606539600,1606539600,1
iam_the_wisdomcube,0,1,0,28,1565236800,1565236800,1
The_loyal_Terminator,0,1,0,6,1608699600,1608699600,1
NightmareSovereign,0,1,0,3,1595390400,1595390400,1
kevlarcupid,0,1,0,1,1598846400,1598846400,1
LemonsInABowl,0,1,0,3,1591329600,1591329600,1
thisisoppositeday,0,1,0,8,1485838800,1485838800,1
LexBrew,0,1,0,1,1573707600,1573707600,1
tattooedhands,0,1,0,102,1577336400,1577336400,1
H2Owings,0,1,0,1,1567483200,1567483200,1
dinosauce212,0,1,0,2,1600660800,1600660800,1
bossonovasoc,1,0,11,0,1596600000,1596600000,1
papahighscore,0,1,0,1,1585454400,1585454400,1
verythin,0,1,0,2,1603684800,1603684800,1
sievo,0,1,0,2,1603425600,1603425600,1
chipmonkyy,0,1,0,0,1603080000,1603080000,1
haiti817,0,1,0,1,1604811600,1604811600,1
whataboutBatmantho,0,1,0,1,1599883200,1599883200,1
notQuiteCanadian,0,1,0,34,1607058000,1607058000,1
brutchev,0,1,0,5,1595908800,1595908800,1
mrfungie,0,1,0,1,1598241600,1598241600,1
DiademaJenks,0,1,0,1,1608786000,1608786000,1
smilealittlebit,0,1,0,2,1575435600,1575435600,1
rojovelasco,0,1,0,2,1555300800,1555300800,1
dmthoth,0,1,0,15,1573362000,1573362000,1
drangon3,0,1,0,1,1601092800,1601092800,1
IzttzI,0,1,0,2,1605848400,1605848400,1
spiderlandcapt,0,1,0,2,1609390800,1609390800,1
sleepysootsprite,0,1,0,6,1569297600,1569297600,1
TatyGGTV,0,1,0,1,1601784000,1601784000,1
pineappleonpizzaisok,0,1,0,2,1608699600,1608699600,1
Onyatop,0,1,0,0,1576731600,1576731600,1
plhenry12,0,1,0,1,1608267600,1608267600,1
Walrus365,0,1,0,4,1599537600,1599537600,1
sagekept,0,1,0,32,1576040400,1576040400,1
rblau,0,1,0,10,1595736000,1595736000,1
operahermit,0,1,0,1,1605762000,1605762000,1
involvrnet,0,1,0,12,1589688000,1589688000,1
SabertoothCaterpilla,0,1,0,21,1607144400,1607144400,1
collegekid788,0,1,0,-7,1582866000,1582866000,1
FatOldRugbyDude,0,1,0,4,1599883200,1599883200,1
SuperS0nic99,0,1,0,1,1584158400,1584158400,1
BroodingBork,0,1,0,18,1588305600,1588305600,1
Blunderbluss,0,1,0,1,1560657600,1560657600,1
trx25,0,1,0,6,1601265600,1601265600,1
aderorr,0,1,0,15,1561780800,1561780800,1
slowwwwwdown,0,1,0,1,1604203200,1604203200,1
giveawayguy99,1,0,5,0,1588132800,1588132800,1
coderapprentice,0,1,0,12,1606107600,1606107600,1
LastAccountPlease,0,1,0,1,1606021200,1606021200,1
coloradoRay,0,1,0,1,1588305600,1588305600,1
LazyLizzy,0,1,0,53,1609390800,1609390800,1
LukaManuka,0,1,0,21,1606021200,1606021200,1
Jyxtrant,0,1,0,1,1592798400,1592798400,1
Shem,1,0,102,0,1596254400,1596254400,1
Narradisall,0,1,0,6,1604379600,1604379600,1
undercover_snail,0,1,0,1,1606712400,1606712400,1
-s-lack_0ff,0,1,0,4,1570334400,1570334400,1
Qzry,0,1,0,2,1575608400,1575608400,1
CalmHedgehog,0,1,0,8,1591675200,1591675200,1
cubbabyy,0,1,0,27,1600142400,1600142400,1
incorrect_brit,0,1,0,10,1576558800,1576558800,1
Remarkable_Cap_291,0,1,0,43,1606971600,1606971600,1
MentalRental,0,1,0,2,1608267600,1608267600,1
JAYHAWKER_15,0,1,0,3,1595563200,1595563200,1
Raygoldd,0,1,0,0,1576990800,1576990800,1
Fit_Laugh9192,0,1,0,9,1608440400,1608440400,1
Gen88,0,1,0,11,1593316800,1593316800,1
richardjohnthomas,0,1,0,2,1593576000,1593576000,1
wulfasa,0,1,0,40,1548910800,1548910800,1
tinyhermit,0,1,0,7,1569384000,1569384000,1
ImmortalLurker19,0,1,0,-3,1594699200,1594699200,1
Philip__IV,0,1,0,13,1568347200,1568347200,1
Sesquipedalian4life,0,1,0,4,1561348800,1561348800,1
riseabove4love,1,0,3,0,1600401600,1600401600,1
aintmarchinanymore,0,1,0,3,1597896000,1597896000,1
dubweb32,0,1,0,2,1594180800,1594180800,1
youstupidcorn,0,1,0,2,1607662800,1607662800,1
vavavam,0,1,0,4,1581051600,1581051600,1
ev-dawg,0,1,0,2,1593921600,1593921600,1
JohnsWisent,0,1,0,2,1596513600,1596513600,1
vk136,0,1,0,-11,1563422400,1563422400,1
mrducci,0,1,0,3,1566705600,1566705600,1
ClockworkCats,0,1,0,-24,1548392400,1548392400,1
whataseeword,0,1,0,6,1575003600,1575003600,1
littlesauceplease,0,1,0,1,1599019200,1599019200,1
-PatchPatch,0,1,0,1,1592798400,1592798400,1
popball,0,1,0,1,1599192000,1599192000,1
Money-Monkey,0,1,0,1,1571544000,1571544000,1
Money-Good,0,1,0,-22,1592971200,1592971200,1
bdsalerno,1,0,2188,0,1593835200,1593835200,1
CountFuckula_,0,1,0,45,1605502800,1605502800,1
estie-the-tato,0,1,0,1,1606712400,1606712400,1
Elendel19,0,1,0,1,1605589200,1605589200,1
Banjoe_031,0,1,0,1,1603771200,1603771200,1
jesspo96,0,1,0,3,1581915600,1581915600,1
nonxoperational,0,1,0,39,1597723200,1597723200,1
FourthLife,0,1,0,2,1600660800,1600660800,1
PowerfulVictory,0,1,0,2,1576904400,1576904400,1
hungry_argentino,0,1,0,7,1611810000,1611810000,1
ATrillionLumens,0,1,0,15,1585627200,1585627200,1
North-Addition,0,1,0,20,1598068800,1598068800,1
didhestealtheraisins,0,1,0,3,1601438400,1601438400,1
ugfish,0,1,0,5,1571112000,1571112000,1
ozomidaf,0,1,0,-3,1573102800,1573102800,1
InvisibleBlueUnicorn,0,1,0,1,1605502800,1605502800,1
Kestralisk,0,1,0,7,1606798800,1606798800,1
FoxyOViolent,0,1,0,1,1603684800,1603684800,1
Druckertinte44,0,1,0,1,1575090000,1575090000,1
Dagguito,0,1,0,-7,1606453200,1606453200,1
byebyefash,0,1,0,13,1580101200,1580101200,1
feebyweeby,0,1,0,2,1591848000,1591848000,1
SpacemanSpiff3,0,1,0,1,1589860800,1589860800,1
starlightkittenforce,0,1,0,6,1555387200,1555387200,1
westd06,0,1,0,1,1581224400,1581224400,1
flowithego,0,1,0,139,1596772800,1596772800,1
musiknits,0,1,0,6,1584590400,1584590400,1
ace-555,0,1,0,4,1598846400,1598846400,1
CandyCrazy2000,0,1,0,6,1586491200,1586491200,1
LacunaSatsuma,0,1,0,2,1578632400,1578632400,1
Kundras,0,1,0,55,1583557200,1583557200,1
UndercoverBully,0,1,0,1,1577336400,1577336400,1
skyshooter22,0,1,0,2,1606107600,1606107600,1
sdzundercover,0,1,0,1,1592280000,1592280000,1
Sverigialover,0,1,0,1,1598673600,1598673600,1
JuBelen,0,1,0,1,1590379200,1590379200,1
ubuntu-uchiha,0,1,0,3,1608699600,1608699600,1
cpb_,0,1,0,2,1608526800,1608526800,1
LucyMorgenstern,0,1,0,101,1606453200,1606453200,1
TypeBest1403,0,1,0,1,1604725200,1604725200,1
jabateeth,0,1,0,2,1598587200,1598587200,1
TheyFoundWayne,0,1,0,-7,1593230400,1593230400,1
setsar,0,1,0,20,1566014400,1566014400,1
dextu,0,1,0,3,1605589200,1605589200,1
velvetdolphin101,0,1,0,2,1605589200,1605589200,1
DanfromCalgary,0,1,0,3,1586318400,1586318400,1
kinkygandalf,0,1,0,3,1607922000,1607922000,1
suicidalfiend,0,1,0,3,1592107200,1592107200,1
BHenL96,0,1,0,1,1573707600,1573707600,1
dodobird98,0,1,0,1,1577422800,1577422800,1
hmenzi04,0,1,0,4,1593748800,1593748800,1
OP_Giddy,0,1,0,1,1599019200,1599019200,1
CapitalAlarm,0,1,0,-33,1568260800,1568260800,1
MagicalDoshDosh,0,1,0,19,1601524800,1601524800,1
GetOffIts8,0,1,0,1,1601006400,1601006400,1
Pyehole,0,1,0,1,1597982400,1597982400,1
Still_Your_Prez,0,1,0,1,1580101200,1580101200,1
James-kudrins,0,1,0,1,1608872400,1608872400,1
strikebeat,1,0,19,0,1602043200,1602043200,1
CamrenRooke,0,1,0,1,1604379600,1604379600,1
LadyWithAHarp,0,1,0,52,1603512000,1603512000,1
passiveabrasive,1,0,7,0,1582779600,1582779600,1
Bury_Me_At_Sea,0,1,0,1,1559275200,1559275200,1
TorFour,0,1,0,2,1600228800,1600228800,1
_TurtleX,0,1,0,7,1591156800,1591156800,1
PATtyyy003,1,0,1,0,1590465600,1590465600,1
1ncorrect,0,1,0,12,1573534800,1573534800,1
PemaCruz,0,1,0,30,1607403600,1607403600,1
Noctam,0,1,0,4,1574398800,1574398800,1
PeterMunchlett,0,1,0,1,1611982800,1611982800,1
jujuJEI,0,1,0,1,1600920000,1600920000,1
SpaceRican,0,1,0,1,1610686800,1610686800,1
p_whimsy,0,1,0,124,1591156800,1591156800,1
toworkistosuffer,1,0,18,0,1566446400,1566446400,1
Dobledanger,0,1,0,1,1593489600,1593489600,1
SRS-Favorite,0,1,0,0,1635307200,1635307200,1
StigIsBig,0,1,0,2,1588132800,1588132800,1
Equal-Law-1876,0,1,0,4,1643259600,1643259600,1
hayyache,0,1,0,1,1587787200,1587787200,1
Counselor03,0,1,0,3,1595563200,1595563200,1
Kazeel_Amataka,0,1,0,1,1591243200,1591243200,1
SouthernWoW,0,1,0,-2,1592798400,1592798400,1
WailingPalin,0,1,0,1,1589860800,1589860800,1
cateater,0,1,0,17,1549429200,1549429200,1
lifemanualplease,0,1,0,1,1604379600,1604379600,1
udntknwsht24,0,1,0,6,1589601600,1589601600,1
k-farsen,0,1,0,5,1608786000,1608786000,1
GramboLazarus,0,1,0,0,1596686400,1596686400,1
ScarcityBig9229,0,1,0,6,1606194000,1606194000,1
daschande,0,1,0,23,1608786000,1608786000,1
craag,0,1,0,34,1565668800,1565668800,1
A_Wet_Sock,0,1,0,-41,1583470800,1583470800,1
thatcherrose,0,1,0,1,1605934800,1605934800,1
zparra232,0,1,0,7,1586318400,1586318400,1
21stCenturyParanoid,0,1,0,2,1605589200,1605589200,1
slaylum,0,1,0,0,1576386000,1576386000,1
TimeToStartTaking,0,1,0,12,1581656400,1581656400,1
Xyber-Faust,0,1,0,1,1579928400,1579928400,1
Fact_checking_cuz,0,1,0,7,1573189200,1573189200,1
bw57570,0,1,0,2,1609304400,1609304400,1
ydyot,0,1,0,3,1608958800,1608958800,1
Klaleara,0,1,0,1,1589860800,1589860800,1
Agne2,0,1,0,-1,1605157200,1605157200,1
Coalesced,0,1,0,201,1600747200,1600747200,1
Jibjuck,1,0,146,0,1584936000,1584936000,1
InthegrOTTO87,0,1,0,7,1608613200,1608613200,1
imperfectmantra,0,1,0,2,1604379600,1604379600,1
turbulent_toad,0,1,0,1,1607490000,1607490000,1
Atlascantakeit,1,0,56,0,1589515200,1589515200,1
Chilliconlaura,0,1,0,0,1598500800,1598500800,1
FakeGirlfriend,0,1,0,1,1570939200,1570939200,1
Callsign_Vibe,0,1,0,38,1584331200,1584331200,1
ObviousWater,0,1,0,18,1607058000,1607058000,1
HermanvonHinten,0,1,0,1,1592280000,1592280000,1
ReasonableProgram9,0,1,0,1,1591416000,1591416000,1
Desperate_Guava4526,0,1,0,1,1598932800,1598932800,1
Forsworn91,0,1,0,1,1612069200,1612069200,1
skoDOOM,0,1,0,1,1578978000,1578978000,1
benben11d12,0,1,0,1,1597464000,1597464000,1
pringleburn,0,1,0,220,1580965200,1580965200,1
knottedscope,0,1,0,1,1612155600,1612155600,1
asharar,0,1,0,9,1592539200,1592539200,1
hp238902,0,1,0,1,1594353600,1594353600,1
1ronb4r,1,0,3,0,1593489600,1593489600,1
brokecostudent,0,1,0,7,1606539600,1606539600,1
deadturquoise,0,1,0,2,1572580800,1572580800,1
likealog,0,1,0,10,1604379600,1604379600,1
DeliberateMelBrooks,1,0,117,0,1609131600,1609131600,1
venomous_turtle9,0,1,0,1,1599192000,1599192000,1
mikeisreptar,0,1,0,5,1585454400,1585454400,1
uuneya,0,1,0,19,1594440000,1594440000,1
NKnowvative1,0,1,0,1,1577250000,1577250000,1
i3unneh,0,1,0,3,1596081600,1596081600,1
aykyle,0,1,0,8,1603512000,1603512000,1
mc_md,0,1,0,1,1621742400,1621742400,1
Trumps_a_cunt,0,1,0,3,1578978000,1578978000,1
Parhelion2261,0,1,0,1,1603512000,1603512000,1
otherguymikey,0,1,0,3,1608786000,1608786000,1
Lanky_Fella,0,1,0,2,1599192000,1599192000,1
Shouting__Ant,0,1,0,4,1600833600,1600833600,1
Killer_The_Cat,0,1,0,3,1592366400,1592366400,1
orangespaces,0,1,0,10,1585454400,1585454400,1
Barryfrombkln,0,1,0,8,1595995200,1595995200,1
Mar_xav,0,1,0,5,1593057600,1593057600,1
backwardsposition74,0,1,0,1,1607490000,1607490000,1
Banned_From_Neopets,0,1,0,2,1574485200,1574485200,1
RGJax,0,1,0,-1,1582088400,1582088400,1
TheCaliforniaOp,0,1,0,2,1604984400,1604984400,1
THOTdestroyer101804,0,1,0,2,1608786000,1608786000,1
Wordman253,0,1,0,5,1597550400,1597550400,1
Calabashaw,0,1,0,1,1600315200,1600315200,1
No_Pumpkin,0,1,0,2,1579582800,1579582800,1
SweetSweetRoll,0,1,0,3,1592193600,1592193600,1
Papa_pierogi,0,1,0,1,1605157200,1605157200,1
Limitless911,0,1,0,1,1609477200,1609477200,1
KryL21,0,1,0,10,1548565200,1548565200,1
GayasHellEnbyfluid,0,1,0,36,1593576000,1593576000,1
silly-stupid-slut,0,1,0,1,1606971600,1606971600,1
HungLikeAn_Ant,0,1,0,1,1575608400,1575608400,1
GuvnaPelican,0,1,0,5,1577854800,1577854800,1
Devilshaker,0,1,0,1,1599192000,1599192000,1
Minitrain,0,1,0,1,1596254400,1596254400,1
cade8ranblefoot,0,1,0,9,1572321600,1572321600,1
FracturedAuthor,0,1,0,9,1608267600,1608267600,1
96744,0,1,0,0,1588219200,1588219200,1
Stewy-Browne,0,1,0,-1,1591329600,1591329600,1
ajakefromstatefarmm,0,1,0,1,1603512000,1603512000,1
MrMosap,0,1,0,1,1640840400,1640840400,1
Kestrel893,0,1,0,1,1602129600,1602129600,1
blueblueberry_,0,1,0,6,1578373200,1578373200,1
dekulakinminecraft,0,1,0,-1,1587182400,1587182400,1
GenericUsername10135,0,1,0,2,1585195200,1585195200,1
demarisco,0,1,0,3,1607662800,1607662800,1
MrDude_1,0,1,0,3,1600056000,1600056000,1
SmokeFrosting,0,1,0,27,1591588800,1591588800,1
Braveknight999,0,1,0,13,1604552400,1604552400,1
Chilld0od,1,0,5,0,1580274000,1580274000,1
kazereek,0,1,0,1,1584763200,1584763200,1
Mcoov,0,1,0,2,1598760000,1598760000,1
ram_fl_beach,0,1,0,1,1609304400,1609304400,1
ketchup-ch1ps,0,1,0,2,1578978000,1578978000,1
astrolov,0,1,0,1,1572930000,1572930000,1
thatpseudoveganlife,0,1,0,8,1583470800,1583470800,1
GendalWeen,0,1,0,7,1595822400,1595822400,1
fightingpanda94,0,1,0,5,1551934800,1551934800,1
Ok-Maize-8244,1,0,84,0,1604203200,1604203200,1
jb122894,0,1,0,2,1607576400,1607576400,1
monkeynards,0,1,0,2,1608699600,1608699600,1
BRUHYEAH,0,1,0,10,1612069200,1612069200,1
KarateGandolf,0,1,0,3,1596859200,1596859200,1
forestgenocide,0,1,0,0,1598760000,1598760000,1
abchandler4,0,1,0,3,1602475200,1602475200,1
BurkeAbroad,0,1,0,5,1599796800,1599796800,1
MeCJay12,0,1,0,1,1590811200,1590811200,1
legend781,1,0,3,0,1597032000,1597032000,1
xenago,0,1,0,12,1585713600,1585713600,1
bbdax,0,1,0,2,1607058000,1607058000,1
shlipshloo,0,1,0,4,1604466000,1604466000,1
richpersimmons,0,1,0,14,1542949200,1542949200,1
ChiProblems,0,1,0,5,1565755200,1565755200,1
dusstiin,0,1,0,3,1568692800,1568692800,1
farleytain,0,1,0,1,1598760000,1598760000,1
ArkantosAoM,0,1,0,4,1608699600,1608699600,1
AnnoyingVoid,0,1,0,3,1585108800,1585108800,1
anonhft,0,1,0,2,1600228800,1600228800,1
eclipseofthebutt,0,1,0,4,1575090000,1575090000,1
DiabeticKoala,0,1,0,14,1608526800,1608526800,1
foobarfault,0,1,0,6,1572062400,1572062400,1
QuarantinedMillennia,0,1,0,-2,1604466000,1604466000,1
OhFuckOffDon,0,1,0,1,1606539600,1606539600,1
The_BenL,0,1,0,1,1582779600,1582779600,1
Murrymonster,0,1,0,6,1600747200,1600747200,1
bumbumboleji,0,1,0,7,1611810000,1611810000,1
shothrdaroundthewrld,0,1,0,12,1595390400,1595390400,1
stowestorm,1,0,12,0,1570593600,1570593600,1
Thaalin,0,1,0,3,1573794000,1573794000,1
PurpleCat95,1,0,8,0,1581310800,1581310800,1
janoycresovani,0,1,0,5,1606626000,1606626000,1
booger_sculptor,0,1,0,1,1558584000,1558584000,1
moodymadzz,0,1,0,17,1572667200,1572667200,1
SnooSuggestions8188,0,1,0,1,1603512000,1603512000,1
Sakswa,0,1,0,3,1590206400,1590206400,1
barracuda1113,0,1,0,3,1582520400,1582520400,1
--recursive,0,1,0,65,1598760000,1598760000,1
bebetter1212,0,1,0,14,1606453200,1606453200,1
pestaa,0,1,0,0,1586923200,1586923200,1
BigfootPolice,0,1,0,1,1589860800,1589860800,1
Zenketski,0,1,0,1,1572148800,1572148800,1
ryanator2,0,1,0,3,1603512000,1603512000,1
mrBean177794,0,1,0,2,1593835200,1593835200,1
chuckitychuck044,0,1,0,3,1585627200,1585627200,1
FriendlyHearse,0,1,0,4,1579064400,1579064400,1
bankerman,0,1,0,1,1578373200,1578373200,1
the_universe_speaks,0,1,0,1,1604984400,1604984400,1
lollapaloooooza,0,1,0,1,1598500800,1598500800,1
pendehoes,0,1,0,1,1609045200,1609045200,1
kmurph72,0,1,0,-1,1606626000,1606626000,1
notabarb,0,1,0,2,1595822400,1595822400,1
anonymouscarbonunit,0,1,0,4,1550984400,1550984400,1
RedCorvid,0,1,0,13,1549083600,1549083600,1
NiralaNox,0,1,0,3,1577250000,1577250000,1
memesandvr,0,1,0,3,1595649600,1595649600,1
Mokazra,0,1,0,1,1609045200,1609045200,1
IUsedToMainTeemo,0,1,0,-3,1589688000,1589688000,1
bearsfan0143,0,1,0,5,1598760000,1598760000,1
Regalzack,0,1,0,1,1572494400,1572494400,1
SweetzDeetz,0,1,0,1,1561608000,1561608000,1
blues_the_robot,0,1,0,7,1608181200,1608181200,1
amp-is-watching-you,0,1,0,5,1538539200,1538539200,1
filet_o_fizz,0,1,0,1,1600142400,1600142400,1
corncrated,0,1,0,5,1605157200,1605157200,1
NWVoS,0,1,0,2,1604379600,1604379600,1
madatnothingagain,0,1,0,1,1572235200,1572235200,1
moosekin16,0,1,0,6,1601352000,1601352000,1
Too_Many_Mind_,0,1,0,1,1589947200,1589947200,1
Tree_Lloyd,0,1,0,13,1609045200,1609045200,1
OmNomShivan,0,1,0,1,1600574400,1600574400,1
vebbing15,0,1,0,3,1601611200,1601611200,1
PaleontologistNew440,0,1,0,1,1603512000,1603512000,1
Smolensk,0,1,0,17,1588219200,1588219200,1
Fnknlb,0,1,0,2,1566446400,1566446400,1
lyssabdubs,0,1,0,38,1600574400,1600574400,1
KindheartednessOk383,0,1,0,1,1603598400,1603598400,1
GE15T,0,1,0,1,1603512000,1603512000,1
KooksEverywhere,0,1,0,5,1584244800,1584244800,1
SelfDiagnosedUnicorn,0,1,0,6,1568952000,1568952000,1
beepbeepdozap,0,1,0,2,1604811600,1604811600,1
phycosismyarse,0,1,0,4,1603512000,1603512000,1
diva4lisia,0,1,0,35,1602216000,1602216000,1
css2165,0,1,0,1,1582866000,1582866000,1
Frutishita,0,1,0,1,1606626000,1606626000,1
mirbakes,0,1,0,65,1601179200,1601179200,1
ghjjvcjnv,0,1,0,2,1593144000,1593144000,1
TheImpulsiveVulcan,0,1,0,6,1569988800,1569988800,1
bananinhax,0,1,0,4,1563681600,1563681600,1
sadisticfreak,0,1,0,11,1582174800,1582174800,1
LaminationStation-,0,1,0,39,1603944000,1603944000,1
feshty,0,1,0,7,1564804800,1564804800,1
MetaBear11,0,1,0,5,1603512000,1603512000,1
rollin9st0ney,0,1,0,5,1578978000,1578978000,1
beaniebabyphat,0,1,0,12,1575522000,1575522000,1
MaddieMadhat,1,0,10,0,1571025600,1571025600,1
Freemoneydotcom,0,1,0,1,1602734400,1602734400,1
-Bitch_Boi-,0,1,0,8,1577422800,1577422800,1
koifu,0,1,0,26,1592712000,1592712000,1
Zacubed,1,0,45,0,1605502800,1605502800,1
G-OASIS,0,1,0,1,1611205200,1611205200,1
mmanaolana,0,1,0,1,1599537600,1599537600,1
Puzzleheaded68,0,1,0,5,1605243600,1605243600,1
EmzoModz,0,1,0,2,1605157200,1605157200,1
tomes521,0,1,0,9,1578286800,1578286800,1
tapiocayumyum,0,1,0,1,1605589200,1605589200,1
BradsterX,0,1,0,2,1569816000,1569816000,1
g6rf8,1,0,66,0,1605502800,1605502800,1
budmeisner1,0,1,0,5,1585022400,1585022400,1
ikindoflikereading,0,1,0,-2,1575954000,1575954000,1
Domby88,0,1,0,4,1605502800,1605502800,1
silverblaze92,0,1,0,1,1605502800,1605502800,1
Rayziel,0,1,0,0,1598673600,1598673600,1
Emozpqqy,0,1,0,3,1607835600,1607835600,1
Cybrbeggr2,0,1,0,9,1605848400,1605848400,1
FartDare,0,1,0,1,1588996800,1588996800,1
M1radus,0,1,0,6,1607317200,1607317200,1
riotboys,0,1,0,6,1581051600,1581051600,1
Zubraxx,0,1,0,3,1581051600,1581051600,1
Jackm941,0,1,0,3,1577336400,1577336400,1
Krowdzilla,0,1,0,1,1597636800,1597636800,1
TheBlueHydro,0,1,0,5,1588132800,1588132800,1
so-psori-aboot-it,0,1,0,12,1585800000,1585800000,1
random_dudelina,0,1,0,3,1589169600,1589169600,1
leafly_,0,1,0,1,1568520000,1568520000,1
tress011,0,1,0,2,1606021200,1606021200,1
Strontianite,0,1,0,22,1605589200,1605589200,1
Saphyrie,0,1,0,53,1605070800,1605070800,1
Gred-and-Forge,0,1,0,1,1608699600,1608699600,1
Napervillian,0,1,0,-6,1575262800,1575262800,1
PanickedTurtles,0,1,0,36,1555905600,1555905600,1
christinawebb1998,1,0,7,0,1572148800,1572148800,1
Benitowastaken,0,1,0,-1,1599019200,1599019200,1
DaveTheDog027,0,1,0,7,1585454400,1585454400,1
El_Tigre,0,1,0,8,1606107600,1606107600,1
Ok-Introduction-244,0,1,0,8,1599019200,1599019200,1
Medeaa,0,1,0,7,1607662800,1607662800,1
bakedjakedape,0,1,0,1,1600833600,1600833600,1
iamherefortherecepie,0,1,0,2,1589860800,1589860800,1
republikkkaren,0,1,0,1,1604293200,1604293200,1
bromagnonman,0,1,0,6,1609390800,1609390800,1
guguus,1,0,385,0,1575349200,1575349200,1
JmyKane,0,1,0,1,1603512000,1603512000,1
MemorableC,0,1,0,4,1607403600,1607403600,1
tarejapublica,0,1,0,9,1595044800,1595044800,1
Plantifull,0,1,0,4,1592625600,1592625600,1
not-in-the-butt,0,1,0,1,1606971600,1606971600,1
Chucklay,0,1,0,124,1598241600,1598241600,1
manti26,0,1,0,42,1589083200,1589083200,1
mix_JamaicanGerman,0,1,0,2,1601179200,1601179200,1
Horror_Potato,0,1,0,19,1581138000,1581138000,1
surfrider212,0,1,0,1,1585108800,1585108800,1
joshnihilist,0,1,0,3,1596600000,1596600000,1
Truk7549,0,1,0,1,1604203200,1604203200,1
knightro25,0,1,0,-4,1581138000,1581138000,1
CoachIsaiah,0,1,0,1,1603512000,1603512000,1
Transmigrating_Souls,0,1,0,1,1598155200,1598155200,1
the-foodchain,0,1,0,3,1574485200,1574485200,1
OmnisExOmnium-Nihil,0,1,0,1,1608526800,1608526800,1
ale6rbd,0,1,0,1,1605243600,1605243600,1
temple3489,0,1,0,4,1589688000,1589688000,1
General-Electriic,0,1,0,3,1603944000,1603944000,1
Kumori_Neko,0,1,0,730,1607576400,1607576400,1
Troxicale,0,1,0,11,1579237200,1579237200,1
sunshlne1212,0,1,0,9,1550552400,1550552400,1
Johnnythrash001,0,1,0,1,1589860800,1589860800,1
guilhermesconrad,0,1,0,3,1603598400,1603598400,1
buffybison,0,1,0,3,1565668800,1565668800,1
kdrocker66,0,1,0,1,1609390800,1609390800,1
wartriddencock,0,1,0,9,1598846400,1598846400,1
MountainTurkey,0,1,0,2,1584158400,1584158400,1
jrwilde,0,1,0,1,1567569600,1567569600,1
fuckkkthattt,0,1,0,-1,1594267200,1594267200,1
Worried_Catch,1,0,47,0,1590897600,1590897600,1
AdLive4721,0,1,0,1,1611982800,1611982800,1
RazzyMocha,0,1,0,1,1642395600,1642395600,1
purplerecon,0,1,0,3,1571198400,1571198400,1
zaatarlacroix,0,1,0,8,1566014400,1566014400,1
olivelamp4,0,1,0,-1,1606626000,1606626000,1
tom-tom-tom-tom-tom,0,1,0,-15,1561521600,1561521600,1
emmeow26,1,0,8,0,1599105600,1599105600,1
JediMasterTomo,0,1,0,2,1562299200,1562299200,1
tharpoonani,0,1,0,1,1603512000,1603512000,1
DasKarlBarx,1,0,945,0,1611896400,1611896400,1
ColdDampForest,0,1,0,1,1606107600,1606107600,1
dawnypaws,0,1,0,5,1563163200,1563163200,1
spl0rg,0,1,0,3,1600056000,1600056000,1
MetalWren,0,1,0,1,1578546000,1578546000,1
SmashedRat,0,1,0,1,1604379600,1604379600,1
FourEcho,0,1,0,9,1600833600,1600833600,1
6ix-z,0,1,0,6,1601611200,1601611200,1
guywiththetoethumb,0,1,0,13,1580101200,1580101200,1
davidlaw1,1,0,32,0,1577595600,1577595600,1
LightTheBurntMatch,0,1,0,-3,1588910400,1588910400,1
ronimal,0,1,0,1,1585454400,1585454400,1
Lost_In_Mesa,0,1,0,10,1585454400,1585454400,1
Keto1995,0,1,0,3,1585886400,1585886400,1
wereinthething,0,1,0,55,1605934800,1605934800,1
Mrmathmonkey,0,1,0,3,1605675600,1605675600,1
ripGGallin-,0,1,0,-2,1609131600,1609131600,1
El-Sueco,0,1,0,1,1605762000,1605762000,1
adverse_fitrep,0,1,0,-2,1608267600,1608267600,1
iheardaruckus,0,1,0,1,1603598400,1603598400,1
iamthethirsty,0,1,0,1,1556078400,1556078400,1
Brucewayne75,0,1,0,27,1555128000,1555128000,1
coconubs94,0,1,0,-31,1580446800,1580446800,1
vllreign,0,1,0,1,1608008400,1608008400,1
headyunicorn,0,1,0,2,1569470400,1569470400,1
Gradam5,0,1,0,2,1606712400,1606712400,1
Neoking,0,1,0,-1,1596686400,1596686400,1
LaCamusNoire,0,1,0,1,1580706000,1580706000,1
Chadman_ultra,0,1,0,3,1577422800,1577422800,1
zyber787,0,1,0,1,1604466000,1604466000,1
Storm_Productions_,0,1,0,20,1593144000,1593144000,1
Chicosballs,0,1,0,3,1588996800,1588996800,1
VegetableWishbone,0,1,0,106,1605589200,1605589200,1
agentsmith350,0,1,0,31,1580533200,1580533200,1
stelfee,0,1,0,3,1571371200,1571371200,1
flatfoldedfuck,1,0,12,0,1585886400,1585886400,1
CanYouMilkMeGreg,0,1,0,-5,1603512000,1603512000,1
ramblersshane1,0,1,0,2,1600315200,1600315200,1
somehomo,0,1,0,36,1608613200,1608613200,1
MushroomTwink,0,1,0,21,1579237200,1579237200,1
kijour,0,1,0,1,1589860800,1589860800,1
KeeKeeOfTheNorth,0,1,0,4,1580274000,1580274000,1
xXLordFamineXx,0,1,0,1,1589774400,1589774400,1
Tenshouu,0,1,0,2,1572494400,1572494400,1
dirtychaplain,0,1,0,3,1582434000,1582434000,1
ilikesaucy,0,1,0,1,1608786000,1608786000,1
-venceremos-,0,1,0,119,1576731600,1576731600,1
UniquePariah,0,1,0,1,1597550400,1597550400,1
Huskyy23,0,1,0,-2,1606626000,1606626000,1
Tr1s7an,0,1,0,-51,1557633600,1557633600,1
camgnostic,0,1,0,7,1580274000,1580274000,1
omakae,0,1,0,13,1608699600,1608699600,1
PreFuturism-0,0,1,0,3,1599105600,1599105600,1
Draconiondevil,0,1,0,1,1608872400,1608872400,1
nabooperin,0,1,0,3,1603512000,1603512000,1
RocketPirate7x,0,1,0,1,1591329600,1591329600,1
Das_Guido,0,1,0,1,1584244800,1584244800,1
Miner_Guyer,0,1,0,1,1575349200,1575349200,1
AtomicSamuraiCyborg,0,1,0,1,1597809600,1597809600,1
chapseas,0,1,0,51,1597291200,1597291200,1
bewitchedanomaly,0,1,0,16,1583298000,1583298000,1
BurningPage,0,1,0,1,1602734400,1602734400,1
kitkatullus,0,1,0,2,1558238400,1558238400,1
1013forthwith,0,1,0,1,1606021200,1606021200,1
RedditAcct39,0,1,0,2,1605589200,1605589200,1
Iron-Sheet,0,1,0,3,1606798800,1606798800,1
gablikestacos69,1,0,644,0,1605416400,1605416400,1
GertrudeMcGraw,0,1,0,47,1605070800,1605070800,1
throwawaysscc,0,1,0,3,1608354000,1608354000,1
RuffCrumblebunch,0,1,0,7,1567569600,1567569600,1
GreenKangaroo3,0,1,0,2,1605157200,1605157200,1
DryCow5,0,1,0,6,1592366400,1592366400,1
gotb89,0,1,0,21,1600488000,1600488000,1
purrifferyy,1,0,25,0,1591761600,1591761600,1
xDeityx,0,1,0,2,1591243200,1591243200,1
CTPVTPonds,0,1,0,13,1607749200,1607749200,1
workfuntimecoolcool,0,1,0,6,1560571200,1560571200,1
Dr_nobby,0,1,0,46,1594353600,1594353600,1
SmugAndEvil,0,1,0,1,1608699600,1608699600,1
ViktorBoskovic,0,1,0,2,1585022400,1585022400,1
helen269,0,1,0,1,1606626000,1606626000,1
fdeth,0,1,0,3,1607317200,1607317200,1
skiingmarmick,0,1,0,1,1590120000,1590120000,1
AnonymousAnchor,0,1,0,1,1603512000,1603512000,1
megscn822,0,1,0,1,1608699600,1608699600,1
yingcha,0,1,0,2,1597377600,1597377600,1
foxandnofriends,0,1,0,1,1598760000,1598760000,1
AutomaticaRoss,0,1,0,1,1573102800,1573102800,1
NihilHS,0,1,0,28,1584676800,1584676800,1
AppropriateTomato,0,1,0,1,1599969600,1599969600,1
Any-Art4501,1,0,1,0,1601956800,1601956800,1
testdex,0,1,0,-7,1598673600,1598673600,1
OffxBrand,0,1,0,1,1606626000,1606626000,1
SgtSandvvich,0,1,0,1,1599105600,1599105600,1
orcdork77,0,1,0,29,1577595600,1577595600,1
boozy_hippogrif,1,0,210,0,1600228800,1600228800,1
Professor_Regressor,0,1,0,7,1602043200,1602043200,1
ledlecreeper27,0,1,0,2,1576213200,1576213200,1
bambooshootstokill,0,1,0,2,1603598400,1603598400,1
Cherry_Bloom95,0,1,0,3,1594440000,1594440000,1
russianrentacop,0,1,0,8,1584590400,1584590400,1
buymerice,0,1,0,1,1597377600,1597377600,1
D_a_l_t_o_n,0,1,0,3,1585454400,1585454400,1
BootyBBz,0,1,0,4,1591329600,1591329600,1
Oranthros_GOM,0,1,0,1,1589860800,1589860800,1
lazy__speedster,0,1,0,10,1603512000,1603512000,1
NBAtoVancouver-Com,0,1,0,32,1577336400,1577336400,1
ShaSay,0,1,0,4,1553486400,1553486400,1
mizChE,0,1,0,3,1591243200,1591243200,1
PepsiWithdrawal,0,1,0,1,1585454400,1585454400,1
k1m_y0_j0ng,0,1,0,3,1597723200,1597723200,1
EASam,0,1,0,20,1611896400,1611896400,1
IridianRaingem,0,1,0,1,1585454400,1585454400,1
donpiano1,0,1,0,1,1549602000,1549602000,1
icansmellcolors,0,1,0,1,1591329600,1591329600,1
carefullexpert,0,1,0,1,1605589200,1605589200,1
markedasred,0,1,0,3,1605070800,1605070800,1
JustWhyDoINeedTo,0,1,0,4,1604984400,1604984400,1
McSethicson,0,1,0,1,1604811600,1604811600,1
LampsLookingatyou,0,1,0,2,1573189200,1573189200,1
TheAmazingKidd,0,1,0,1,1586404800,1586404800,1
Midgetooni,0,1,0,6,1607230800,1607230800,1
LimerentRomantic,1,0,3,0,1603339200,1603339200,1
casparquid,1,0,1,0,1604203200,1604203200,1
Rinuriguru,0,1,0,5,1600488000,1600488000,1
lostoompa,0,1,0,1,1591243200,1591243200,1
itssimpleman,0,1,0,11,1580446800,1580446800,1
365468451354,0,1,0,-5,1571630400,1571630400,1
deepintothecreep,0,1,0,1,1588824000,1588824000,1
Downtown-Accident,0,1,0,2,1609390800,1609390800,1
jmr131ftw,0,1,0,35,1574312400,1574312400,1
jaximointhecut,0,1,0,1,1607490000,1607490000,1
Tankietankietankie,1,0,110,0,1601697600,1601697600,1
Sweatyveggiebag,0,1,0,1,1585454400,1585454400,1
Tha_Dude_Abidez,0,1,0,1,1605070800,1605070800,1
PatientAwkwardSucks,1,0,9,0,1605070800,1605070800,1
scotty3281,0,1,0,10,1580533200,1580533200,1
Treatment87,1,0,12,0,1594612800,1594612800,1
SavingToasty,0,1,0,1,1575176400,1575176400,1
amoebanomaly,0,1,0,2,1602820800,1602820800,1
thecareerpuzzle,0,1,0,11,1601179200,1601179200,1
doiiob,0,1,0,1,1598241600,1598241600,1
SnooTomatoes6398,0,1,0,2,1611896400,1611896400,1
monkeyburrito411,0,1,0,-12,1579842000,1579842000,1
0Muffinz0,0,1,0,1,1594699200,1594699200,1
thatspokethus,0,1,0,9,1565928000,1565928000,1
Baseplate,0,1,0,1,1581138000,1581138000,1
human0id_typh00n,0,1,0,8,1583211600,1583211600,1
xironreaver,1,0,322,0,1559966400,1559966400,1
100pct_Linda,0,1,0,17,1560312000,1560312000,1
isweedglutenfree,0,1,0,9,1578027600,1578027600,1
Hushnut97,0,1,0,2,1603512000,1603512000,1
bignigog,0,1,0,1,1600660800,1600660800,1
QuarterLifeCircus,0,1,0,23,1603512000,1603512000,1
GordonRamsThee,0,1,0,1,1605934800,1605934800,1
kickazzgoalie,0,1,0,12,1606539600,1606539600,1
Cest_Pontrol,0,1,0,3,1595217600,1595217600,1
Fixed_Sprint,0,1,0,17,1607144400,1607144400,1
Squeaky-shoppingcart,0,1,0,3,1594094400,1594094400,1
HotSauce_LeFierce,0,1,0,4,1605502800,1605502800,1
Comrade1996,0,1,0,1,1574312400,1574312400,1
petraV86,0,1,0,6,1566014400,1566014400,1
xMinillax,0,1,0,1,1593144000,1593144000,1
notsure05,0,1,0,3,1597291200,1597291200,1
zucio809,0,1,0,1,1602475200,1602475200,1
LunaticJamez,1,0,357,0,1579755600,1579755600,1
Metrix145,0,1,0,1,1606021200,1606021200,1
Seancd10,0,1,0,1,1605589200,1605589200,1
TentacleTitan,0,1,0,8,1604984400,1604984400,1
october73,0,1,0,1,1589860800,1589860800,1
robo-66y,0,1,0,5,1599019200,1599019200,1
ProCy_R,0,1,0,1,1610686800,1610686800,1
AstroturfWebsite,0,1,0,1,1613365200,1613365200,1
sir_lorsion,0,1,0,1,1603512000,1603512000,1
hammyhamm,0,1,0,1,1597723200,1597723200,1
bucket_of_dogs,0,1,0,2,1573534800,1573534800,1
newyorkbro992,1,0,8,0,1578718800,1578718800,1
PopePC,0,1,0,24,1611810000,1611810000,1
ShankOfJustice,0,1,0,1,1594872000,1594872000,1
Proteandk,0,1,0,2,1598328000,1598328000,1
CriticalCrazy,0,1,0,40,1569988800,1569988800,1
PunkiiDonutz,0,1,0,8,1596254400,1596254400,1
Jacklewis98,0,1,0,-5,1604293200,1604293200,1
Annika_23,0,1,0,10,1606885200,1606885200,1
MacFrite,0,1,0,9,1612069200,1612069200,1
OJazairi,0,1,0,2,1607662800,1607662800,1
lolitashy,0,1,0,3,1552449600,1552449600,1
altgrave,0,1,0,1,1587960000,1587960000,1
lovelylittlebabe,0,1,0,9,1587787200,1587787200,1
Jayaraja,0,1,0,19,1565582400,1565582400,1
TomAss886,0,1,0,1,1582261200,1582261200,1
dacaal7890,0,1,0,1,1598760000,1598760000,1
sprucemoose12,0,1,0,18,1570766400,1570766400,1
Forest_Solitaire,0,1,0,30,1605502800,1605502800,1
flyazfuk,0,1,0,1,1602129600,1602129600,1
musicpunk77,0,1,0,1,1602043200,1602043200,1
NikkoXavier,0,1,0,-3,1604203200,1604203200,1
pezgoon,0,1,0,4,1608440400,1608440400,1
newaccount20202020,0,1,0,3,1575262800,1575262800,1
newaltcuzi4gotmypass,0,1,0,2,1604030400,1604030400,1
-cAcAbOx-,0,1,0,2,1603598400,1603598400,1
Gunshow-UK,0,1,0,8,1600315200,1600315200,1
Lobh24,1,0,6,0,1605762000,1605762000,1
Kryp70kn1gh7,0,1,0,9,1582520400,1582520400,1
Beginning-Limit-6381,0,1,0,0,1635393600,1635393600,1
6-of-5,0,1,0,1,1587441600,1587441600,1
FishinShirt,0,1,0,12,1594008000,1594008000,1
ljndrqzd1,0,1,0,0,1585454400,1585454400,1
freefalldreams,0,1,0,29,1570161600,1570161600,1
russobolado,0,1,0,1,1603166400,1603166400,1
VoreLord,0,1,0,11,1555732800,1555732800,1
bigtiddygothbf,0,1,0,1,1604725200,1604725200,1
yubg8,0,1,0,3,1608267600,1608267600,1
RandomerSchmandomer,0,1,0,2,1558497600,1558497600,1
Q_s9_5FkG_x68,1,0,0,0,1455339600,1455339600,1
tappinass,0,1,0,2,1570248000,1570248000,1
SwingLord420,0,1,0,6,1608094800,1608094800,1
tinydisaster,0,1,0,18,1577336400,1577336400,1
FastMike69,0,1,0,1,1624852800,1624852800,1
MostGloriousPotato,1,0,39,0,1582693200,1582693200,1
frabelle,0,1,0,2,1599105600,1599105600,1
Mikey5time,0,1,0,5,1565755200,1565755200,1
ShadowViking47,0,1,0,1,1606626000,1606626000,1
s-charrine,0,1,0,9,1576558800,1576558800,1
HippieWizard666,0,1,0,0,1611982800,1611982800,1
BernieCutMyHours,0,1,0,-7,1577336400,1577336400,1
Orbitalintelligence,0,1,0,8,1605762000,1605762000,1
Tubaprince,0,1,0,1,1605675600,1605675600,1
Powered_541,0,1,0,1,1580014800,1580014800,1
roboticicecream,0,1,0,5,1603512000,1603512000,1
veintiseiss,0,1,0,1,1557979200,1557979200,1
DrFartNuggets,1,0,0,0,1590984000,1590984000,1
Blackesst,0,1,0,2,1607576400,1607576400,1
loosesleeves,0,1,0,11,1602561600,1602561600,1
hatchetations,0,1,0,3,1552363200,1552363200,1
beartolome,0,1,0,1,1605243600,1605243600,1
geoffreyaaronnail,0,1,0,1,1557288000,1557288000,1
EatItLikeItsCandy,0,1,0,3,1583643600,1583643600,1
CommentsOnOccasion,0,1,0,11,1601956800,1601956800,1
orange_rhyme,0,1,0,1,1597291200,1597291200,1
E-Bee123,0,1,0,7,1608872400,1608872400,1
wassaprocker,0,1,0,1,1607835600,1607835600,1
Cupcake35,0,1,0,1,1572321600,1572321600,1
owlzitty,0,1,0,1,1596600000,1596600000,1
aeonion,0,1,0,1,1612069200,1612069200,1
GuiltyGTR,0,1,0,2,1607922000,1607922000,1
Gropey_Maurice,0,1,0,1,1599796800,1599796800,1
wouldgiveyouup,0,1,0,1,1611982800,1611982800,1
haygrlhay,0,1,0,2,1576645200,1576645200,1
chonkosouras,0,1,0,6,1603598400,1603598400,1
josemartin2211,0,1,0,0,1603512000,1603512000,1
sonspork,0,1,0,5,1603512000,1603512000,1
Sorry4StupidQuestion,0,1,0,42,1604203200,1604203200,1
sensualscents,0,1,0,81,1567656000,1567656000,1
francisforincarcopla,0,1,0,1,1612069200,1612069200,1
NecrocideASH,0,1,0,1,1584244800,1584244800,1
arieljoc,0,1,0,4,1603771200,1603771200,1
PapillonJellyBreak,0,1,0,68,1603080000,1603080000,1
Qfanjen,0,1,0,3,1587873600,1587873600,1
pwasemiller,1,0,17,0,1593057600,1593057600,1
Poo_,0,1,0,0,1606626000,1606626000,1
TTGG,0,1,0,0,1581051600,1581051600,1
HeatherBeam,0,1,0,14,1595995200,1595995200,1
bruhdankmemes,1,0,22,0,1607403600,1607403600,1
DotMatrixed,0,1,0,1,1603512000,1603512000,1
Montana_RN,0,1,0,1,1574485200,1574485200,1
CreauxTeeRhobat,0,1,0,2,1603512000,1603512000,1
sparklezombie,0,1,0,7,1552968000,1552968000,1
worG-eenK,0,1,0,-2,1607922000,1607922000,1
toriyay,0,1,0,15,1608267600,1608267600,1
LifebookMan,0,1,0,2,1608699600,1608699600,1
Look_its_Rob,0,1,0,-2,1606626000,1606626000,1
Sunniigod,0,1,0,1,1634529600,1634529600,1
gromnirit,0,1,0,8,1606626000,1606626000,1
unreliablememory,0,1,0,1,1605675600,1605675600,1
fagendaz,0,1,0,11,1609304400,1609304400,1
YoshiYogurt,0,1,0,4,1579323600,1579323600,1
TranscendingFlesh,0,1,0,70,1594526400,1594526400,1
TreeRaccoon,1,0,46,0,1600660800,1600660800,1
HolidayWallaby,0,1,0,2,1603598400,1603598400,1
sleeprsandcnderellas,0,1,0,23,1581051600,1581051600,1
Quewhat3341,0,1,0,2,1598760000,1598760000,1
Theopneusty,0,1,0,2,1559188800,1559188800,1
JoanOfArkSurvivalEvo,0,1,0,5,1579064400,1579064400,1
zakur01,0,1,0,1,1602734400,1602734400,1
Ghepip,0,1,0,1,1599105600,1599105600,1
SadOceanBreeze,0,1,0,9,1604116800,1604116800,1
recklessrider,0,1,0,1,1604030400,1604030400,1
imcuteforanuglygirl,0,1,0,1,1605416400,1605416400,1
FYXK,0,1,0,6,1602907200,1602907200,1
Caged_Birds,0,1,0,0,1482210000,1482210000,1
Three6serpent,0,1,0,39,1605157200,1605157200,1
Beachfantan,0,1,0,-3,1601956800,1601956800,1
JMaster098,0,1,0,6,1587614400,1587614400,1
deptofspace,0,1,0,66,1565668800,1565668800,1
why-can-i-taste-pee,0,1,0,2,1606626000,1606626000,1
Juggz666,0,1,0,21,1584676800,1584676800,1
BamBamGoBoomBoom,0,1,0,40,1608958800,1608958800,1
mooohaha64,0,1,0,3,1574139600,1574139600,1
YouL-ttleShit,0,1,0,1,1589947200,1589947200,1
choochoobubs,0,1,0,43,1599364800,1599364800,1
akaleeroy,0,1,0,1,1531800000,1531800000,1
shogunmoguns,0,1,0,41,1591848000,1591848000,1
zezzene,0,1,0,3,1598500800,1598500800,1
bsrg,0,1,0,1,1580446800,1580446800,1
daskdaso,0,1,0,11,1589947200,1589947200,1
busybee223,0,1,0,1,1591416000,1591416000,1
flanpeach,0,1,0,1,1603512000,1603512000,1
Chaim-Achasse,0,1,0,3,1603512000,1603512000,1
MaleNeanderthal,0,1,0,7,1597291200,1597291200,1
AllAboutMyBiz,0,1,0,1,1635393600,1635393600,1
Mayortomatillo,0,1,0,1,1574053200,1574053200,1
RedClipperLighter,0,1,0,5,1587528000,1587528000,1
IIArchBishopII,0,1,0,2,1575349200,1575349200,1
_Liche_,0,1,0,2,1606539600,1606539600,1
itisogre,0,1,0,3,1612069200,1612069200,1
sgt_taco891,0,1,0,9,1560657600,1560657600,1
Shower_Handel,0,1,0,4,1553486400,1553486400,1
GeauxLesGeaux,0,1,0,1,1588824000,1588824000,1
TruthToPower77,1,0,45,0,1611896400,1611896400,1
uajoshn,0,1,0,1,1602216000,1602216000,1
curiouslabrador,0,1,0,6,1585454400,1585454400,1
CathyHHArden,0,1,0,1,1621915200,1621915200,1
dblala,0,1,0,2,1606021200,1606021200,1
corporatefittest,0,1,0,1,1596254400,1596254400,1
Americandreambruh,0,1,0,143,1574139600,1574139600,1
Amisten,0,1,0,3,1603339200,1603339200,1
Clarky1979,0,1,0,1,1605848400,1605848400,1
Wheres_that_to,0,1,0,3,1583557200,1583557200,1
giantgnomes,0,1,0,1,1575435600,1575435600,1
gungnirodin,0,1,0,2,1605848400,1605848400,1
diamonduice,0,1,0,1,1604984400,1604984400,1
CinnamonCereals,0,1,0,15,1571457600,1571457600,1
originalwombat,0,1,0,2,1574139600,1574139600,1
brianswichkow,0,1,0,47,1601697600,1601697600,1
junyaminty,0,1,0,1,1605589200,1605589200,1
amcafifa,1,0,58,0,1580792400,1580792400,1
maggynolia,0,1,0,1,1591243200,1591243200,1
leafkatherine,0,1,0,3,1566878400,1566878400,1
eldri_sv,0,1,0,13,1586404800,1586404800,1
kickyouintheface67,0,1,0,18,1600315200,1600315200,1
tvhelpmepls,0,1,0,2,1602820800,1602820800,1
ExTurk,0,1,0,2,1593835200,1593835200,1
CRISIS37,0,1,0,-2,1563336000,1563336000,1
bigdaddycla,0,1,0,1,1591156800,1591156800,1
_chamomile_tea_,0,1,0,1,1572667200,1572667200,1
krypthic,0,1,0,12,1573966800,1573966800,1
alexisrose101,0,1,0,1,1597377600,1597377600,1
adamks,0,1,0,6,1601956800,1601956800,1
festlap,0,1,0,1,1610946000,1610946000,1
Shep_Meister,0,1,0,1,1592193600,1592193600,1
vote4muscles,0,1,0,7,1605762000,1605762000,1
sublimesting,0,1,0,-8,1581915600,1581915600,1
TheRavensRegards,0,1,0,8,1572494400,1572494400,1
ThrowawayFaye818,0,1,0,23,1601524800,1601524800,1
VictorZiblis,0,1,0,4,1584504000,1584504000,1
kingcole1,0,1,0,5,1595563200,1595563200,1
SwedishDrummer,0,1,0,1,1606885200,1606885200,1
rootyMcTooty,0,1,0,4,1568606400,1568606400,1
superbeastdj,0,1,0,80,1596600000,1596600000,1
SquishySand,0,1,0,1,1581829200,1581829200,1
Bluetwo12,0,1,0,1,1606626000,1606626000,1
Lem32,0,1,0,2,1611982800,1611982800,1
WunderBear420,1,0,5,0,1599537600,1599537600,1
_inveniam_viam,0,1,0,1,1585454400,1585454400,1
Prestigious_Spray_13,0,1,0,1,1611982800,1611982800,1
Pallypot,0,1,0,2,1604379600,1604379600,1
wisdomworks_,0,1,0,1,1570507200,1570507200,1
manic_panic,0,1,0,1,1580446800,1580446800,1
Pinkbebe666,0,1,0,5,1601524800,1601524800,1
beebobopple,0,1,0,3,1602129600,1602129600,1
banjojoestar,0,1,0,-1,1598932800,1598932800,1
Basic-Fuel,0,1,0,15,1582693200,1582693200,1
Evan64m,0,1,0,3,1580706000,1580706000,1
Aviator91,0,1,0,1,1585195200,1585195200,1
tycam01,0,1,0,1,1600574400,1600574400,1
Derp_Herpson,0,1,0,3,1584417600,1584417600,1
Direct_Ad_6534,0,1,0,6,1600920000,1600920000,1
wmclain,0,1,0,2,1587700800,1587700800,1
nona_ssv,0,1,0,-1,1611810000,1611810000,1
X79g,0,1,0,2,1598932800,1598932800,1
69_Ben_Dover_420,0,1,0,3,1606626000,1606626000,1
Valnerium,0,1,0,1,1603512000,1603512000,1
blackburn009,0,1,0,20,1598760000,1598760000,1
Sassycatfarts,1,0,235,0,1608267600,1608267600,1
StuartBaker159,0,1,0,2,1602734400,1602734400,1
PhoenixUnreal,0,1,0,1,1579755600,1579755600,1
abaganoush,1,0,35,0,1582002000,1582002000,1
doylemilton,0,1,0,12,1577422800,1577422800,1
Ieditforyou,0,1,0,3,1604811600,1604811600,1
mud_tug,0,1,0,0,1611982800,1611982800,1
ExtraterrestrialYang,0,1,0,2,1573707600,1573707600,1
whybotherrr,0,1,0,11,1596513600,1596513600,1
chapterpt,0,1,0,3,1591243200,1591243200,1
MildChaoss,0,1,0,22,1588478400,1588478400,1
xxseraph,0,1,0,1,1601352000,1601352000,1
My_Invalid_Username,0,1,0,21,1609477200,1609477200,1
Driptank10,0,1,0,1,1603512000,1603512000,1
AMSMunich,0,1,0,0,1600574400,1600574400,1
fraafyo,0,1,0,-11,1596686400,1596686400,1
Liv4lov,0,1,0,27,1592539200,1592539200,1
Silver_Smurfer,0,1,0,-12,1581224400,1581224400,1
reyki6667,0,1,0,7,1573794000,1573794000,1
Commercial_Ad_864,0,1,0,1,1600660800,1600660800,1
Optimassacre,0,1,0,1,1608267600,1608267600,1
Mr_Spats,0,1,0,0,1594180800,1594180800,1
TheRealSamHyde999,0,1,0,2,1608526800,1608526800,1
jasfusion,1,0,71,0,1611810000,1611810000,1
win_a_rabbit,0,1,0,1,1606626000,1606626000,1
terere,0,1,0,14,1564632000,1564632000,1
ankerlinemerie,0,1,0,3,1594180800,1594180800,1
waitImcoming,0,1,0,36,1577941200,1577941200,1
AlienGinsburg,0,1,0,7,1594785600,1594785600,1
eljarhead,0,1,0,1,1602388800,1602388800,1
ContemporaryHippie,0,1,0,3,1606971600,1606971600,1
InsaneDwarf,0,1,0,3,1558238400,1558238400,1
detcadeR_emaN,0,1,0,21,1566187200,1566187200,1
AppalachiaVaudeville,0,1,0,15,1581138000,1581138000,1
dreamyeyed,0,1,0,2,1600142400,1600142400,1
iiiiillllliiiiillll,0,1,0,3,1594440000,1594440000,1
Milena-Celeste,0,1,0,3,1574485200,1574485200,1
-crazyindianguy-,0,1,0,4,1608526800,1608526800,1
TheKCTreat,0,1,0,2,1577336400,1577336400,1
iyioi,0,1,0,-1,1606366800,1606366800,1
whattimeoclock,0,1,0,4,1569211200,1569211200,1
dmarie67,0,1,0,1,1585627200,1585627200,1
spiral_ineg,0,1,0,1,1563076800,1563076800,1
meow2042,0,1,0,1,1598760000,1598760000,1
Sacto43,0,1,0,1,1577682000,1577682000,1
unique_username_22,0,1,0,1,1553659200,1553659200,1
fearandloath8,0,1,0,5,1583125200,1583125200,1
cocacolabiggulp,0,1,0,1,1585454400,1585454400,1
Iwillsellyouavice,0,1,0,3,1585454400,1585454400,1
atepensarnumnick,0,1,0,1,1603512000,1603512000,1
TheHumanCheeze,0,1,0,11,1573016400,1573016400,1
forestdev_,0,1,0,5,1592452800,1592452800,1
Asyriel,0,1,0,3,1576818000,1576818000,1
anuaps,0,1,0,2,1589688000,1589688000,1
DepressedMess21,0,1,0,9,1582606800,1582606800,1
Killebrew9876,0,1,0,1,1599796800,1599796800,1
funnygirlsaywhat,0,1,0,5,1599451200,1599451200,1
lxa478,0,1,0,1,1598846400,1598846400,1
Infowarsdotcom1,0,1,0,10,1598414400,1598414400,1
ArtyBoomshaka,0,1,0,2,1558929600,1558929600,1
Icy-Sink338,0,1,0,2,1612069200,1612069200,1
TheMentallord,0,1,0,6,1598760000,1598760000,1
44z53947nwcgy8kx8pjb,0,1,0,154,1573966800,1573966800,1
Dohgdan,0,1,0,2,1560139200,1560139200,1
Tremaphore,0,1,0,1,1596600000,1596600000,1
whiptheria,0,1,0,0,1544072400,1544072400,1
Scaindawgs_,0,1,0,-15,1588996800,1588996800,1
ladisman69,1,0,130,0,1607317200,1607317200,1
DyvrNebula,0,1,0,3,1600660800,1600660800,1
ohmygoditspurple,0,1,0,1,1606539600,1606539600,1
CptRoque,0,1,0,6,1591243200,1591243200,1
MopeyCrackerz,1,0,208,0,1565323200,1565323200,1
Cairo_Suite,0,1,0,1,1601179200,1601179200,1
DemPirx,0,1,0,1,1604984400,1604984400,1
jdelta1adams,0,1,0,2,1606107600,1606107600,1
Fatty_Wraps,0,1,0,32,1585195200,1585195200,1
Eragon856,0,1,0,1,1598068800,1598068800,1
Lucky_caller,0,1,0,1,1547874000,1547874000,1
orbitalfrog,0,1,0,2,1562385600,1562385600,1
Derangedcity,0,1,0,3,1600574400,1600574400,1
TheJoker516,0,1,0,0,1600920000,1600920000,1
TylertheDouche,0,1,0,12,1601352000,1601352000,1
SteamyMcSteamerson,0,1,0,3,1606021200,1606021200,1
Noncencee,1,0,15,0,1604898000,1604898000,1
Hard_Left_Hooker,0,1,0,2,1602129600,1602129600,1
somniumrosado,0,1,0,2,1600228800,1600228800,1
deter01,0,1,0,-43,1608267600,1608267600,1
YesThisIsSam,0,1,0,1,1589515200,1589515200,1
IvanyeilEmmixert,0,1,0,11,1607317200,1607317200,1
cyberjet189,1,0,7,0,1415768400,1415768400,1
shr3dthegnarbrah,0,1,0,17,1591070400,1591070400,1
mason6787,0,1,0,0,1611982800,1611982800,1
ironpete,0,1,0,2,1572408000,1572408000,1
Screamingmonkey83,0,1,0,2,1611637200,1611637200,1
aaccoottuu,0,1,0,3,1591243200,1591243200,1
y7uoMike,0,1,0,9,1562817600,1562817600,1
GarchomptheXd0,0,1,0,8,1607662800,1607662800,1
benjarvisthrowaway,0,1,0,4,1599710400,1599710400,1
FakeHome,0,1,0,2,1593835200,1593835200,1
Cantomic66,0,1,0,9,1612069200,1612069200,1
drk_knight_67,0,1,0,1,1606626000,1606626000,1
PapaEchoKilo,0,1,0,5,1575608400,1575608400,1
redmartian1,0,1,0,1,1606366800,1606366800,1
TisNotMyMainAccount,0,1,0,1,1591329600,1591329600,1
ethics_aesthetics,0,1,0,1,1606021200,1606021200,1
a_tiny_ant,0,1,0,5,1604725200,1604725200,1
Buggums,0,1,0,1,1556596800,1556596800,1
I3P,0,1,0,6,1576731600,1576731600,1
Uhhlecksus,0,1,0,4,1592798400,1592798400,1
Waterlemon_Pug,0,1,0,1,1605157200,1605157200,1
warmpatches,0,1,0,23,1556510400,1556510400,1
Kaptain_Kosher,0,1,0,3,1597982400,1597982400,1
was_sup,0,1,0,1,1569124800,1569124800,1
nacho-chonky,0,1,0,-1,1591329600,1591329600,1
iamalargehousecat,0,1,0,2,1606885200,1606885200,1
ploste,0,1,0,4,1585022400,1585022400,1
tavigsy,0,1,0,1,1579669200,1579669200,1
CreativeCandy9,0,1,0,2,1591243200,1591243200,1
sourmermaid,0,1,0,12,1558843200,1558843200,1
sbhuahua,0,1,0,10,1611810000,1611810000,1
gwenhyfwar,0,1,0,6,1580878800,1580878800,1
Miserable_Smoke,0,1,0,2,1605589200,1605589200,1
iwanderedlonely,1,0,2,0,1410840000,1410840000,1
churrofromspace,0,1,0,2,1595822400,1595822400,1
graymond115,0,1,0,1,1598155200,1598155200,1
HowComeIDK,0,1,0,8,1598500800,1598500800,1
EmbodiementOfAutism,0,1,0,3,1572843600,1572843600,1
MinorFourChord,0,1,0,1,1605070800,1605070800,1
FailureToComply0,0,1,0,18,1606453200,1606453200,1
rugby-panda,0,1,0,6,1605589200,1605589200,1
spamishTheGreat,0,1,0,2,1578373200,1578373200,1
SophosVA,0,1,0,2,1573362000,1573362000,1
High54Every1,0,1,0,1,1606626000,1606626000,1
ikmkim,0,1,0,8,1555992000,1555992000,1
Logisticsbitches,0,1,0,-33,1573362000,1573362000,1
palerthanpale1,1,0,7,0,1557720000,1557720000,1
ughaibu,0,1,0,1,1559966400,1559966400,1
0110001001101111ss,0,1,0,223,1608699600,1608699600,1
Zendelli222,0,1,0,3,1600142400,1600142400,1
Hmaddog_2000_2,0,1,0,1,1602820800,1602820800,1
nicoletasin,0,1,0,3,1564718400,1564718400,1
darklion125,0,1,0,3,1601611200,1601611200,1
DarwinCassidy,1,0,90,0,1554868800,1554868800,1
When_pigsfly,0,1,0,8,1572235200,1572235200,1
jonica1991,0,1,0,4,1591588800,1591588800,1
1415141,0,1,0,1,1607835600,1607835600,1
raven_sov,0,1,0,2,1612501200,1612501200,1
mayonnaiseplayer7,0,1,0,3,1606021200,1606021200,1
-YaQ-,0,1,0,-1,1602820800,1602820800,1
6feetawayfromu,0,1,0,1,1594872000,1594872000,1
Throwmeawaynow1887,0,1,0,-9,1580187600,1580187600,1
annoying_DAD_bot,0,1,0,2,1562126400,1562126400,1
CatHairIsEverywhere,0,1,0,3,1600401600,1600401600,1
booyah719,0,1,0,24,1573362000,1573362000,1
nocommentingallowed,0,1,0,1,1591329600,1591329600,1
Hermea,0,1,0,4,1602216000,1602216000,1
sketchy_pineapple,0,1,0,3,1608786000,1608786000,1
FunnySimple9,1,0,1,0,1586232000,1586232000,1
Warpath1138,0,1,0,1,1573621200,1573621200,1
Theghostofjoehill,0,1,0,1,1555905600,1555905600,1
just-jon,0,1,0,7,1607230800,1607230800,1
Rdsknight11,1,0,154,0,1593835200,1593835200,1
Zuezema,0,1,0,-1,1583557200,1583557200,1
kingjaffejoffer-c2a,0,1,0,1,1608786000,1608786000,1
GulfTangoKilo,0,1,0,-2,1579237200,1579237200,1
samarasabine,0,1,0,2,1601179200,1601179200,1
Sonnyjesuswept,0,1,0,6,1605502800,1605502800,1
Indestructuble_Man,0,1,0,1,1573794000,1573794000,1
Notnyethescienceguy,0,1,0,86,1548306000,1548306000,1
scoutarooni,0,1,0,2,1605070800,1605070800,1
AloysiusAlgaliarept,0,1,0,92,1611723600,1611723600,1
SkyWanderluster,0,1,0,2,1585368000,1585368000,1
Crystal225,0,1,0,1,1612069200,1612069200,1
FineFox8,0,1,0,4,1561780800,1561780800,1
bonjourpaste,0,1,0,20,1571716800,1571716800,1
jiggjuggjogg,1,0,7,0,1572667200,1572667200,1
Trick_Display,0,1,0,1,1568520000,1568520000,1
MLein97,0,1,0,15,1585454400,1585454400,1
Nickadee16,0,1,0,1,1606021200,1606021200,1
luxe-lime,0,1,0,21,1602043200,1602043200,1
SFW_Ahegao_Rathalos,0,1,0,3,1586664000,1586664000,1
slinkyinmotion,0,1,0,215,1586923200,1586923200,1
bonnieistired,0,1,0,3,1582088400,1582088400,1
Plain_Jain,0,1,0,1,1573362000,1573362000,1
DoesN0tCompute,0,1,0,1,1585454400,1585454400,1
MrMeanJeans,0,1,0,1,1600747200,1600747200,1
hablador,0,1,0,11,1577422800,1577422800,1
socialistnetwork,0,1,0,1,1595908800,1595908800,1
__ArthurDent__,0,1,0,105,1609045200,1609045200,1
raquin_,0,1,0,3,1601438400,1601438400,1
InspiredToast,1,0,1807,0,1607403600,1607403600,1
tgr2094,0,1,0,2,1584158400,1584158400,1
Walk-The-Rope,0,1,0,1,1591329600,1591329600,1
Noahlirnirs,0,1,0,-14,1574830800,1574830800,1
tacobellqueenjaz,0,1,0,1,1596513600,1596513600,1
HerpsDean_,0,1,0,1,1608267600,1608267600,1
stretch2099,0,1,0,2,1601179200,1601179200,1
CharlestonChewbacca,0,1,0,11,1606626000,1606626000,1
jwat4455,0,1,0,1,1604466000,1604466000,1
shotgunbath,0,1,0,-1,1585540800,1585540800,1
Auterbot,0,1,0,1,1609131600,1609131600,1
MachoNacho95,0,1,0,1,1575954000,1575954000,1
123bpd,0,1,0,5,1568952000,1568952000,1
k_jm,0,1,0,47,1559016000,1559016000,1
peyton473,0,1,0,39,1607490000,1607490000,1
carl0071,0,1,0,3,1573621200,1573621200,1
trashman3mc,0,1,0,2,1600660800,1600660800,1
fuckthefuturee,0,1,0,1,1600315200,1600315200,1
becomeNone,0,1,0,4,1561608000,1561608000,1
WiseWoodrow,0,1,0,3,1642827600,1642827600,1
aquagiraffe-,0,1,0,1,1608526800,1608526800,1
all4wishboy,0,1,0,3,1585627200,1585627200,1
oldfrancis,0,1,0,1,1605934800,1605934800,1
hmmcn,0,1,0,-7,1586664000,1586664000,1
Blu3_Skull,0,1,0,2,1601006400,1601006400,1
PsychoNerd91,0,1,0,11,1605502800,1605502800,1
RippedBaracade,1,0,839,0,1589947200,1589947200,1
HouseNegative9428,0,1,0,4,1609390800,1609390800,1
ButtStuff69_FR_tho,0,1,0,-3,1601870400,1601870400,1
Cthulhu-ftagn,0,1,0,47,1557028800,1557028800,1
Chfreak,0,1,0,1,1605157200,1605157200,1
420pooplover69,0,1,0,7,1600833600,1600833600,1
ImpossiblePackage,0,1,0,1,1559361600,1559361600,1
gn3xu5,0,1,0,8,1600315200,1600315200,1
mystacheisgreen,0,1,0,-5,1574398800,1574398800,1
cucumba_water,0,1,0,4,1571630400,1571630400,1
vincentmario,0,1,0,4,1586318400,1586318400,1
yyxxyyuuyyuuxx,0,1,0,6,1570075200,1570075200,1
kielonek1,0,1,0,3,1594699200,1594699200,1
Danieltsss,0,1,0,3,1569643200,1569643200,1
charredest,0,1,0,3,1563076800,1563076800,1
nobodyknowsimherr,0,1,0,1,1607576400,1607576400,1
darthv3iga,0,1,0,1,1605502800,1605502800,1
Onslaught23gr,0,1,0,16,1603684800,1603684800,1
budddalove,0,1,0,1,1578114000,1578114000,1
zlittle586,0,1,0,2,1602820800,1602820800,1
Plowbeast,0,1,0,1,1624248000,1624248000,1
raptorpizza,0,1,0,3,1600574400,1600574400,1
NebulaNinja,0,1,0,1,1565928000,1565928000,1
Alexander009,0,1,0,1,1576558800,1576558800,1
themobyone,1,0,5,0,1608526800,1608526800,1
Krokon123,1,0,2,0,1586577600,1586577600,1
Mettamakesitbetter,0,1,0,-3,1582779600,1582779600,1
RelevantTalkingHead,0,1,0,1,1602302400,1602302400,1
CatLapFootCramp,0,1,0,2,1603512000,1603512000,1
ImbeddedElite,0,1,0,1,1591243200,1591243200,1
Spyyyyyyyy22,0,1,0,1,1581224400,1581224400,1
DrakuliasAlfonz,0,1,0,3,1547874000,1547874000,1
FunboyFrags,0,1,0,16,1576990800,1576990800,1
HelloSir1989,0,1,0,4,1603512000,1603512000,1
Olek2706,1,0,41,0,1605502800,1605502800,1
StavBecoming,0,1,0,2,1598846400,1598846400,1
throwawayjpyo,0,1,0,5,1598155200,1598155200,1
but-imnotadoctor,0,1,0,7,1602388800,1602388800,1
ultimagriever,0,1,0,3,1571889600,1571889600,1
Fellow_human_male,0,1,0,15,1598673600,1598673600,1
Kulomin,0,1,0,7,1580101200,1580101200,1
welcome2egypt,1,0,494,0,1612069200,1612069200,1
Skenny_P,0,1,0,1,1592798400,1592798400,1
TurbineNipples,0,1,0,1,1573534800,1573534800,1
2BrownBalls,0,1,0,23,1548306000,1548306000,1
man_lizard,0,1,0,1,1611982800,1611982800,1
mattakuu,0,1,0,0,1589688000,1589688000,1
shizenmeister,0,1,0,2,1605848400,1605848400,1
MrPapadapalas,0,1,0,3,1604984400,1604984400,1
raspberriesofwrath,0,1,0,4,1599796800,1599796800,1
icetalon91,0,1,0,20,1569643200,1569643200,1
kn728570,0,1,0,59,1574658000,1574658000,1
JoseSpiknSpan,0,1,0,6,1583384400,1583384400,1
deere_64,1,0,26,0,1582261200,1582261200,1
pdwp90,0,1,0,44,1606539600,1606539600,1
bsgman,0,1,0,-28,1557892800,1557892800,1
veronicabitchlasagna,0,1,0,6,1570852800,1570852800,1
Tulpagasm,0,1,0,1,1599105600,1599105600,1
utf16,0,1,0,5,1598760000,1598760000,1
mchoiess,0,1,0,1,1607317200,1607317200,1
thiscommentmademe,0,1,0,3,1611810000,1611810000,1
CorenCorias,0,1,0,1,1598760000,1598760000,1
Rd2dcd,0,1,0,1,1573707600,1573707600,1
catsbookstea,0,1,0,5,1565323200,1565323200,1
zr0gravity7,0,1,0,-4,1594094400,1594094400,1
90-90-90,0,1,0,2,1591156800,1591156800,1
Dreamearth,0,1,0,5,1590638400,1590638400,1
cmize7,0,1,0,1,1607835600,1607835600,1
POWERRL_RANGER,0,1,0,1,1597723200,1597723200,1
TheLastArnold,0,1,0,1,1599537600,1599537600,1
Weisserfuchs,0,1,0,3,1602820800,1602820800,1
jnorr13,0,1,0,1,1601179200,1601179200,1
bigbadcig,0,1,0,1,1603080000,1603080000,1
PhtevenTheSecond,0,1,0,11,1605589200,1605589200,1
BlindingRex,0,1,0,1,1605589200,1605589200,1
MachineGunStalin,0,1,0,20,1581656400,1581656400,1
amejeremy,0,1,0,8,1575349200,1575349200,1
Greatjon,0,1,0,2,1600574400,1600574400,1
210971911,0,1,0,4,1605243600,1605243600,1
Ridewithme38,0,1,0,3,1570420800,1570420800,1
Skypuppy77,0,1,0,5,1605502800,1605502800,1
chilittle,0,1,0,10,1585281600,1585281600,1
Technologenesis,0,1,0,330,1589601600,1589601600,1
theoldchunk,0,1,0,25,1583812800,1583812800,1
itllbeokayla,0,1,0,55,1602648000,1602648000,1
revolver_othello,0,1,0,2,1590465600,1590465600,1
potato_the_king,0,1,0,4,1603339200,1603339200,1
jwjwjwkwk,0,1,0,-23,1605502800,1605502800,1
ArkancideOfBeef,0,1,0,2,1603080000,1603080000,1
TheShadiestPillow,0,1,0,-11,1584417600,1584417600,1
-kgm-,0,1,0,2,1534737600,1534737600,1
Vizwalla,0,1,0,20,1573448400,1573448400,1
The_Ringleader,0,1,0,-7,1567310400,1567310400,1
araknu000,0,1,0,3,1581915600,1581915600,1
smokedgoudatriscuits,1,0,120,0,1600833600,1600833600,1
arganshlarb,0,1,0,1,1598932800,1598932800,1
Dee2620,0,1,0,1,1591329600,1591329600,1
JoeyRamenNoodles,0,1,0,15,1593144000,1593144000,1
amizelkova,0,1,0,2,1582434000,1582434000,1
inboxzerohero,0,1,0,0,1571112000,1571112000,1
Reala27,0,1,0,2,1547355600,1547355600,1
Hydropotesinermis,0,1,0,8,1577509200,1577509200,1
HideousPillow,0,1,0,3,1597377600,1597377600,1
MortyKhan,0,1,0,2,1591502400,1591502400,1
sewer_mermaid,0,1,0,16,1556510400,1556510400,1
swvn352,0,1,0,2,1605848400,1605848400,1
ActuallyTwoUpvotes,0,1,0,1,1594353600,1594353600,1
thestrangescientist,0,1,0,4,1594612800,1594612800,1
professional_burrito,0,1,0,62,1590638400,1590638400,1
the_onion_ASMR-boy,0,1,0,3,1590984000,1590984000,1
homophobejesus,0,1,0,0,1600660800,1600660800,1
reedyp,0,1,0,1,1589947200,1589947200,1
Magerface,0,1,0,4,1595131200,1595131200,1
Bennykelli1,0,1,0,2,1598155200,1598155200,1
astral_realms,0,1,0,1,1574053200,1574053200,1
i_cant_draw_women,0,1,0,9,1597377600,1597377600,1
mxzf,0,1,0,0,1580101200,1580101200,1
jklaiho,1,0,11,0,1597032000,1597032000,1
cosmicmilkshakes,0,1,0,-38,1595390400,1595390400,1
Good_Roll,0,1,0,2,1572148800,1572148800,1
afidemon,0,1,0,3,1578027600,1578027600,1
SilentUser44,0,1,0,3,1602561600,1602561600,1
lordfappington69,0,1,0,1,1557115200,1557115200,1
YouDontKnowMe2017,0,1,0,3,1606626000,1606626000,1
Ferrocene_swgoh,0,1,0,9,1599019200,1599019200,1
eatuhcactus,0,1,0,6,1600660800,1600660800,1
MayonnaiseHotdog,0,1,0,2,1579669200,1579669200,1
secue,0,1,0,16,1570420800,1570420800,1
bzelditch,1,0,0,0,1611982800,1611982800,1
Skitz-o-fritz,0,1,0,4,1582779600,1582779600,1
Jah_Ith_Ber,0,1,0,8,1431576000,1431576000,1
Faeblekun,0,1,0,222,1608786000,1608786000,1
cfabby,0,1,0,1,1558929600,1558929600,1
Fit_Sweet457,0,1,0,1,1594699200,1594699200,1
SabreMase,0,1,0,1,1585454400,1585454400,1
abhisn,1,0,29,0,1542517200,1542517200,1
Chris_Reager,0,1,0,3,1582779600,1582779600,1
itssublimee,0,1,0,7,1576558800,1576558800,1
Callipygian_Superman,0,1,0,25,1574830800,1574830800,1
Mysterious-Title-852,0,1,0,6,1603771200,1603771200,1
deeeeevebrunnn,0,1,0,2,1603512000,1603512000,1
Nabotna,0,1,0,8,1579755600,1579755600,1
DavidJHovsepian,1,0,4,0,1587960000,1587960000,1
ediblenecklace,0,1,0,1,1592539200,1592539200,1
TheRiteGuy,0,1,0,8,1598760000,1598760000,1
RadioActiveIt,0,1,0,23,1585195200,1585195200,1
walrus120,0,1,0,1,1608699600,1608699600,1
quavokareem,1,0,188,0,1582434000,1582434000,1
CyberDiablo,0,1,0,1,1453784400,1453784400,1
aardwolfie,0,1,0,1,1595563200,1595563200,1
gay_watermelon_,0,1,0,1,1608613200,1608613200,1
LumaKey,0,1,0,34,1606280400,1606280400,1
EpicProf,0,1,0,2,1605157200,1605157200,1
lil_waine,0,1,0,1,1635307200,1635307200,1
Sofa-King-Confused,0,1,0,22,1598760000,1598760000,1
CSS-SeniorProgrammer,0,1,0,2,1606021200,1606021200,1
JesusRasputin,0,1,0,1,1605157200,1605157200,1
MalaXor,0,1,0,2,1601352000,1601352000,1
div2691,0,1,0,4,1605502800,1605502800,1
nope_them_all,0,1,0,1,1605330000,1605330000,1
beautifulplanet,1,0,79,0,1596859200,1596859200,1
dredd_adore,0,1,0,48,1601265600,1601265600,1
whitepawsparklez,0,1,0,3,1608440400,1608440400,1
Yithar,0,1,0,1,1567483200,1567483200,1
WarmEase,0,1,0,30,1547528400,1547528400,1
IndianBrothels,0,1,0,3,1548824400,1548824400,1
Distrumpia,0,1,0,1,1607403600,1607403600,1
bremijo,0,1,0,18,1577336400,1577336400,1
Olafseye,0,1,0,9,1604898000,1604898000,1
boo0,0,1,0,39,1576731600,1576731600,1
Simonyevich,0,1,0,3,1578891600,1578891600,1
guy92,0,1,0,53,1604379600,1604379600,1
LordWukong,0,1,0,0,1607835600,1607835600,1
EverythingIWant2Know,0,1,0,1,1605589200,1605589200,1
Bigyeetus2020,0,1,0,1,1606626000,1606626000,1
Rare_Huckleberry_999,0,1,0,1,1608008400,1608008400,1
rocafellasalazar,0,1,0,1,1592107200,1592107200,1
Everythings,0,1,0,1,1584763200,1584763200,1
ascii122,0,1,0,1,1585454400,1585454400,1
Ricer_Civic,0,1,0,1,1584072000,1584072000,1
MiezaruTe,0,1,0,1,1588478400,1588478400,1
thelesliesmooth,0,1,0,-1,1591416000,1591416000,1
Tre_Scrilla,0,1,0,10,1573275600,1573275600,1
Aukavis,0,1,0,1,1607662800,1607662800,1
Palidor206,0,1,0,1,1574139600,1574139600,1
PharmaPlus,0,1,0,-1,1611896400,1611896400,1
BloodSweatandFears,1,0,46,0,1605502800,1605502800,1
JohnColburn,0,1,0,25,1579755600,1579755600,1
PhenomenallyBack,0,1,0,1,1569038400,1569038400,1
CrystalSpyryt,0,1,0,1,1519794000,1519794000,1
keepinitoldskool,0,1,0,4,1605070800,1605070800,1
xeroblaze0,0,1,0,3,1605762000,1605762000,1
ArchdukeValeCortez,0,1,0,3,1607317200,1607317200,1
therealyoualreadykno,0,1,0,8,1553400000,1553400000,1
milkinhisveins,0,1,0,2,1605848400,1605848400,1
LemonCucumbers,0,1,0,2,1604379600,1604379600,1
IcedBennu,0,1,0,3,1542862800,1542862800,1
CrackCoffeine,0,1,0,6,1536552000,1536552000,1
selfhelpfitness,1,0,0,0,1607144400,1607144400,1
Troliver_13,0,1,0,2,1590638400,1590638400,1
in_essence,1,0,100,0,1544072400,1544072400,1
Septic-Mist,0,1,0,3,1586664000,1586664000,1
ImGonnaZoom,0,1,0,1,1596600000,1596600000,1
jowangtang,0,1,0,5,1608786000,1608786000,1
evening_swimmer,1,0,54,0,1605848400,1605848400,1
Kikiyoshima,0,1,0,-1,1595908800,1595908800,1
ReidRulz,0,1,0,4,1567483200,1567483200,1
DJGreenHill,0,1,0,-24,1600833600,1600833600,1
snow-days,0,1,0,2,1611896400,1611896400,1
staleperspective,0,1,0,9,1599019200,1599019200,1
boingoboingoboingo34,0,1,0,5,1585454400,1585454400,1
RonaldCherrycoke,0,1,0,30,1564459200,1564459200,1
powahballoflove,0,1,0,1,1592107200,1592107200,1
deepfriedtots,0,1,0,2,1608267600,1608267600,1
luna_tehee,0,1,0,1,1595217600,1595217600,1
magicweasel7,0,1,0,14,1606539600,1606539600,1
RaroRabble,0,1,0,1,1585540800,1585540800,1
T0m0king,0,1,0,1,1573534800,1573534800,1
turboiv,0,1,0,-4,1607835600,1607835600,1
september72020507pm,0,1,0,16,1600747200,1600747200,1
roadrunnner0,0,1,0,19,1609218000,1609218000,1
cyb3rstrike,0,1,0,3,1580187600,1580187600,1
mog_knight,0,1,0,12,1611982800,1611982800,1
newsfish,0,1,0,10,1598846400,1598846400,1
TimesSquareMagician,0,1,0,0,1611982800,1611982800,1
Kindly-Pruned,0,1,0,2,1600315200,1600315200,1
DontCallMeJen,0,1,0,3,1585281600,1585281600,1
DaveVsGodzi77a,0,1,0,6,1607662800,1607662800,1
Dr-Gubby,0,1,0,1,1603512000,1603512000,1
AndHowDidIGetHere,0,1,0,27,1599192000,1599192000,1
Tinuhhhhh,0,1,0,2,1603684800,1603684800,1
DergerDergs,0,1,0,8,1598760000,1598760000,1
Maxwell-hill,0,1,0,2,1606194000,1606194000,1
SirNanashi,0,1,0,1,1598846400,1598846400,1
Moocowsnap,0,1,0,0,1581051600,1581051600,1
sjlopez,0,1,0,1,1583899200,1583899200,1
Shadow_jacker,0,1,0,6,1603425600,1603425600,1
Hjhawley7,0,1,0,1,1556596800,1556596800,1
TheMagicNumber_,0,1,0,-19,1577336400,1577336400,1
PaPaPleb,0,1,0,1,1603512000,1603512000,1
buttsonfire1,1,0,0,0,1609390800,1609390800,1
___def,0,1,0,5,1554436800,1554436800,1
HugbugKayth,0,1,0,-1,1561348800,1561348800,1
KasdinKingofDreams,0,1,0,1,1625544000,1625544000,1
Alexxed,0,1,0,3,1571544000,1571544000,1
jamesjp,0,1,0,3,1596600000,1596600000,1
edythbunker,0,1,0,7,1611723600,1611723600,1
seventy1forty9,0,1,0,1,1580274000,1580274000,1
germanodactylus,0,1,0,7,1581224400,1581224400,1
DevilsFavoritAdvocat,0,1,0,2,1603512000,1603512000,1
Cheeze_It,0,1,0,2,1598846400,1598846400,1
Progrum,0,1,0,155,1606107600,1606107600,1
knightshell,0,1,0,1,1571371200,1571371200,1
gravitypressure,0,1,0,4,1608872400,1608872400,1
jspittman,0,1,0,4,1593489600,1593489600,1
HeartInOsaka,0,1,0,2,1591243200,1591243200,1
divtaur,0,1,0,2,1587873600,1587873600,1
electrikdreamachine,0,1,0,16,1577336400,1577336400,1
fistfulloframen,0,1,0,0,1608613200,1608613200,1
EverGlow89,0,1,0,5,1580101200,1580101200,1
notarronrodgers,0,1,0,-18,1573016400,1573016400,1
Stoke-me-a-clipper,0,1,0,2,1600574400,1600574400,1
pdxwhitino,0,1,0,1,1557979200,1557979200,1
Its-a-Shitbox,0,1,0,1,1604293200,1604293200,1
moosecakies,0,1,0,5,1581829200,1581829200,1
The_yeet_skeet,0,1,0,1,1595304000,1595304000,1
sassysassysarah,0,1,0,9,1609131600,1609131600,1
m0loch,0,1,0,2,1608354000,1608354000,1
eight_ninths_below,0,1,0,2,1607662800,1607662800,1
pulse14,0,1,0,11,1598760000,1598760000,1
Groundbreaking_Dare5,0,1,0,1,1597118400,1597118400,1
bootlicker5001,0,1,0,13,1593576000,1593576000,1
pastguy2727,0,1,0,1,1606194000,1606194000,1
milkthrower,0,1,0,1,1603512000,1603512000,1
Aethermancer,0,1,0,2,1612069200,1612069200,1
Jeffyoubetya,0,1,0,-1,1598414400,1598414400,1
AstroWhitt,0,1,0,37,1608526800,1608526800,1
Fringelunaticman,0,1,0,-9,1608094800,1608094800,1
WeJustTry,0,1,0,4,1586836800,1586836800,1
hobgoblob,0,1,0,2,1602129600,1602129600,1
Merrick88,0,1,0,1,1589860800,1589860800,1
Potatolantern,0,1,0,4,1585454400,1585454400,1
SquishyHumanform,0,1,0,14,1585886400,1585886400,1
Pixelated_Fudge,0,1,0,1,1582779600,1582779600,1
Xenthys,1,0,40,0,1599624000,1599624000,1
Saj313,0,1,0,1,1582520400,1582520400,1
HazDaGeek,0,1,0,13,1584158400,1584158400,1
nuephelkystikon,0,1,0,2,1581483600,1581483600,1
Running4Badges,0,1,0,8,1606971600,1606971600,1
nobody_nothing-,0,1,0,1,1609045200,1609045200,1
The-Broseph,0,1,0,1,1566187200,1566187200,1
easyentry,0,1,0,0,1584590400,1584590400,1
immajerkmyselfoff,0,1,0,3,1563940800,1563940800,1
startedthinkinboutit,0,1,0,15,1604898000,1604898000,1
ThurgoodJenkinsJr,0,1,0,1,1597636800,1597636800,1
flummingbird,0,1,0,1,1580878800,1580878800,1
HABABABAB,0,1,0,1,1578891600,1578891600,1
dfinkelstein,0,1,0,6,1573534800,1573534800,1
JBarkle,0,1,0,1,1612069200,1612069200,1
Drakkoblood,0,1,0,9,1573880400,1573880400,1
WhadoIknow,0,1,0,1,1608699600,1608699600,1
Slotcanyoneer,0,1,0,4,1576126800,1576126800,1
TheAmbitiousKitty,0,1,0,0,1602907200,1602907200,1
halfajob,0,1,0,3,1586404800,1586404800,1
MrMisklanius,0,1,0,3,1595304000,1595304000,1
mattycamachio,0,1,0,13,1607144400,1607144400,1
LemmeLaroo,0,1,0,1,1606021200,1606021200,1
slygal17,0,1,0,5,1571371200,1571371200,1
MasHamburguesa,0,1,0,18,1584072000,1584072000,1
Ms_Iambic_Pentagram,0,1,0,7,1554955200,1554955200,1
Bowtothe_Crown,0,1,0,3,1603598400,1603598400,1
aferre5,0,1,0,1,1603512000,1603512000,1
senilerhino,0,1,0,10,1605070800,1605070800,1
roma32387,0,1,0,2,1590206400,1590206400,1
Jsc1976,0,1,0,1,1607403600,1607403600,1
howfckndareyou,0,1,0,1,1594785600,1594785600,1
WriteBrainedJR,0,1,0,3,1600142400,1600142400,1
leadergorilla,0,1,0,1,1589860800,1589860800,1
youngemarx,0,1,0,5,1606194000,1606194000,1
Important-Ad-1241,0,1,0,1,1603512000,1603512000,1
bruh-momentum6,0,1,0,2,1586232000,1586232000,1
slyguyomy,0,1,0,1,1600574400,1600574400,1
pizzasnack,0,1,0,2,1563249600,1563249600,1
Frothyogreloins,0,1,0,11,1605416400,1605416400,1
punkpoppenguin,0,1,0,3,1605070800,1605070800,1
DeathToPennies,0,1,0,1,1609563600,1609563600,1
We_Can_Escape,0,1,0,2,1608267600,1608267600,1
hammermuffin,0,1,0,1,1643173200,1643173200,1
radosla,0,1,0,7,1592193600,1592193600,1
rancidcum,0,1,0,2,1576126800,1576126800,1
Jason1143,0,1,0,35,1612069200,1612069200,1
Kitzer76er,0,1,0,2,1603512000,1603512000,1
dragonowl1990,0,1,0,2,1594094400,1594094400,1
silentfern,0,1,0,3,1597723200,1597723200,1
Gun-in-the-sun,0,1,0,0,1600228800,1600228800,1
Sinister-Mephisto,0,1,0,4,1583812800,1583812800,1
CooleSache17,0,1,0,0,1606885200,1606885200,1
happybuttiredgryff,0,1,0,9,1608440400,1608440400,1
laura9sks,0,1,0,1,1563854400,1563854400,1
joebloggs8668,0,1,0,0,1608267600,1608267600,1
wiliani,0,1,0,1,1606280400,1606280400,1
metalmegs,0,1,0,2,1600142400,1600142400,1
dollfan0,0,1,0,3,1608613200,1608613200,1
ChipChipington,0,1,0,1,1605243600,1605243600,1
XCollusionX,0,1,0,1,1608872400,1608872400,1
Space_Patrol_Digger,0,1,0,2,1600401600,1600401600,1
Marketing_Shoddy,0,1,0,1,1608613200,1608613200,1
NugBlazer,0,1,0,1,1603512000,1603512000,1
MyNamRob,0,1,0,1,1608786000,1608786000,1
thesuperbaddest,0,1,0,6,1603339200,1603339200,1
WigglyWoo777,0,1,0,4,1602993600,1602993600,1
the_injog,1,0,7,0,1602129600,1602129600,1
PickleRickForTheWin,0,1,0,1,1585195200,1585195200,1
The_Locust_God,0,1,0,7,1578373200,1578373200,1
dsfenasni,0,1,0,2,1601179200,1601179200,1
BuyThisUsername420,0,1,0,4,1583643600,1583643600,1
rustygrape,0,1,0,1,1611982800,1611982800,1
OXIOXIOXI,0,1,0,8,1603425600,1603425600,1
vv_o_e_s,0,1,0,21,1588046400,1588046400,1
redneckhippynerd,0,1,0,2,1601352000,1601352000,1
DogTeeth_Val,0,1,0,73,1571976000,1571976000,1
vaguenagging,0,1,0,25,1602734400,1602734400,1
Cr21LA,0,1,0,1,1604379600,1604379600,1
Chittlings,0,1,0,24,1609304400,1609304400,1
electriclady99,0,1,0,1,1610254800,1610254800,1
ArkaneSociety,0,1,0,2,1608267600,1608267600,1
karandhilon,0,1,0,6,1540094400,1540094400,1
Departedsoul,0,1,0,71,1602388800,1602388800,1
_MSPisshead,0,1,0,-1,1585627200,1585627200,1
elvis_dead_twin,0,1,0,16,1597809600,1597809600,1
Ultrasound700,0,1,0,8,1599019200,1599019200,1
Historically_Dumb,0,1,0,44,1594008000,1594008000,1
MadeSomewhereElse,0,1,0,17,1598414400,1598414400,1
This_isR2Me,0,1,0,1,1604379600,1604379600,1
sheldonowns,0,1,0,5,1600747200,1600747200,1
shanebenning,0,1,0,14,1577336400,1577336400,1
BodybuilderAlert905,0,1,0,16,1608094800,1608094800,1
karlnite,0,1,0,5,1573794000,1573794000,1
Kit10phish,0,1,0,1,1581915600,1581915600,1
AsliReddington,0,1,0,734,1606107600,1606107600,1
IWant1Die,0,1,0,5,1584936000,1584936000,1
are_you_nucking_futs,0,1,0,1,1588132800,1588132800,1
tallwheel,0,1,0,4,1600833600,1600833600,1
minecraftmined,0,1,0,6,1600747200,1600747200,1
powerphail,0,1,0,2,1573189200,1573189200,1
thefalconepunched,0,1,0,3,1608872400,1608872400,1
rozzy27,0,1,0,2,1600660800,1600660800,1
Lyrene,0,1,0,3,1574830800,1574830800,1
Lakesys,0,1,0,18,1570161600,1570161600,1
EncepTiion,0,1,0,18,1562644800,1562644800,1
tired_and_hungry2,0,1,0,-4,1585454400,1585454400,1
TrashMasterGeneral,0,1,0,9,1560657600,1560657600,1
madmadmad23,0,1,0,7,1589688000,1589688000,1
IAmTheShitRedditSays,0,1,0,2,1598673600,1598673600,1
arrav21,0,1,0,4,1571112000,1571112000,1
ContextVomit,0,1,0,9,1584504000,1584504000,1
hellsangel101,0,1,0,25,1572494400,1572494400,1
jeromerules,0,1,0,21,1559016000,1559016000,1
Zuksod,0,1,0,3,1573448400,1573448400,1
Nashboy45,0,1,0,14,1580014800,1580014800,1
Fabreezey157,0,1,0,3,1582779600,1582779600,1
IzarkKiaTarj,0,1,0,4,1612069200,1612069200,1
Qu1nn1fer,0,1,0,0,1608699600,1608699600,1
keanuisbea,0,1,0,1,1595908800,1595908800,1
kysaeay,0,1,0,9,1600660800,1600660800,1
vardaan2,0,1,0,1,1607922000,1607922000,1
Kaywin,0,1,0,6,1543640400,1543640400,1
firenowplz,0,1,0,1,1590552000,1590552000,1
Saint_meme,0,1,0,7,1592625600,1592625600,1
privied_youth,0,1,0,1,1555905600,1555905600,1
norewichhea,0,1,0,53,1609477200,1609477200,1
Bird-in-a-suit,0,1,0,19,1589688000,1589688000,1
TheMeatLady21,0,1,0,1,1587182400,1587182400,1
Kalthramis,0,1,0,2,1604030400,1604030400,1
SnarfSnarf2533,0,1,0,3,1605848400,1605848400,1
Scatman_Jeff,0,1,0,24,1578891600,1578891600,1
Mursenightingale,0,1,0,2,1575608400,1575608400,1
dieinside,0,1,0,8,1585454400,1585454400,1
IAteSouvlaki,0,1,0,6,1577336400,1577336400,1
idcbro101108,0,1,0,1,1604293200,1604293200,1
neverworlds,0,1,0,3,1552194000,1552194000,1
invention64,0,1,0,1,1595217600,1595217600,1
wesjb,0,1,0,11,1549515600,1549515600,1
GothBunnyClique,0,1,0,2,1603080000,1603080000,1
11235813_,0,1,0,2,1565755200,1565755200,1
imamydesk,0,1,0,3,1609477200,1609477200,1
treehugger98,1,0,80,0,1575954000,1575954000,1
savormyham,0,1,0,5,1589860800,1589860800,1
PraiseGodJihyo,0,1,0,1,1603684800,1603684800,1
Behead-The-Rich,0,1,0,2,1567396800,1567396800,1
Razr_2012,0,1,0,3,1603598400,1603598400,1
L0nesomeDrifter,0,1,0,-2,1596168000,1596168000,1
okikio,0,1,0,2,1596772800,1596772800,1
jj26meu,0,1,0,1,1607230800,1607230800,1
gondollas,0,1,0,3,1575608400,1575608400,1
reasonb4belief,0,1,0,3,1597723200,1597723200,1
calmerpoleece,0,1,0,11,1566446400,1566446400,1
hrb4,1,0,577,0,1583384400,1583384400,1
FnordPrefect2020,0,1,0,1,1605157200,1605157200,1
rvconfusef,0,1,0,2,1590724800,1590724800,1
just_a_bug,0,1,0,6,1587182400,1587182400,1
n0tdiorhomie,0,1,0,5,1591416000,1591416000,1
solar_flannels,1,0,59,0,1588305600,1588305600,1
babygoattears96,0,1,0,5,1600574400,1600574400,1
ImamChapo,0,1,0,4,1611637200,1611637200,1
tocopillator,0,1,0,6,1552276800,1552276800,1
fatchicken17,0,1,0,7,1598068800,1598068800,1
aesthetic_city,0,1,0,3,1592625600,1592625600,1
agprincess,0,1,0,2,1611896400,1611896400,1
HanDolo_5Twelve,0,1,0,1,1603512000,1603512000,1
devianb,0,1,0,1,1578373200,1578373200,1
Louielouielouaaaah,0,1,0,5,1605848400,1605848400,1
TheGhostofCoffee,0,1,0,0,1609131600,1609131600,1
WhiteWashedWeeaboo,0,1,0,7,1562472000,1562472000,1
throwglu,0,1,0,3,1599796800,1599796800,1
TommyShortSleeves,0,1,0,3,1588737600,1588737600,1
ForThatNotSoSmartSub,0,1,0,4,1599019200,1599019200,1
tioteo666,0,1,0,8,1604811600,1604811600,1
alex4291,0,1,0,115,1606885200,1606885200,1
oneandonlyjames,0,1,0,6,1578805200,1578805200,1
blair2006,0,1,0,1,1580619600,1580619600,1
jo_nat,0,1,0,1,1564286400,1564286400,1
jakepaul111,0,1,0,3,1603598400,1603598400,1
newyearlefty,0,1,0,3,1572408000,1572408000,1
DescipleOfCorn,0,1,0,2,1603598400,1603598400,1
Big-Bat-755,0,1,0,-2,1601179200,1601179200,1
legally_a_crumb,0,1,0,3,1603684800,1603684800,1
CoinTotemGolem,0,1,0,1,1573621200,1573621200,1
Sancho90,0,1,0,1,1598673600,1598673600,1
CircuitouslyEvil,0,1,0,3,1599105600,1599105600,1
Aprilham,0,1,0,14,1605589200,1605589200,1
Revka79,0,1,0,8,1611982800,1611982800,1
NYSThroughway,0,1,0,1,1571889600,1571889600,1
YaBoyVolke,0,1,0,1,1569124800,1569124800,1
mostlikelydepressed,0,1,0,2,1598587200,1598587200,1
BuddyThePup,0,1,0,-1,1552795200,1552795200,1
kkaaiibbaa,0,1,0,2,1606539600,1606539600,1
BetterOldNeon,0,1,0,11,1605243600,1605243600,1
ZombieInACage,0,1,0,3,1600142400,1600142400,1
Firmsocks,0,1,0,11,1606107600,1606107600,1
Glittering-Relief185,0,1,0,1,1637211600,1637211600,1
gimmealldagiggles22,0,1,0,2,1606971600,1606971600,1
Billiruben,0,1,0,1,1606021200,1606021200,1
BlerStar95,0,1,0,1,1603512000,1603512000,1
SECsuckondeez,0,1,0,2,1598846400,1598846400,1
Overlord_Goddard,0,1,0,10,1576386000,1576386000,1
babyslothbouquet,0,1,0,3,1609131600,1609131600,1
rocket2119,1,0,23,0,1575867600,1575867600,1
MJZMan,0,1,0,1,1608008400,1608008400,1
Polish_Frisbee97,0,1,0,1,1605589200,1605589200,1
Fishknocker678,0,1,0,20,1605589200,1605589200,1
blerk51167,0,1,0,3,1605934800,1605934800,1
slotwuato,1,0,125,0,1609131600,1609131600,1
CoAoW,0,1,0,74,1559275200,1559275200,1
profound15x18,0,1,0,8,1608699600,1608699600,1
GodFuckMyLife,0,1,0,-4,1607576400,1607576400,1
lorddrezz,0,1,0,1,1605157200,1605157200,1
br1ck_l4dy,0,1,0,18,1608094800,1608094800,1
penfist,0,1,0,-2,1606021200,1606021200,1
worseusernameever,0,1,0,5,1588219200,1588219200,1
Landocomando67,0,1,0,-2,1608613200,1608613200,1
itsyaboyObama,0,1,0,7,1608526800,1608526800,1
CremeGoodness,0,1,0,-22,1602820800,1602820800,1
93911939,0,1,0,1,1579323600,1579323600,1
Conway2709,1,0,187,0,1606539600,1606539600,1
JJDude,0,1,0,1,1605589200,1605589200,1
herpherpaderpderp93,0,1,0,2,1603512000,1603512000,1
Isla_Nooblar,0,1,0,3,1605157200,1605157200,1
ZombifiedByCataclysm,0,1,0,2,1608354000,1608354000,1
lewnr321,0,1,0,10,1556251200,1556251200,1
Prudent_School_8929,0,1,0,2,1603080000,1603080000,1
mtn_moto_adv,0,1,0,15,1611982800,1611982800,1
theboobfondler,0,1,0,2,1603425600,1603425600,1
Jax_77,0,1,0,1,1608786000,1608786000,1
cringelien,0,1,0,7,1562040000,1562040000,1
PrettyBoyOGHI,0,1,0,14,1582606800,1582606800,1
bxcr152,0,1,0,2,1607662800,1607662800,1
elysyred,0,1,0,1,1606885200,1606885200,1
TheReal-Donut,0,1,0,1,1570075200,1570075200,1
dropkick4855,0,1,0,1,1593144000,1593144000,1
AcornJim,0,1,0,-3,1608354000,1608354000,1
thrazefister,0,1,0,2,1598673600,1598673600,1
bz0hdp,0,1,0,16,1561780800,1561780800,1
mydogeatsmyshoes,0,1,0,1,1588996800,1588996800,1
strathmeyer,0,1,0,1,1550293200,1550293200,1
schroedingerskoala,0,1,0,79,1604030400,1604030400,1
ashareah,1,0,295,0,1594094400,1594094400,1
RHAMAHLI,0,1,0,1,1591243200,1591243200,1
moe_sizlacks_nuts,0,1,0,2,1601352000,1601352000,1
CrustaceanCreation,0,1,0,2,1598760000,1598760000,1
ouijahead,0,1,0,2,1569297600,1569297600,1
kittykrunk,0,1,0,1,1582779600,1582779600,1
poweroflamp,0,1,0,2,1530676800,1530676800,1
LCDRformat,0,1,0,1,1606280400,1606280400,1
_Synthetic_Emotions_,0,1,0,1,1606194000,1606194000,1
Nazi_Punks_FUCKOFF,1,0,58,0,1598328000,1598328000,1
SausMastrJah,0,1,0,4,1595908800,1595908800,1
hueydeweyandlouis,0,1,0,2,1598155200,1598155200,1
iCanCatch88,0,1,0,2,1578546000,1578546000,1
RiosRiot,0,1,0,2,1603512000,1603512000,1
vanillatoo,0,1,0,1,1612155600,1612155600,1
Silentmooses,0,1,0,2,1603598400,1603598400,1
Fizzy_Bits,0,1,0,18,1583643600,1583643600,1
gatorNic,0,1,0,-1,1596340800,1596340800,1
TnL17,0,1,0,-1,1605589200,1605589200,1
doesanyonehaveweed,0,1,0,2,1581224400,1581224400,1
BennettF,0,1,0,6,1592798400,1592798400,1
expandingeveryday,0,1,0,1,1603512000,1603512000,1
JudgeHolden-,0,1,0,17,1605502800,1605502800,1
Isaibnmaryam,0,1,0,34,1600920000,1600920000,1
FuckWhatUveHeard,0,1,0,6,1593662400,1593662400,1
ElvenCouncil,0,1,0,4,1572753600,1572753600,1
Illegal_alien4,0,1,0,1,1599537600,1599537600,1
GromflomiteAssassin,0,1,0,16,1598673600,1598673600,1
Netdogca63,0,1,0,1,1579928400,1579928400,1
nautilator44,0,1,0,86,1584676800,1584676800,1
nova-bootstrap,0,1,0,0,1592971200,1592971200,1
AbsoluteMalcontent,0,1,0,1,1572930000,1572930000,1
alx_cosi6,0,1,0,16,1590897600,1590897600,1
Mountain-Repair-266,0,1,0,1,1608267600,1608267600,1
Bozhark,0,1,0,1,1590120000,1590120000,1
OfficerComrade,0,1,0,1,1601956800,1601956800,1
ElleYeah,0,1,0,9,1592107200,1592107200,1
brelice,0,1,0,2,1597636800,1597636800,1
coffeequeen1738,0,1,0,2,1611810000,1611810000,1
ldifoelrbuc8kdoegyxu,0,1,0,1,1601438400,1601438400,1
vasiliy_the_cat,0,1,0,1,1608267600,1608267600,1
NealKenneth,0,1,0,-1,1580101200,1580101200,1
AlBramo,0,1,0,1,1600660800,1600660800,1
postulio,0,1,0,0,1577422800,1577422800,1
Kretek_Kreddit,0,1,0,5,1581138000,1581138000,1
sceptic_tank,0,1,0,7,1581310800,1581310800,1
Dukakis2020,0,1,0,0,1598846400,1598846400,1
melgibson666,0,1,0,-7,1584244800,1584244800,1
GreatMight,0,1,0,1,1598414400,1598414400,1
pktkp,0,1,0,-8,1585454400,1585454400,1
mj5150,0,1,0,1,1578373200,1578373200,1
Umbrage_Taken,0,1,0,0,1607835600,1607835600,1
bokebiy,0,1,0,5,1604030400,1604030400,1
ThatHeinousAnus,0,1,0,11,1607749200,1607749200,1
Denaros,0,1,0,5,1539921600,1539921600,1
webeperry,0,1,0,1,1598760000,1598760000,1
izreeaal,0,1,0,1,1599796800,1599796800,1
Asullenriot,0,1,0,3,1564286400,1564286400,1
Dorkykong2,0,1,0,30,1572667200,1572667200,1
Doctor_Expendable,0,1,0,2,1595649600,1595649600,1
magicworld710,0,1,0,7,1598673600,1598673600,1
TempestLock,0,1,0,1,1597204800,1597204800,1
98gremlin,0,1,0,1,1612069200,1612069200,1
hisurfing,0,1,0,1,1579150800,1579150800,1
tykusstarcraft,0,1,0,3,1602820800,1602820800,1
Scared-Attorney-8087,0,1,0,-15,1608872400,1608872400,1
SurfinSocks,0,1,0,2,1575176400,1575176400,1
tommy1010,0,1,0,1,1583985600,1583985600,1
Shishananee,0,1,0,3,1572930000,1572930000,1
Obliterature,0,1,0,13,1590465600,1590465600,1
hol-lia,0,1,0,2,1594008000,1594008000,1
thereitisthereitwent,0,1,0,1,1590552000,1590552000,1
Arius_the_Dude,1,0,9,0,1573966800,1573966800,1
JamKelsey,0,1,0,0,1560916800,1560916800,1
depbego,0,1,0,8,1584676800,1584676800,1
xmasindec,0,1,0,65,1607835600,1607835600,1
supremenastydogg,0,1,0,1,1604984400,1604984400,1
zzGravity,0,1,0,-7,1584244800,1584244800,1
tonycandance,0,1,0,3,1605589200,1605589200,1
NoCallToGetSnippy,0,1,0,23,1573275600,1573275600,1
justinbdavis2002,0,1,0,1,1582779600,1582779600,1
Luke_Nukem_2D,0,1,0,0,1585454400,1585454400,1
Tsevyn,0,1,0,2,1545022800,1545022800,1
War_Daddy_Zangief,0,1,0,32,1604379600,1604379600,1
gousey,0,1,0,1,1558843200,1558843200,1
hAWsuueh,0,1,0,31,1597464000,1597464000,1
theloftytransient,1,0,26,0,1537934400,1537934400,1
chacismom,1,0,27,0,1583899200,1583899200,1
coffee_mage,0,1,0,1,1606626000,1606626000,1
FabFabFabio,0,1,0,0,1607490000,1607490000,1
owhisback,0,1,0,5,1576558800,1576558800,1
assi9001,0,1,0,16,1576645200,1576645200,1
doo-doo-directum,0,1,0,5,1585800000,1585800000,1
outofthebox2021,0,1,0,1,1613019600,1613019600,1
Squirxicaljelly,0,1,0,-19,1597550400,1597550400,1
bigfootsbro,0,1,0,1,1574226000,1574226000,1
Jabbas_lackey,0,1,0,7,1576645200,1576645200,1
coinuser,0,1,0,2,1600574400,1600574400,1
MrAl290,0,1,0,19,1605070800,1605070800,1
helenaclover,0,1,0,2,1582261200,1582261200,1
ChemicalBags1,0,1,0,8,1608786000,1608786000,1
Freshyfreshfresh,0,1,0,2,1545022800,1545022800,1
BrowntownStreak,0,1,0,2,1587009600,1587009600,1
BetaAthe,0,1,0,35,1605070800,1605070800,1
_goflyakite_,0,1,0,-5,1586491200,1586491200,1
masterflappie,0,1,0,-3,1565323200,1565323200,1
bogeuh,0,1,0,1,1599710400,1599710400,1
ineverremember1234,0,1,0,2,1608613200,1608613200,1
YouandWhoseArmy,0,1,0,3,1603512000,1603512000,1
ghazghoul,0,1,0,8,1582952400,1582952400,1
BPbeats,0,1,0,1,1598155200,1598155200,1
Saggre,0,1,0,0,1584504000,1584504000,1
theShinsfan710,0,1,0,5,1564545600,1564545600,1
CamelSpyder,0,1,0,2,1562904000,1562904000,1
deez_nuts_ha_gotem,0,1,0,1,1581570000,1581570000,1
banspoonguard,0,1,0,9,1601611200,1601611200,1
sir_thottomous,0,1,0,1,1608699600,1608699600,1
kaiomi,0,1,0,102,1607403600,1607403600,1
WannabeTechieNinja,0,1,0,38,1598760000,1598760000,1
Sandwich-Fun,0,1,0,5,1605416400,1605416400,1
hownot2getajob,0,1,0,1,1600142400,1600142400,1
DeKlaasVaag,0,1,0,2,1609045200,1609045200,1
HotF22InUrArea,0,1,0,2,1576645200,1576645200,1
shreddyk,0,1,0,4,1587355200,1587355200,1
quezalcoatl,0,1,0,1,1581570000,1581570000,1
AncientProgrammer,0,1,0,1,1589947200,1589947200,1
DrFabulous0,0,1,0,20,1604466000,1604466000,1
Bobby_Bobb3rson,0,1,0,1,1586491200,1586491200,1
Antares777,0,1,0,5,1596859200,1596859200,1
47981247,0,1,0,1,1605589200,1605589200,1
IDontknowydontudoone,0,1,0,1,1608958800,1608958800,1
WinPeaks,0,1,0,10,1572148800,1572148800,1
I_Raise_You,0,1,0,1,1585454400,1585454400,1
SpaceCavem4n,0,1,0,2,1581224400,1581224400,1
bethdunne95,0,1,0,14,1593316800,1593316800,1
XxtinykrakenxX,1,0,2,0,1583298000,1583298000,1
crazydragon89,0,1,0,9,1596427200,1596427200,1
Grimley_PNW,0,1,0,5,1587960000,1587960000,1
SweepsAndBeeps,0,1,0,3,1592625600,1592625600,1
ShowNoREDDIT,0,1,0,3,1588132800,1588132800,1
Here_we_go_again187,0,1,0,1,1611982800,1611982800,1
market_confit,0,1,0,0,1593662400,1593662400,1
Mamita14,0,1,0,1,1591761600,1591761600,1
1mtw0w3ak,0,1,0,-5,1559188800,1559188800,1
Mountain_Fever,0,1,0,2,1550293200,1550293200,1
HeckinNegra,0,1,0,1,1583643600,1583643600,1
ChloeKarfuckian,0,1,0,1,1608354000,1608354000,1
ArginatorBongo,0,1,0,3,1600315200,1600315200,1
KuijperBelt,0,1,0,2,1611637200,1611637200,1
SheepyDX,0,1,0,1,1591329600,1591329600,1
ScuffMcGruff,0,1,0,11,1569816000,1569816000,1
handsomefutch,1,0,13,0,1575090000,1575090000,1
throwawaywork186,0,1,0,7,1568692800,1568692800,1
tigerdrummer,0,1,0,1,1562731200,1562731200,1
dinosaurOG,0,1,0,12,1602302400,1602302400,1
fnadde42,0,1,0,2,1598500800,1598500800,1
HerrHerrmannMann,0,1,0,96,1602043200,1602043200,1
Worthitmoment,0,1,0,2,1594958400,1594958400,1
SquishyPeanutbutter,0,1,0,6,1605416400,1605416400,1
DailyDrivesaDragon,0,1,0,2,1605330000,1605330000,1
loegare,0,1,0,5,1609304400,1609304400,1
chinaisasshole,0,1,0,2,1605934800,1605934800,1
youngkookwojcik84,0,1,0,8,1605762000,1605762000,1
Nuclearsquirrel,1,0,30,0,1562212800,1562212800,1
sumdufuch,1,0,120,0,1605589200,1605589200,1
ChevalBlancBukowski,0,1,0,-26,1563854400,1563854400,1
sooperdooper28,0,1,0,1,1603512000,1603512000,1
liampjames95,0,1,0,0,1601265600,1601265600,1
wibblywobbly420,0,1,0,1,1585454400,1585454400,1
RealityLivesNow,0,1,0,6,1570939200,1570939200,1
vea_ariam,0,1,0,85,1551589200,1551589200,1
spundred,0,1,0,0,1611982800,1611982800,1
storm1412,0,1,0,8,1598328000,1598328000,1
bigHossdaddy69,0,1,0,1,1591329600,1591329600,1
krudam,0,1,0,9,1611896400,1611896400,1
phongku,0,1,0,1,1582088400,1582088400,1
kloppie,0,1,0,6,1564632000,1564632000,1
CoolGuyClubMemberNo2,0,1,0,4,1597032000,1597032000,1
urwaryeyes,0,1,0,2,1569384000,1569384000,1
chewyfruitsx,0,1,0,15,1600920000,1600920000,1
Smerphy,0,1,0,10,1605934800,1605934800,1
Flipachair,0,1,0,2,1605589200,1605589200,1
topsyturvy76,0,1,0,1,1606539600,1606539600,1
chainercygnus,0,1,0,3,1572843600,1572843600,1
Hooded_Lizard,0,1,0,1,1591156800,1591156800,1
Moisturized_Bum,0,1,0,1,1605243600,1605243600,1
storiesti,0,1,0,3,1605157200,1605157200,1
wheresmyglasses12,0,1,0,3,1601611200,1601611200,1
ruskieb0t8472,0,1,0,3,1605502800,1605502800,1
sharkattack85,0,1,0,16,1609045200,1609045200,1
Types__with__penis,0,1,0,0,1580014800,1580014800,1
Big_Manta,0,1,0,3,1592452800,1592452800,1
mummia1173,1,0,20,0,1604725200,1604725200,1
Aybarand,0,1,0,-8,1607317200,1607317200,1
fastwolf5,0,1,0,4,1581829200,1581829200,1
nuttydude41,0,1,0,3,1606712400,1606712400,1
jerikofeng,0,1,0,7,1604898000,1604898000,1
votemarshall,0,1,0,6,1612069200,1612069200,1
Sp00ked123,0,1,0,0,1600660800,1600660800,1
Yoghertz,0,1,0,1,1571198400,1571198400,1
MLXIII,0,1,0,19,1593921600,1593921600,1
Mr-Delightful,0,1,0,6,1584072000,1584072000,1
ellzray,0,1,0,2,1569384000,1569384000,1
Toofast4yall,0,1,0,1,1591156800,1591156800,1
PoisonedBear,0,1,0,3,1597204800,1597204800,1
indomienator,0,1,0,1,1610773200,1610773200,1
FortuitousFenian,0,1,0,14,1570420800,1570420800,1
littlepanda44,0,1,0,1,1572321600,1572321600,1
FortunePaw,0,1,0,89,1603512000,1603512000,1
91100Tex,0,1,0,3,1539921600,1539921600,1
gatanegra,0,1,0,9,1595908800,1595908800,1
gardengnomebecca,1,0,12,0,1584158400,1584158400,1
Elgin_McQueen,0,1,0,3,1605589200,1605589200,1
throwawaycollegeacco,0,1,0,1,1604203200,1604203200,1
imSp00kd,0,1,0,1,1588046400,1588046400,1
olskoolsmrtass,0,1,0,1,1555300800,1555300800,1
purplelegs,0,1,0,3,1572753600,1572753600,1
terr-rawr-saur,0,1,0,1,1560657600,1560657600,1
soyuz_93,0,1,0,39,1573707600,1573707600,1
Sarah1990ger,1,0,0,0,1599451200,1599451200,1
nynelivez,0,1,0,3,1563249600,1563249600,1
Rabalaz,1,0,346,0,1607576400,1607576400,1
no-pandas,0,1,0,3,1580446800,1580446800,1
DJ_PLATNUM,0,1,0,2,1608267600,1608267600,1
Oversett-u-homofil,1,0,0,0,1607922000,1607922000,1
MattDelVideos,0,1,0,1,1585454400,1585454400,1
tinyhillsky,0,1,0,1,1573102800,1573102800,1
atomek_xxi,0,1,0,9,1608613200,1608613200,1
TheBiffBiff,0,1,0,1,1596859200,1596859200,1
Joffreys_Greasy_Cunt,0,1,0,1,1603857600,1603857600,1
TheWishPretzel,1,0,1188,0,1592020800,1592020800,1
Dwallace_The_Lawless,0,1,0,2,1583211600,1583211600,1
Boon_Backwards,0,1,0,3,1558238400,1558238400,1
Sliderisk,1,0,86,0,1608613200,1608613200,1
SaucyMeatMan,0,1,0,0,1602820800,1602820800,1
snazzarool,0,1,0,4,1582952400,1582952400,1
The-Pixel-Phantom,0,1,0,13,1567137600,1567137600,1
HowToUseStairs,0,1,0,4,1584417600,1584417600,1
echeverianne,0,1,0,540,1577163600,1577163600,1
vegaling,0,1,0,5,1574312400,1574312400,1
perpetuatinstupidity,0,1,0,1,1606626000,1606626000,1
bunnytrox,0,1,0,10,1594008000,1594008000,1
uzikaduzi,0,1,0,1,1575435600,1575435600,1
ebetemelege,0,1,0,5,1603080000,1603080000,1
natolele,0,1,0,3,1587614400,1587614400,1
Luire-Cendrillon,0,1,0,1,1603512000,1603512000,1
swaggon,0,1,0,4,1606021200,1606021200,1
OlriK15,0,1,0,1,1602043200,1602043200,1
NagsUkulele,0,1,0,1,1606021200,1606021200,1
Draxonn,0,1,0,13,1604898000,1604898000,1
ihavechestpains,0,1,0,2,1589774400,1589774400,1
glowup1511,0,1,0,1,1617595200,1617595200,1
drk311,1,0,201,0,1607490000,1607490000,1
serafel,0,1,0,11,1607922000,1607922000,1
spunkychickpea,0,1,0,1,1560398400,1560398400,1
puccafab,0,1,0,1,1570766400,1570766400,1
ObstreperousCanadian,0,1,0,1,1549861200,1549861200,1
Trentski33,0,1,0,1,1597118400,1597118400,1
kaZeeleKs,0,1,0,20,1604030400,1604030400,1
yogaandpickles,1,0,3,0,1566187200,1566187200,1
Alasdaire,0,1,0,17,1589256000,1589256000,1
Monkey_Priest,0,1,0,12,1572494400,1572494400,1
beardstachioso,0,1,0,2,1603512000,1603512000,1
hslsbsll,0,1,0,1,1618372800,1618372800,1
coolbmc,0,1,0,39,1598673600,1598673600,1
eggylemonade,1,0,337,0,1595736000,1595736000,1
ManLeader,0,1,0,3,1589947200,1589947200,1
homivorous,1,0,13,0,1542776400,1542776400,1
dfsgsgsfdsd,0,1,0,11,1606798800,1606798800,1
Aggressive_Bunch_733,1,0,15,0,1607662800,1607662800,1
GlobalVV,0,1,0,1,1606280400,1606280400,1
Grouchy-Resolution-6,0,1,0,2,1610686800,1610686800,1
Rockthemountain,0,1,0,24,1605589200,1605589200,1
carguy84,0,1,0,64,1605502800,1605502800,1
DoctorWhisky,0,1,0,1,1605589200,1605589200,1
LimoneSkye,0,1,0,-2,1559534400,1559534400,1
Stripe4206,0,1,0,18,1592366400,1592366400,1
SurfRod57,0,1,0,9,1578200400,1578200400,1
EpochCookie,0,1,0,1,1585454400,1585454400,1
DapirateTroll,0,1,0,3,1603512000,1603512000,1
ericaelizabeth86,0,1,0,2,1584158400,1584158400,1
MithranArkanere,0,1,0,3,1589083200,1589083200,1
BroccoliSerious6356,0,1,0,1,1609045200,1609045200,1
ChibiNinja0,0,1,0,6,1574053200,1574053200,1
mega345,0,1,0,1,1603512000,1603512000,1
Tripoteur,0,1,0,5,1582174800,1582174800,1
TrademarkedLobster,0,1,0,41,1597896000,1597896000,1
Byzantine04,0,1,0,4,1561694400,1561694400,1
Creole1962,0,1,0,4,1565668800,1565668800,1
cremvursti,0,1,0,5,1571889600,1571889600,1
Johnufucker,0,1,0,-1,1603425600,1603425600,1
Red_Black_Flag,0,1,0,21,1591329600,1591329600,1
karl_hungas,0,1,0,1,1605934800,1605934800,1
AcephalicDude,0,1,0,16,1566964800,1566964800,1
Specter1125,0,1,0,1,1605416400,1605416400,1
awesomeness0232,0,1,0,1,1602129600,1602129600,1
GloomyEra666,0,1,0,1,1611810000,1611810000,1
iavoidhumancontact,0,1,0,3,1611982800,1611982800,1
hampa9,0,1,0,1,1595736000,1595736000,1
_yellowlights,0,1,0,5,1593921600,1593921600,1
eBanNut,0,1,0,0,1608267600,1608267600,1
Lucasaurusawesome,0,1,0,13,1567569600,1567569600,1
megasupreme,0,1,0,2,1574139600,1574139600,1
tolurkistolearn,0,1,0,3,1584158400,1584158400,1
ResIpsaBroquitur,0,1,0,8,1573362000,1573362000,1
Gratefuldaze23,0,1,0,36,1607835600,1607835600,1
bobbit_gottit,0,1,0,1,1594267200,1594267200,1
REDGuineaPig,0,1,0,3,1612155600,1612155600,1
jomb,0,1,0,7,1580706000,1580706000,1
glittering_psycho,0,1,0,1,1581138000,1581138000,1
Canned-poon,0,1,0,1,1599105600,1599105600,1
IdfightGahndi,0,1,0,-2,1586232000,1586232000,1
Have_you_seen_my_cat,0,1,0,2,1603598400,1603598400,1
mamasteakmilk,0,1,0,4,1608267600,1608267600,1
FelinaVonDraco,0,1,0,3,1592280000,1592280000,1
YeahsureProbably,0,1,0,2,1577336400,1577336400,1
ambsdorf825,0,1,0,3,1582779600,1582779600,1
livingfortheliquid,0,1,0,1,1591329600,1591329600,1
lorenzo-i,0,1,0,17,1578027600,1578027600,1
weezer953,0,1,0,5,1603512000,1603512000,1
Reulorics,0,1,0,1,1606539600,1606539600,1
Burpalot,0,1,0,3,1589256000,1589256000,1
hcgjbrsbjgvjiyffegjg,0,1,0,2,1608094800,1608094800,1
lloyd096,0,1,0,7,1598241600,1598241600,1
SingleMaltShooter,0,1,0,-1,1594094400,1594094400,1
Ender1337otron,0,1,0,1,1578027600,1578027600,1
ag425,0,1,0,31,1553313600,1553313600,1
EquivalentCoyote,0,1,0,3,1578978000,1578978000,1
EtherealSpirit,0,1,0,1,1608872400,1608872400,1
Thrillog,0,1,0,2,1581397200,1581397200,1
Davriel_,0,1,0,-1,1595304000,1595304000,1
OVERLORDMAXIMUS,0,1,0,4,1602129600,1602129600,1
freshone89,0,1,0,9,1579755600,1579755600,1
Venific,1,0,3,0,1572843600,1572843600,1
Glum_Adhesiveness131,0,1,0,2,1599364800,1599364800,1
batesman23,0,1,0,14,1603512000,1603512000,1
IndustrialDesignLife,0,1,0,3,1605934800,1605934800,1
GanNing220,0,1,0,1,1600315200,1600315200,1
I_am_not_a_murderer,0,1,0,1,1589169600,1589169600,1
brnlng,0,1,0,1,1429848000,1429848000,1
CountAardvark,0,1,0,1,1585454400,1585454400,1
beep_beeeeep,0,1,0,3,1604379600,1604379600,1
beergaggles,0,1,0,4,1609218000,1609218000,1
sidgallegos,0,1,0,1,1605589200,1605589200,1
AdApprehensive9997,0,1,0,3,1591416000,1591416000,1
anthroarcha,0,1,0,2,1609390800,1609390800,1
hippopotomonstro_etc,0,1,0,2,1569297600,1569297600,1
LittleWords_please,0,1,0,0,1603512000,1603512000,1
Makrovich,0,1,0,3,1597982400,1597982400,1
Targonian_Darius,0,1,0,16,1566014400,1566014400,1
jmloia,0,1,0,1,1600920000,1600920000,1
thathifiguy,0,1,0,2,1603771200,1603771200,1
jpbronco,0,1,0,1,1604379600,1604379600,1
FabianTheElf,0,1,0,73,1608786000,1608786000,1
Sir_Boofington,0,1,0,1,1567051200,1567051200,1
therealstealthydan,0,1,0,1,1606366800,1606366800,1
mmmmmmmm28,0,1,0,1,1605589200,1605589200,1
hgeufj,0,1,0,1,1608699600,1608699600,1
Zshelley,0,1,0,3,1597550400,1597550400,1
FingerZaps,0,1,0,2,1590465600,1590465600,1
thetheshowshow,0,1,0,6,1589860800,1589860800,1
Aquamayne1,0,1,0,1,1598846400,1598846400,1
yelpisforsnitches,1,0,61,0,1572321600,1572321600,1
AmnesicAlieApe,0,1,0,9,1567569600,1567569600,1
Milk_moustache,0,1,0,7,1580706000,1580706000,1
Thermofluid,1,0,6,0,1606453200,1606453200,1
YourKingAnatoliy,0,1,0,14,1593748800,1593748800,1
Tech_Itch,0,1,0,23,1578373200,1578373200,1
nick_name_was_taken,0,1,0,1,1612069200,1612069200,1
Apprehensive_West140,0,1,0,1,1635048000,1635048000,1
bellabichon,0,1,0,-15,1547182800,1547182800,1
VIIIIRGINIA,0,1,0,3,1590379200,1590379200,1
SupermotoArchitect,0,1,0,4,1602302400,1602302400,1
shaze,0,1,0,10,1584072000,1584072000,1
karmablue83,1,0,29,0,1587096000,1587096000,1
maybeamarxist,0,1,0,11,1582952400,1582952400,1
littlestupidman,0,1,0,2,1597636800,1597636800,1
iccebberg2,0,1,0,1,1585800000,1585800000,1
violetcherryblue,0,1,0,6,1575867600,1575867600,1
Dornith,0,1,0,2,1605157200,1605157200,1
Lowflyinggsxr,0,1,0,3,1601352000,1601352000,1
badsparrow,0,1,0,7,1604379600,1604379600,1
overbayc123,0,1,0,2,1609390800,1609390800,1
Othon-Mann,0,1,0,1,1608699600,1608699600,1
sanseiryu,0,1,0,2,1587441600,1587441600,1
OrangeStudioLP,0,1,0,25,1577163600,1577163600,1
MessedUpLogic,0,1,0,2,1603252800,1603252800,1
gallooted,0,1,0,1,1608267600,1608267600,1
louloublueyes20,0,1,0,1,1594008000,1594008000,1
pablo1019,1,0,7,0,1602907200,1602907200,1
ncljdm,0,1,0,3,1591675200,1591675200,1
Yana_DelRey,0,1,0,3,1603512000,1603512000,1
pandarong,0,1,0,1,1603512000,1603512000,1
wlp3354,0,1,0,1,1612069200,1612069200,1
Archaeoculus,0,1,0,3,1602475200,1602475200,1
98smlc,0,1,0,1,1606626000,1606626000,1
AtomisteBX,0,1,0,2,1608354000,1608354000,1
m4c1p,0,1,0,37,1597636800,1597636800,1
JeffActual,0,1,0,2,1572062400,1572062400,1
Mr_Mr_Anderson,0,1,0,2,1576645200,1576645200,1
Zer0thehero89,0,1,0,7,1606194000,1606194000,1
Runescribe,0,1,0,11,1561694400,1561694400,1
deadlypants9338,0,1,0,-1,1582088400,1582088400,1
GooseFaceKilla97,0,1,0,1,1643173200,1643173200,1
patchnotespod,0,1,0,2,1611982800,1611982800,1
itsamanbearpig,0,1,0,24,1575349200,1575349200,1
jasonbrodyn,0,1,0,2,1592884800,1592884800,1
FoaRyan,0,1,0,2,1547614800,1547614800,1
alchoholics,1,0,8,0,1596254400,1596254400,1
ConservativeToilet,0,1,0,0,1585454400,1585454400,1
losingpens,0,1,0,1,1608699600,1608699600,1
HoochyCoochyMan,1,0,264,0,1587096000,1587096000,1
bassoonwoman,0,1,0,3,1589515200,1589515200,1
burgerkingsr,0,1,0,1,1603512000,1603512000,1
yusukekitagawafan,0,1,0,20,1599796800,1599796800,1
_ByteMeh,0,1,0,1,1590638400,1590638400,1
ProDiesel,0,1,0,2,1608267600,1608267600,1
bodyeclectric,0,1,0,5,1604811600,1604811600,1
charjolie95,1,0,316,0,1577941200,1577941200,1
acolyte_jin,0,1,0,1,1596168000,1596168000,1
ByeItsWaffles98,1,0,3,0,1606885200,1606885200,1
Ryuuka-chan,0,1,0,2,1611810000,1611810000,1
blue_mold,0,1,0,5,1513832400,1513832400,1
unnamed887,0,1,0,1,1582866000,1582866000,1
thefocus123,0,1,0,28,1577941200,1577941200,1
AxionEdge,1,0,10,0,1564113600,1564113600,1
asa_stal,0,1,0,10,1578718800,1578718800,1
hacktheself,0,1,0,17,1603512000,1603512000,1
sesso17,1,0,22,0,1584936000,1584936000,1
goonga0567,0,1,0,1,1608267600,1608267600,1
Biff_Whipster,0,1,0,12,1591243200,1591243200,1
machineheadg2r,0,1,0,2,1603512000,1603512000,1
somethingsecretuknow,0,1,0,1,1597982400,1597982400,1
wickedpixel,0,1,0,3,1573966800,1573966800,1
Left_Fist,1,0,67,0,1560052800,1560052800,1
QaMxxx,0,1,0,1,1602561600,1602561600,1
Pierrocana,0,1,0,5,1593230400,1593230400,1
Sipipthefiend,0,1,0,1,1597377600,1597377600,1
silkypanties22,1,0,19,0,1569902400,1569902400,1
Peter_Puppy,0,1,0,7,1558843200,1558843200,1
Gentlekill97,0,1,0,5,1594180800,1594180800,1
LastLeigh,0,1,0,3,1581224400,1581224400,1
SoyIsGoy,0,1,0,1,1579669200,1579669200,1
medalleaf-,0,1,0,9,1598760000,1598760000,1
Bongelato,0,1,0,6,1561089600,1561089600,1
Healthgothwannabe,0,1,0,7,1598414400,1598414400,1
spero313,0,1,0,1,1599969600,1599969600,1
jaemastercho,0,1,0,1,1585454400,1585454400,1
BackThatAffUp,0,1,0,2,1560139200,1560139200,1
ShonuffofCtown,0,1,0,1,1600747200,1600747200,1
magical_giraffe,0,1,0,4,1592366400,1592366400,1
jskurrt,0,1,0,9,1608094800,1608094800,1
TheAsianBarbarian,0,1,0,3,1578978000,1578978000,1
UnchainedGoku,1,0,141,0,1597550400,1597550400,1
gimmedatmeatball,0,1,0,3,1606021200,1606021200,1
universechild333,0,1,0,1,1612587600,1612587600,1
Rawveenmcqueen,0,1,0,2,1609477200,1609477200,1
ItsNeverLupusDumbass,0,1,0,5,1581483600,1581483600,1
ScenicHwyOverpass,0,1,0,8,1593144000,1593144000,1
AGiantPope,0,1,0,66,1603771200,1603771200,1
layschipsdude,0,1,0,1,1585454400,1585454400,1
Leoheroic92,0,1,0,7,1570680000,1570680000,1
hsoftl,0,1,0,2,1585454400,1585454400,1
matusz13,0,1,0,32,1584676800,1584676800,1
JohnnyFootballHero,0,1,0,0,1580878800,1580878800,1
oliviarrrgh,0,1,0,2,1607230800,1607230800,1
tlmx1035,0,1,0,3,1565582400,1565582400,1
likeupdogg,0,1,0,9,1607662800,1607662800,1
siver_the_duck,0,1,0,32,1575262800,1575262800,1
natethe5ththree,0,1,0,44,1588996800,1588996800,1
momochan1992,0,1,0,19,1603857600,1603857600,1
mittsquinter,0,1,0,19,1586491200,1586491200,1
Particular-Bar-1726,0,1,0,6,1611982800,1611982800,1
Epic_Weaselz,0,1,0,1,1575867600,1575867600,1
HandOnAStove,0,1,0,3,1562299200,1562299200,1
DanceEng,0,1,0,2,1605934800,1605934800,1
RumpyCustardo,0,1,0,2,1605070800,1605070800,1
MrMrAnderson,0,1,0,2,1604898000,1604898000,1
Fit_Scholar7303,0,1,0,1,1606021200,1606021200,1
Astroworm2020,0,1,0,1,1582347600,1582347600,1
lowstressfree,0,1,0,2,1552795200,1552795200,1
Gonzo5595,0,1,0,-15,1565582400,1565582400,1
Wikipedia_EarlyLife,0,1,0,-6,1580014800,1580014800,1
Viatuvitatu,0,1,0,1,1598155200,1598155200,1
RT858940,0,1,0,2,1608267600,1608267600,1
mileysighruss,0,1,0,1,1598155200,1598155200,1
JonRonJovi,0,1,0,2,1556337600,1556337600,1
Earthfury,0,1,0,1,1605934800,1605934800,1
M3zsu,0,1,0,1,1605502800,1605502800,1
TOKENCOMPANY,1,0,41,0,1605243600,1605243600,1
Spaceork3001,0,1,0,1,1594958400,1594958400,1
YouOnlyLiveTwice28,0,1,0,6,1571976000,1571976000,1
xxxMaximizerxxx,0,1,0,0,1608094800,1608094800,1
Bagreplayo,0,1,0,1,1608699600,1608699600,1
Plasticious,0,1,0,2,1605589200,1605589200,1
Winchester85,0,1,0,1,1582779600,1582779600,1
Clemens909,0,1,0,2,1554436800,1554436800,1
megahedda,0,1,0,98,1578891600,1578891600,1
5imo,0,1,0,7,1592971200,1592971200,1
notetaking83,0,1,0,1,1607922000,1607922000,1
dvsfish,0,1,0,5,1550293200,1550293200,1
HiImDoneWithBS,0,1,0,2,1608094800,1608094800,1
ChooseAndAct,0,1,0,1,1589169600,1589169600,1
SarahPalinisaMuslim,0,1,0,22,1605589200,1605589200,1
DiscoSprinkles,0,1,0,1,1605157200,1605157200,1
PhunkieDorez,0,1,0,-1,1606366800,1606366800,1
DaleGribble3,0,1,0,1,1604379600,1604379600,1
Yoichiyo,1,0,250,0,1599883200,1599883200,1
BasedStickguy,0,1,0,3,1552276800,1552276800,1
side-throw,0,1,0,13,1595563200,1595563200,1
Hopeful_Record_6571,0,1,0,1,1620878400,1620878400,1
WestTexasCrude,0,1,0,1,1585108800,1585108800,1
Visual-Philosopher80,0,1,0,5,1601611200,1601611200,1
zron13_85,0,1,0,1,1585454400,1585454400,1
simjanes2k,0,1,0,2,1608267600,1608267600,1
Onegreeneye,0,1,0,2,1592712000,1592712000,1
M1llenium,0,1,0,1,1597377600,1597377600,1
Cosmologicon,0,1,0,1,1584676800,1584676800,1
CynthiaChames,0,1,0,1,1552622400,1552622400,1
some_random_nonsense,0,1,0,2,1608267600,1608267600,1
DMmeyourpersonality,0,1,0,3,1605762000,1605762000,1
LordMalice86,0,1,0,1,1585108800,1585108800,1
fjarl1,0,1,0,1,1605070800,1605070800,1
moto-muscle,0,1,0,15,1604811600,1604811600,1
joeyh31,0,1,0,3,1578978000,1578978000,1
Draco546,0,1,0,15,1604552400,1604552400,1
confirmSuspicions,0,1,0,8,1611982800,1611982800,1
jackybeau,0,1,0,2,1606626000,1606626000,1
YamsInternational,0,1,0,1,1606626000,1606626000,1
eight40pm,0,1,0,14,1611810000,1611810000,1
Tuna_Salad_Sando,0,1,0,-7,1605762000,1605762000,1
SoraUsagi,0,1,0,1,1608872400,1608872400,1
PostAnythingForKarma,0,1,0,4,1600660800,1600660800,1
Data_shade,0,1,0,12,1605675600,1605675600,1
milhouse21386,0,1,0,3,1612069200,1612069200,1
marrisseys,0,1,0,13,1594872000,1594872000,1
rastascetic,0,1,0,0,1604379600,1604379600,1
Rancerino,0,1,0,-1,1593662400,1593662400,1
dulmal6,0,1,0,4,1600574400,1600574400,1
YuLyKeDiS,0,1,0,10,1599105600,1599105600,1
FanaticalExplorer,0,1,0,-2,1572062400,1572062400,1
Jswimmin,0,1,0,22,1567656000,1567656000,1
Zixxion,0,1,0,3,1611810000,1611810000,1
KalAl,0,1,0,72,1609304400,1609304400,1
MasonicGivingCircle,0,1,0,7,1609218000,1609218000,1
turtlemeateater,1,0,98,0,1605502800,1605502800,1
atm424,0,1,0,-1,1580101200,1580101200,1
career_whatcareer,0,1,0,20,1597982400,1597982400,1
renewedthinking,0,1,0,2,1603598400,1603598400,1
JustForBrowsing,0,1,0,88,1572753600,1572753600,1
nevernate,0,1,0,1,1581224400,1581224400,1
PaulBlart64,0,1,0,-3,1607662800,1607662800,1
Venusian-2,0,1,0,1,1603512000,1603512000,1
fuckyourandomcitizen,1,0,384,0,1602302400,1602302400,1
Korturas,0,1,0,1,1605502800,1605502800,1
nkryptid,0,1,0,16,1596686400,1596686400,1
WendellStampsX,0,1,0,1,1589860800,1589860800,1
throwaway1138,0,1,0,3,1603512000,1603512000,1
entropylaser,0,1,0,2,1587268800,1587268800,1
Festibowl,0,1,0,4,1605589200,1605589200,1
ocmfoa,0,1,0,1,1606626000,1606626000,1
CageShades,0,1,0,0,1604811600,1604811600,1
ISuckAtTri,0,1,0,1,1589601600,1589601600,1
coolman20012,0,1,0,44,1604811600,1604811600,1
SlimPuffs,0,1,0,14,1596513600,1596513600,1
obi_wan_kanerdy,0,1,0,3,1592193600,1592193600,1
Dragon-Kaimori,0,1,0,1,1572930000,1572930000,1
Where_is_Olivia,0,1,0,6,1593835200,1593835200,1
ImportantMatters,0,1,0,2,1600488000,1600488000,1
arsvitabrev,0,1,0,2,1536552000,1536552000,1
KHDTX13,1,0,37,0,1597291200,1597291200,1
domechromer,0,1,0,-12,1607317200,1607317200,1
iota1atg,0,1,0,1,1634702400,1634702400,1
c40r,0,1,0,15,1593403200,1593403200,1
majorminor999,0,1,0,11,1605157200,1605157200,1
hellogovna,0,1,0,5,1611896400,1611896400,1
DevaOni,0,1,0,1,1593316800,1593316800,1
_kathleen_,0,1,0,9,1577682000,1577682000,1
Duthos,0,1,0,7,1603857600,1603857600,1
MyOther_UN_is_Clever,0,1,0,17,1581397200,1581397200,1
BigDerry37,0,1,0,6,1579323600,1579323600,1
swissfrenchman,0,1,0,4,1598760000,1598760000,1
Iswaterreallywet,0,1,0,-1,1585454400,1585454400,1
Ni1vlac,0,1,0,2,1603684800,1603684800,1
AfterMeSluttyCharms,0,1,0,8,1582088400,1582088400,1
MoonSpankRaw,0,1,0,127,1581138000,1581138000,1
pick_me_apart,0,1,0,4,1576818000,1576818000,1
guitargold,0,1,0,6,1562817600,1562817600,1
HowdoIsayKvothe,0,1,0,1,1593230400,1593230400,1
carefootable,0,1,0,12,1572753600,1572753600,1
JayJay0169,0,1,0,6,1590638400,1590638400,1
Justthetipsenpai,0,1,0,3,1574053200,1574053200,1
YoureTryingToKillMe,1,0,14,0,1607058000,1607058000,1
urth2betsy,0,1,0,5,1595995200,1595995200,1
Alfred_K,1,0,2,0,1607490000,1607490000,1
FireKal,0,1,0,1,1573362000,1573362000,1
Biggs_Starboner,0,1,0,18,1563163200,1563163200,1
ForeverMaloneR698,0,1,0,2,1579064400,1579064400,1
AliceJust,1,0,34,0,1607835600,1607835600,1
drizzyDrake351,0,1,0,-1,1598414400,1598414400,1
ling-hing,0,1,0,-2,1605934800,1605934800,1
matt345op,0,1,0,1,1608958800,1608958800,1
CrypticSympathy,0,1,0,15,1575608400,1575608400,1
DrWardleberg27,0,1,0,1,1606021200,1606021200,1
SuperHeavyHydrogen,0,1,0,1,1605157200,1605157200,1
gives_free_rimjobs,0,1,0,46,1606798800,1606798800,1
evgfreyman,0,1,0,-1,1603339200,1603339200,1
kragor85,0,1,0,2,1572753600,1572753600,1
tutira_yeah_nah_kiwi,0,1,0,1,1600574400,1600574400,1
happilywritingaway,0,1,0,9,1607662800,1607662800,1
SiegeTower,1,0,4,0,1602648000,1602648000,1
ExpressGuarantee,0,1,0,5,1560484800,1560484800,1
Threshorfeed,0,1,0,6,1612069200,1612069200,1
4_Noted_Mystic_Tops,0,1,0,3,1539921600,1539921600,1
imgurRefugee85,0,1,0,8,1597636800,1597636800,1
SMOKIN-PORK,0,1,0,12,1601870400,1601870400,1
mountnagoya,0,1,0,11,1584676800,1584676800,1
a-streetcar-desire,0,1,0,10,1596600000,1596600000,1
JamesBigam,0,1,0,1,1605589200,1605589200,1
Boom-de-yada,0,1,0,2,1594094400,1594094400,1
ciaomoose,0,1,0,13,1592798400,1592798400,1
Aliceinsludge,0,1,0,5,1606539600,1606539600,1
SpiritualLimes,0,1,0,6,1595822400,1595822400,1
Grouchy_Noise_9428,0,1,0,2,1609131600,1609131600,1
osidius,0,1,0,2,1603512000,1603512000,1
Professorbranch,0,1,0,1,1605157200,1605157200,1
DublinSmoke,0,1,0,36,1566014400,1566014400,1
SirCSquared,0,1,0,14,1574312400,1574312400,1
OaSoaD,0,1,0,1,1608786000,1608786000,1
Outterwilds,0,1,0,1,1608440400,1608440400,1
AgroTeddy,0,1,0,7,1604030400,1604030400,1
isthisariotoracrisis,0,1,0,4,1578978000,1578978000,1
LakeHuronMonster,0,1,0,2,1608613200,1608613200,1
Deinodude,1,0,18,0,1551934800,1551934800,1
TomEd170,0,1,0,2,1606539600,1606539600,1
SunGobu,0,1,0,5,1584590400,1584590400,1
Sen7ryGun,0,1,0,3,1605589200,1605589200,1
Witchief,0,1,0,6,1612155600,1612155600,1
lolghurt,0,1,0,9,1612069200,1612069200,1
StoneyMedow,0,1,0,2,1603512000,1603512000,1
apfrun,0,1,0,8,1609131600,1609131600,1
PortableAunt,0,1,0,1,1608267600,1608267600,1
RiW-Kirby,0,1,0,3,1602648000,1602648000,1
LonnieMachin,0,1,0,2,1599019200,1599019200,1
FiIthy_Communist,0,1,0,3,1508990400,1508990400,1
RoombaKing,0,1,0,4,1606971600,1606971600,1
occams1razor,0,1,0,10,1598068800,1598068800,1
big_belly8,1,0,38,0,1611896400,1611896400,1
bornmayhem,0,1,0,1,1608958800,1608958800,1
CaveatLusor,1,0,5,0,1595217600,1595217600,1
RSmith892,0,1,0,1,1604898000,1604898000,1
ut-dom-throwaway,0,1,0,13,1608526800,1608526800,1
delphic0n,0,1,0,2,1599883200,1599883200,1
Manic1234567,0,1,0,2,1584763200,1584763200,1
PaleBoard,1,0,1,0,1597550400,1597550400,1
CoolJRT,0,1,0,1,1592020800,1592020800,1
younghaim,0,1,0,7,1563854400,1563854400,1
laineyone,0,1,0,3,1554782400,1554782400,1
Haktir,0,1,0,9,1603252800,1603252800,1
AllNewTypeFace,0,1,0,1,1569988800,1569988800,1
tiger666,0,1,0,3,1606539600,1606539600,1
VergeThySinus,0,1,0,18,1606626000,1606626000,1
PutsPlease,0,1,0,1,1585454400,1585454400,1
AnOrdinaryMammal,0,1,0,1,1591329600,1591329600,1
UbiquitouSparky,0,1,0,3,1603512000,1603512000,1
Garkano8,1,0,49,0,1606626000,1606626000,1
MalikTheScot,1,0,28,0,1561953600,1561953600,1
leothelnss,1,0,14,0,1587009600,1587009600,1
RowdyRoddiDiper,0,1,0,-2,1582779600,1582779600,1
breighvehart,0,1,0,1,1608267600,1608267600,1
darkenfire,0,1,0,6,1585454400,1585454400,1
Cell_Saga,0,1,0,2,1597982400,1597982400,1
Wh4rrgarbl,0,1,0,1,1604638800,1604638800,1
jank_king20,0,1,0,19,1560484800,1560484800,1
Joelball1,0,1,0,1,1599796800,1599796800,1
sephkarlo,0,1,0,1,1604116800,1604116800,1
Deceptichum,0,1,0,2,1598760000,1598760000,1
greatpeach,0,1,0,1,1618718400,1618718400,1
Reecopolis,0,1,0,2,1603598400,1603598400,1
EniarrolG,0,1,0,1,1596600000,1596600000,1
Roddoman,0,1,0,40,1561262400,1561262400,1
peachteatree,0,1,0,3,1577509200,1577509200,1
Wittler420_69,0,1,0,6,1607317200,1607317200,1
Frye_,0,1,0,2,1545973200,1545973200,1
etopio,0,1,0,5,1566705600,1566705600,1
AccurateScreen0,0,1,0,1,1588996800,1588996800,1
GuidanceShot1409,0,1,0,1,1605502800,1605502800,1
TheDominantSpecies,0,1,0,0,1609131600,1609131600,1
slippingparadox,1,0,7,0,1568260800,1568260800,1
Piperthefoxxx,0,1,0,7,1598500800,1598500800,1
SnickerH,1,0,3,0,1605243600,1605243600,1
thegreekfire,0,1,0,1,1588478400,1588478400,1
thecatgoesmoo,0,1,0,15,1605934800,1605934800,1
lin0sh0enganmei,0,1,0,3,1600488000,1600488000,1
e_liana,0,1,0,1,1598846400,1598846400,1
hautecouturecheetos,0,1,0,13,1550898000,1550898000,1
Nopyloku,0,1,0,24,1568520000,1568520000,1
thetmanrules,0,1,0,2,1591416000,1591416000,1
Holliemb7693,0,1,0,6,1575262800,1575262800,1
THE_JEWISH_MONK,0,1,0,3,1572753600,1572753600,1
mPixelPop,0,1,0,6,1573966800,1573966800,1
joshdmb41,0,1,0,1,1606539600,1606539600,1
theafonis,0,1,0,0,1598673600,1598673600,1
paulusmagintie,0,1,0,2,1603512000,1603512000,1
donotflushthat,0,1,0,14,1603425600,1603425600,1
Kipiftw,0,1,0,5,1582779600,1582779600,1
Jangsterish,0,1,0,6,1609304400,1609304400,1
Spokker,0,1,0,2,1591243200,1591243200,1
GriNcs,0,1,0,8,1571630400,1571630400,1
ElectricYV,0,1,0,1,1608526800,1608526800,1
Jomtung,0,1,0,11,1585454400,1585454400,1
BigSmashy,0,1,0,1,1605502800,1605502800,1
libertarianinchief,0,1,0,-3,1572667200,1572667200,1
Agggah,0,1,0,2,1605848400,1605848400,1
tszmarci,0,1,0,45,1575349200,1575349200,1
Cynicbats,0,1,0,4,1596600000,1596600000,1
Jealous_Watercress,0,1,0,18,1602734400,1602734400,1
ferrrretsultan,0,1,0,2,1593921600,1593921600,1
Ice_Limp,1,0,2050,0,1612155600,1612155600,1
nynikai,0,1,0,-1,1550293200,1550293200,1
Terminal-Psychosis,0,1,0,2,1603598400,1603598400,1
MAXIMUM_OVER_FART,0,1,0,1,1608786000,1608786000,1
yazie92,0,1,0,1,1578373200,1578373200,1
terminallyDormant,0,1,0,1,1575262800,1575262800,1
Tentaclarm,1,0,22,0,1579669200,1579669200,1
ThatHotGuyIRL,0,1,0,-4,1585454400,1585454400,1
joyosects,0,1,0,5,1573966800,1573966800,1
vio1et_revi1e,0,1,0,11,1611982800,1611982800,1
Crossfadefan69,0,1,0,8,1595995200,1595995200,1
cryptstew,0,1,0,2,1574139600,1574139600,1
spellingbotwithtumor,0,1,0,3,1538107200,1538107200,1
haina123,0,1,0,32,1588219200,1588219200,1
lostfourtime,0,1,0,1,1584158400,1584158400,1
alexx-gray,0,1,0,10,1576472400,1576472400,1
ThaNorth,0,1,0,5,1578373200,1578373200,1
blunt__nation,0,1,0,1,1604638800,1604638800,1
Rakshasa29,0,1,0,2,1600660800,1600660800,1
Boosty-McBoostFace,0,1,0,1,1560657600,1560657600,1
BigBootyRiver,0,1,0,26,1595131200,1595131200,1
BegReg2005,0,1,0,1,1605762000,1605762000,1
TAW_275,0,1,0,1,1588046400,1588046400,1
nothingbeast,0,1,0,3,1598673600,1598673600,1
Dr_Downvote_,0,1,0,12,1593835200,1593835200,1
djcallender,0,1,0,1,1576299600,1576299600,1
rlemur,0,1,0,1,1589860800,1589860800,1
last-resort-4-a-gf,0,1,0,1,1605157200,1605157200,1
MisterWoogie,0,1,0,4,1603598400,1603598400,1
AmbiguousSkull,0,1,0,1,1603512000,1603512000,1
MyBossSucks1999,0,1,0,12,1609131600,1609131600,1
FingersToKeyboard,0,1,0,3,1611982800,1611982800,1
szwabski_kurwik,0,1,0,1,1598846400,1598846400,1
shreeder335,0,1,0,1,1598760000,1598760000,1
peachdoxie,0,1,0,4,1606539600,1606539600,1
thesmasbole,0,1,0,0,1594008000,1594008000,1
mw145s,0,1,0,2,1582606800,1582606800,1
matildust,0,1,0,5,1597291200,1597291200,1
callmenuveena,0,1,0,9,1592107200,1592107200,1
water_and_pixels,0,1,0,3,1605070800,1605070800,1
moriartygotswag,0,1,0,3,1608008400,1608008400,1
RedPillAlphaBigCock,0,1,0,1,1601352000,1601352000,1
unlcejanks,0,1,0,1,1589947200,1589947200,1
animals-are-my-life,0,1,0,1,1603512000,1603512000,1
ConorYEAH,0,1,0,2,1593316800,1593316800,1
redxgk,0,1,0,1,1608008400,1608008400,1
dushamp,0,1,0,4,1565150400,1565150400,1
CrimsonNecrosis,0,1,0,2,1604811600,1604811600,1
TheTurboGay,0,1,0,2,1602734400,1602734400,1
nehuge,0,1,0,3,1583125200,1583125200,1
ElvaSylvie,0,1,0,4,1554264000,1554264000,1
Remote-Commercial,0,1,0,1,1581310800,1581310800,1
seraph582,0,1,0,2,1593316800,1593316800,1
sdsc17,0,1,0,2,1603512000,1603512000,1
mmmbacon999,0,1,0,1,1592193600,1592193600,1
ThisIsBirdDemic,0,1,0,5,1602216000,1602216000,1
bguglielmi88,0,1,0,1,1638162000,1638162000,1
alonabc,0,1,0,4,1569470400,1569470400,1
iptamenomwro,0,1,0,1,1569211200,1569211200,1
_Le_Chef_,1,0,11,0,1548738000,1548738000,1
Niall_DeNobis,0,1,0,7,1607144400,1607144400,1
Veryiety,0,1,0,11,1600747200,1600747200,1
sendappreciateit,0,1,0,8,1574830800,1574830800,1
pleio_neo,1,0,5327,0,1609218000,1609218000,1
Ironwood_Lover,0,1,0,3,1596772800,1596772800,1
LiutenantBaked,0,1,0,3,1573794000,1573794000,1
violetmonstermunch,0,1,0,1,1600488000,1600488000,1
saywhatnow117,0,1,0,3,1608440400,1608440400,1
yawya,0,1,0,3,1606626000,1606626000,1
lstanfo1509,0,1,0,1,1605589200,1605589200,1
Complaineee,0,1,0,3,1603512000,1603512000,1
Giveaway_Guy,0,1,0,1,1569643200,1569643200,1
beenygods,0,1,0,1,1591070400,1591070400,1
AMeierFussballgott,0,1,0,1,1591243200,1591243200,1
jwood13,0,1,0,1,1585195200,1585195200,1
chadwilkins,0,1,0,1,1540699200,1540699200,1
insipid_wisdom,0,1,0,10,1602129600,1602129600,1
senorgraves,0,1,0,1,1583125200,1583125200,1
captainsmacks,0,1,0,1,1539835200,1539835200,1
coffeegaze,0,1,0,-1,1570507200,1570507200,1
boab_129,0,1,0,2,1584763200,1584763200,1
rambleon4ever,0,1,0,2,1575781200,1575781200,1
thxforthefijiwater,0,1,0,2,1581742800,1581742800,1
pot8odragon,0,1,0,1,1589083200,1589083200,1
gambitgrl,0,1,0,40,1581138000,1581138000,1
lokken1234,0,1,0,-1,1589860800,1589860800,1
bunnyQatar,0,1,0,5,1589083200,1589083200,1
triceratopsMD,0,1,0,8,1611982800,1611982800,1
XnewXdiabolicX,0,1,0,1,1491883200,1491883200,1
makoivis,0,1,0,3,1580706000,1580706000,1
Cessdon,0,1,0,5,1584504000,1584504000,1
SwedzCubed,0,1,0,4,1573275600,1573275600,1
ASA0RedEye,0,1,0,1,1601524800,1601524800,1
OrwellianHell,0,1,0,3,1556683200,1556683200,1
tinspoons,0,1,0,1,1602734400,1602734400,1
Y0Universe,1,0,40,0,1578114000,1578114000,1
snugglypuppies,0,1,0,1,1574226000,1574226000,1
whatif2187,0,1,0,2,1588824000,1588824000,1
Eddie888,0,1,0,7,1584936000,1584936000,1
timmyhigt369,0,1,0,5,1577077200,1577077200,1
impinanotheraccount,0,1,0,1,1577509200,1577509200,1
NooDLe8989,0,1,0,4,1585195200,1585195200,1
Ronkerjake,0,1,0,4,1605243600,1605243600,1
HighOnLife,0,1,0,5,1551675600,1551675600,1
LongLimbsLenore,0,1,0,1,1580274000,1580274000,1
colinsan1,0,1,0,1,1604116800,1604116800,1
GALACTON,0,1,0,0,1568692800,1568692800,1
Volta001,0,1,0,2,1592107200,1592107200,1
Harmonious_Serenity,1,0,1015,0,1609131600,1609131600,1
Writer1202,0,1,0,0,1592280000,1592280000,1
underwear_dickholes,0,1,0,0,1602648000,1602648000,1
artsy897,0,1,0,1,1560571200,1560571200,1
khajiit_is_innocent_,0,1,0,4,1549256400,1549256400,1
Stratifyed,0,1,0,5,1585022400,1585022400,1
Atworkwasalreadytake,0,1,0,84,1605934800,1605934800,1
theoddsaretheodds,0,1,0,63,1579582800,1579582800,1
Ringthebellhefell,1,0,14,0,1596254400,1596254400,1
Gasster1212,0,1,0,6,1548478800,1548478800,1
FlighingHigh,0,1,0,1,1604466000,1604466000,1
AineofTheWoods,0,1,0,2,1599710400,1599710400,1
BadKarmaHo,0,1,0,-39,1592366400,1592366400,1
AlkanK,0,1,0,2,1597291200,1597291200,1
Fairydick123,0,1,0,1,1555214400,1555214400,1
rrd0084,0,1,0,3,1606366800,1606366800,1
DieNeuenWelt,0,1,0,1,1575608400,1575608400,1
Mr-Darkseid,0,1,0,23,1563249600,1563249600,1
rezevilfan,0,1,0,2,1603512000,1603512000,1
stan_le_panda,0,1,0,4,1588824000,1588824000,1
Somerfeeild,0,1,0,2,1606971600,1606971600,1
eatfuzzybacon,0,1,0,2,1599883200,1599883200,1
cloudbasedsardony,0,1,0,11,1593662400,1593662400,1
TangoJager,0,1,0,2,1594180800,1594180800,1
Paperthinpsyche,0,1,0,8,1601697600,1601697600,1
GayreTranquillo,0,1,0,5,1559275200,1559275200,1
aperez6077,0,1,0,35,1571544000,1571544000,1
dkrbst,0,1,0,1,1608786000,1608786000,1
Plip_Plip_,0,1,0,0,1599192000,1599192000,1
magmainourhearts,0,1,0,8,1601611200,1601611200,1
ironjaw3ds,0,1,0,1,1597982400,1597982400,1
georgemucussss,0,1,0,1,1594526400,1594526400,1
tyzbit,0,1,0,4,1605934800,1605934800,1
radsleepy_x,0,1,0,1,1552536000,1552536000,1
EpicVacuumCleaner,0,1,0,2,1566446400,1566446400,1
Los_Lewis,0,1,0,1,1607576400,1607576400,1
munchyw_ahammer,0,1,0,3,1603598400,1603598400,1
rereintarnation,0,1,0,7,1566360000,1566360000,1
Rando6734122,0,1,0,2,1603512000,1603512000,1
humansrthealiens,1,0,91,0,1579410000,1579410000,1
RandomNameB,0,1,0,0,1582174800,1582174800,1
xicolink25,0,1,0,23,1606107600,1606107600,1
LindaGale19,0,1,0,1,1605330000,1605330000,1
PixeLimes,0,1,0,2,1609477200,1609477200,1
JimRatte,0,1,0,1,1600228800,1600228800,1
stjep,0,1,0,3,1600660800,1600660800,1
zesty_hootenany,0,1,0,3,1603598400,1603598400,1
Killdreth,0,1,0,52,1582261200,1582261200,1
toopunkrawk,0,1,0,90,1608181200,1608181200,1
alias1126,0,1,0,0,1581656400,1581656400,1
Noahnoah55,0,1,0,20,1564027200,1564027200,1
RagingCanadians,0,1,0,0,1577682000,1577682000,1
makefastUS,1,0,1,0,1539921600,1539921600,1
ketopianfuture,0,1,0,9,1605675600,1605675600,1
Own-Salt-7471,1,0,14,0,1602820800,1602820800,1
Top__Tsun,1,0,113,0,1605330000,1605330000,1
Brendon3485,0,1,0,2,1603598400,1603598400,1
mtbguy1981,0,1,0,15,1584417600,1584417600,1
Benjamin701,0,1,0,1,1608008400,1608008400,1
deviantbono,0,1,0,-10,1592366400,1592366400,1
redditcrazy123,0,1,0,1,1605675600,1605675600,1
Cozy_Owee,0,1,0,70,1564372800,1564372800,1
jmaz2k1,0,1,0,13,1580274000,1580274000,1
Haltheleon,0,1,0,3,1587700800,1587700800,1
Triffleman,0,1,0,7,1594094400,1594094400,1
dankmernes,0,1,0,1,1600574400,1600574400,1
MarKeNet,1,0,1,0,1607317200,1607317200,1
bobsthebuilder129,0,1,0,-25,1594612800,1594612800,1
thesarl,0,1,0,2,1569470400,1569470400,1
KaisaLover123,0,1,0,1,1608354000,1608354000,1
Heftyuhffh,0,1,0,1,1585454400,1585454400,1
Slyder,0,1,0,-2,1585022400,1585022400,1
PM_ME_CRYPTOCURRENCY,0,1,0,0,1599019200,1599019200,1
billiam7787,0,1,0,1,1587614400,1587614400,1
kylefield22,0,1,0,9,1597896000,1597896000,1
brettoseph,0,1,0,7,1601438400,1601438400,1
slowpoke147,0,1,0,1,1576558800,1576558800,1
devoutdefeatist,0,1,0,5,1606971600,1606971600,1
lucajones88,0,1,0,38,1562040000,1562040000,1
melokobeai,0,1,0,0,1557374400,1557374400,1
BoxxyFoxxy,0,1,0,1,1560398400,1560398400,1
Sure-Lawyer,1,0,5,0,1582693200,1582693200,1
Real_Perd_Hapley,0,1,0,8,1573102800,1573102800,1
b333ppp,0,1,0,1,1603598400,1603598400,1
thenaughtiest1,0,1,0,5,1584072000,1584072000,1
aetheric-dreams,0,1,0,3,1611810000,1611810000,1
sainterosa92,0,1,0,3,1572148800,1572148800,1
locaprincesaa,0,1,0,62,1571976000,1571976000,1
ajh13,1,0,51,0,1606539600,1606539600,1
KimJongSkill492,0,1,0,5,1581224400,1581224400,1
Slothfulness69,0,1,0,2,1560225600,1560225600,1
PurpleSailor,0,1,0,11,1600660800,1600660800,1
NubiaAnu,0,1,0,2,1606107600,1606107600,1
Mr_Boggis,0,1,0,5,1585368000,1585368000,1
crypto_crab,0,1,0,1,1585108800,1585108800,1
DestressedLemon,1,0,9,0,1577941200,1577941200,1
wotiw,0,1,0,1,1600660800,1600660800,1
premierfeu,0,1,0,1,1600574400,1600574400,1
-EdgeLord-,0,1,0,9,1583726400,1583726400,1
Chris-Richardson,1,0,0,0,1579410000,1579410000,1
Irish_Samurai,0,1,0,2,1577682000,1577682000,1
littlemissluna7,0,1,0,8,1580878800,1580878800,1
FruitKnuist,1,0,69,0,1578286800,1578286800,1
dubiousandbi,0,1,0,1,1582606800,1582606800,1
Hellhole5,0,1,0,-1,1580101200,1580101200,1
BlakePayne,0,1,0,3,1573707600,1573707600,1
x80lbBludgersx,0,1,0,7,1564372800,1564372800,1
sexapus,0,1,0,5,1606107600,1606107600,1
fralackles,0,1,0,9,1608699600,1608699600,1
even_so,1,0,73,0,1557720000,1557720000,1
th3davinci,0,1,0,1,1606539600,1606539600,1
Brox42,0,1,0,12,1607490000,1607490000,1
Frutas_del_bosque,0,1,0,1,1606626000,1606626000,1
317RedPill,0,1,0,2,1608699600,1608699600,1
abowlofrice1,0,1,0,-2,1596772800,1596772800,1
chapstickbomber,0,1,0,91,1571112000,1571112000,1
Banesatis,0,1,0,1,1608267600,1608267600,1
Nohbudy,0,1,0,-1,1583470800,1583470800,1
jen_kelley,0,1,0,2,1582779600,1582779600,1
JurFony,0,1,0,1,1591243200,1591243200,1
Mr_Dumass40,0,1,0,3,1581397200,1581397200,1
nafnotenda,0,1,0,5,1607317200,1607317200,1
doppio01,0,1,0,2,1602043200,1602043200,1
theRealUser123,0,1,0,-1,1606626000,1606626000,1
Piggy_Farm,0,1,0,23,1562644800,1562644800,1
beckisnotmyname,0,1,0,18,1598414400,1598414400,1
bauertastic,0,1,0,1,1606021200,1606021200,1
TemporarySecretary99,0,1,0,21,1608008400,1608008400,1
bananicula,0,1,0,13,1606885200,1606885200,1
nowyourdoingit,0,1,0,-6,1594699200,1594699200,1
Cha_94,0,1,0,2,1597032000,1597032000,1
birannosaurus_rex,0,1,0,9,1555560000,1555560000,1
MaintenanceMikey,0,1,0,0,1592107200,1592107200,1
Walkrob14,0,1,0,2,1609390800,1609390800,1
DimeBagJoe,0,1,0,10,1605934800,1605934800,1
invisible_emoticon,0,1,0,1,1605330000,1605330000,1
SSR_Id_prefer_not_to,0,1,0,14,1611637200,1611637200,1
haircopter,0,1,0,2,1614142800,1614142800,1
chipfunks,0,1,0,2,1599451200,1599451200,1
Electronic_instance,0,1,0,9,1562558400,1562558400,1
Hawk978,0,1,0,1,1576818000,1576818000,1
dystopicvida,0,1,0,1,1608526800,1608526800,1
KeithFromAccounting,0,1,0,1,1611896400,1611896400,1
ASquared79,0,1,0,1,1603512000,1603512000,1
BlazeHeatnix83,0,1,0,3,1571371200,1571371200,1
lonely_dot,0,1,0,5,1562212800,1562212800,1
nuggetyboon,0,1,0,1,1611723600,1611723600,1
8an5,0,1,0,7,1608526800,1608526800,1
GeorgeClintonsLawyer,0,1,0,4,1597550400,1597550400,1
T-diddles,0,1,0,2,1598760000,1598760000,1
depressedalt33,0,1,0,6,1593489600,1593489600,1
tevez22,1,0,36,0,1598673600,1598673600,1
philosophical_nut,0,1,0,5,1591416000,1591416000,1
MagnetoManectric,0,1,0,1,1599451200,1599451200,1
fooz_eppelin,0,1,0,1,1573621200,1573621200,1
missylizzy,0,1,0,0,1592539200,1592539200,1
notkatemonster,0,1,0,1,1585627200,1585627200,1
mikeyrando2020,0,1,0,1,1605070800,1605070800,1
stormgirrafe,0,1,0,2,1604984400,1604984400,1
groundfairy,0,1,0,2,1593835200,1593835200,1
jussbrowcin,0,1,0,4,1608872400,1608872400,1
taxtt,1,0,31,0,1592020800,1592020800,1
Enes_24,0,1,0,1,1607576400,1607576400,1
hotpinkmp3,0,1,0,9,1599624000,1599624000,1
ChocolateRage,0,1,0,14,1608354000,1608354000,1
many-eyedwolf,0,1,0,2,1603771200,1603771200,1
nomad656,0,1,0,2,1605070800,1605070800,1
theepicguy03,1,0,2,0,1591243200,1591243200,1
throwagay1211,0,1,0,2,1570939200,1570939200,1
Shpagin,0,1,0,-13,1607403600,1607403600,1
SurfceDetail,0,1,0,17,1594440000,1594440000,1
arguser,0,1,0,3,1568260800,1568260800,1
thismustbetheplace23,0,1,0,16,1607317200,1607317200,1
marzagg,0,1,0,12,1607662800,1607662800,1
Seanrps,0,1,0,2,1600142400,1600142400,1
poptarts-are-ravioli,0,1,0,2,1591329600,1591329600,1
lucas4114,0,1,0,1,1592452800,1592452800,1
Smaidz,0,1,0,1,1599451200,1599451200,1
T_Babyboi,0,1,0,2,1603771200,1603771200,1
Charl3magne,0,1,0,3,1608094800,1608094800,1
STTCollector,0,1,0,1,1578459600,1578459600,1
ReallyObsessed,0,1,0,3,1608181200,1608181200,1
florix78,0,1,0,1,1613106000,1613106000,1
FireFromTonsOfLiars,0,1,0,1,1573621200,1573621200,1
garuraa,0,1,0,7,1571025600,1571025600,1
moduztolenz,0,1,0,5,1563163200,1563163200,1
Midknight81,0,1,0,-5,1608267600,1608267600,1
s0ciety_a5under,0,1,0,17,1605934800,1605934800,1
Singular-cat-lady,0,1,0,7,1605070800,1605070800,1
geforce789,0,1,0,1,1593144000,1593144000,1
NaruNerd100,0,1,0,2,1604552400,1604552400,1
arduous_raven,0,1,0,14,1609304400,1609304400,1
Phartingflowers,0,1,0,1,1604466000,1604466000,1
divergentperson,0,1,0,2,1602907200,1602907200,1
klaatuveratanecto,0,1,0,0,1601092800,1601092800,1
draco74403,0,1,0,4,1550379600,1550379600,1
huntervano,0,1,0,3,1571112000,1571112000,1
big_meats93,0,1,0,3,1592971200,1592971200,1
goblingirl22,0,1,0,45,1569384000,1569384000,1
taylormattbell,0,1,0,1,1606366800,1606366800,1
Wotcha-,0,1,0,4,1581570000,1581570000,1
ISmellLikeBlackTea,0,1,0,1,1602734400,1602734400,1
thefartofthemeal,0,1,0,-13,1608094800,1608094800,1
Rentun,0,1,0,2,1548133200,1548133200,1
YaxtaYeendu,0,1,0,1,1601524800,1601524800,1
JebidiahStJacques,1,0,0,0,1599537600,1599537600,1
Freefall84,0,1,0,0,1603598400,1603598400,1
Another_Road,0,1,0,2,1599624000,1599624000,1
Unknownuser_2001,0,1,0,3,1609131600,1609131600,1
charlestontime,0,1,0,5,1589601600,1589601600,1
andudetoo,0,1,0,14,1565064000,1565064000,1
username1685,0,1,0,4,1573448400,1573448400,1
opticalshadow,0,1,0,41,1600660800,1600660800,1
Pledge_CS,0,1,0,1,1572062400,1572062400,1
cest_nul,0,1,0,1,1591243200,1591243200,1
Nebulousy,0,1,0,7,1606280400,1606280400,1
laserdruckervk,0,1,0,1,1598760000,1598760000,1
SugondeseChild,0,1,0,13,1568865600,1568865600,1
PleasePMmeSteamKeys,0,1,0,122,1575781200,1575781200,1
rubbish_heap,0,1,0,1,1593403200,1593403200,1
AlteredSpaceMonkey,0,1,0,1,1584244800,1584244800,1
TotallyNotEko,0,1,0,2,1608699600,1608699600,1
runebell,0,1,0,15,1593576000,1593576000,1
Medium_Way,0,1,0,5,1585454400,1585454400,1
Zestyclose_Standard6,0,1,0,-2,1611810000,1611810000,1
Meih_Notyou,0,1,0,3,1603512000,1603512000,1
HauntedCS,0,1,0,1,1569470400,1569470400,1
FlatulentCentaur,0,1,0,2,1608613200,1608613200,1
Veerdavid,0,1,0,2,1595304000,1595304000,1
TossedSalad499,0,1,0,2,1611637200,1611637200,1
CBDenthusiastic,0,1,0,6,1603512000,1603512000,1
jayatil2,0,1,0,1,1611982800,1611982800,1
BobFromBeyond,0,1,0,2,1575003600,1575003600,1
unholy79,0,1,0,1,1603425600,1603425600,1
IrregularConfusion,0,1,0,1,1601265600,1601265600,1
Kryten_2X4B_523P,0,1,0,1,1608267600,1608267600,1
pixelvspixel,0,1,0,2,1581310800,1581310800,1
semajdvd,0,1,0,2,1575608400,1575608400,1
spideypark,0,1,0,11,1611982800,1611982800,1
JonnTheMartian,0,1,0,11,1592107200,1592107200,1
louiseoxford,0,1,0,4,1573534800,1573534800,1
So_Forlorn,0,1,0,1,1608526800,1608526800,1
resunicree,1,0,9,0,1544072400,1544072400,1
WedSquib,0,1,0,0,1588478400,1588478400,1
sdragonite,0,1,0,3,1603512000,1603512000,1
Tinbits,0,1,0,3,1603598400,1603598400,1
JonSnowgaryen,0,1,0,28,1589428800,1589428800,1
BlueAldo,0,1,0,10,1570680000,1570680000,1
bw4393,0,1,0,4,1598500800,1598500800,1
jaden_smiths_eyes,0,1,0,2,1599796800,1599796800,1
zixaz0,0,1,0,3,1609390800,1609390800,1
neesters,0,1,0,8,1608958800,1608958800,1
tetert69,0,1,0,7,1576040400,1576040400,1
prewfrock,0,1,0,-9,1580014800,1580014800,1
emiCouchPotato,0,1,0,5,1608699600,1608699600,1
SarjeHaynes,0,1,0,12,1589342400,1589342400,1
unc_bernie,0,1,0,24,1584158400,1584158400,1
someurbanNDN,0,1,0,4,1598760000,1598760000,1
DepressedKylar,0,1,0,2,1604203200,1604203200,1
rasquache,1,0,10,0,1530936000,1530936000,1
wak90,0,1,0,7,1576558800,1576558800,1
xxx_420_glaze_it_xxx,0,1,0,1,1608526800,1608526800,1
rsmccli,0,1,0,2,1597896000,1597896000,1
Algur,0,1,0,-7,1578891600,1578891600,1
TheEppidemic,0,1,0,-5,1605589200,1605589200,1
Draco_6160,0,1,0,1,1604293200,1604293200,1
r-whatdoyouthink_,0,1,0,11,1597809600,1597809600,1
Hellfire12345677,0,1,0,21,1595908800,1595908800,1
Hang_The_State,0,1,0,1,1587096000,1587096000,1
NagoEnkidu,0,1,0,1,1605416400,1605416400,1
Drakeytown,0,1,0,1,1591329600,1591329600,1
Perfect_Try7261,0,1,0,3,1611982800,1611982800,1
JigglySquishyFlesh,0,1,0,0,1601352000,1601352000,1
RockemSockemRowboats,1,0,382,0,1579755600,1579755600,1
Dark_Seraphim_,0,1,0,8,1583557200,1583557200,1
EmbarasedMillionaire,0,1,0,2,1599537600,1599537600,1
crunch94,0,1,0,6,1597464000,1597464000,1
SaviorComeBackFromUp,0,1,0,4,1586059200,1586059200,1
Powerup6666,0,1,0,1,1585454400,1585454400,1
PM_ME_YOUR_TIE_POSE,0,1,0,15,1609304400,1609304400,1
moneymichal,0,1,0,11,1606539600,1606539600,1
HairWeAre,0,1,0,39,1589256000,1589256000,1
ActualMindfuck,0,1,0,3,1584676800,1584676800,1
Osmium_tetraoxide,0,1,0,3,1517806800,1517806800,1
Ninra,0,1,0,1,1607662800,1607662800,1
Kamonji,0,1,0,4,1552276800,1552276800,1
ionstorm20,0,1,0,5,1594353600,1594353600,1
EBG26,0,1,0,1,1546405200,1546405200,1
Goodnight-Elizabeth,0,1,0,10,1567137600,1567137600,1
tricycle-,0,1,0,14,1595563200,1595563200,1
zupo137,0,1,0,1,1558411200,1558411200,1
aero_dynomite,1,0,2,0,1585281600,1585281600,1
captnjackedsparrow,0,1,0,1,1598414400,1598414400,1
Jar70,0,1,0,1,1593662400,1593662400,1
spudz191,0,1,0,-2,1557374400,1557374400,1
Zoroo67,0,1,0,5,1592539200,1592539200,1
Mashm4n,0,1,0,9,1587268800,1587268800,1
Geeves_Bot,0,1,0,34,1587268800,1587268800,1
_Random_Username_,0,1,0,1,1546405200,1546405200,1
UofLBird,0,1,0,6,1606885200,1606885200,1
IllegitimateGoat,0,1,0,1,1585454400,1585454400,1
jeffbrown711,0,1,0,2,1570507200,1570507200,1
simpinainteazy,0,1,0,34,1608786000,1608786000,1
GiannieB,0,1,0,1,1600315200,1600315200,1
SushiNinjaBun,0,1,0,16,1590120000,1590120000,1
slashermax,0,1,0,1,1589947200,1589947200,1
makmakfalankino,0,1,0,-8,1592798400,1592798400,1
ChalkyWhite23,0,1,0,7,1604203200,1604203200,1
mikeman7918,0,1,0,19,1597982400,1597982400,1
Choon93,0,1,0,0,1563336000,1563336000,1
canyongolf,0,1,0,2,1585454400,1585454400,1
RabidWench,0,1,0,8,1585627200,1585627200,1
dingusbroats,1,0,0,0,1564545600,1564545600,1
H3AR5AY,0,1,0,91,1589860800,1589860800,1
Cobblob,0,1,0,4,1587441600,1587441600,1
salt_shaker_damnit,0,1,0,2,1607144400,1607144400,1
amoxtli_flores,0,1,0,4,1600401600,1600401600,1
Throwawaybawks,0,1,0,6,1604030400,1604030400,1
Kilo_G_looked_up,0,1,0,1,1608699600,1608699600,1
momcano,0,1,0,1,1605848400,1605848400,1
notjakob,0,1,0,1,1608699600,1608699600,1
VanUltima,0,1,0,0,1570075200,1570075200,1
The_Chaos_Pope,0,1,0,3,1597291200,1597291200,1
usualproof,0,1,0,19,1546578000,1546578000,1
BarelyLethal,0,1,0,-7,1573966800,1573966800,1
nexxyPlayz,0,1,0,1,1604379600,1604379600,1
mlyay,0,1,0,7,1571025600,1571025600,1
Pmag86,0,1,0,2,1588651200,1588651200,1
ShihPoosRule,0,1,0,-1,1589256000,1589256000,1
IrateBandit1,0,1,0,3,1607058000,1607058000,1
bridaddy300,0,1,0,14,1594785600,1594785600,1
Violyre,0,1,0,5,1607835600,1607835600,1
Blackrose_,0,1,0,3,1598846400,1598846400,1
pheonix940,0,1,0,3,1595390400,1595390400,1
all-thing,0,1,0,83,1549429200,1549429200,1
Atomic254,0,1,0,2,1602734400,1602734400,1
d_awkward_boner,0,1,0,7,1601179200,1601179200,1
bringbackswg,0,1,0,1,1605502800,1605502800,1
ipoopskittles,0,1,0,5,1583899200,1583899200,1
tooscaredthrowaway8,0,1,0,3,1608958800,1608958800,1
RealNameIsTaken,0,1,0,1,1573621200,1573621200,1
justarandom3dprinter,0,1,0,1,1607576400,1607576400,1
propsmon,1,0,8,0,1598932800,1598932800,1
LizardLover2000,0,1,0,13,1579237200,1579237200,1
contactcapybara,0,1,0,9,1561176000,1561176000,1
jerseymeathook,0,1,0,38,1609045200,1609045200,1
M41WalkerBulldog,1,0,5,0,1608267600,1608267600,1
JellyBand,0,1,0,7,1593316800,1593316800,1
ShadowedTurtle,0,1,0,60,1601524800,1601524800,1
TheShroomKing,0,1,0,3,1601265600,1601265600,1
Agora_Black_Flag,0,1,0,3,1467777600,1467777600,1
The_great_him,0,1,0,3,1582952400,1582952400,1
bullsonparade82,0,1,0,2,1598068800,1598068800,1
CallumWalk,1,0,9,0,1592020800,1592020800,1
PM_UR_NUDE_BODY,0,1,0,1,1604030400,1604030400,1
screamemer,0,1,0,12,1589601600,1589601600,1
messyscoundrel,0,1,0,5,1572843600,1572843600,1
blothesho,0,1,0,2,1599710400,1599710400,1
Dasclimber,0,1,0,3,1603512000,1603512000,1
laceyriver,0,1,0,11,1580446800,1580446800,1
gameboyCasper,1,0,0,0,1582347600,1582347600,1
torutaka,0,1,0,1,1582779600,1582779600,1
fam_margera_XYZ,0,1,0,1,1596340800,1596340800,1
GregorSamsaa,0,1,0,-1,1578373200,1578373200,1
OnaccountaY,0,1,0,2,1597550400,1597550400,1
SaltiestRaccoon,0,1,0,1,1611896400,1611896400,1
Normalunicorn,0,1,0,3,1604466000,1604466000,1
dankwrangler,0,1,0,21,1553227200,1553227200,1
ToastPaintsMinis,0,1,0,3,1582952400,1582952400,1
dalhousieAluminum,0,1,0,1,1606021200,1606021200,1
Toasterman2k,0,1,0,9,1580619600,1580619600,1
hlfempty69,1,0,11,0,1598068800,1598068800,1
Neorio1,0,1,0,-4,1606885200,1606885200,1
InvaderNugget,0,1,0,13,1601524800,1601524800,1
LJ-Rubicon,0,1,0,1,1585454400,1585454400,1
moondizzlepie,0,1,0,40,1600920000,1600920000,1
boogerbogger,0,1,0,1,1593835200,1593835200,1
AutomaticReboot,0,1,0,20,1562040000,1562040000,1
Armian,0,1,0,14,1509076800,1509076800,1
christria,0,1,0,0,1606539600,1606539600,1
tttt11112,0,1,0,2,1593316800,1593316800,1
sirzack92,0,1,0,1,1605589200,1605589200,1
breadfred1,0,1,0,3,1609304400,1609304400,1
ljs_xxxx,0,1,0,1,1600574400,1600574400,1
LowB0b,0,1,0,25,1608008400,1608008400,1
bortkasta,0,1,0,4,1584936000,1584936000,1
Abstractogenesis,0,1,0,3,1602734400,1602734400,1
dmfd1234,0,1,0,1,1589860800,1589860800,1
spudpuffin,0,1,0,3,1603857600,1603857600,1
TachyonChip,0,1,0,1,1583985600,1583985600,1
burninginq,0,1,0,2,1598068800,1598068800,1
wheredidthefeelsgo,0,1,0,43,1595390400,1595390400,1
Your_average_Nihlist,0,1,0,6,1603598400,1603598400,1
LeoLaDawg,0,1,0,6,1581224400,1581224400,1
faisies,0,1,0,3,1602043200,1602043200,1
abasio,0,1,0,17,1596254400,1596254400,1
Phylael,0,1,0,3,1605330000,1605330000,1
OregonCityHippie,0,1,0,1,1608526800,1608526800,1
highonnuggs,0,1,0,1,1600574400,1600574400,1
throwawaydfbbgfcv-BF,0,1,0,12,1585454400,1585454400,1
kuhtuhfuh,0,1,0,44,1596427200,1596427200,1
BoldEagle21,0,1,0,1,1604466000,1604466000,1
kushasorous,0,1,0,2,1597982400,1597982400,1
OWSucks,0,1,0,26,1596859200,1596859200,1
KnightGalavant,0,1,0,-5,1571630400,1571630400,1
Rogue_Siren,1,0,14,0,1607144400,1607144400,1
rooftoppastryshop,0,1,0,2,1580187600,1580187600,1
Mintyfreshbrains,0,1,0,5,1598155200,1598155200,1
unique-irrelevant,0,1,0,6,1593057600,1593057600,1
foxtrot-luv,0,1,0,1,1595736000,1595736000,1
CleverNameTheSecond,0,1,0,3,1581224400,1581224400,1
benjandpurge,0,1,0,1,1607835600,1607835600,1
PlaneswalkerFrost,0,1,0,1,1599969600,1599969600,1
sidenotesidepiece,0,1,0,1,1586059200,1586059200,1
ssiixxssiixx,0,1,0,3,1590638400,1590638400,1
RogerRogerRegor,0,1,0,14,1567569600,1567569600,1
MattW1997,0,1,0,1,1587096000,1587096000,1
desolatewinds,0,1,0,7,1557979200,1557979200,1
throwaway_aug_2019,0,1,0,1,1600574400,1600574400,1
wokenihilist,0,1,0,8,1570593600,1570593600,1
thislittlewiggy,0,1,0,13,1612155600,1612155600,1
FuzzySamuri2004,0,1,0,-88,1597636800,1597636800,1
mylescool,0,1,0,10,1608181200,1608181200,1
andstopher,0,1,0,-1,1582779600,1582779600,1
maaalicelaaamb,0,1,0,19,1572062400,1572062400,1
rhclem,0,1,0,2,1605502800,1605502800,1
Tmbgkc,0,1,0,8,1598760000,1598760000,1
duke9350,0,1,0,1,1589860800,1589860800,1
kstrike155,0,1,0,2,1584331200,1584331200,1
T4nk4rd666,0,1,0,2,1579582800,1579582800,1
gamesage53,0,1,0,3,1606021200,1606021200,1
thk_,1,0,542,0,1595390400,1595390400,1
EvilGummyBear26,0,1,0,1,1605416400,1605416400,1
StGoran,0,1,0,5,1603857600,1603857600,1
scuttledumpster,0,1,0,-1,1585454400,1585454400,1
thri54,0,1,0,12,1604379600,1604379600,1
healthy_mind69,0,1,0,0,1605589200,1605589200,1
sureshot321,0,1,0,1,1621828800,1621828800,1
beep_bop_boop_4,0,1,0,2,1583899200,1583899200,1
worthfightingfor1,1,0,61,0,1584676800,1584676800,1
xxSadie,0,1,0,2,1564027200,1564027200,1
REDACTED_EXPUNGED,0,1,0,20,1605416400,1605416400,1
machinam2015,0,1,0,18,1561262400,1561262400,1
tiredteachermaria,0,1,0,2,1582434000,1582434000,1
lampgate,0,1,0,1,1600660800,1600660800,1
Little_Ad_1619,0,1,0,4,1604030400,1604030400,1
Upstairs-Molasses453,0,1,0,1,1606626000,1606626000,1
SteeleDynamics,0,1,0,26,1600574400,1600574400,1
yunotxgirl,0,1,0,11,1577422800,1577422800,1
GraboidAttackVictim,0,1,0,3,1602820800,1602820800,1
metalpunkspur,0,1,0,7,1566878400,1566878400,1
JJ-heady,0,1,0,3,1599019200,1599019200,1
Abnobear,0,1,0,1,1592107200,1592107200,1
vraalapa,0,1,0,6,1608267600,1608267600,1
GAQUEMEX,0,1,0,8,1604811600,1604811600,1
OLSTBAABD,0,1,0,5,1588564800,1588564800,1
branflakes82,0,1,0,3,1601006400,1601006400,1
broksonic,0,1,0,2,1572667200,1572667200,1
Janderts,0,1,0,22,1577854800,1577854800,1
karuparlubibu,0,1,0,1,1603598400,1603598400,1
litty_kitty3005,0,1,0,-3,1547442000,1547442000,1
dexx4d,0,1,0,1,1571889600,1571889600,1
VividTreacle0,0,1,0,37,1600228800,1600228800,1
wearenottheborg,0,1,0,5,1574830800,1574830800,1
Ninja-Shoddy,1,0,7438,0,1603339200,1603339200,1
HatelandFrogman,1,0,8,0,1592712000,1592712000,1
draunchio,0,1,0,-18,1594699200,1594699200,1
Iced--Tea,1,0,65,0,1605416400,1605416400,1
Pepsibroski,0,1,0,19,1589342400,1589342400,1
Anymeans6,0,1,0,7,1599883200,1599883200,1
flapjacksandgravy,0,1,0,3,1584849600,1584849600,1
MallPicartney,0,1,0,2,1575522000,1575522000,1
Obandigo,0,1,0,13,1605675600,1605675600,1
JoeRecuerdo,0,1,0,53,1594008000,1594008000,1
-Nardis-,0,1,0,2,1573534800,1573534800,1
Tricky_Ballsack,1,0,13,0,1588824000,1588824000,1
YEEyourlastHAW,0,1,0,3,1576818000,1576818000,1
TheEldritchHorror,0,1,0,12,1573621200,1573621200,1
AltHypo2,0,1,0,26,1580619600,1580619600,1
Kamelasa,0,1,0,2,1593662400,1593662400,1
jojobinksss,1,0,6,0,1605762000,1605762000,1
nekr0wizard,0,1,0,17,1607662800,1607662800,1
TrapOtto,0,1,0,2,1600315200,1600315200,1
mita-vittua,0,1,0,9,1571544000,1571544000,1
ddpeaches95,0,1,0,1,1553918400,1553918400,1
uncoolchick,0,1,0,54,1596600000,1596600000,1
kalechips321,0,1,0,-2,1589688000,1589688000,1
OOOdragonessOOO,0,1,0,2,1585454400,1585454400,1
NedNoodleHead,0,1,0,2,1550725200,1550725200,1
GTStD,0,1,0,1,1589947200,1589947200,1
pm_me_ur_gaming_pc,0,1,0,1,1576645200,1576645200,1
Lungz85,0,1,0,2,1578373200,1578373200,1
gfjvf,0,1,0,1,1585454400,1585454400,1
KlaudiSy,0,1,0,18,1600833600,1600833600,1
gingariffic,0,1,0,16,1556856000,1556856000,1
Teqie,0,1,0,1,1540094400,1540094400,1
PutinsIntestines,0,1,0,-2,1608267600,1608267600,1
wannabearthoe,0,1,0,3,1583985600,1583985600,1
DifferentPassenger,0,1,0,2,1592107200,1592107200,1
green_chambers,0,1,0,4,1598846400,1598846400,1
willehbird,0,1,0,0,1599796800,1599796800,1
hatingthefruit,0,1,0,16,1603425600,1603425600,1
pm_me_butt_stuff_rn,0,1,0,1,1559534400,1559534400,1
SugarJunkie0,0,1,0,13,1605157200,1605157200,1
Vaeloc,0,1,0,3,1573016400,1573016400,1
LFK1236,0,1,0,3,1605762000,1605762000,1
DaxtersLLC,0,1,0,1,1589428800,1589428800,1
HumeCat,0,1,0,4,1591502400,1591502400,1
asmallcoal,0,1,0,3,1576040400,1576040400,1
MyNameIsLucyAndImA,0,1,0,6,1594353600,1594353600,1
BobBaratheonsBastard,0,1,0,11,1597377600,1597377600,1
122505221,0,1,0,-15,1593662400,1593662400,1
poppymcculturestein,0,1,0,2,1589601600,1589601600,1
howdyanna,0,1,0,1,1603512000,1603512000,1
lusmrt,0,1,0,2,1584590400,1584590400,1
New_Axus,0,1,0,0,1576386000,1576386000,1
StormCaller02,0,1,0,7,1580101200,1580101200,1
pamtar,0,1,0,1,1546405200,1546405200,1
luoldeng_,1,0,94,0,1599537600,1599537600,1
yoruthe2nd,0,1,0,9,1607144400,1607144400,1
MikeShekelstein,0,1,0,-1,1585454400,1585454400,1
wickerman93,0,1,0,-3,1576990800,1576990800,1
uptheaffiliates,0,1,0,14,1608958800,1608958800,1
MrPinklesworth,0,1,0,3,1571716800,1571716800,1
Aisforanus,0,1,0,10,1607922000,1607922000,1
zacjkl,0,1,0,1,1575781200,1575781200,1
bluddragon1,0,1,0,3,1606366800,1606366800,1
engineeringStudent0_,0,1,0,2,1583812800,1583812800,1
10kLostAllenWrenches,0,1,0,13,1601524800,1601524800,1
dogtroep,0,1,0,4,1571976000,1571976000,1
red_papyrus63,0,1,0,2,1575608400,1575608400,1
Naveedamin7992,0,1,0,1,1604116800,1604116800,1
RockabyeRy,0,1,0,6,1606885200,1606885200,1
hairyreptile,0,1,0,36,1570852800,1570852800,1
Zastrozzi,0,1,0,11,1584763200,1584763200,1
FaNT1m,0,1,0,2,1566964800,1566964800,1
cold40,0,1,0,48,1594872000,1594872000,1
KinkyTech,0,1,0,1,1605589200,1605589200,1
Milkshake8863,0,1,0,1,1578373200,1578373200,1
Peach_Baby666,0,1,0,1,1591329600,1591329600,1
Sumumfachunk,0,1,0,9,1595476800,1595476800,1
-Rick_Sanchez_,0,1,0,2,1578373200,1578373200,1
gallopsdidnothingwrg,0,1,0,1,1604379600,1604379600,1
Th596,0,1,0,3,1599796800,1599796800,1
JewelOfTheValley,0,1,0,1,1599796800,1599796800,1
breezywood,0,1,0,4,1580014800,1580014800,1
AtticusPaperchase,0,1,0,2,1589947200,1589947200,1
deepfreshwater,0,1,0,16,1593057600,1593057600,1
silver_sofa,0,1,0,1,1604030400,1604030400,1
DiamondShrimp,0,1,0,1,1616472000,1616472000,1
aesu,0,1,0,1,1572580800,1572580800,1
rabidhamster87,0,1,0,22,1581138000,1581138000,1
CheeseMcoy,0,1,0,4,1583125200,1583125200,1
OnwardToEnnui,0,1,0,1,1603512000,1603512000,1
blackcyberpunk,0,1,0,19,1559188800,1559188800,1
RespectTheFancy,0,1,0,1,1604898000,1604898000,1
shadydude55,0,1,0,1,1605502800,1605502800,1
necromantzer,0,1,0,6,1576645200,1576645200,1
666GothAngelSinner,0,1,0,4,1577422800,1577422800,1
-miami_nice,0,1,0,12,1584849600,1584849600,1
bootythirty,0,1,0,-12,1567569600,1567569600,1
TheRambleMammal,0,1,0,3,1569124800,1569124800,1
wybeubfer,0,1,0,12,1584331200,1584331200,1
veryordinary56,1,0,31,0,1591416000,1591416000,1
Significant_Bus_357,0,1,0,1,1607576400,1607576400,1
Murder_of_Craws,0,1,0,8,1589688000,1589688000,1
Mac-Bomaco,0,1,0,3,1578373200,1578373200,1
vtmace,0,1,0,-1,1571025600,1571025600,1
sycamore98,0,1,0,1,1604116800,1604116800,1
DrinkElectronic1467,0,1,0,4,1608181200,1608181200,1
eyeohok,0,1,0,8,1561262400,1561262400,1
MaxObesity,0,1,0,3,1572408000,1572408000,1
Foldedpencil,0,1,0,23,1573707600,1573707600,1
Plmr87,0,1,0,1,1587441600,1587441600,1
WeirdBeardx,0,1,0,2,1601352000,1601352000,1
BarryTrotz86,0,1,0,9,1600401600,1600401600,1
brinabobina,0,1,0,2,1588305600,1588305600,1
Pjones2127,0,1,0,2,1607576400,1607576400,1
Trollsniper,1,0,18,0,1605502800,1605502800,1
SpiritedAthlete3064,0,1,0,2,1613278800,1613278800,1
ExAnim0,0,1,0,1,1546664400,1546664400,1
OkStatus7997,0,1,0,1,1606626000,1606626000,1
wisdumcube,0,1,0,91,1580014800,1580014800,1
DJ_JOWZY,0,1,0,4,1592884800,1592884800,1
Frunken_Duckboi,0,1,0,3,1603166400,1603166400,1
KiwisEatingKiwis,0,1,0,6,1534478400,1534478400,1
usorfama,0,1,0,3,1605762000,1605762000,1
Dmles,0,1,0,2,1599883200,1599883200,1
Legeto,0,1,0,-5,1605589200,1605589200,1
Maximilian1271,0,1,0,1,1600574400,1600574400,1
socratesthighs,0,1,0,1,1589601600,1589601600,1
blackmollies,0,1,0,13,1605330000,1605330000,1
puellab,0,1,0,3,1556769600,1556769600,1
MaxStout808,0,1,0,1,1608872400,1608872400,1
Daemonecles,0,1,0,1,1584936000,1584936000,1
Tunit66,0,1,0,2,1603512000,1603512000,1
karmafarmbuddha,0,1,0,4,1598760000,1598760000,1
le_wild_poster,0,1,0,1,1593835200,1593835200,1
shreking-warrior,0,1,0,1,1603080000,1603080000,1
Violetscockroach,0,1,0,-32,1568520000,1568520000,1
Wildest83,0,1,0,50,1573966800,1573966800,1
agveq,0,1,0,5,1584763200,1584763200,1
-pepe_the_clown-,0,1,0,2,1562472000,1562472000,1
Roof_Horse,0,1,0,2,1591329600,1591329600,1
TheRealMarkTwain,0,1,0,5,1571716800,1571716800,1
QueenOfBoggle,0,1,0,1,1594267200,1594267200,1
deadkarma38,0,1,0,37,1585368000,1585368000,1
lovelyleesa,0,1,0,6,1602388800,1602388800,1
avaya432,0,1,0,2,1605070800,1605070800,1
This_is_RubeN,0,1,0,1,1578373200,1578373200,1
BrideOfEinstein14,0,1,0,2,1599883200,1599883200,1
Ch33rn0,0,1,0,2,1560052800,1560052800,1
pvhkouta,0,1,0,2,1605070800,1605070800,1
Manath,0,1,0,1,1601265600,1601265600,1
babyheadedcat,0,1,0,9,1603944000,1603944000,1
sigitev589,0,1,0,8,1607230800,1607230800,1
Niddsid,0,1,0,2,1577250000,1577250000,1
indoobitably,0,1,0,1,1611982800,1611982800,1
heckatrashy,0,1,0,1,1579064400,1579064400,1
oliander42,0,1,0,9,1558756800,1558756800,1
AoE2manatarms,0,1,0,43,1596859200,1596859200,1
WhiteStripeNoGrip,0,1,0,4,1584244800,1584244800,1
Van-Buren-Boy,0,1,0,1,1597896000,1597896000,1
cbrawlz,1,0,4144,0,1580533200,1580533200,1
Yiggity_Yikes,0,1,0,6,1607403600,1607403600,1
hkaro16,0,1,0,43,1597118400,1597118400,1
lucid_green,0,1,0,2,1603512000,1603512000,1
crystalhalo,0,1,0,1,1568865600,1568865600,1
bibbleskit,0,1,0,2,1573621200,1573621200,1
JustLetMePick69,0,1,0,1,1605157200,1605157200,1
jackphelps,0,1,0,2,1567569600,1567569600,1
Tsunder-plane,0,1,0,33,1580274000,1580274000,1
ssjb788,0,1,0,11,1597377600,1597377600,1
KrisDuvalle,0,1,0,3,1599710400,1599710400,1
natemc,0,1,0,6,1604379600,1604379600,1
LUNARGUILD,0,1,0,3,1576904400,1576904400,1
PedroDharma,1,0,57,0,1586750400,1586750400,1
Annihilate_the_CCP,0,1,0,0,1603512000,1603512000,1
aldonosuger,0,1,0,2,1596772800,1596772800,1
AutoClueless,0,1,0,12,1557979200,1557979200,1
bobbycado,0,1,0,14,1598500800,1598500800,1
procrochetnator,0,1,0,1,1577422800,1577422800,1
MrDripsAbit,0,1,0,1,1605502800,1605502800,1
laceandhoney,0,1,0,37,1574053200,1574053200,1
merkmuds,0,1,0,3,1607662800,1607662800,1
davidking1222,0,1,0,20,1583211600,1583211600,1
EkstraHeftyLetterHea,1,0,3,0,1606626000,1606626000,1
TheSpookyKabooki,0,1,0,12,1607403600,1607403600,1
Al-Alecto,0,1,0,2,1579496400,1579496400,1
THEORIGINALSNOOPDONG,0,1,0,1,1575522000,1575522000,1
MandoTheMisfit,0,1,0,1,1588046400,1588046400,1
DuvalHeart,0,1,0,1,1603512000,1603512000,1
Nervous_Language,0,1,0,7,1593835200,1593835200,1
liptonthrowback,0,1,0,4,1551330000,1551330000,1
SaggyBallsHD,0,1,0,2,1572148800,1572148800,1
Slamduck,0,1,0,8,1600574400,1600574400,1
T4for4,0,1,0,2,1601956800,1601956800,1
Danilcoolrl,0,1,0,1,1585454400,1585454400,1
ShroudedNight,0,1,0,6,1605589200,1605589200,1
ku20000,0,1,0,3,1572062400,1572062400,1
Lyras__,0,1,0,1,1611982800,1611982800,1
semideclared,0,1,0,1,1603512000,1603512000,1
hurb_up,0,1,0,3,1603598400,1603598400,1
frostsladekinbote,0,1,0,3,1593144000,1593144000,1
bpnoy3,0,1,0,1,1607490000,1607490000,1
Danamaganza,0,1,0,2,1573621200,1573621200,1
orangemen0000,0,1,0,-6,1581224400,1581224400,1
captain_jackharkness,0,1,0,8,1574398800,1574398800,1
ramp5757,0,1,0,1,1606712400,1606712400,1
controlledchaos631,0,1,0,1,1603512000,1603512000,1
M1lkS0da,0,1,0,1,1639717200,1639717200,1
snahanak,0,1,0,1,1604984400,1604984400,1
maplekeener,0,1,0,1,1606626000,1606626000,1
Shen_an_igator,0,1,0,-88,1572494400,1572494400,1
urdxddylingling,0,1,0,1,1596859200,1596859200,1
thelowelyman101,0,1,0,3,1553745600,1553745600,1
redguardnugz,0,1,0,5,1604293200,1604293200,1
thejekky_br,0,1,0,4,1578891600,1578891600,1
Milky02,0,1,0,5,1569124800,1569124800,1
Sure-Pound,0,1,0,6,1583726400,1583726400,1
72OverOfficer,0,1,0,12,1586836800,1586836800,1
yash019,0,1,0,15,1575694800,1575694800,1
monkeyboy9537,0,1,0,-9,1590465600,1590465600,1
Eradinn,0,1,0,6,1611810000,1611810000,1
ZakeshPoacher,0,1,0,-2,1585022400,1585022400,1
make-that-monet,0,1,0,21,1589428800,1589428800,1
483783268,0,1,0,3,1600142400,1600142400,1
NurseWretched,0,1,0,3,1575435600,1575435600,1
Arkavari1,0,1,0,2,1584331200,1584331200,1
markymarkwalters,0,1,0,1,1559361600,1559361600,1
dirtydustyroads,0,1,0,1,1606626000,1606626000,1
Thereminz,0,1,0,2,1603512000,1603512000,1
Letoile23,0,1,0,8,1605330000,1605330000,1
vanderbonnar,0,1,0,-10,1597291200,1597291200,1
spacecaoboi,0,1,0,1,1607662800,1607662800,1
mstarrbrannigan,0,1,0,2,1579150800,1579150800,1
BetterBagelBabe,0,1,0,21,1594872000,1594872000,1
Call_me_Vimc,0,1,0,0,1603425600,1603425600,1
ProClacker,0,1,0,4,1605070800,1605070800,1
krystiancbarrie,0,1,0,2,1602734400,1602734400,1
Nyangire2,0,1,0,4,1594872000,1594872000,1
travma07,0,1,0,1,1608699600,1608699600,1
SoManyWasps,1,0,84,0,1567656000,1567656000,1
havesexwithme666,1,0,132,0,1571716800,1571716800,1
pianoceo,0,1,0,1,1595044800,1595044800,1
IGetHypedEasily,0,1,0,23,1590120000,1590120000,1
Fuckyredditmods,0,1,0,-10,1585022400,1585022400,1
LifeHackTraining,0,1,0,1,1579064400,1579064400,1
Li0nsFTW,0,1,0,15,1591156800,1591156800,1
mference123,0,1,0,2,1582520400,1582520400,1
builenbrand,1,0,16,0,1437451200,1437451200,1
caddoheart,0,1,0,1,1605589200,1605589200,1
IAteMyBrocoli,0,1,0,1,1608181200,1608181200,1
black272,0,1,0,-13,1608440400,1608440400,1
lonewolfie1289,0,1,0,34,1604466000,1604466000,1
JollyRogersJolly,0,1,0,3,1607230800,1607230800,1
XuchilbaraLobselVith,0,1,0,5,1599019200,1599019200,1
h0n3y_,0,1,0,3,1604811600,1604811600,1
MaoMakesMeCum,0,1,0,16,1559620800,1559620800,1
Sagacious_Sophistry,0,1,0,8,1578805200,1578805200,1
Rektangulus,0,1,0,94,1596168000,1596168000,1
thejoyoflife1987,1,0,4,0,1605070800,1605070800,1
Vivid-Comb,0,1,0,1,1587614400,1587614400,1
PopeRaunchyIV,0,1,0,4,1578891600,1578891600,1
demalition90,0,1,0,2,1585454400,1585454400,1
LargeTittiedToddler,1,0,51,0,1546405200,1546405200,1
ethbullrun,0,1,0,2,1600574400,1600574400,1
YoungBlok,0,1,0,50,1573448400,1573448400,1
VivecsMangina,0,1,0,1,1602820800,1602820800,1
iyosipydas,1,0,24,0,1571889600,1571889600,1
thememescoper,0,1,0,1,1570334400,1570334400,1
Antrephellious,0,1,0,2,1600920000,1600920000,1
ThePandaKing3,0,1,0,1,1594094400,1594094400,1
kiritimati55,0,1,0,9,1596600000,1596600000,1
terratitorex,0,1,0,4,1606021200,1606021200,1
Ravenhayth,0,1,0,1,1608181200,1608181200,1
ventoidiota,1,0,14,0,1607490000,1607490000,1
DaEffBeeEye,0,1,0,2,1597118400,1597118400,1
Jegr35,0,1,0,21,1600228800,1600228800,1
Pistache2,1,0,15,0,1582693200,1582693200,1
dasmelloforange,0,1,0,1,1607662800,1607662800,1
DEVILSCUNT,0,1,0,1,1578373200,1578373200,1
FooBarBazDeadBeef,0,1,0,2,1603512000,1603512000,1
iambatmansguns,0,1,0,121,1600574400,1600574400,1
hrb2d2,0,1,0,1,1608872400,1608872400,1
zee924,0,1,0,11,1611982800,1611982800,1
ohhhhhJINsnap,0,1,0,3,1608699600,1608699600,1
blundetto,0,1,0,1,1600747200,1600747200,1
StinkyHeXoR,0,1,0,5,1581397200,1581397200,1
tiger844,0,1,0,1,1600660800,1600660800,1
ghrescd,1,0,16,0,1603080000,1603080000,1
7832507840,0,1,0,4,1558497600,1558497600,1
Cellsmass,1,0,842,0,1574053200,1574053200,1
MoonbeamThunderbutt,0,1,0,0,1482296400,1482296400,1
Strawberry3525_,0,1,0,1,1601179200,1601179200,1
Theron3206,0,1,0,1,1604466000,1604466000,1
gwfin,0,1,0,7,1575262800,1575262800,1
LadyTentacles,0,1,0,1,1606798800,1606798800,1
Se7enFan,0,1,0,21,1601092800,1601092800,1
Dr_Gats,0,1,0,1,1584676800,1584676800,1
crashtheparty,0,1,0,7,1603512000,1603512000,1
Tat0rman,0,1,0,-2,1585454400,1585454400,1
TheTrueMurph,0,1,0,2,1556078400,1556078400,1
Dazzling-Wafer,0,1,0,0,1576645200,1576645200,1
Geosaysbye,0,1,0,21,1580619600,1580619600,1
may_sun,0,1,0,1,1590465600,1590465600,1
EnormousOrangutan,0,1,0,0,1601265600,1601265600,1
GalacticMystic,0,1,0,14,1608354000,1608354000,1
ButternutSquashGuy,0,1,0,3,1608267600,1608267600,1
bunny_mama_,0,1,0,5,1594785600,1594785600,1
2smokesleft,0,1,0,3,1606280400,1606280400,1
Surfgonzo,0,1,0,12,1582952400,1582952400,1
ispaticup,0,1,0,1,1599364800,1599364800,1
commentsrfun,0,1,0,2,1602561600,1602561600,1
Tibector,0,1,0,6,1606885200,1606885200,1
Brockollihouse,0,1,0,9,1611896400,1611896400,1
Kann0n2,0,1,0,1,1594958400,1594958400,1
piepackage,0,1,0,1,1571716800,1571716800,1
wannabeawelder,0,1,0,6,1603771200,1603771200,1
RolloTomasi83,0,1,0,1,1606626000,1606626000,1
martin_noyd,0,1,0,2,1553832000,1553832000,1
detournemen,0,1,0,2,1572580800,1572580800,1
quartermaaster,0,1,0,1,1606021200,1606021200,1
Psilodelic,0,1,0,2,1597550400,1597550400,1
UsernameTabarnak,0,1,0,-2,1608786000,1608786000,1
chedarchese,0,1,0,1,1598068800,1598068800,1
MandoLakes,0,1,0,2,1593144000,1593144000,1
gashejje,0,1,0,1,1609131600,1609131600,1
Anon314159262,0,1,0,3,1571716800,1571716800,1
D13s3ll,0,1,0,2,1603339200,1603339200,1
BigInhale,0,1,0,4,1594094400,1594094400,1
unique-name-9035768,0,1,0,-21,1584158400,1584158400,1
The_Aswaf,0,1,0,1,1579582800,1579582800,1
Lou_Am,0,1,0,2,1593316800,1593316800,1
Hungboy6969420,0,1,0,27,1584158400,1584158400,1
koreanwizard,0,1,0,3,1591329600,1591329600,1
_EarlofSandwich__,0,1,0,3,1603512000,1603512000,1
OmegaGM,0,1,0,7,1565323200,1565323200,1
manicbassman,0,1,0,1,1612069200,1612069200,1
revstate,0,1,0,1,1601006400,1601006400,1
MyUsernameIsRedacted,0,1,0,1,1572667200,1572667200,1
experiencinghumanity,0,1,0,1,1592798400,1592798400,1
Great_WhiteSnark,0,1,0,-2,1582779600,1582779600,1
hearsecloth,0,1,0,3,1608440400,1608440400,1
NickLand117,0,1,0,1,1602907200,1602907200,1
Snaggleback,0,1,0,16,1607922000,1607922000,1
Ribbon-of-Starlight,0,1,0,5,1601870400,1601870400,1
throwaway7799887,0,1,0,4,1573621200,1573621200,1
Naotevejoha20anos,0,1,0,-2,1603339200,1603339200,1
h3lblad3,0,1,0,6,1548738000,1548738000,1
honeyryderx,0,1,0,4,1559102400,1559102400,1
A10110101Z,0,1,0,2,1585454400,1585454400,1
CookedLikeaCookie,0,1,0,2,1579150800,1579150800,1
moonpie_massacre,0,1,0,78,1579928400,1579928400,1
Reaperfucker,0,1,0,2,1604811600,1604811600,1
Mutantpineapple,0,1,0,1,1604379600,1604379600,1
UnionizeAmazon,0,1,0,3,1607490000,1607490000,1
neur0,0,1,0,8,1609304400,1609304400,1
HoozaTA,0,1,0,142,1575176400,1575176400,1
degamezolder,0,1,0,1,1597723200,1597723200,1
fetus_bumhole,0,1,0,1,1572667200,1572667200,1
irvth,0,1,0,1,1578200400,1578200400,1
Paradoxthefox,0,1,0,1,1573534800,1573534800,1
Cowardly_Squrrel,0,1,0,1,1602734400,1602734400,1
EugeneorJauques,1,0,26,0,1609045200,1609045200,1
gogo--yubari,0,1,0,2,1593316800,1593316800,1
eoCoe,1,0,136,0,1597118400,1597118400,1
brimur123,0,1,0,11,1593576000,1593576000,1
Knuc85,0,1,0,3,1598846400,1598846400,1
colebrv,0,1,0,1,1585454400,1585454400,1
graveyardfuzz2,0,1,0,1,1578286800,1578286800,1
bettedaviseyepatch,0,1,0,3,1588996800,1588996800,1
Shanepro,0,1,0,1,1606626000,1606626000,1
Dolphin-LSD-Test,0,1,0,9,1581656400,1581656400,1
MasterCucumber,0,1,0,1,1598932800,1598932800,1
lapetasse,0,1,0,28,1607662800,1607662800,1
Yanko_reddit,0,1,0,1,1605502800,1605502800,1
Brie1532,1,0,1,0,1563854400,1563854400,1
HIVnotAdeathSentence,0,1,0,2,1600920000,1600920000,1
JayBird9540,0,1,0,5,1576904400,1576904400,1
bakirsakal,0,1,0,2,1599451200,1599451200,1
uptheneck,0,1,0,10,1549342800,1549342800,1
_Vanquished,0,1,0,0,1594180800,1594180800,1
arkibet,0,1,0,5,1594353600,1594353600,1
Allstar818,0,1,0,1,1603512000,1603512000,1
millioncoola,0,1,0,1,1582693200,1582693200,1
smallberry_tornados,0,1,0,4,1608267600,1608267600,1
jeffgibbard,0,1,0,2,1603857600,1603857600,1
HodesFTW,0,1,0,1,1595822400,1595822400,1
musajoemo,0,1,0,11,1590465600,1590465600,1
yeettherichh,0,1,0,391,1588305600,1588305600,1
Perrydev,0,1,0,1,1567396800,1567396800,1
WistfulNightSky,0,1,0,1,1635566400,1635566400,1
jonlandrum,0,1,0,8,1607835600,1607835600,1
AlphaNumericDisplay,0,1,0,1,1581310800,1581310800,1
javier123454321,0,1,0,8,1588824000,1588824000,1
Stottymod,0,1,0,4,1603512000,1603512000,1
dreamer_jenny,0,1,0,4,1603771200,1603771200,1
Mightymushroom1,0,1,0,7,1605589200,1605589200,1
DodsonHere,0,1,0,6,1599105600,1599105600,1
PPeixotoX,0,1,0,1,1593921600,1593921600,1
11SomeGuy17,0,1,0,1,1559275200,1559275200,1
essentialfloss,0,1,0,2,1611896400,1611896400,1
runnerconst,0,1,0,18,1599278400,1599278400,1
Sevaa_1104,0,1,0,13,1592280000,1592280000,1
literally_zaphod,0,1,0,14,1596254400,1596254400,1
Mark1_M00,0,1,0,1,1581310800,1581310800,1
NoRookieMistakes,0,1,0,2,1606194000,1606194000,1
valkyre09,0,1,0,71,1579669200,1579669200,1
majormarvy,0,1,0,-1,1591156800,1591156800,1
mattamz,0,1,0,2,1598068800,1598068800,1
rohobian,0,1,0,20,1611896400,1611896400,1
Bowens1993,0,1,0,-1,1606539600,1606539600,1
Smex_Addict,0,1,0,0,1577509200,1577509200,1
Jaloppinos,0,1,0,6,1604203200,1604203200,1
bayarealoser650,0,1,0,1,1595563200,1595563200,1
SezitLykItiz,0,1,0,1,1600747200,1600747200,1
Null225,0,1,0,3,1586577600,1586577600,1
Throway12453125,0,1,0,1,1569643200,1569643200,1
LightChaos,0,1,0,1,1574744400,1574744400,1
altstruts,0,1,0,4,1594958400,1594958400,1
ConstantHomework,0,1,0,1,1608267600,1608267600,1
VirtualEffort8,0,1,0,-7,1597550400,1597550400,1
Enbyous,0,1,0,3,1603944000,1603944000,1
vellamour,0,1,0,5,1608354000,1608354000,1
anarcopirate,0,1,0,19,1565755200,1565755200,1
tjscali,0,1,0,-3,1589256000,1589256000,1
KristyBanalia,0,1,0,3,1568347200,1568347200,1
icantthinkofanamefs,0,1,0,3,1547528400,1547528400,1
zipper_sniffer,0,1,0,0,1606539600,1606539600,1
sirgorillaglue,0,1,0,1,1585454400,1585454400,1
ce11ar-d00r,0,1,0,29,1599278400,1599278400,1
Archer10214,0,1,0,9,1583812800,1583812800,1
Zporadik,0,1,0,3,1608699600,1608699600,1
pharan_x,0,1,0,1,1560484800,1560484800,1
fishyfishyfish1,0,1,0,1,1586232000,1586232000,1
leftshoelace136,0,1,0,0,1583726400,1583726400,1
Mr__Stalin,0,1,0,5,1570420800,1570420800,1
FuckingHONDA,0,1,0,1,1643000400,1643000400,1
trashrelations,0,1,0,-3,1607576400,1607576400,1
ainitabitch,0,1,0,52,1578978000,1578978000,1
Mrs_Lamb,0,1,0,15,1566446400,1566446400,1
CapricornBromine,0,1,0,1,1607317200,1607317200,1
West_Shine_1061,0,1,0,64,1611982800,1611982800,1
icry2much8,0,1,0,9,1587960000,1587960000,1
JPecker,0,1,0,2,1575435600,1575435600,1
FOGZRB,0,1,0,1,1608354000,1608354000,1
redsteve905,0,1,0,1,1584158400,1584158400,1
Astrosin,0,1,0,19,1572667200,1572667200,1
Erythroy,0,1,0,4,1593748800,1593748800,1
lynn8518,0,1,0,32,1572753600,1572753600,1
poopie3939,0,1,0,5,1607835600,1607835600,1
ImAbeaGleama7641,0,1,0,1,1587441600,1587441600,1
Chicken65,0,1,0,4,1593057600,1593057600,1
caturday4eva,0,1,0,2,1606280400,1606280400,1
alert592,0,1,0,1,1604379600,1604379600,1
fucking_giraffes,0,1,0,34,1601524800,1601524800,1
audyaudvi,1,0,22,0,1608267600,1608267600,1
personwithface_,0,1,0,38,1588392000,1588392000,1
hormonboy,0,1,0,5,1582261200,1582261200,1
pennyforyourscotch,0,1,0,2,1580274000,1580274000,1
Moose281,0,1,0,1,1599796800,1599796800,1
Cybara,0,1,0,7,1585713600,1585713600,1
yahkeith_,0,1,0,1,1600056000,1600056000,1
mvp42069,0,1,0,1,1592884800,1592884800,1
GloryWaves,0,1,0,1,1577595600,1577595600,1
0124305060,0,1,0,10,1560571200,1560571200,1
Percuriosa,0,1,0,3,1598068800,1598068800,1
_SpriteCranberry,0,1,0,5,1573362000,1573362000,1
aubbabe,0,1,0,2,1563249600,1563249600,1
puresttrenofhate,0,1,0,7,1605589200,1605589200,1
queenineedafleet,0,1,0,58,1599451200,1599451200,1
staranxietytime,1,0,22,0,1592971200,1592971200,1
IAmTheMindTrip,0,1,0,3,1608699600,1608699600,1
BabyDuckJoel,0,1,0,1,1592798400,1592798400,1
ivangalic5,0,1,0,-9,1598500800,1598500800,1
tlf9888,0,1,0,13,1579410000,1579410000,1
Satch93,0,1,0,2,1566446400,1566446400,1
Lower_Combination_83,1,0,1,0,1607749200,1607749200,1
P1nkSn0rlax,1,0,54,0,1591329600,1591329600,1
ShiNo_Usagi,0,1,0,14,1597118400,1597118400,1
01l1lll1l1l1l0OOll11,0,1,0,3,1572148800,1572148800,1
Caligapiscis,0,1,0,1,1602561600,1602561600,1
OneMatureLobster,0,1,0,9,1595390400,1595390400,1
LeftAloneTalking,1,0,2,0,1608094800,1608094800,1
uzeruzer,0,1,0,1,1608613200,1608613200,1
Sideways2,0,1,0,2,1585454400,1585454400,1
lovepeacebass,0,1,0,10,1587182400,1587182400,1
ExCoomBrain,0,1,0,-12,1605934800,1605934800,1
wasdninja,0,1,0,8,1601524800,1601524800,1
Born2Explore11,0,1,0,3,1585886400,1585886400,1
piinkchampagne,0,1,0,38,1583557200,1583557200,1
Saba-baby,0,1,0,1,1612069200,1612069200,1
arazni,0,1,0,3,1607835600,1607835600,1
FireballFoxtrot,0,1,0,26,1597636800,1597636800,1
she_is_my_girl,0,1,0,2,1570420800,1570420800,1
ThotSayer,0,1,0,4,1593576000,1593576000,1
Prs3286,0,1,0,1,1608267600,1608267600,1
iactuallyhaveaname,0,1,0,25,1598587200,1598587200,1
VeryDramatic,0,1,0,24,1591243200,1591243200,1
MayvisDelacour,0,1,0,3,1591243200,1591243200,1
miIIzog,0,1,0,1,1586923200,1586923200,1
MadamGingerFarts,0,1,0,3,1585454400,1585454400,1
seekingdangdo,0,1,0,0,1600660800,1600660800,1
grumpenprole,0,1,0,3,1570075200,1570075200,1
MAKE_ME_REDDIT,0,1,0,1,1611810000,1611810000,1
ScottHalpin,1,0,16,0,1590033600,1590033600,1
JackalberryJewels,0,1,0,3,1575176400,1575176400,1
PerpetualTorture,0,1,0,3,1556251200,1556251200,1
The_Pahuna,0,1,0,1,1579669200,1579669200,1
Skothatron,0,1,0,1,1604203200,1604203200,1
bennyllama,0,1,0,32,1602907200,1602907200,1
Francl27,0,1,0,2,1607749200,1607749200,1
EdgyWalmartSlave,0,1,0,12,1596600000,1596600000,1
Wriggg,0,1,0,3,1593057600,1593057600,1
radprogrammer,0,1,0,2,1607662800,1607662800,1
HammockEngineer,0,1,0,2,1574139600,1574139600,1
ColeAppreciationV2,0,1,0,9,1568088000,1568088000,1
IWill_FindOut,0,1,0,10,1606366800,1606366800,1
muwtant,0,1,0,11,1605589200,1605589200,1
DanzigKaduro,0,1,0,3,1605070800,1605070800,1
biohacking_recovery,0,1,0,7,1572930000,1572930000,1
ohmegatron,0,1,0,1,1606280400,1606280400,1
Salinkus,0,1,0,3,1573621200,1573621200,1
santawartooth,0,1,0,3,1610773200,1610773200,1
JoeDice,0,1,0,0,1604898000,1604898000,1
xpialidont,0,1,0,1,1589947200,1589947200,1
Stoond,0,1,0,4,1600833600,1600833600,1
FlCoC,0,1,0,2,1608267600,1608267600,1
Albanian-Virus,0,1,0,0,1598500800,1598500800,1
muthafuckenkatlaydee,0,1,0,68,1551675600,1551675600,1
pandakaaat,0,1,0,10,1598846400,1598846400,1
facetrolled,0,1,0,11,1597636800,1597636800,1
evergreengirl98,0,1,0,1,1594872000,1594872000,1
WaveHack,0,1,0,2,1575349200,1575349200,1
AltruisticPeanutHead,0,1,0,39,1597032000,1597032000,1
Itsmando12,0,1,0,0,1585454400,1585454400,1
AngelsIsland,0,1,0,3,1598328000,1598328000,1
cultural-obamaism,0,1,0,5,1548997200,1548997200,1
realbabysealclubber,0,1,0,4,1573621200,1573621200,1
TeGro,0,1,0,1,1585281600,1585281600,1
RapescoStapler,0,1,0,25,1583812800,1583812800,1
Pink_Lotus,0,1,0,30,1585454400,1585454400,1
PacificYT,0,1,0,18,1600747200,1600747200,1
Free_Bread,0,1,0,8,1595390400,1595390400,1
angelsofadversity,0,1,0,13,1564113600,1564113600,1
celestialbisexual,0,1,0,29,1602302400,1602302400,1
PastMyExpiryDate,0,1,0,1,1606626000,1606626000,1
RarePeypey,0,1,0,6,1592366400,1592366400,1
Kuntitled,0,1,0,19,1544763600,1544763600,1
cincyfan04,0,1,0,7,1598846400,1598846400,1
millysaurusrexjr,0,1,0,7,1571803200,1571803200,1
itsjasonpham,0,1,0,1,1602043200,1602043200,1
SpaceCondom,0,1,0,1,1606453200,1606453200,1
unetor,0,1,0,2,1600747200,1600747200,1
HyphensCantSaveMyURL,1,0,43,0,1593144000,1593144000,1
PollysLithium,0,1,0,0,1601179200,1601179200,1
thedeadlyrhythm42,0,1,0,1,1602734400,1602734400,1
SonatinaNZ,0,1,0,1,1579064400,1579064400,1
thehunter699,0,1,0,1,1585454400,1585454400,1
Fraeddi,1,0,6,0,1589256000,1589256000,1
Kinda_OP,0,1,0,1,1606626000,1606626000,1
thereallilcya,0,1,0,-1,1585454400,1585454400,1
SugarRushLux,0,1,0,1,1606626000,1606626000,1
LivelyWallflower,0,1,0,1,1557201600,1557201600,1
jonsins42,0,1,0,27,1582520400,1582520400,1
Optaze,0,1,0,-10,1602388800,1602388800,1
gotnolife2,0,1,0,79,1589342400,1589342400,1
metzger_87,0,1,0,36,1573016400,1573016400,1
fiordsdancer,0,1,0,2,1583557200,1583557200,1
Final_Greggit,0,1,0,0,1599105600,1599105600,1
SixtyMetreMud,0,1,0,2,1602648000,1602648000,1
croquemonsieur10,0,1,0,22,1608267600,1608267600,1
Captain_Badname,1,0,15,0,1550293200,1550293200,1
biscuitmaester,0,1,0,1,1588996800,1588996800,1
wet_grilled_cheese,1,0,0,0,1592020800,1592020800,1
tottenham1991,0,1,0,3,1578114000,1578114000,1
thefirdblu,0,1,0,2,1603512000,1603512000,1
CosmicAlicorn,0,1,0,3,1596772800,1596772800,1
GrantExploit,0,1,0,2,1607144400,1607144400,1
Schizological,0,1,0,-11,1588478400,1588478400,1
SometimesAccurate,0,1,0,1,1581224400,1581224400,1
Nightstands,0,1,0,2,1593835200,1593835200,1
GreenPinguino,0,1,0,11,1600574400,1600574400,1
preetipeach,0,1,0,2,1608786000,1608786000,1
mrs_yellow,1,0,3,0,1597550400,1597550400,1
Galbo1337,0,1,0,4,1595390400,1595390400,1
NoctivagousNomad,0,1,0,1,1608094800,1608094800,1
CarAccountUsername,0,1,0,-2,1608267600,1608267600,1
CaptainPryk,0,1,0,2,1598414400,1598414400,1
BeavesTheDingo,0,1,0,2,1555473600,1555473600,1
UkrainischerKosake,0,1,0,2,1573621200,1573621200,1
CommieYahweh,0,1,0,2,1601265600,1601265600,1
srose3158,0,1,0,4,1587009600,1587009600,1
soadzombi,0,1,0,0,1581915600,1581915600,1
Turin_Turambar_wolf,0,1,0,1,1608267600,1608267600,1
Blissfullyaimless,0,1,0,2,1571630400,1571630400,1
packman_jon,0,1,0,4,1580533200,1580533200,1
Dontjudgemeforasking,0,1,0,2,1579928400,1579928400,1
dreamcrusher-,0,1,0,17,1597550400,1597550400,1
suitcasefullofbees,0,1,0,1,1591934400,1591934400,1
Marxwassexuallyhot,1,0,5,0,1549602000,1549602000,1
spicygrandma27,0,1,0,29,1556424000,1556424000,1
Wallapagos,0,1,0,1,1601352000,1601352000,1
Iknight60,0,1,0,17,1593748800,1593748800,1
yagamisubaru,0,1,0,3,1561780800,1561780800,1
Xavbeat03,0,1,0,1,1603512000,1603512000,1
Persephales,0,1,0,1,1586145600,1586145600,1
ItsRainingSomewhere,0,1,0,1,1572321600,1572321600,1
BennetSisterNumber6,0,1,0,1,1598500800,1598500800,1
SecularScience,0,1,0,1,1585454400,1585454400,1
RoseL123,0,1,0,10,1580274000,1580274000,1
joel231,0,1,0,1,1608699600,1608699600,1
maniczebra,0,1,0,4,1603512000,1603512000,1
scooterbike1968,0,1,0,1,1603425600,1603425600,1
Vandal-463,0,1,0,0,1573189200,1573189200,1
mybloodyvalentine_,1,0,24,0,1603252800,1603252800,1
anxiouspatronus,0,1,0,4,1588305600,1588305600,1
rezadential,0,1,0,2,1603512000,1603512000,1
Muhabla,0,1,0,1,1573534800,1573534800,1
wasistmir,0,1,0,2,1558497600,1558497600,1
mycatsnameislucky,0,1,0,3,1588737600,1588737600,1
knesha,1,0,7,0,1611982800,1611982800,1
boogboi89,0,1,0,-1,1598760000,1598760000,1
torialexandrina,0,1,0,1,1603512000,1603512000,1
throw39284725,0,1,0,1,1593316800,1593316800,1
no-fckin-clue,1,0,243,0,1604116800,1604116800,1
fattacochoad,0,1,0,1,1599019200,1599019200,1
celestiallizard,0,1,0,4,1566878400,1566878400,1
Lenondesu,0,1,0,4,1608613200,1608613200,1
adave4allreasons,0,1,0,1,1587528000,1587528000,1
nbajam40k,0,1,0,1,1590120000,1590120000,1
sludgewizard666,0,1,0,4,1582779600,1582779600,1
SkintEastwoods,0,1,0,7,1603944000,1603944000,1
SEAN771177,0,1,0,1,1595217600,1595217600,1
leehwgoC,0,1,0,2,1603598400,1603598400,1
Some-Cool-dude,0,1,0,2,1608872400,1608872400,1
ZeroSkriblz,0,1,0,3,1597032000,1597032000,1
peppereth,0,1,0,1,1581138000,1581138000,1
loness,0,1,0,2,1606280400,1606280400,1
pco801,0,1,0,1,1605589200,1605589200,1
CGB_Zach,0,1,0,1,1605589200,1605589200,1
noticingloops,0,1,0,1,1602216000,1602216000,1
GoatRoper36749,0,1,0,8,1579064400,1579064400,1
Mango-Bear,0,1,0,15,1605848400,1605848400,1
opqpqpqo,0,1,0,4,1609304400,1609304400,1
Nutropli,1,0,399,0,1609131600,1609131600,1
donut211,0,1,0,3,1593835200,1593835200,1
woutje1999,0,1,0,11,1593230400,1593230400,1
RIPGeorgeHarrison,0,1,0,1,1602907200,1602907200,1
Icywolfcreative,0,1,0,3,1601870400,1601870400,1
Adman32,0,1,0,2,1557288000,1557288000,1
inlinetriple17,0,1,0,1,1560657600,1560657600,1
BangkokCockBanger,0,1,0,-112,1593662400,1593662400,1
BamBamToxico,0,1,0,276,1607576400,1607576400,1
odawwg187,0,1,0,2,1578373200,1578373200,1
FieryGhosts,0,1,0,5,1595563200,1595563200,1
Chagrin_Exultation,0,1,0,3,1592020800,1592020800,1
Competitive-Donkey69,0,1,0,-4,1604984400,1604984400,1
Callumborn2,0,1,0,-1,1582779600,1582779600,1
bloatedTemplar,0,1,0,2,1565150400,1565150400,1
Cessabits,0,1,0,10,1592366400,1592366400,1
Oregongrown96,0,1,0,1,1599883200,1599883200,1
snypavat1,0,1,0,0,1594440000,1594440000,1
baeworth,0,1,0,2,1593576000,1593576000,1
dali_ocelot,1,0,74,0,1607835600,1607835600,1
tzenrick,0,1,0,4,1604984400,1604984400,1
smuckersbytylerr,0,1,0,1,1608699600,1608699600,1
notgoodatgrappling,0,1,0,1,1604379600,1604379600,1
ihavenoopalfruitonme,0,1,0,7,1575781200,1575781200,1
boognight22,0,1,0,1,1585022400,1585022400,1
flbreglass,0,1,0,0,1597118400,1597118400,1
DoggieDMB,0,1,0,1,1560916800,1560916800,1
paularindam_,0,1,0,1,1604030400,1604030400,1
ya_boi_dinosaur,0,1,0,1,1585454400,1585454400,1
mans3n,0,1,0,3,1601611200,1601611200,1
PacificGlacier,0,1,0,2,1586059200,1586059200,1
andrewkingswood,0,1,0,7,1575435600,1575435600,1
JustinDM_Speedruns,0,1,0,3,1581138000,1581138000,1
LadyLovesRoses,0,1,0,2,1611982800,1611982800,1
monk_of_amatka,0,1,0,7,1556251200,1556251200,1
DaSilence,0,1,0,-10,1605589200,1605589200,1
Anarchidi,0,1,0,9,1605070800,1605070800,1
RantAgainstTheMan,0,1,0,3,1598846400,1598846400,1
sirreginaldpoopypot,0,1,0,3,1612069200,1612069200,1
heldox_,0,1,0,3,1582088400,1582088400,1
Nemo_the_Pirate,0,1,0,1,1569902400,1569902400,1
Twagg,0,1,0,5,1592712000,1592712000,1
clbemrich,0,1,0,1,1596340800,1596340800,1
CYBORGMER,0,1,0,-10,1565755200,1565755200,1
asshat6983,0,1,0,1,1608267600,1608267600,1
shlabbiemilliams,0,1,0,3,1578632400,1578632400,1
calyboy,0,1,0,2,1607317200,1607317200,1
Mr_butt_touch,0,1,0,1,1580014800,1580014800,1
softball753,0,1,0,3,1603080000,1603080000,1
some_fake_doors_,0,1,0,-6,1598673600,1598673600,1
MrLeinmfveber,0,1,0,0,1598760000,1598760000,1
Sendooo,0,1,0,6,1566446400,1566446400,1
oryiesis,0,1,0,1,1605243600,1605243600,1
WomanBeaterMidir,0,1,0,6,1599364800,1599364800,1
RanceZero,0,1,0,5,1607058000,1607058000,1
TheNiteWolf,0,1,0,1,1584158400,1584158400,1
EltonFrimp,0,1,0,1,1608958800,1608958800,1
Omaraloro,0,1,0,15,1596686400,1596686400,1
cmhooley,0,1,0,1,1603512000,1603512000,1
LuDeRu,0,1,0,3,1596427200,1596427200,1
BossHogGA,0,1,0,1,1588737600,1588737600,1
Killer-Kitten,0,1,0,1,1606280400,1606280400,1
eatkrispykreme,0,1,0,48,1606885200,1606885200,1
Gingee777,0,1,0,8,1609218000,1609218000,1
ionowl,0,1,0,2,1609304400,1609304400,1
cooties_and_chaos,0,1,0,7,1592539200,1592539200,1
JBadleyy,0,1,0,2,1571803200,1571803200,1
IAmGeorgeClooneyAMA,0,1,0,4,1605762000,1605762000,1
dronemonk,0,1,0,3,1590638400,1590638400,1
Spartacus1958,1,0,2,0,1611982800,1611982800,1
hdwisnd,0,1,0,86,1583038800,1583038800,1
sindustrial777,0,1,0,2,1600747200,1600747200,1
geraldxxx78,0,1,0,1,1573966800,1573966800,1
godca_grema,0,1,0,1,1576645200,1576645200,1
drunksquirrel,0,1,0,5,1585281600,1585281600,1
NotSelfishFocused,0,1,0,1,1606453200,1606453200,1
hotpoopie,0,1,0,3,1611464400,1611464400,1
digibucc,0,1,0,2,1577422800,1577422800,1
thetinybirdie,0,1,0,9,1606280400,1606280400,1
cptndv23,0,1,0,1,1609304400,1609304400,1
SpartanxApathy,0,1,0,1,1592280000,1592280000,1
Cryonics-01,0,1,0,1,1608526800,1608526800,1
qodyn,0,1,0,1,1611550800,1611550800,1
Outrageous-Advertise,0,1,0,1,1608526800,1608526800,1
Supreme_Math_Debater,0,1,0,2,1602043200,1602043200,1
lifemisunderstood,0,1,0,2,1608181200,1608181200,1
ThousandQueerReich,0,1,0,0,1563854400,1563854400,1
461337679164376,0,1,0,27,1609218000,1609218000,1
Taxidriver98,0,1,0,2,1574917200,1574917200,1
Ammutse,0,1,0,1,1591675200,1591675200,1
Novel-Ad7357,0,1,0,0,1608699600,1608699600,1
Chris_MS99,0,1,0,3,1585368000,1585368000,1
MrAntipathique,0,1,0,2,1569729600,1569729600,1
goodtoknow92,0,1,0,1,1591243200,1591243200,1
LitesoBrite,0,1,0,26,1606453200,1606453200,1
goingnowherespecial,0,1,0,41,1608094800,1608094800,1
fierfek66,0,1,0,1,1605243600,1605243600,1
inoffensive1,0,1,0,19,1508644800,1508644800,1
XxSMCxX1587,0,1,0,-2,1606626000,1606626000,1
ThePsychoticBanana,0,1,0,19,1599105600,1599105600,1
romancingthevoid,0,1,0,51,1607662800,1607662800,1
xkcd_transcriber,0,1,0,1,1467864000,1467864000,1
Ginkpirate,0,1,0,1,1607230800,1607230800,1
throwaway-understudy,0,1,0,11,1568088000,1568088000,1
themonkrat,0,1,0,10,1596427200,1596427200,1
FM98_GHIF,0,1,0,1,1591329600,1591329600,1
pat_the_giraffe,0,1,0,0,1609390800,1609390800,1
xmcya,1,0,47,0,1557460800,1557460800,1
eikhorn,0,1,0,5,1609045200,1609045200,1
TrashyMcTrashacct,0,1,0,10,1601611200,1601611200,1
scifiandboardgames,0,1,0,1,1584244800,1584244800,1
jaymejackson,0,1,0,3,1601870400,1601870400,1
viva777,0,1,0,17,1579582800,1579582800,1
magnificentmemer,0,1,0,2,1579323600,1579323600,1
Plasticover,0,1,0,1,1482469200,1482469200,1
fouronebrew,0,1,0,7,1564632000,1564632000,1
drdeathmetal,1,0,5,0,1583470800,1583470800,1
AmyCee20,0,1,0,1,1592798400,1592798400,1
fiftynine_,0,1,0,8,1603598400,1603598400,1
ItIsntMolly,0,1,0,4,1600228800,1600228800,1
feshuansauca,0,1,0,1,1578459600,1578459600,1
forensikat,0,1,0,2,1573707600,1573707600,1
Meromero73,1,0,41,0,1584763200,1584763200,1
TheVoiceOverDude,0,1,0,7,1584763200,1584763200,1
throwaway37157941313,0,1,0,2,1598328000,1598328000,1
KetchupPackets5,0,1,0,7,1577509200,1577509200,1
hidehken,0,1,0,2,1583211600,1583211600,1
yoloGolf,0,1,0,2,1602734400,1602734400,1
Rovinovic,0,1,0,25,1592107200,1592107200,1
HIITMAN69,0,1,0,2,1590984000,1590984000,1
atgmailcom,0,1,0,1,1601006400,1601006400,1
AverageSinner,0,1,0,1,1581915600,1581915600,1
BendQueasy,1,0,1056,0,1612069200,1612069200,1
paisleyhaze,0,1,0,7,1580792400,1580792400,1
samderose,0,1,0,8,1603339200,1603339200,1
CUNT_ERADICATOR,0,1,0,4,1606021200,1606021200,1
90bronco,0,1,0,3,1584763200,1584763200,1
thoughtVomiter,1,0,24,0,1599451200,1599451200,1
Saucermote,0,1,0,16,1612155600,1612155600,1
doctorjinxmd,0,1,0,57,1609477200,1609477200,1
Mikeybarnes,0,1,0,0,1605934800,1605934800,1
Wonderful_Physics,0,1,0,12,1576990800,1576990800,1
Faisalz332,0,1,0,3,1572843600,1572843600,1
fixedfree,1,0,108,0,1557460800,1557460800,1
meccanismi,0,1,0,31,1608699600,1608699600,1
CollectableRat,0,1,0,-38,1587441600,1587441600,1
killerfistlee,0,1,0,1,1582779600,1582779600,1
snuggiemclovin,0,1,0,44,1595476800,1595476800,1
clockworkcocksack,0,1,0,1,1585454400,1585454400,1
Vulture051,0,1,0,6,1606021200,1606021200,1
Ncit3,0,1,0,4,1600660800,1600660800,1
Wary_beary,0,1,0,24,1609304400,1609304400,1
Painter_Horror,0,1,0,0,1606280400,1606280400,1
rnobgyn,0,1,0,1,1605070800,1605070800,1
ExpertDonut,0,1,0,2,1585540800,1585540800,1
Spaciax,0,1,0,1,1608699600,1608699600,1
Mayniac182,0,1,0,76,1587614400,1587614400,1
Dereck_W,0,1,0,1,1597204800,1597204800,1
Yaboionthesticka,0,1,0,10,1571976000,1571976000,1
MrTristanClark,0,1,0,-6,1584763200,1584763200,1
HHG6511,0,1,0,1,1588305600,1588305600,1
rAzZLedAzzLIciOUs,0,1,0,8,1601265600,1601265600,1
half-blonde-princess,0,1,0,25,1563508800,1563508800,1
CrommVardek,0,1,0,-3,1603425600,1603425600,1
Chemical_Secretary_6,1,0,0,0,1612155600,1612155600,1
quackersthursday,1,0,47,0,1608613200,1608613200,1
TheMania,0,1,0,1,1573534800,1573534800,1
BarronRhett,0,1,0,39,1571630400,1571630400,1
Little_Elia,0,1,0,4,1573362000,1573362000,1
pooper1978,0,1,0,1,1612069200,1612069200,1
skredditt,0,1,0,4,1588996800,1588996800,1
Pupsker,0,1,0,2,1603512000,1603512000,1
Nevilletraine,0,1,0,2,1603598400,1603598400,1
steezefabreeze,0,1,0,1,1611982800,1611982800,1
JoshiRaez,0,1,0,2,1554091200,1554091200,1
CadenceNeko,0,1,0,2,1571803200,1571803200,1
bruhimtripping,0,1,0,8,1588910400,1588910400,1
booyaabooshaw,0,1,0,1,1606626000,1606626000,1
atastefulwaterbottle,0,1,0,2,1603080000,1603080000,1
stacebrace,0,1,0,7,1605070800,1605070800,1
mcpickems,0,1,0,-1,1589601600,1589601600,1
inthenameofdopamine,0,1,0,2,1605502800,1605502800,1
rocketpeace1,0,1,0,34,1577768400,1577768400,1
ThineFail,0,1,0,2,1589774400,1589774400,1
BeardofFrankenstein,0,1,0,9,1543381200,1543381200,1
TripleOrgasm,0,1,0,2,1540785600,1540785600,1
Gwynzyy,0,1,0,7,1605416400,1605416400,1
amirof1,0,1,0,2,1582779600,1582779600,1
wageslawe,0,1,0,1,1586664000,1586664000,1
WorkCentre5335,0,1,0,5,1603598400,1603598400,1
thelegopharaoh,0,1,0,2,1582174800,1582174800,1
cheesyellowdischarge,0,1,0,1,1608267600,1608267600,1
SatansAvocado,0,1,0,1,1561435200,1561435200,1
ztsmart,0,1,0,-1,1556596800,1556596800,1
Nhierophant,0,1,0,2,1572494400,1572494400,1
bigpeenplayerbaby,0,1,0,1,1606626000,1606626000,1
PoisonOkie,0,1,0,1,1604379600,1604379600,1
Anhydrous_NaCl,0,1,0,6,1609563600,1609563600,1
Sushi_Roll_73,0,1,0,1,1600488000,1600488000,1
Straightupscrambled,0,1,0,5,1609131600,1609131600,1
j_ratgeb,1,0,15,0,1515733200,1515733200,1
teenagelonar,0,1,0,1,1606712400,1606712400,1
Fantastica4077,0,1,0,5,1601611200,1601611200,1
rainelle95,0,1,0,4,1597809600,1597809600,1
official_caligula,0,1,0,-2,1611982800,1611982800,1
Uzasodinson,0,1,0,13,1585454400,1585454400,1
kskdjdjdjdkdkdjd,0,1,0,0,1595908800,1595908800,1
pfromfivfbiuavd,0,1,0,2,1605589200,1605589200,1
Theschyisfalling,0,1,0,6,1569384000,1569384000,1
DoomGuy66,0,1,0,1,1584936000,1584936000,1
Imsirlsynotamonkey,0,1,0,37,1608786000,1608786000,1
arnorath,0,1,0,93,1605330000,1605330000,1
Oxanascorpion,0,1,0,2,1566964800,1566964800,1
shitredo,0,1,0,1,1601438400,1601438400,1
YoMammaUgly,0,1,0,1,1580014800,1580014800,1
thebloodflower,0,1,0,2,1607144400,1607144400,1
Where-Egirls-Dare,0,1,0,12,1602734400,1602734400,1
crazykylaa,1,0,167,0,1580187600,1580187600,1
fUll951,0,1,0,1,1611896400,1611896400,1
adjones,0,1,0,1,1576213200,1576213200,1
dstensuna,0,1,0,1,1555387200,1555387200,1
JesusInVegas,0,1,0,25,1606971600,1606971600,1
kvaughn76,0,1,0,4,1548997200,1548997200,1
ClarSco,0,1,0,27,1598068800,1598068800,1
PWH3_NYC,1,0,269,0,1600056000,1600056000,1
XXMAVR1KXX,0,1,0,1,1573534800,1573534800,1
karmaportrait,0,1,0,16,1606798800,1606798800,1
KidUnique161,0,1,0,3,1603857600,1603857600,1
alexius339,0,1,0,1,1616385600,1616385600,1
wheezy_cheese,0,1,0,1,1603080000,1603080000,1
uncreativivity,0,1,0,25,1600315200,1600315200,1
GrumpyCrouton,0,1,0,13,1605070800,1605070800,1
ratloverr,0,1,0,14,1597032000,1597032000,1
NoOneNumber9,0,1,0,5,1601611200,1601611200,1
theunknowncomrade,0,1,0,37,1575176400,1575176400,1
Ramacher,0,1,0,1,1610082000,1610082000,1
cookieexpertuser,0,1,0,1,1593489600,1593489600,1
lil_witchling,0,1,0,2,1561176000,1561176000,1
Tenshik,0,1,0,2,1593921600,1593921600,1
p_cool_guy,0,1,0,-2,1584763200,1584763200,1
Krikkits,0,1,0,8,1598068800,1598068800,1
personparty,0,1,0,4,1605762000,1605762000,1
doafnuts,0,1,0,2,1561089600,1561089600,1
throwaway_viii,0,1,0,13,1601870400,1601870400,1
thestonedbandit,0,1,0,45,1598587200,1598587200,1
Pokeypokeypoke,0,1,0,5,1602820800,1602820800,1
CunningRunt,0,1,0,9,1581310800,1581310800,1
withaining,0,1,0,6,1601438400,1601438400,1
PhizzyP99,0,1,0,21,1606280400,1606280400,1
mclitch,0,1,0,1,1589256000,1589256000,1
tokyopeachgirl,0,1,0,1,1584763200,1584763200,1
Aktion-L,0,1,0,8,1604030400,1604030400,1
abeardedblacksmith,0,1,0,2,1553313600,1553313600,1
Oregonguy3,0,1,0,2,1592193600,1592193600,1
ochungochdum,0,1,0,1,1569384000,1569384000,1
sol97xyz,0,1,0,5,1580014800,1580014800,1
Mr_Cook1324,0,1,0,2,1604379600,1604379600,1
username_liets,0,1,0,3,1598673600,1598673600,1
droppedsignal,0,1,0,-1,1608354000,1608354000,1
NoBarkAllBite,0,1,0,2,1596600000,1596600000,1
notcomingslow,0,1,0,8,1572580800,1572580800,1
iwviw,0,1,0,8,1569124800,1569124800,1
Withnails,1,0,66,0,1570420800,1570420800,1
celtssoxpat,1,0,40,0,1604898000,1604898000,1
Anthemusa831,0,1,0,1,1604293200,1604293200,1
YomiGimoY,0,1,0,1,1604030400,1604030400,1
ieathairpussy,0,1,0,3,1594612800,1594612800,1
ThrowRA73000,0,1,0,-13,1609304400,1609304400,1
Mike_Hunt_42069,0,1,0,11,1603684800,1603684800,1
ruchenn,1,0,37,0,1599364800,1599364800,1
kmfdm1974,0,1,0,3,1604466000,1604466000,1
simonio11,0,1,0,5,1581224400,1581224400,1
donbesodumb,0,1,0,1,1599019200,1599019200,1
antelopecantelop,0,1,0,1,1608786000,1608786000,1
Yayo69420,0,1,0,-2,1567310400,1567310400,1
unhelpful_twat,0,1,0,9,1570075200,1570075200,1
brickshithouse6969,0,1,0,1,1591329600,1591329600,1
ich_glaube,0,1,0,-2,1556510400,1556510400,1
themaratha,0,1,0,5,1605243600,1605243600,1
Coma94,0,1,0,1,1602129600,1602129600,1
Solkre,0,1,0,1,1602734400,1602734400,1
56and57,0,1,0,1,1569124800,1569124800,1
blyrehs,0,1,0,1,1637125200,1637125200,1
lordlicorice,0,1,0,0,1601956800,1601956800,1
WeJustWantOurMaps,0,1,0,3,1608613200,1608613200,1
MyNameIdeaWasTaken,0,1,0,2,1602820800,1602820800,1
Handyman_07,0,1,0,1,1603080000,1603080000,1
Ebassett101,0,1,0,55,1566878400,1566878400,1
wrenskibaby,0,1,0,10,1582779600,1582779600,1
joeChump,0,1,0,62,1607403600,1607403600,1
endlessbummmer,1,0,16,0,1593403200,1593403200,1
AmbitiousInterest0,0,1,0,1,1604811600,1604811600,1
donutmogul,0,1,0,3,1598328000,1598328000,1
Ashenox,0,1,0,4,1596427200,1596427200,1
Marius7th,0,1,0,3,1608440400,1608440400,1
thediesel26,0,1,0,6,1603512000,1603512000,1
whizzdome,0,1,0,1,1607749200,1607749200,1
Test0styrone,0,1,0,4,1561348800,1561348800,1
mdgang,0,1,0,1,1591243200,1591243200,1
rRavage,0,1,0,5,1612242000,1612242000,1
Crazy-Yoghurt-5410,0,1,0,5,1612069200,1612069200,1
skirtstr,0,1,0,2,1608267600,1608267600,1
Lord_Abort,0,1,0,5,1555473600,1555473600,1
Murrrtits,0,1,0,-2,1591243200,1591243200,1
AdventurousSeaweed88,0,1,0,1,1602129600,1602129600,1
SenorSplashdamage,0,1,0,5,1578373200,1578373200,1
Scar-Paci,0,1,0,-3,1585454400,1585454400,1
AdministrationSoft92,1,0,11,0,1612069200,1612069200,1
K_U,0,1,0,1,1608181200,1608181200,1
wvxx_,0,1,0,2,1560225600,1560225600,1
GloriousReign,0,1,0,1,1599278400,1599278400,1
lanceforehand,0,1,0,2,1564027200,1564027200,1
frostysnowmen,0,1,0,5,1602388800,1602388800,1
turbo_stealth,1,0,5,0,1607576400,1607576400,1
Throwmebaraway,1,0,29,0,1538884800,1538884800,1
CosmicVibrations,0,1,0,-4,1605589200,1605589200,1
Kahlessandro,0,1,0,3,1605330000,1605330000,1
WankGonJin,0,1,0,-5,1605243600,1605243600,1
doenietzomoeilijk,0,1,0,1,1605243600,1605243600,1
shivansh2524,0,1,0,1,1594008000,1594008000,1
ADimwittedTree,0,1,0,10,1581915600,1581915600,1
LeastIHaveChicken,0,1,0,7,1603512000,1603512000,1
morbowillcrushyou,0,1,0,1,1596772800,1596772800,1
wordsmatteror_w_e,0,1,0,5,1576040400,1576040400,1
Gunnercel,0,1,0,-11,1583125200,1583125200,1
Hurricanewisdom,0,1,0,2,1608613200,1608613200,1
ScIONSSB,0,1,0,3,1608526800,1608526800,1
Japaliicious,0,1,0,193,1598846400,1598846400,1
Joe4913,0,1,0,5,1594353600,1594353600,1
2skunks1cup,0,1,0,3,1573880400,1573880400,1
TripleT-KA,0,1,0,1,1608872400,1608872400,1
AlpsClimber_,0,1,0,1,1599019200,1599019200,1
Prestigious-Fly4248,1,0,0,0,1602907200,1602907200,1
jerkenstine,0,1,0,15,1568260800,1568260800,1
owen1410,0,1,0,1,1589860800,1589860800,1
acearchivist,0,1,0,4,1594008000,1594008000,1
Tyler9297,0,1,0,8,1600833600,1600833600,1
Lickyostuff,0,1,0,2,1578459600,1578459600,1
Atomic_Chad,0,1,0,9,1604379600,1604379600,1
FreedomMurky4913,0,1,0,1,1608958800,1608958800,1
It_is_a_truth,0,1,0,5,1611896400,1611896400,1
Belmish,0,1,0,8,1574917200,1574917200,1
srefermat,0,1,0,3,1605675600,1605675600,1
kingcal,0,1,0,10,1593230400,1593230400,1
g00nbags,0,1,0,1,1614574800,1614574800,1
BadBoyWithABumbag,0,1,0,1,1589947200,1589947200,1
nsoitgoze,0,1,0,1,1624593600,1624593600,1
superscout,0,1,0,1,1582088400,1582088400,1
Kintarly,0,1,0,1,1598068800,1598068800,1
KiloBravo44,0,1,0,3,1607835600,1607835600,1
haiuhboosa,0,1,0,1,1608613200,1608613200,1
ooooofda,0,1,0,5,1604811600,1604811600,1
_heybuddy_,0,1,0,1,1571976000,1571976000,1
IanFlemingRedux,0,1,0,2,1591329600,1591329600,1
i_will_let_you_know,0,1,0,1,1568001600,1568001600,1
Fallentitan98,0,1,0,-2,1607576400,1607576400,1
CriminalScum33,0,1,0,6,1599883200,1599883200,1
mygodshessohot,0,1,0,1,1596772800,1596772800,1
JurassicP0rk,0,1,0,15,1589342400,1589342400,1
DysonDad,0,1,0,1,1592539200,1592539200,1
jessixa-,1,0,548,0,1608181200,1608181200,1
BovieVei,0,1,0,4,1591243200,1591243200,1
Michaelz926,0,1,0,-2,1612069200,1612069200,1
the_internet_is_cool,0,1,0,10,1571457600,1571457600,1
gliz5714,0,1,0,1,1603512000,1603512000,1
abadhabitinthemaking,0,1,0,14,1547182800,1547182800,1
jrowleyxi,0,1,0,1,1604984400,1604984400,1
mrcoffee8,0,1,0,0,1607576400,1607576400,1
dashisdank,0,1,0,24,1577854800,1577854800,1
DreamWithinAMatrix,0,1,0,2,1603598400,1603598400,1
EddieBr0ck616,0,1,0,1,1621742400,1621742400,1
SMP750,0,1,0,-9,1577336400,1577336400,1
JustArmadillo5,0,1,0,5,1591675200,1591675200,1
threepodpeas,0,1,0,1,1612328400,1612328400,1
Papa_Ursidae,1,0,37,0,1560484800,1560484800,1
cruggero22,0,1,0,1,1608699600,1608699600,1
Naniali123,0,1,0,10,1588737600,1588737600,1
Samuelf89,0,1,0,1,1608267600,1608267600,1
FLABCAKE,0,1,0,4,1603598400,1603598400,1
grassisgreen8,0,1,0,2,1599710400,1599710400,1
AllDogsGoToDevin,0,1,0,15,1603339200,1603339200,1
CombustibleShotgun,0,1,0,4,1607576400,1607576400,1
GreenHausFleur,0,1,0,13,1605934800,1605934800,1
fabedays1k,0,1,0,1,1605848400,1605848400,1
Lucius_V,0,1,0,0,1606885200,1606885200,1
hjh5353,0,1,0,2,1560744000,1560744000,1
catmampbell,0,1,0,5,1570507200,1570507200,1
thowaway11486,0,1,0,5,1560052800,1560052800,1
Wa1t_Wh4t_wh3N,0,1,0,3,1604552400,1604552400,1
merlincat007,0,1,0,6,1550552400,1550552400,1
Onlyastronaut,0,1,0,5,1579928400,1579928400,1
The_Nekrodahmus,0,1,0,1,1578373200,1578373200,1
Romaltaufiq,0,1,0,1,1597809600,1597809600,1
Ms-Anon-Y-Mous,0,1,0,2,1608008400,1608008400,1
TomDankEngine,0,1,0,13,1573534800,1573534800,1
Doug3Reid,0,1,0,3,1605502800,1605502800,1
SeneInSPAAACE,0,1,0,2,1596772800,1596772800,1
wolvesonsaturn,0,1,0,5,1582952400,1582952400,1
datthepirate,0,1,0,1,1595476800,1595476800,1
Dreadnova_Darius,0,1,0,12,1561780800,1561780800,1
Destroyerofwookies,0,1,0,7,1581656400,1581656400,1
balrog687,0,1,0,10,1590984000,1590984000,1
PM_ME_WEALTH_ADVICE,0,1,0,2,1549083600,1549083600,1
AcornTits,0,1,0,3,1603512000,1603512000,1
rubyginger,0,1,0,1,1563163200,1563163200,1
EisVisage,0,1,0,5,1604811600,1604811600,1
DSynergy,0,1,0,5,1607317200,1607317200,1
alcatrazcgp,0,1,0,8,1585281600,1585281600,1
infpdumbass,0,1,0,1,1611982800,1611982800,1
deyazfootball,1,0,8,0,1612155600,1612155600,1
deathtoislam2020,0,1,0,1,1559793600,1559793600,1
AXone1814,0,1,0,1,1582347600,1582347600,1
pragueyboi,0,1,0,9,1571371200,1571371200,1
Wageslave4lyfe,0,1,0,7,1584676800,1584676800,1
2wheel-enthusiast,0,1,0,2,1594785600,1594785600,1
Roko__,0,1,0,-8,1579323600,1579323600,1
babycreature,0,1,0,2,1601352000,1601352000,1
ExperienceGas,0,1,0,-1,1601179200,1601179200,1
alainaredburn,1,0,1,0,1539921600,1539921600,1
Anishiriwan,0,1,0,2,1590552000,1590552000,1
depranxiousenergy,0,1,0,2,1606971600,1606971600,1
stanktardo69,0,1,0,-2,1604466000,1604466000,1
FakeGamerGurl,0,1,0,1,1552449600,1552449600,1
zcook7904,0,1,0,0,1589256000,1589256000,1
Chowboi,0,1,0,12,1573448400,1573448400,1
CognitiveDissident7,0,1,0,2,1572930000,1572930000,1
transmothra,0,1,0,6,1611896400,1611896400,1
dc2015bd,0,1,0,3,1605070800,1605070800,1
adrockdc,0,1,0,3,1604898000,1604898000,1
lostintime000,0,1,0,2,1607058000,1607058000,1
blackm00r,0,1,0,5,1566187200,1566187200,1
letsgetthisbread1273,0,1,0,2,1564977600,1564977600,1
DeathOnTheSpot,0,1,0,24,1608181200,1608181200,1
ItsNawtSeek,0,1,0,5,1570161600,1570161600,1
Diogenes81,0,1,0,3,1576299600,1576299600,1
Yoboijossi,0,1,0,2,1577941200,1577941200,1
pyrrhicvictorylap,0,1,0,1,1611982800,1611982800,1
Minato56,0,1,0,-25,1583557200,1583557200,1
Seacrux,0,1,0,2,1605762000,1605762000,1
viciousdisposition,0,1,0,2,1582779600,1582779600,1
TiberiusMars,0,1,0,1,1609390800,1609390800,1
naew13,0,1,0,2,1567396800,1567396800,1
Fr0stWo1f,0,1,0,4,1567051200,1567051200,1
KhajiitHasSkooma,0,1,0,19,1585022400,1585022400,1
Ser_Pr1ze,0,1,0,3,1578286800,1578286800,1
Lazy_davey707,0,1,0,1,1598414400,1598414400,1
-The_Drucifer-,0,1,0,2,1573275600,1573275600,1
_WalRussian_,0,1,0,41,1564459200,1564459200,1
DiamondsandtheMarina,0,1,0,0,1608786000,1608786000,1
cameocream,0,1,0,2,1606626000,1606626000,1
KarlMarxButVegan,0,1,0,2,1597377600,1597377600,1
heyo1234,0,1,0,1,1585454400,1585454400,1
potatoking37,1,0,480,0,1574139600,1574139600,1
mr-capital-c,0,1,0,-4,1612069200,1612069200,1
pdog8000,0,1,0,11,1552449600,1552449600,1
lairdisonfire,0,1,0,4,1570766400,1570766400,1
JMountain26,0,1,0,4,1587355200,1587355200,1
1192634165913457,0,1,0,2,1575694800,1575694800,1
Frequent_Ad_4216,0,1,0,1,1634270400,1634270400,1
Juan4yerlife,0,1,0,2,1578978000,1578978000,1
R0GU3PVNDV,0,1,0,18,1561608000,1561608000,1
elpachuquito,0,1,0,34,1608958800,1608958800,1
hantu_tiga_satu,0,1,0,4,1606971600,1606971600,1
ngkn92,0,1,0,5,1603425600,1603425600,1
58working,0,1,0,4,1554782400,1554782400,1
katsalion,0,1,0,27,1585713600,1585713600,1
Patterson9191717,1,0,52,0,1590379200,1590379200,1
boyplz3,0,1,0,1,1598587200,1598587200,1
Daedalus871,0,1,0,6,1586836800,1586836800,1
NahDude_Nah,0,1,0,21,1598760000,1598760000,1
StupidMoniker,0,1,0,2,1550638800,1550638800,1
Kazakas,0,1,0,2,1590206400,1590206400,1
OPs_Mom_and_Dad,0,1,0,140,1578286800,1578286800,1
Total_Bug_4062,1,0,50,0,1608094800,1608094800,1
Ms_Sommersby,0,1,0,1,1601352000,1601352000,1
Paladin5890,0,1,0,3,1593576000,1593576000,1
exclamationpointttt,0,1,0,1,1608526800,1608526800,1
Morphenominal,0,1,0,2,1600488000,1600488000,1
TheRune,0,1,0,6,1595131200,1595131200,1
theverbsterbes,0,1,0,0,1606626000,1606626000,1
Fruitcake36,1,0,14,0,1587787200,1587787200,1
getrektson69,0,1,0,0,1571716800,1571716800,1
Capable_Examination,0,1,0,1,1588824000,1588824000,1
LeonardoDaTiddies,0,1,0,3,1597204800,1597204800,1
ajwubbin,0,1,0,-4,1571976000,1571976000,1
dcl32,0,1,0,7,1542517200,1542517200,1
bywhooo,1,0,16,0,1606280400,1606280400,1
1tigolebitties1,0,1,0,1,1605934800,1605934800,1
Pennnel,0,1,0,225,1605070800,1605070800,1
Kozmec,0,1,0,12,1607662800,1607662800,1
Eyedema,0,1,0,2,1579842000,1579842000,1
andysaurus_rex,0,1,0,13,1585454400,1585454400,1
betterthansadrda,0,1,0,8,1606885200,1606885200,1
Boopy123562i,0,1,0,1,1601092800,1601092800,1
vagarik,0,1,0,12,1568001600,1568001600,1
thefuckulookenat,0,1,0,1,1600574400,1600574400,1
tgg11,0,1,0,8,1593835200,1593835200,1
DoubleDrewski,0,1,0,5,1595390400,1595390400,1
heelek,0,1,0,58,1590984000,1590984000,1
waynology,1,0,9,0,1581656400,1581656400,1
lurkerfox,0,1,0,1,1598932800,1598932800,1
velacreations,0,1,0,1,1465963200,1465963200,1
torondir77,0,1,0,1,1598760000,1598760000,1
6daddybonez,0,1,0,1,1597204800,1597204800,1
smashythyfashy,0,1,0,19,1561953600,1561953600,1
SuckMyRhubarb,0,1,0,97,1600401600,1600401600,1
August_28th,1,0,63,0,1581138000,1581138000,1
method__Dan,0,1,0,12,1598760000,1598760000,1
beargrimzly,0,1,0,3,1572235200,1572235200,1
NH2486,0,1,0,-10,1599019200,1599019200,1
superfriends92,0,1,0,7,1600660800,1600660800,1
ClearHouse6,0,1,0,11,1586836800,1586836800,1
tmotom,0,1,0,3,1561435200,1561435200,1
MarxIsARussianAsset,0,1,0,1,1600228800,1600228800,1
Rau_Le-Creuset,1,0,78,0,1595995200,1595995200,1
pagesniffer,0,1,0,2,1563249600,1563249600,1
bibbidybum,0,1,0,4,1585195200,1585195200,1
recigar,0,1,0,0,1601352000,1601352000,1
cptpegbeard,0,1,0,2,1583125200,1583125200,1
ExceedinglyGayDuck,0,1,0,7,1600920000,1600920000,1
MiTrouavei,0,1,0,2,1569988800,1569988800,1
galkatokk,0,1,0,1,1606885200,1606885200,1
PokemonBreederAJ,0,1,0,8,1593057600,1593057600,1
Elevryn,0,1,0,8,1582779600,1582779600,1
ThirteenAreBastards,1,0,110,0,1595822400,1595822400,1
housemusick,0,1,0,0,1588046400,1588046400,1
dietacoca,0,1,0,1,1581224400,1581224400,1
achoe2,0,1,0,-6,1553140800,1553140800,1
jingrokku,0,1,0,6,1601352000,1601352000,1
nostopthoughts,0,1,0,-8,1576818000,1576818000,1
ashigarualex,0,1,0,2,1588478400,1588478400,1
apyrrypa,0,1,0,1,1608786000,1608786000,1
aroaroa08,0,1,0,1,1609477200,1609477200,1
Eternal-Wonderer,0,1,0,7,1608872400,1608872400,1
DERPorDIE,0,1,0,4,1603684800,1603684800,1
Honest8Bob,0,1,0,3,1606539600,1606539600,1
Giirth_Brooks,0,1,0,3,1572062400,1572062400,1
yeboidouwe,0,1,0,7,1598932800,1598932800,1
Faith3lizabeth,0,1,0,300,1597636800,1597636800,1
Nubasu,0,1,0,9,1611810000,1611810000,1
seiyayamata,0,1,0,8,1604725200,1604725200,1
bingbong-hello,0,1,0,1,1597723200,1597723200,1
Dabugar,0,1,0,0,1601179200,1601179200,1
Wonderful_Success,0,1,0,-1,1585368000,1585368000,1
HermesIII34,0,1,0,10,1607144400,1607144400,1
muckdog13,0,1,0,1,1605675600,1605675600,1
RedCorundum,0,1,0,3,1612328400,1612328400,1
games4ames,0,1,0,2,1593662400,1593662400,1
camstarrankin,1,0,17,0,1594612800,1594612800,1
bonafart,0,1,0,-2,1589774400,1589774400,1
SullivantheBoss,0,1,0,11,1588478400,1588478400,1
hot_chem,0,1,0,2,1595304000,1595304000,1
HeThatGreetsWithFire,0,1,0,13,1608354000,1608354000,1
ThisGuyMightGetIt,0,1,0,4,1602820800,1602820800,1
mrmiyagi84,0,1,0,27,1592366400,1592366400,1
CrunchyDreads,0,1,0,18,1607576400,1607576400,1
glorreich,0,1,0,12,1563768000,1563768000,1
scrambler_guy,0,1,0,5,1611982800,1611982800,1
Morcafe,0,1,0,41,1600660800,1600660800,1
ramsesbc,0,1,0,2,1604898000,1604898000,1
newuseraccount2w24,0,1,0,1,1563854400,1563854400,1
seanslaysean,0,1,0,1,1591243200,1591243200,1
AmandaKay0831,0,1,0,14,1554091200,1554091200,1
HaveN448,0,1,0,2,1569470400,1569470400,1
crispycrabpizza,0,1,0,833,1601092800,1601092800,1
porcupine-free,0,1,0,7,1603425600,1603425600,1
fr33gnstinbl00m,0,1,0,1,1611982800,1611982800,1
vhsprincess,0,1,0,5,1594094400,1594094400,1
GrandRedditor,1,0,10,0,1599105600,1599105600,1
asc24,0,1,0,20,1571630400,1571630400,1
Zarthen7,0,1,0,4,1643259600,1643259600,1
balthazar_nor,0,1,0,9,1606453200,1606453200,1
smoothea,1,0,0,0,1600660800,1600660800,1
aimless-audio,0,1,0,-6,1557806400,1557806400,1
hammadanees_99,1,0,0,0,1589515200,1589515200,1
turdBroth5000,0,1,0,2,1586923200,1586923200,1
instantghetto,0,1,0,1,1605157200,1605157200,1
jesusisjustalright,0,1,0,2,1593230400,1593230400,1
newagelove,0,1,0,14,1572753600,1572753600,1
Liljagare,0,1,0,3,1591329600,1591329600,1
JohnCarterofAres,1,0,18,0,1552276800,1552276800,1
jeddzeppelin,0,1,0,6,1604203200,1604203200,1
objeteh,0,1,0,1,1607317200,1607317200,1
vanvannz,0,1,0,3,1592625600,1592625600,1
Somni20,0,1,0,4,1609304400,1609304400,1
StephenSchleis,0,1,0,2,1556251200,1556251200,1
Deezley3,0,1,0,4,1605675600,1605675600,1
reeeeeflexes,0,1,0,1,1578373200,1578373200,1
JamesFerg650,0,1,0,1,1591329600,1591329600,1
titafe,0,1,0,-3,1587700800,1587700800,1
SterlingVapor,0,1,0,5,1570939200,1570939200,1
TheyCallMeHansel,0,1,0,18,1593403200,1593403200,1
Ziddix,0,1,0,1,1561694400,1561694400,1
bubbabear244,0,1,0,59,1593662400,1593662400,1
Sup3rSp1der620,0,1,0,1,1600142400,1600142400,1
Gravelord-_Nito,0,1,0,1,1585454400,1585454400,1
Ishuun,0,1,0,2,1579669200,1579669200,1
Gr0v3y,0,1,0,3,1562904000,1562904000,1
Killarny,0,1,0,3,1605157200,1605157200,1
SkippingRecord,0,1,0,1,1601352000,1601352000,1
cinclushibernicus,0,1,0,5,1575349200,1575349200,1
iBeWaRee,0,1,0,1,1603512000,1603512000,1
silverkingx2,0,1,0,5,1562817600,1562817600,1
darkangelx,0,1,0,3,1607922000,1607922000,1
LifeIsBizarre,0,1,0,163,1601611200,1601611200,1
mediumeasy,0,1,0,10,1602043200,1602043200,1
bastrdsnbroknthings,0,1,0,1,1609390800,1609390800,1
omoney256,0,1,0,1,1604116800,1604116800,1
PurpByThePound,0,1,0,2,1590120000,1590120000,1
kimjongunderdog,0,1,0,5,1565582400,1565582400,1
JBLikesHeavyMetal,0,1,0,2,1549515600,1549515600,1
Sonata_Arcticuno,0,1,0,3,1553572800,1553572800,1
rubyglue,0,1,0,3,1580965200,1580965200,1
Assaltwaffle,0,1,0,2,1585454400,1585454400,1
xnotacopx,0,1,0,0,1578373200,1578373200,1
torpor_of_dusk,1,0,21,0,1576645200,1576645200,1
I_KN0W_N0TH1NG,0,1,0,2,1597636800,1597636800,1
younglink28,0,1,0,2,1579669200,1579669200,1
AIMpb,0,1,0,3,1604030400,1604030400,1
Shlickneth,0,1,0,-23,1608181200,1608181200,1
RedditSucksEnormousD,0,1,0,5,1562817600,1562817600,1
BloodgazmNZL,0,1,0,2,1585454400,1585454400,1
TwoGrills,0,1,0,0,1584763200,1584763200,1
MagicAmnesiac,0,1,0,3,1597982400,1597982400,1
longlong1210,0,1,0,3,1598846400,1598846400,1
lizarny,0,1,0,1,1585454400,1585454400,1
dease42-2,0,1,0,6,1577854800,1577854800,1
bispinosa,0,1,0,1,1608786000,1608786000,1
Cheshire90,0,1,0,-5,1589601600,1589601600,1
blastradii,0,1,0,7,1603512000,1603512000,1
Appropriate_Figure_3,0,1,0,1,1613710800,1613710800,1
DasRaetsel,0,1,0,4,1590033600,1590033600,1
Nylund,0,1,0,3,1609304400,1609304400,1
HanSupreme,0,1,0,8,1577768400,1577768400,1
pissedantelope,0,1,0,1,1597723200,1597723200,1
grantbwilson,0,1,0,4,1599364800,1599364800,1
DubEnder,0,1,0,6,1577422800,1577422800,1
Thormidable,0,1,0,14,1561003200,1561003200,1
yololism,0,1,0,4,1601784000,1601784000,1
chevy1500,0,1,0,6,1585195200,1585195200,1
routinara,0,1,0,1,1606885200,1606885200,1
Fourseventy,0,1,0,2,1591243200,1591243200,1
fun24069,0,1,0,1,1608267600,1608267600,1
nep_999,0,1,0,2,1591588800,1591588800,1
banality_of_ervil,0,1,0,7,1580101200,1580101200,1
aka_Foamy,0,1,0,11,1591329600,1591329600,1
Ron3000,0,1,0,7,1600574400,1600574400,1
quarter_thief,0,1,0,112,1606626000,1606626000,1
boi_u_gey,1,0,0,0,1596081600,1596081600,1
miserablenb,0,1,0,1,1553745600,1553745600,1
jeffseadot,0,1,0,2,1580446800,1580446800,1
ChicagoMarket,0,1,0,1,1601438400,1601438400,1
UnfriendlyToast,0,1,0,1,1585454400,1585454400,1
RaaviRaviticus,0,1,0,1,1580533200,1580533200,1
Infantilefratercide,0,1,0,2,1588305600,1588305600,1
mikek3,0,1,0,4,1609390800,1609390800,1
slyshadow2018,0,1,0,3,1602734400,1602734400,1
Richard_Soars,0,1,0,8,1585108800,1585108800,1
UlfurGaming,0,1,0,1,1603598400,1603598400,1
ortakvommaroc,0,1,0,6,1592107200,1592107200,1
forgive_everything_,0,1,0,1,1596600000,1596600000,1
spazbastiann,1,0,0,0,1599105600,1599105600,1
blinkpanther,0,1,0,4,1598760000,1598760000,1
Surprisinglygoodish,0,1,0,1,1594267200,1594267200,1
kazacy,0,1,0,10,1603598400,1603598400,1
wannabeisraeli,0,1,0,6,1589169600,1589169600,1
booksmettte,1,0,1,0,1456635600,1456635600,1
kebabmonkey,0,1,0,-1,1608267600,1608267600,1
AmrikiYaqub,0,1,0,1,1605070800,1605070800,1
Cheesybox,0,1,0,8,1611982800,1611982800,1
notkatemoss,0,1,0,1,1601352000,1601352000,1
doc8,0,1,0,1,1589860800,1589860800,1
nago7650,0,1,0,1,1576645200,1576645200,1
justakuikskwiz,0,1,0,1,1579064400,1579064400,1
surely_not_erik,0,1,0,2,1603512000,1603512000,1
Rev_MossGatlin,0,1,0,1,1595304000,1595304000,1
ausernamethatistoolo,0,1,0,21,1575176400,1575176400,1
Deserted_Derserter,0,1,0,1,1591243200,1591243200,1
beautiful2228,0,1,0,7,1603512000,1603512000,1
SuperCyka,0,1,0,2,1606539600,1606539600,1
MustBeDTF-for-MBDTF,0,1,0,-1,1587009600,1587009600,1
Fletch71011,0,1,0,1,1550293200,1550293200,1
Lilly_1337,0,1,0,95,1605934800,1605934800,1
Chris_the13th,0,1,0,11,1581310800,1581310800,1
MateusMalice,0,1,0,191,1583211600,1583211600,1
masqu-the-turtle,0,1,0,149,1608872400,1608872400,1
hellianthum,0,1,0,5,1597291200,1597291200,1
_bruhtastic,0,1,0,1,1623038400,1623038400,1
Donlemonisretarded,0,1,0,1,1603512000,1603512000,1
A-Aron_Shaquiel,0,1,0,18,1584417600,1584417600,1
SelfAwareThoughts,0,1,0,1,1591243200,1591243200,1
bob_newhart_of_dixie,1,0,14,0,1598414400,1598414400,1
Rhona_Redtail,0,1,0,1,1606626000,1606626000,1
assman912,0,1,0,1,1605070800,1605070800,1
squaredInfinitesimal,0,1,0,5,1607230800,1607230800,1
Kazdanilicious,0,1,0,1,1599537600,1599537600,1
thewizard757,0,1,0,1,1569729600,1569729600,1
Packetnoodles,0,1,0,2,1591934400,1591934400,1
ignorediacritics,0,1,0,2,1555387200,1555387200,1
firesalmon7,0,1,0,1,1559102400,1559102400,1
WarmBaths,0,1,0,77,1585454400,1585454400,1
JadeLove17,0,1,0,13,1578632400,1578632400,1
Informal-View,0,1,0,32,1594180800,1594180800,1
ScavsArePeopleToo,0,1,0,1,1600660800,1600660800,1
kiramylordandmygod,0,1,0,6,1578027600,1578027600,1
Poundage2794,0,1,0,124,1580274000,1580274000,1
harmoniousmonday,0,1,0,8,1547010000,1547010000,1
obadiah24,0,1,0,3,1547787600,1547787600,1
erinwnr,0,1,0,29,1608440400,1608440400,1
xRichardCraniumx,0,1,0,5,1607490000,1607490000,1
Electrical-Job-9824,0,1,0,9,1604811600,1604811600,1
mclaughlin477,0,1,0,15,1559880000,1559880000,1
ZemyaSoldat,0,1,0,6,1605589200,1605589200,1
beginneratten,0,1,0,1,1603425600,1603425600,1
Dragovian,0,1,0,5,1562040000,1562040000,1
IvoryAS,0,1,0,3,1593576000,1593576000,1
Several_Elephant,0,1,0,-1,1587528000,1587528000,1
kageonist,0,1,0,12,1592193600,1592193600,1
inferno723,0,1,0,1,1606194000,1606194000,1
Aetra,0,1,0,1,1609390800,1609390800,1
figMtn,0,1,0,0,1640754000,1640754000,1
Vote_For_Caboose,0,1,0,3,1606107600,1606107600,1
Pope-Xancis,0,1,0,20,1569816000,1569816000,1
bvanevery,0,1,0,8,1602993600,1602993600,1
doenoe1992,0,1,0,18,1571371200,1571371200,1
Cactusthelion,0,1,0,8,1607490000,1607490000,1
redheadedgnomegirl,0,1,0,9,1584763200,1584763200,1
Young_Clean_Bastard,0,1,0,6,1603512000,1603512000,1
Redtex,0,1,0,-6,1600747200,1600747200,1
depressedbreakfast,0,1,0,-6,1598414400,1598414400,1
Peppermintmaddy,0,1,0,1,1556251200,1556251200,1
FixatedOnYourBeauty,0,1,0,1,1606539600,1606539600,1
wharlie,0,1,0,1,1606021200,1606021200,1
MetoyTheGuy,0,1,0,9,1609390800,1609390800,1
Jk14m,0,1,0,1,1603598400,1603598400,1
chainsawbobcat,0,1,0,9,1554436800,1554436800,1
luts-o,0,1,0,8,1563163200,1563163200,1
RasshuRasshu,1,0,13,0,1592539200,1592539200,1
helmetboy02,0,1,0,1,1579410000,1579410000,1
RoidParade,0,1,0,1,1579064400,1579064400,1
crownketer,0,1,0,6,1586750400,1586750400,1
andrestv,0,1,0,6,1609304400,1609304400,1
Cynical-Skin,0,1,0,3,1554609600,1554609600,1
Steve0848,0,1,0,0,1579064400,1579064400,1
mrm112,0,1,0,1,1608786000,1608786000,1
t-schrand,0,1,0,1,1605589200,1605589200,1
christianburns87,1,0,131,0,1515301200,1515301200,1
_PrimalKink_,0,1,0,1,1601524800,1601524800,1
nullsi,0,1,0,1,1603512000,1603512000,1
zestypesto,0,1,0,3,1600747200,1600747200,1
some-booty,0,1,0,1,1598155200,1598155200,1
Rowvan,0,1,0,1,1589083200,1589083200,1
TrenningEveryday,0,1,0,2,1581310800,1581310800,1
dicproles,0,1,0,1,1598846400,1598846400,1
slippery-fische,0,1,0,3,1611810000,1611810000,1
minimum_effort_,0,1,0,14,1601092800,1601092800,1
ProfaneHearts,0,1,0,34,1612155600,1612155600,1
BrattyLittlePunk,0,1,0,9,1611896400,1611896400,1
Grindl,0,1,0,2,1599019200,1599019200,1
IAmTaka_VG,0,1,0,75,1612069200,1612069200,1
WhatYouDoNowMatters,0,1,0,1,1591243200,1591243200,1
XXXCherry,0,1,0,1,1585281600,1585281600,1
IAmCaptainDolphin,0,1,0,2,1603512000,1603512000,1
persona118,0,1,0,1,1598155200,1598155200,1
LexiLaLa324,0,1,0,2,1611810000,1611810000,1
shipsaplenty,0,1,0,1,1596772800,1596772800,1
pandakatzu,0,1,0,1,1603512000,1603512000,1
LustStarrr,0,1,0,1,1606021200,1606021200,1
ilikemusictheory,0,1,0,2,1606194000,1606194000,1
Usernamealreadytakn1,0,1,0,13,1606712400,1606712400,1
youtubefactsbot,0,1,0,1,1475208000,1475208000,1
georgeyellow,0,1,0,2,1635912000,1635912000,1
ishd_wiwy,0,1,0,4,1574312400,1574312400,1
googlecacheguy,0,1,0,1,1460260800,1460260800,1
Lo2W96,0,1,0,2,1605502800,1605502800,1
thatwhinypeasant,0,1,0,1,1576818000,1576818000,1
DumbshitOnTheRight,0,1,0,1,1600574400,1600574400,1
mcgivro,0,1,0,-3,1577336400,1577336400,1
SkepticalGerm,0,1,0,0,1594872000,1594872000,1
DerjungeSonnenschein,0,1,0,2,1599364800,1599364800,1
darken_saga,0,1,0,1,1603512000,1603512000,1
brysonsmonson,0,1,0,1,1608958800,1608958800,1
amobogio,0,1,0,9,1606366800,1606366800,1
Argaos,0,1,0,1,1605589200,1605589200,1
atbenny,0,1,0,9,1598241600,1598241600,1
cucumbersfortheking,0,1,0,19,1576818000,1576818000,1
Candypeddler209,0,1,0,19,1590379200,1590379200,1
GanjaG,1,0,40,0,1605502800,1605502800,1
juzz85,0,1,0,3,1608181200,1608181200,1
Phuccyou,0,1,0,2,1594008000,1594008000,1
Insertclever_name,0,1,0,9,1576645200,1576645200,1
triciams,0,1,0,1,1570075200,1570075200,1
seedyrom247,0,1,0,5,1584158400,1584158400,1
FriendlySpinach420,0,1,0,5,1606021200,1606021200,1
darthmastertrapper,0,1,0,0,1582779600,1582779600,1
closetofcorgis,0,1,0,5,1603598400,1603598400,1
vegan_butt,0,1,0,6,1604811600,1604811600,1
MingeyMackrel,0,1,0,1,1595908800,1595908800,1
march9191,0,1,0,1,1604811600,1604811600,1
JaySmite,0,1,0,2,1600488000,1600488000,1
FilthyShoggoth,0,1,0,1,1603512000,1603512000,1
Floppygunt,0,1,0,3,1598068800,1598068800,1
ifragbunniez,0,1,0,1,1609563600,1609563600,1
ihateboringsex2020,0,1,0,12,1605502800,1605502800,1
jeffjeffersonthe3rd,0,1,0,4,1562299200,1562299200,1
lajaw,0,1,0,4,1578027600,1578027600,1
Bradythenarwhal,0,1,0,5,1611982800,1611982800,1
Cat_Conrad,0,1,0,1,1613970000,1613970000,1
Wildflower1144,0,1,0,1,1578978000,1578978000,1
jayembeisme,0,1,0,3,1611982800,1611982800,1
tkl93,0,1,0,112,1561694400,1561694400,1
Darkshadow0308,0,1,0,2,1603684800,1603684800,1
Spoonwrangler,0,1,0,2,1598760000,1598760000,1
Countcristo42,0,1,0,47,1587009600,1587009600,1
Reddokkanbruddah,0,1,0,2,1605502800,1605502800,1
TryThisTwiceTwice,0,1,0,-1,1582779600,1582779600,1
OkileyDokely,0,1,0,2,1602734400,1602734400,1
x_Serenity_x,0,1,0,2,1596772800,1596772800,1
GladdenFields,1,0,23,0,1608094800,1608094800,1
psychic_olympian,1,0,125,0,1599019200,1599019200,1
GlutamineQuestion,0,1,0,3,1607403600,1607403600,1
Cone_henge,0,1,0,3,1605330000,1605330000,1
Stories-With-Bears,0,1,0,6,1595390400,1595390400,1
CorporateHobo,1,0,4,0,1589947200,1589947200,1
ingressagent,0,1,0,1,1534478400,1534478400,1
Roflllobster,0,1,0,4,1594699200,1594699200,1
zamaar,0,1,0,2,1607922000,1607922000,1
mmob18,0,1,0,2,1592798400,1592798400,1
Tsurting,0,1,0,1,1606798800,1606798800,1
Dismal-Cranberry,0,1,0,12,1582002000,1582002000,1
Tri4Realz,0,1,0,38,1607490000,1607490000,1
guildoflilies,0,1,0,4,1588132800,1588132800,1
farchellme,1,0,5,0,1547874000,1547874000,1
Rab_Legend,0,1,0,1,1577854800,1577854800,1
AlaskaZooManiple,0,1,0,1,1597032000,1597032000,1
alex_0_0_0,0,1,0,2,1593057600,1593057600,1
mulahn,0,1,0,5,1585368000,1585368000,1
rsewateroily,0,1,0,2,1608440400,1608440400,1
renzuit,0,1,0,14,1587355200,1587355200,1
nsprxpr,0,1,0,9,1587528000,1587528000,1
SpaceZombieZed,1,0,46,0,1572235200,1572235200,1
blueswizzles,0,1,0,2,1552449600,1552449600,1
hansdampf17,0,1,0,2,1602734400,1602734400,1
BklynBrit,0,1,0,3,1600228800,1600228800,1
YTubeInfoBot,0,1,0,3,1539057600,1539057600,1
JohnWicksAnimeWaifu,0,1,0,28,1575435600,1575435600,1
acidicjazzhead,0,1,0,23,1603684800,1603684800,1
tomahawktomtom,0,1,0,1,1600574400,1600574400,1
chasingwildlife,0,1,0,26,1606280400,1606280400,1
harveydangerkid,0,1,0,1,1606021200,1606021200,1
Cei34,1,0,49,0,1515819600,1515819600,1
idonteven93,0,1,0,2,1577941200,1577941200,1
EverythngISayIsRight,0,1,0,7,1602648000,1602648000,1
teslaistheshit,0,1,0,19,1600660800,1600660800,1
random_turd,0,1,0,73,1607403600,1607403600,1
909sAndLifelines,0,1,0,0,1608267600,1608267600,1
Bannedfromthenet,1,0,66,0,1595822400,1595822400,1
Wtf_Its_John,0,1,0,0,1575003600,1575003600,1
IronColumn,0,1,0,7,1544763600,1544763600,1
eleat001,0,1,0,1,1602820800,1602820800,1
GucciGlocc,0,1,0,6,1602734400,1602734400,1
Anew20034,0,1,0,4,1588046400,1588046400,1
frankz33,0,1,0,1,1608526800,1608526800,1
cheesboy12,0,1,0,3,1582693200,1582693200,1
ChillWilliam,0,1,0,19,1577768400,1577768400,1
acctIMade,0,1,0,-2,1607662800,1607662800,1
SN0WFAKER,0,1,0,2,1603512000,1603512000,1
jvidal7247,0,1,0,11,1587614400,1587614400,1
Glytchrider,0,1,0,27,1592366400,1592366400,1
bigger-sigh,0,1,0,1,1597636800,1597636800,1
ryavco,0,1,0,-4,1566964800,1566964800,1
lizlingus,0,1,0,58,1599451200,1599451200,1
TManiatis,0,1,0,5,1597636800,1597636800,1
Chememistry,0,1,0,-2,1606539600,1606539600,1
liberalpete,0,1,0,1,1603512000,1603512000,1
Who_Cares-Anyway,0,1,0,0,1600660800,1600660800,1
JamieLaineRose,0,1,0,29,1567915200,1567915200,1
aerialgirl67,0,1,0,1,1641790800,1641790800,1
mario_butdepressed,0,1,0,2,1601179200,1601179200,1
tk8398,0,1,0,1,1591243200,1591243200,1
NoidedPotSmoker,0,1,0,9,1577422800,1577422800,1
alizacarter,1,0,0,0,1579496400,1579496400,1
benja_pink,0,1,0,3,1581915600,1581915600,1
vagabond202,0,1,0,1,1574139600,1574139600,1
Joshkovic,0,1,0,10,1576040400,1576040400,1
WhatRoughBeast73,0,1,0,2,1582779600,1582779600,1
dhfatty,0,1,0,53,1589860800,1589860800,1
Gplcc,0,1,0,4,1599105600,1599105600,1
eurikas,0,1,0,2,1588996800,1588996800,1
lgodsey,0,1,0,1,1606366800,1606366800,1
hyperlethalrabbit,0,1,0,2,1588824000,1588824000,1
spps10,0,1,0,4,1605675600,1605675600,1
Interpoli0,0,1,0,10,1591761600,1591761600,1
valdamjong,0,1,0,1,1605502800,1605502800,1
_tunainthebrine_,0,1,0,13,1600488000,1600488000,1
Airesigns,0,1,0,3,1603080000,1603080000,1
PotatoLevelTree,0,1,0,1,1600660800,1600660800,1
zabuza999,0,1,0,11,1607490000,1607490000,1
Hookah_bookah,0,1,0,6,1591243200,1591243200,1
unsurejunior,0,1,0,2,1611982800,1611982800,1
Mark-Stover,0,1,0,1,1542171600,1542171600,1
Choopster,0,1,0,-20,1599019200,1599019200,1
shapie_,0,1,0,29,1576645200,1576645200,1
sl0bbyb0bby,0,1,0,1,1600228800,1600228800,1
jurassicthot,0,1,0,9,1602648000,1602648000,1
Chriswheela,0,1,0,1,1603512000,1603512000,1
Platosuccs,0,1,0,4,1602734400,1602734400,1
functious,0,1,0,100,1574658000,1574658000,1
goggs_,0,1,0,5,1599969600,1599969600,1
quontexer,1,0,686,0,1600056000,1600056000,1
SimoneCabbage,0,1,0,3,1574744400,1574744400,1
JabroniAlmighty,0,1,0,4,1611982800,1611982800,1
Steber42,0,1,0,12,1601870400,1601870400,1
idle_voluptuary,0,1,0,1,1608872400,1608872400,1
CupOfChaffee,0,1,0,1,1565064000,1565064000,1
ProudBlackMatt,0,1,0,1,1578459600,1578459600,1
Relaxyourpants,0,1,0,1,1599883200,1599883200,1
trip115,0,1,0,14,1590811200,1590811200,1
Gr33nT1g3r,0,1,0,27,1571630400,1571630400,1
Poe1995,0,1,0,1,1591329600,1591329600,1
mynameiscarise1,0,1,0,1,1585627200,1585627200,1
blonderaider21,0,1,0,1,1578373200,1578373200,1
21Violets,0,1,0,2,1606885200,1606885200,1
resmi_,0,1,0,32,1607490000,1607490000,1
the66fastback1,0,1,0,2,1579150800,1579150800,1
Ob_Nosh,0,1,0,9,1598155200,1598155200,1
Dz6__Zt4,1,0,0,0,1455426000,1455426000,1
ochipapo,0,1,0,1,1572930000,1572930000,1
n0vapine,0,1,0,1,1594008000,1594008000,1
bubblegumkittenx,0,1,0,4,1605675600,1605675600,1
Mitchdotcom,0,1,0,147,1604984400,1604984400,1
Land_Tax,0,1,0,1,1609650000,1609650000,1
AshleighsAdvice,0,1,0,20,1606626000,1606626000,1
babyfacebobo,0,1,0,5,1608267600,1608267600,1
p3p3_sylvia,0,1,0,19,1607662800,1607662800,1
JidRK,0,1,0,8,1603598400,1603598400,1
plutos123,1,0,2,0,1571976000,1571976000,1
Madman5765,0,1,0,1,1582088400,1582088400,1
CliffLake,0,1,0,5,1605070800,1605070800,1
Abdaroth,0,1,0,7,1604811600,1604811600,1
aardapol,0,1,0,2,1591243200,1591243200,1
mr_no1,0,1,0,-33,1604203200,1604203200,1
oak_and_clover,0,1,0,23,1597550400,1597550400,1
lucille_2_is_NOT_a_b,0,1,0,7,1570075200,1570075200,1
porridge_boy11,0,1,0,17,1612069200,1612069200,1
sh3r4f,1,0,334,0,1592971200,1592971200,1
WhyNoLove5,0,1,0,1,1606626000,1606626000,1
real_BernieSanders,0,1,0,2,1581915600,1581915600,1
slendy_bends,0,1,0,2,1595822400,1595822400,1
dolan2736,0,1,0,0,1567051200,1567051200,1
planetes2020,0,1,0,7,1546750800,1546750800,1
oggardner,0,1,0,2,1608181200,1608181200,1
LIQUIDLARRY666,0,1,0,7,1572235200,1572235200,1
ForestRanger42,0,1,0,10,1580533200,1580533200,1
Remarkable_Try471,0,1,0,1,1602388800,1602388800,1
Divemasterjim,0,1,0,1,1585108800,1585108800,1
BollockSnot,0,1,0,1,1600747200,1600747200,1
SnarkyRaccoon,0,1,0,2,1568088000,1568088000,1
lolfcknmemethrowaway,0,1,0,26,1578200400,1578200400,1
jrcontreras18,0,1,0,1,1592798400,1592798400,1
ItJustGotRielle,0,1,0,3,1583643600,1583643600,1
CJPsalm139,0,1,0,7,1571371200,1571371200,1
dingogordy,0,1,0,63,1577422800,1577422800,1
Soruze,0,1,0,1,1610600400,1610600400,1
chilling89,0,1,0,-4,1605589200,1605589200,1
daaaaaaaaniel,0,1,0,1,1604293200,1604293200,1
platinumhandz,0,1,0,6,1609045200,1609045200,1
Tiredandinsatiable,0,1,0,4,1586836800,1586836800,1
DeepestWinterBlue,0,1,0,1,1606626000,1606626000,1
junktrunk909,0,1,0,1,1566100800,1566100800,1
publicenemyone,0,1,0,8,1583298000,1583298000,1
whenijusthavetopost,0,1,0,11,1574398800,1574398800,1
mitronaguay,0,1,0,3,1564372800,1564372800,1
snowstatic,0,1,0,5,1609390800,1609390800,1
Paddington_Fear,0,1,0,20,1545800400,1545800400,1
DudeTheBlow,0,1,0,15,1573102800,1573102800,1
Playmakermike,0,1,0,30,1568260800,1568260800,1
lovemaker69,0,1,0,1,1605589200,1605589200,1
greeengoth,0,1,0,2,1601179200,1601179200,1
Front_Lavishness_628,1,0,1,0,1611896400,1611896400,1
doctornowzaradan,1,0,21,0,1612069200,1612069200,1
Prism1331,0,1,0,3,1590120000,1590120000,1
gabriele9023,0,1,0,84,1595822400,1595822400,1
jeparleunpeu,1,0,142,0,1574226000,1574226000,1
WID_Call_IT,0,1,0,1,1612069200,1612069200,1
GALL0WSHUM0R,0,1,0,1,1605589200,1605589200,1
Tiny_mimikyuu,0,1,0,8,1593835200,1593835200,1
peakockpower,0,1,0,6,1604379600,1604379600,1
Frez-zy,0,1,0,11,1595217600,1595217600,1
AnthropicBias,0,1,0,1,1598760000,1598760000,1
obamahypebeast,0,1,0,-25,1601870400,1601870400,1
Layotam,0,1,0,4,1595908800,1595908800,1
Superaltusername,0,1,0,23,1574226000,1574226000,1
Christian92,0,1,0,1,1593662400,1593662400,1
021fluff5,0,1,0,18,1598932800,1598932800,1
ty1553,0,1,0,1,1587009600,1587009600,1
exguerrero1,0,1,0,0,1605070800,1605070800,1
churnate,0,1,0,7,1608440400,1608440400,1
blahalreadytaken,0,1,0,1,1591329600,1591329600,1
nukaman1993,0,1,0,0,1578718800,1578718800,1
EndVSGaming,0,1,0,6,1577595600,1577595600,1
tzui1234,0,1,0,1,1603598400,1603598400,1
j450n_l,1,0,14,0,1589515200,1589515200,1
corn-scalp,0,1,0,9,1555732800,1555732800,1
ozymandias411,0,1,0,0,1584244800,1584244800,1
Chanticleer85,0,1,0,4,1609218000,1609218000,1
vegerotten,1,0,24,0,1569643200,1569643200,1
Gravity203,0,1,0,11,1567310400,1567310400,1
AresMacks,0,1,0,6,1601956800,1601956800,1
abdlbun,0,1,0,6,1585800000,1585800000,1
abmongoe,0,1,0,2,1594353600,1594353600,1
riccopicko,0,1,0,6,1599883200,1599883200,1
Die4Metal,0,1,0,8,1584504000,1584504000,1
Inumaru_Bara,0,1,0,2,1592712000,1592712000,1
WeirdAvocado,0,1,0,-7,1611982800,1611982800,1
mightk3ep531,0,1,0,1,1607317200,1607317200,1
mynameisscurvy,0,1,0,10,1606453200,1606453200,1
heyitsmeyourcouch,0,1,0,2,1562299200,1562299200,1
paulekas_,0,1,0,6,1605589200,1605589200,1
CecalandMallTrust,0,1,0,6,1594699200,1594699200,1
ButTheyWereSILENT,0,1,0,28,1602043200,1602043200,1
RedditAdminsFascist,0,1,0,1,1565928000,1565928000,1
MinccinoLuna,0,1,0,0,1582866000,1582866000,1
xRoflface,0,1,0,8,1557201600,1557201600,1
pearlqueen00,0,1,0,3,1569556800,1569556800,1
risapisa,0,1,0,2,1604379600,1604379600,1
m0rtivius,0,1,0,7,1583557200,1583557200,1
Argeet,0,1,0,1,1598932800,1598932800,1
PremAzad,0,1,0,1,1549429200,1549429200,1
enigma2421,0,1,0,5,1570680000,1570680000,1
TheBigEmptyxd,0,1,0,74,1571976000,1571976000,1
axechamp75,0,1,0,8,1567828800,1567828800,1
FreshlyWritten69,0,1,0,1,1605589200,1605589200,1
DesertShot,0,1,0,2,1608613200,1608613200,1
Its_a_me_depresso,0,1,0,1,1606626000,1606626000,1
minion_haha,0,1,0,-1,1591243200,1591243200,1
weird_quiet_guy,0,1,0,2,1587441600,1587441600,1
cheyennetology,0,1,0,50,1611982800,1611982800,1
jhrf,0,1,0,1,1430712000,1430712000,1
Jupichan,0,1,0,1,1590033600,1590033600,1
UnderdogSMO,0,1,0,5,1612069200,1612069200,1
wonderberry77,0,1,0,6,1546405200,1546405200,1
Skasios,0,1,0,1,1605589200,1605589200,1
RabbidCupcakes,0,1,0,1,1604466000,1604466000,1
smittywasnumeruno,0,1,0,2,1609304400,1609304400,1
madr1x_,0,1,0,8,1608613200,1608613200,1
DrDroidz,0,1,0,1,1608786000,1608786000,1
SnorlaxSax,0,1,0,1,1593835200,1593835200,1
serific79,0,1,0,1,1573534800,1573534800,1
overman_rs,0,1,0,3,1573448400,1573448400,1
gia527,0,1,0,6,1597896000,1597896000,1
tuckedfexas,0,1,0,1,1585454400,1585454400,1
skidlz,0,1,0,2,1584158400,1584158400,1
Particular_Edge,0,1,0,5,1585886400,1585886400,1
EnderPossessor,1,0,11,0,1606539600,1606539600,1
TimeSplatters,1,0,12,0,1584417600,1584417600,1
Pm_me_your_uuuuugh,0,1,0,1,1566360000,1566360000,1
BongLeardDongLick,0,1,0,1,1582347600,1582347600,1
Downbound92,0,1,0,6,1576386000,1576386000,1
megarachnid,0,1,0,4,1568952000,1568952000,1
HungDaddyNYC,0,1,0,1,1573189200,1573189200,1
imeanum,1,0,772,0,1592366400,1592366400,1
BBisnotme,0,1,0,180,1590033600,1590033600,1
ArticunoDosTres,0,1,0,1,1601092800,1601092800,1
Trypee,0,1,0,3,1596772800,1596772800,1
thefullernator,0,1,0,5,1592798400,1592798400,1
bonanza_jellyroll,0,1,0,1,1611810000,1611810000,1
ConfusedALot_69,0,1,0,1,1634616000,1634616000,1
imdefinitelyhungry,0,1,0,2,1606626000,1606626000,1
macmacmac93,0,1,0,1,1600833600,1600833600,1
MLGIsLyf,0,1,0,7,1557115200,1557115200,1
Pauliwhirl3,0,1,0,2,1576299600,1576299600,1
NikkiStikk,0,1,0,1,1558843200,1558843200,1
Correct-Valuable5276,1,0,317,0,1611982800,1611982800,1
NineteenthHouseplant,1,0,16,0,1605762000,1605762000,1
starrynightmare,0,1,0,11,1565150400,1565150400,1
kartik3e,0,1,0,-1,1608440400,1608440400,1
DistinctFerret,0,1,0,30,1564977600,1564977600,1
sim_83,0,1,0,29,1568779200,1568779200,1
kriptiklgcy,0,1,0,26,1595476800,1595476800,1
DirteeCanuck,0,1,0,2,1600833600,1600833600,1
szlr,0,1,0,19,1573016400,1573016400,1
iron_strix,0,1,0,9,1596254400,1596254400,1
imwatchingyou-_-,0,1,0,1,1576386000,1576386000,1
HowaboutGreg,0,1,0,2,1574139600,1574139600,1
TadVatum,0,1,0,-17,1607317200,1607317200,1
t0niidk,0,1,0,8,1573362000,1573362000,1
themunnandonly,0,1,0,1,1576472400,1576472400,1
pheonix1723,0,1,0,4,1608267600,1608267600,1
BrainCellDotExe,0,1,0,1,1603512000,1603512000,1
aregayPeriod,0,1,0,-8,1590552000,1590552000,1
CarlosimoDangerosimo,0,1,0,2,1599192000,1599192000,1
samsta7,0,1,0,-4,1605934800,1605934800,1
drosalesf,0,1,0,2,1577941200,1577941200,1
Spamme54321,0,1,0,-3,1593576000,1593576000,1
JUlCEBOX,0,1,0,5,1594267200,1594267200,1
mtobbagan_md91,0,1,0,1,1605416400,1605416400,1
dan_from_texas_,0,1,0,26,1606885200,1606885200,1
I_Like_Big_Budds,0,1,0,1,1606626000,1606626000,1
notatree,0,1,0,10,1606107600,1606107600,1
Vinterblot,0,1,0,7,1603512000,1603512000,1
yesIamMrDJ,0,1,0,44,1576818000,1576818000,1
takoyakicult,0,1,0,14,1585368000,1585368000,1
ajgrinds,0,1,0,1,1598846400,1598846400,1
Kerbanautg,0,1,0,1,1602043200,1602043200,1
princess_awesomepony,0,1,0,1,1572235200,1572235200,1
churm95,0,1,0,-10,1572148800,1572148800,1
Cole3823,0,1,0,1,1600747200,1600747200,1
fu242,0,1,0,5,1582866000,1582866000,1
LionOnTables,0,1,0,1,1608267600,1608267600,1
VaporSaltyCaper,0,1,0,1,1595131200,1595131200,1
pretend_vacation,0,1,0,2,1595908800,1595908800,1
kevdogg33a,0,1,0,1,1603598400,1603598400,1
clown_pants,0,1,0,1,1611982800,1611982800,1
Not_a_jmod,0,1,0,3,1578200400,1578200400,1
Booradley320,0,1,0,2,1597032000,1597032000,1
NeckRoFeltYa,0,1,0,1,1603598400,1603598400,1
nerdquadrat,0,1,0,14,1560398400,1560398400,1
magagagagoogoo,0,1,0,1,1604379600,1604379600,1
LilxSmoke,0,1,0,2,1608699600,1608699600,1
AcrobaticAge,0,1,0,2,1525924800,1525924800,1
i8apickle2020,0,1,0,90,1605675600,1605675600,1
potential_wasted,0,1,0,25,1599969600,1599969600,1
LetMePushTheButton,0,1,0,2,1608354000,1608354000,1
JackDilsenberg,0,1,0,2,1602648000,1602648000,1
dextersaintjacquesiv,0,1,0,10,1567656000,1567656000,1
MarquizMilton,0,1,0,1,1607144400,1607144400,1
FungalAftershaft,0,1,0,53,1592107200,1592107200,1
monarch_j,0,1,0,27,1607576400,1607576400,1
INeverFeelAtHome,0,1,0,3,1575694800,1575694800,1
woahiwalk,0,1,0,2,1464494400,1464494400,1
pessirnist,0,1,0,3,1601611200,1601611200,1
cypher3327,0,1,0,6,1576558800,1576558800,1
venezia44,0,1,0,1,1586059200,1586059200,1
AxellSwim,0,1,0,2,1588478400,1588478400,1
MeatraffleJackpot,0,1,0,9,1578891600,1578891600,1
ParmAxolotl,0,1,0,2,1588478400,1588478400,1
BlueLikeThunder,0,1,0,1,1607662800,1607662800,1
ON_A_POWERPLAY,0,1,0,2,1546405200,1546405200,1
hexydes,0,1,0,2,1589515200,1589515200,1
comfortably_dumb76,0,1,0,1,1608267600,1608267600,1
swithin,0,1,0,12,1572667200,1572667200,1
MemeGeneratorBot34,0,1,0,1,1585454400,1585454400,1
aljobar,0,1,0,2,1599451200,1599451200,1
ctl8,0,1,0,1,1602734400,1602734400,1
Farax,0,1,0,8,1581915600,1581915600,1
DarkLordKohan,0,1,0,5,1584676800,1584676800,1
cozy_lolo,0,1,0,1,1591243200,1591243200,1
squats_in_curl_rack,0,1,0,3,1582520400,1582520400,1
AceAttorneyt,0,1,0,1,1562299200,1562299200,1
bler_ugh,0,1,0,2,1603166400,1603166400,1
GONKworshipper,0,1,0,2,1634529600,1634529600,1
whtwlf8,0,1,0,1,1582779600,1582779600,1
Bhalooooo,0,1,0,1,1600747200,1600747200,1
notreallymoz,0,1,0,2,1603512000,1603512000,1
markgamedev,0,1,0,2,1595736000,1595736000,1
SteamDonky,0,1,0,8,1594612800,1594612800,1
inxs212,0,1,0,1,1609822800,1609822800,1
Israfiel27,0,1,0,1,1608872400,1608872400,1
jar_of_change,0,1,0,6,1462766400,1462766400,1
Smokester121,0,1,0,1,1604030400,1604030400,1
LadyJedi12,0,1,0,8,1606885200,1606885200,1
mtttike,0,1,0,1,1585886400,1585886400,1
Racoon_riley,0,1,0,1,1605589200,1605589200,1
mornsbarstool,0,1,0,1,1579669200,1579669200,1
dieomesieptoch,0,1,0,3,1518930000,1518930000,1
Lexellence,0,1,0,11,1593921600,1593921600,1
Gallowbooblikeskids,0,1,0,-2,1550293200,1550293200,1
blekkja,0,1,0,44,1611896400,1611896400,1
JoePesto99,0,1,0,9,1581829200,1581829200,1
risingsun70,0,1,0,1,1579064400,1579064400,1
throw20twenty,1,0,6,0,1597982400,1597982400,1
Ialdabaoth13,0,1,0,3,1594785600,1594785600,1
reauxgg,0,1,0,-5,1591329600,1591329600,1
711BotSmoker,0,1,0,-2,1606539600,1606539600,1
Da_one_and_lonely91,0,1,0,1,1584763200,1584763200,1
HorizontalBob,0,1,0,1,1578459600,1578459600,1
alpine_guinea_pigs,0,1,0,3,1606971600,1606971600,1
padriec,0,1,0,286,1602043200,1602043200,1
Zbljuv,0,1,0,5,1581051600,1581051600,1
littlediobolic,0,1,0,5,1539921600,1539921600,1
fantumn,0,1,0,-11,1549515600,1549515600,1
Dontflamemeplease,0,1,0,1,1561348800,1561348800,1
sleenies,0,1,0,1,1589342400,1589342400,1
NonAlienBeing,0,1,0,10,1607490000,1607490000,1
jbolt7,0,1,0,1,1599883200,1599883200,1
BugabuseMe,0,1,0,1,1608872400,1608872400,1
Queer_Empress,0,1,0,3,1596254400,1596254400,1
hokahey23,0,1,0,1,1605934800,1605934800,1
pwbeatty,0,1,0,1,1606712400,1606712400,1
In_The_Paint,0,1,0,1,1609045200,1609045200,1
SootButt42,0,1,0,1,1598068800,1598068800,1
AssHurtsFromSitting,1,0,6,0,1587441600,1587441600,1
Violence_IsTheAnswer,0,1,0,10,1609390800,1609390800,1
RunawaySpoon45,0,1,0,1,1577509200,1577509200,1
l1ttleb,0,1,0,4,1597982400,1597982400,1
LiteShowDaAgent,0,1,0,-2,1600660800,1600660800,1
ragingklaxon,0,1,0,2,1576040400,1576040400,1
Crabtree333,0,1,0,22,1573707600,1573707600,1
Themanimnot,0,1,0,2,1608958800,1608958800,1
Rahmin_Noodle_Queen,0,1,0,2,1556596800,1556596800,1
Smileyface3000,0,1,0,8,1607317200,1607317200,1
utopista114,0,1,0,20,1597982400,1597982400,1
bruh---momento,0,1,0,1,1599537600,1599537600,1
badhairyear2018,0,1,0,1,1560830400,1560830400,1
345aw4trf43,0,1,0,1,1599019200,1599019200,1
gw2nooooob,0,1,0,-6,1595649600,1595649600,1
beganyestr9t,1,0,7,0,1475812800,1475812800,1
glzag,0,1,0,3,1605502800,1605502800,1
RecreationalAV,0,1,0,2,1594872000,1594872000,1
WiscoMick,0,1,0,59,1607922000,1607922000,1
TheReal_Loser,0,1,0,3,1583125200,1583125200,1
zavtraprivet,0,1,0,17,1587873600,1587873600,1
Sea_Prize_3464,0,1,0,1,1609390800,1609390800,1
yetidogs,1,0,9,0,1510808400,1510808400,1
Carsondo1,0,1,0,-4,1595390400,1595390400,1
Milhala,0,1,0,5,1608008400,1608008400,1
annoyed_w_the_world,0,1,0,1,1585454400,1585454400,1
Mataratta,0,1,0,12,1596427200,1596427200,1
LegendaryPeanut,0,1,0,6,1593662400,1593662400,1
erawlxm,0,1,0,1,1600833600,1600833600,1
bensawn,0,1,0,2,1579669200,1579669200,1
rustylugnuts,0,1,0,47,1605243600,1605243600,1
HZLFC,0,1,0,4,1589515200,1589515200,1
FarCod2,0,1,0,3,1609131600,1609131600,1
T1B2V3,0,1,0,2,1609045200,1609045200,1
WinSlip,0,1,0,1,1578632400,1578632400,1
-WittyUsername_,0,1,0,1,1591329600,1591329600,1
sic_parvis_magna_,0,1,0,-2,1562731200,1562731200,1
3rdAveregestDudeEver,0,1,0,1,1605157200,1605157200,1
KistlBier1312,0,1,0,1,1586664000,1586664000,1
zumacraig,0,1,0,6,1539921600,1539921600,1
CheeezBlue,0,1,0,-1,1606539600,1606539600,1
Emoooooly,0,1,0,4,1583643600,1583643600,1
HansGruberHangover,0,1,0,20,1603684800,1603684800,1
cyber_hacked,1,0,1,0,1492142400,1492142400,1
Orolol,0,1,0,1,1566878400,1566878400,1
oliviapopesbutthole,0,1,0,4,1583211600,1583211600,1
DolceGaCrazy,0,1,0,3,1591761600,1591761600,1
shecurve,0,1,0,1,1593835200,1593835200,1
18April1775,0,1,0,3,1570075200,1570075200,1
atheist1009,1,0,96,0,1608699600,1608699600,1
NoiseBarn,0,1,0,13,1587268800,1587268800,1
AIHexonal,0,1,0,2,1589947200,1589947200,1
Hungry_Penguino,0,1,0,8,1596945600,1596945600,1
qwuack-clack-,0,1,0,1,1606021200,1606021200,1
noah1831,0,1,0,1,1605934800,1605934800,1
HairRaid,0,1,0,3,1599364800,1599364800,1
Bandaloopdeloop,1,0,3,0,1570680000,1570680000,1
bluorangey,0,1,0,28,1602043200,1602043200,1
Gnomrad,0,1,0,3,1592452800,1592452800,1
ambiguouslygaybat,1,0,33,0,1569297600,1569297600,1
LilithBoadicea,0,1,0,13,1598414400,1598414400,1
DopeMan93,0,1,0,1,1608613200,1608613200,1
troolytroof,0,1,0,2,1606366800,1606366800,1
kachna,0,1,0,1,1581224400,1581224400,1
nicholasruunu,0,1,0,1,1604203200,1604203200,1
GrapefruitPlucker,0,1,0,15,1608526800,1608526800,1
AOK265,1,0,225,0,1608872400,1608872400,1
Sycthros,0,1,0,216,1605070800,1605070800,1
no_mouse_no_keyboard,0,1,0,1,1584158400,1584158400,1
sadboysed,0,1,0,-15,1601611200,1601611200,1
swordbeam,0,1,0,1,1561867200,1561867200,1
JohnnyIsSoAlive,0,1,0,1,1600660800,1600660800,1
haskeer_nico,0,1,0,19,1595390400,1595390400,1
whodunn1t,0,1,0,7,1563422400,1563422400,1
iliketrainsandtrains,0,1,0,-1,1604379600,1604379600,1
Geckonavajo,0,1,0,8,1599883200,1599883200,1
impressiverep,0,1,0,2,1578718800,1578718800,1
cookinbird,0,1,0,1,1573189200,1573189200,1
Pariahdog119,0,1,0,13,1611982800,1611982800,1
I9-9900K_Maximus_XI,0,1,0,-5,1602907200,1602907200,1
Evernight,0,1,0,1,1598760000,1598760000,1
Famous-Investigator6,0,1,0,8,1608181200,1608181200,1
dingdonghierarchyisw,0,1,0,4,1599537600,1599537600,1
gooddaysir,0,1,0,16,1612069200,1612069200,1
Raginmoron,0,1,0,4,1589688000,1589688000,1
NotMyFaultImMoody,0,1,0,1,1603684800,1603684800,1
flamannn,0,1,0,3,1606021200,1606021200,1
salty_margarita,0,1,0,1,1560916800,1560916800,1
cuteintern,0,1,0,2,1606539600,1606539600,1
AJSMKO,0,1,0,1,1608267600,1608267600,1
CaseyJones73,0,1,0,1,1605589200,1605589200,1
Globalruler__,0,1,0,6,1597809600,1597809600,1
Bot_Thinks,0,1,0,1,1635393600,1635393600,1
BlueShadesTM,0,1,0,16,1580274000,1580274000,1
criscrossdresser,0,1,0,3,1561780800,1561780800,1
DoMeHarderer,0,1,0,1,1600574400,1600574400,1
VolcelTHOT,0,1,0,1,1554177600,1554177600,1
princessbae,0,1,0,10,1599624000,1599624000,1
Saffa1986,0,1,0,-1,1598155200,1598155200,1
spikemill,0,1,0,1,1591156800,1591156800,1
SultanFox,0,1,0,2,1570766400,1570766400,1
Tasty-Pomegranate-10,0,1,0,3,1607922000,1607922000,1
theolentangy,0,1,0,12,1591588800,1591588800,1
Zelonelystoner,0,1,0,1,1570420800,1570420800,1
robohozo,0,1,0,5,1607230800,1607230800,1
merlinbaker67,0,1,0,2,1574571600,1574571600,1
CJ_Jones,0,1,0,2,1576472400,1576472400,1
davidohh,0,1,0,1,1608699600,1608699600,1
flatice,0,1,0,9,1556510400,1556510400,1
Direct-Rip1058,0,1,0,1,1600142400,1600142400,1
terminator_and_tots,0,1,0,3,1604030400,1604030400,1
thebobrup,0,1,0,2,1591329600,1591329600,1
spacemanap,0,1,0,1,1596254400,1596254400,1
Foreskin_Burglar,0,1,0,3,1598932800,1598932800,1
Figpucker6969,0,1,0,2,1598241600,1598241600,1
tiggertigger2,0,1,0,127,1575954000,1575954000,1
PhoenixAZisHot,0,1,0,18,1573707600,1573707600,1
gimme_the_jabonzote,0,1,0,17,1607749200,1607749200,1
CitizunKane,0,1,0,3,1596340800,1596340800,1
GentlemansGentleman,0,1,0,8,1573534800,1573534800,1
Buce123,0,1,0,-9,1580274000,1580274000,1
DookieToe,0,1,0,1,1600660800,1600660800,1
jmc9000,0,1,0,7,1564113600,1564113600,1
GoodCalendarYear,1,0,30,0,1611810000,1611810000,1
daniel_night_lewis,0,1,0,1,1596340800,1596340800,1
OnlyGoodPedoIsADead1,0,1,0,0,1603598400,1603598400,1
NoraMajora,0,1,0,27,1573534800,1573534800,1
Consolidatedtoast,0,1,0,7,1606021200,1606021200,1
Your-Whorror,0,1,0,1,1605934800,1605934800,1
ScorpioGC_,0,1,0,0,1579237200,1579237200,1
Imakemyownjerky,0,1,0,1,1603512000,1603512000,1
Sir_Grits,0,1,0,27,1602993600,1602993600,1
Guy_A,0,1,0,8,1559707200,1559707200,1
babeepunk,0,1,0,1,1607576400,1607576400,1
ToniMarino,0,1,0,1,1570939200,1570939200,1
ComradeSuperman,0,1,0,1,1574485200,1574485200,1
pennywar,0,1,0,1,1616212800,1616212800,1
bianksterrr,0,1,0,9,1606366800,1606366800,1
abrainmess,0,1,0,2,1606366800,1606366800,1
Rumblysheep,0,1,0,-1,1593576000,1593576000,1
BFNgaming,0,1,0,18,1575954000,1575954000,1
RawrRRitchie,0,1,0,10,1612069200,1612069200,1
Guinness19,0,1,0,4,1590033600,1590033600,1
theMRMaddMan,0,1,0,1,1603512000,1603512000,1
ResilientLuna,0,1,0,4,1593489600,1593489600,1
pandaclaw_,0,1,0,1,1569211200,1569211200,1
Redpill_1989,0,1,0,4,1603598400,1603598400,1
_arry42,1,0,9,0,1599192000,1599192000,1
5cr1ptk1tty,0,1,0,1,1603512000,1603512000,1
MysticWhimsy,0,1,0,17,1549256400,1549256400,1
bigboybluesy,0,1,0,11,1611810000,1611810000,1
dirtyditch,0,1,0,4,1605070800,1605070800,1
mfo245,0,1,0,14,1607662800,1607662800,1
Str8MufCabbage,0,1,0,1,1576990800,1576990800,1
LexOrkus,0,1,0,2,1596340800,1596340800,1
uagdnidu3,0,1,0,1,1573707600,1573707600,1
FoolishPreacher,0,1,0,33,1587873600,1587873600,1
therealfafafa,0,1,0,6,1593835200,1593835200,1
zesty_mordant,0,1,0,1,1583985600,1583985600,1
_Clairvoyant__,0,1,0,1,1582952400,1582952400,1
cjt11203,0,1,0,1,1598932800,1598932800,1
Spicetake,0,1,0,1,1578373200,1578373200,1
MyLegGuyFromSB,0,1,0,1,1573794000,1573794000,1
jeffsayno,0,1,0,1,1605589200,1605589200,1
chronicenigma,0,1,0,1,1605070800,1605070800,1
mlg129,0,1,0,2,1585800000,1585800000,1
thevioletjinx,0,1,0,1,1603512000,1603512000,1
Tarantula_1,1,0,10,0,1608094800,1608094800,1
some-incomp,0,1,0,2,1640754000,1640754000,1
PGDTX77,0,1,0,5,1612155600,1612155600,1
BryLoW,0,1,0,8,1571544000,1571544000,1
fre3k,0,1,0,-1,1603512000,1603512000,1
batty_lashes,0,1,0,4,1606366800,1606366800,1
epicmylife,0,1,0,1,1605589200,1605589200,1
sadisticlxve,0,1,0,9,1609390800,1609390800,1
dannongreekyogurt,0,1,0,1,1594267200,1594267200,1
tishthefish99999,0,1,0,2,1598673600,1598673600,1
deezharry,0,1,0,-6,1605589200,1605589200,1
Everydaypsychopath,0,1,0,3,1572667200,1572667200,1
ignitomork,0,1,0,8,1567137600,1567137600,1
JuanSellsWhite,0,1,0,1,1578546000,1578546000,1
Mrwombatspants,0,1,0,37,1575176400,1575176400,1
katonajozsi,0,1,0,10,1608008400,1608008400,1
JfizzleMshizzle,0,1,0,4,1605589200,1605589200,1
the_loneliest_noodle,0,1,0,6,1605502800,1605502800,1
cookieintheinternet,0,1,0,5,1603771200,1603771200,1
chefog6,0,1,0,1,1608613200,1608613200,1
3bears10000rats,0,1,0,1,1607058000,1607058000,1
KushCactus,0,1,0,3,1608267600,1608267600,1
NeinJaVielleicht,0,1,0,133,1577163600,1577163600,1
LiamBrad5,0,1,0,1,1581742800,1581742800,1
genaricgoblin,0,1,0,5,1578978000,1578978000,1
CyEriton,0,1,0,2,1566360000,1566360000,1
FarSpeed,0,1,0,7,1602043200,1602043200,1
fallingbackward,0,1,0,5,1563249600,1563249600,1
fortyeightD,0,1,0,0,1588824000,1588824000,1
EverydayGettingPoor,0,1,0,2,1599364800,1599364800,1
killyoursins,0,1,0,3,1576645200,1576645200,1
Secret_anime_watcher,1,0,24,0,1575435600,1575435600,1
triceratops94,0,1,0,6,1593835200,1593835200,1
acertainboy,0,1,0,1,1608699600,1608699600,1
rivers61,0,1,0,16,1607317200,1607317200,1
occultfire,0,1,0,1,1580446800,1580446800,1
Perseus_AWC,0,1,0,2,1598414400,1598414400,1
blackberrytrps,0,1,0,4,1577422800,1577422800,1
desaerun,0,1,0,3,1590206400,1590206400,1
guevera,0,1,0,2,1574744400,1574744400,1
yka12,0,1,0,2,1595390400,1595390400,1
jell-o-mold,0,1,0,0,1606626000,1606626000,1
be_consistent,0,1,0,2,1593576000,1593576000,1
AFK_IRL88,0,1,0,3,1573707600,1573707600,1
WhipTheLlama,0,1,0,4,1588824000,1588824000,1
tailsuser606,0,1,0,8,1573448400,1573448400,1
ChoiceFlatworm,0,1,0,13,1586318400,1586318400,1
silent_boy,0,1,0,35,1598760000,1598760000,1
xx_84045,0,1,0,1,1605502800,1605502800,1
Enigmatic246,0,1,0,9,1604552400,1604552400,1
esecallum,0,1,0,1,1609477200,1609477200,1
jaiman,0,1,0,57,1588651200,1588651200,1
fratticus_maximus,0,1,0,2,1599278400,1599278400,1
mellow-cello,0,1,0,15,1567051200,1567051200,1
Ardansedan335,0,1,0,5,1576818000,1576818000,1
FlyingRep,0,1,0,1,1574139600,1574139600,1
hybygy,0,1,0,-2,1606626000,1606626000,1
Dependent_Contact143,0,1,0,4,1603425600,1603425600,1
Friendly-Enby,0,1,0,1,1578805200,1578805200,1
Stackman23,0,1,0,-11,1585454400,1585454400,1
Gterwin,0,1,0,71,1584590400,1584590400,1
HotMessOtter,0,1,0,1,1605589200,1605589200,1
ToadwithBigButt,0,1,0,3,1604552400,1604552400,1
ECCE-HOMOsapien,0,1,0,24,1604898000,1604898000,1
peevishoriley,0,1,0,15,1556683200,1556683200,1
BestDressedDay,0,1,0,7,1606626000,1606626000,1
rememberthename123,0,1,0,5,1600833600,1600833600,1
skane1017,0,1,0,10,1570334400,1570334400,1
SuperRainbowUnicorn,0,1,0,4,1607490000,1607490000,1
GingerBenjaminButton,0,1,0,6,1612069200,1612069200,1
aaaaabbbccc,0,1,0,2,1589774400,1589774400,1
PM_ME_SUGGESTIVENESS,0,1,0,5,1579323600,1579323600,1
Inventanewthing,0,1,0,2,1584158400,1584158400,1
sexy_salazar,0,1,0,-4,1607317200,1607317200,1
maskake,0,1,0,14,1566100800,1566100800,1
alabe227,0,1,0,1,1606626000,1606626000,1
RangerMain,0,1,0,2,1602734400,1602734400,1
kustomwithak,0,1,0,1,1603512000,1603512000,1
CanadianCryptoChris,0,1,0,5,1603425600,1603425600,1
chickentendis,0,1,0,1,1594353600,1594353600,1
bgfan26,0,1,0,21,1602388800,1602388800,1
Pimpwave,0,1,0,29,1568606400,1568606400,1
PAEDO_COMEDY_YOUTUBE,0,1,0,2,1589342400,1589342400,1
SpookyStirnerite,1,0,16,0,1466481600,1466481600,1
Meeds85,0,1,0,1,1591329600,1591329600,1
risxAli,0,1,0,1,1604379600,1604379600,1
Spartan3153,0,1,0,1,1604466000,1604466000,1
blackandbroken,1,0,27,0,1575262800,1575262800,1
miched99,0,1,0,12,1599451200,1599451200,1
penndawg74,1,0,3909,0,1586577600,1586577600,1
pinkbicyclee,0,1,0,2,1567310400,1567310400,1
Tributemest,0,1,0,17,1585022400,1585022400,1
legallydead2006,0,1,0,21,1569124800,1569124800,1
dickint0aster,0,1,0,1,1608526800,1608526800,1
jujijengo,0,1,0,3,1587268800,1587268800,1
realchildofhell,0,1,0,32,1595476800,1595476800,1
1248853,0,1,0,1,1606971600,1606971600,1
breeso,0,1,0,4,1611896400,1611896400,1
th3m3m3thi3f,1,0,53,0,1607144400,1607144400,1
ouijaboardmeeting,0,1,0,28,1608613200,1608613200,1
StressingAlways,0,1,0,1,1580792400,1580792400,1
Jimmychanga2424,0,1,0,3,1596081600,1596081600,1
MargeauxSauvage,0,1,0,1,1603512000,1603512000,1
airwavesflow,1,0,8915,0,1606366800,1606366800,1
OmarAYousry,1,0,491,0,1602907200,1602907200,1
gabrieme2190,0,1,0,3,1586404800,1586404800,1
bleuwillow,0,1,0,55,1592884800,1592884800,1
armyofspartans,0,1,0,-18,1591675200,1591675200,1
tjurjevic16,0,1,0,1,1607662800,1607662800,1
sexual_pasta,0,1,0,42,1570507200,1570507200,1
-everythingsgood-,0,1,0,10,1558929600,1558929600,1
FELECIAWER,0,1,0,3,1602648000,1602648000,1
coffedrank,0,1,0,1,1591243200,1591243200,1
Giraffe_Dude,0,1,0,1,1603512000,1603512000,1
JD-Puffy,0,1,0,3,1599537600,1599537600,1
theonlyavailablename,0,1,0,3,1577941200,1577941200,1
dswpro,0,1,0,-9,1592107200,1592107200,1
ExpressoDepresso03,0,1,0,24,1605157200,1605157200,1
linkrina1,0,1,0,1,1609304400,1609304400,1
N0tHimAgain,0,1,0,1,1604466000,1604466000,1
Racheldagamer94,0,1,0,6,1599710400,1599710400,1
Impossible_Rabbit,1,0,183,0,1606021200,1606021200,1
akibejbe,0,1,0,1,1608872400,1608872400,1
sad_inconvenience,0,1,0,11,1585627200,1585627200,1
ChargingAntelope,0,1,0,4,1594526400,1594526400,1
TheFirstTime11,0,1,0,1,1602302400,1602302400,1
MrBjomolf,0,1,0,3,1567656000,1567656000,1
CSA-Joe,0,1,0,2,1604725200,1604725200,1
danceballerinadance,0,1,0,2,1578978000,1578978000,1
yashthesharma,0,1,0,1,1601006400,1601006400,1
zrg,0,1,0,1,1586750400,1586750400,1
syllencedd_,0,1,0,1,1603512000,1603512000,1
Malekeileigh,0,1,0,1,1578459600,1578459600,1
dullexcitement,0,1,0,5,1598068800,1598068800,1
TheFishRevolution,0,1,0,-1,1584763200,1584763200,1
ytosb,0,1,0,3,1605589200,1605589200,1
taylor325,0,1,0,1,1605589200,1605589200,1
oooooooofffff,0,1,0,-11,1586750400,1586750400,1
GameAholicFTW,0,1,0,5,1603598400,1603598400,1
deadflagblues,0,1,0,6,1605848400,1605848400,1
thealien369,0,1,0,-5,1592712000,1592712000,1
jeaniuslol,0,1,0,3,1606885200,1606885200,1
TrubbishFan,0,1,0,5,1600142400,1600142400,1
Jerry-_-Garcia,1,0,8,0,1585540800,1585540800,1
KnittedKnight,0,1,0,3,1608958800,1608958800,1
courtneypc,0,1,0,3,1575435600,1575435600,1
luneunion,0,1,0,23,1547182800,1547182800,1
dergeraet93,0,1,0,4,1592280000,1592280000,1
rushakenyan,0,1,0,0,1591329600,1591329600,1
Chemonaut,0,1,0,3,1550293200,1550293200,1
JormungandrSerp,0,1,0,2,1597377600,1597377600,1
Truedough9,0,1,0,1,1576818000,1576818000,1
SodaPopnskii,0,1,0,1,1600660800,1600660800,1
senorrawr,0,1,0,2,1592884800,1592884800,1
khal_Jayams,0,1,0,1,1570248000,1570248000,1
loddal,0,1,0,1,1609131600,1609131600,1
Bitch-King-Of-Angmar,0,1,0,9,1602648000,1602648000,1
Ejacubation,0,1,0,1,1601956800,1601956800,1
TheJulius64,1,0,318,0,1601092800,1601092800,1
autowikibot,0,1,0,1,1421125200,1421125200,1
RxDotaValk,0,1,0,21,1573189200,1573189200,1
hillbois,0,1,0,2,1587268800,1587268800,1
GuiltyGoblin,0,1,0,1,1591502400,1591502400,1
si737,0,1,0,2,1606798800,1606798800,1
gigidabest,0,1,0,0,1589947200,1589947200,1
FredaFF,0,1,0,2,1603684800,1603684800,1
pratyushv,0,1,0,1,1608699600,1608699600,1
Antiniebla,0,1,0,1,1603339200,1603339200,1
Saizaku_,0,1,0,6,1600660800,1600660800,1
promiseall,0,1,0,9,1612155600,1612155600,1
toobul,0,1,0,1,1607230800,1607230800,1
Jimbrutan,1,0,5,0,1576558800,1576558800,1
verylobsterlike,0,1,0,16,1592366400,1592366400,1
SuperSav85,0,1,0,1,1598932800,1598932800,1
Damien_Torrence,0,1,0,3,1540180800,1540180800,1
stop_stopping,0,1,0,3,1608872400,1608872400,1
PembertoniePizzaz,0,1,0,37,1575694800,1575694800,1
BedroomAcoustics,0,1,0,10,1604984400,1604984400,1
dca6484,0,1,0,1,1641099600,1641099600,1
Prysorra2,0,1,0,2,1603684800,1603684800,1
suburbanRebelDad,0,1,0,7,1603425600,1603425600,1
Insta-fail,0,1,0,1,1612069200,1612069200,1
Saldrias-on-ph,0,1,0,3,1602475200,1602475200,1
UltraNemesis,0,1,0,1,1572843600,1572843600,1
megabitfl,0,1,0,4,1591416000,1591416000,1
Canyoubackupjustabit,0,1,0,0,1585886400,1585886400,1
Tommy_Taylor,0,1,0,5,1586577600,1586577600,1
galacticactus,0,1,0,2,1586059200,1586059200,1
kermithefrogggg,0,1,0,1,1604552400,1604552400,1
Quik2505,0,1,0,-2,1584763200,1584763200,1
Jimbob15515,0,1,0,14,1602388800,1602388800,1
GoneByEaster,0,1,0,6,1598760000,1598760000,1
bron685,0,1,0,18,1576040400,1576040400,1
Agent6isaboi,0,1,0,6,1577768400,1577768400,1
mavynblCk,0,1,0,-7,1572843600,1572843600,1
KingsReserve,0,1,0,1,1569643200,1569643200,1
merricatmortmain,0,1,0,8,1603080000,1603080000,1
masklinn,0,1,0,9,1603512000,1603512000,1
thrwycoastfi45634,0,1,0,4,1540008000,1540008000,1
spicycupcake3,0,1,0,2,1588651200,1588651200,1
beastwarking,0,1,0,10,1595131200,1595131200,1
daniel_hlfrd,0,1,0,5,1604984400,1604984400,1
jrihard8989,0,1,0,17,1579323600,1579323600,1
DukeofVermont,0,1,0,2,1609477200,1609477200,1
DissociatedRacoon,0,1,0,58,1603252800,1603252800,1
marcybojohn,0,1,0,4,1598760000,1598760000,1
icusu,0,1,0,5,1607835600,1607835600,1
Redditsresidentloser,0,1,0,3,1585627200,1585627200,1
bandido56,0,1,0,-2,1585454400,1585454400,1
DioramaPhoenix,0,1,0,13,1575781200,1575781200,1
Minerface,0,1,0,3,1585886400,1585886400,1
A_Work_In_Progress23,0,1,0,7,1594353600,1594353600,1
boobsnbacon4,0,1,0,3,1600228800,1600228800,1
thepurpleskittles,0,1,0,2,1608613200,1608613200,1
i1100a,0,1,0,121,1584244800,1584244800,1
zekethrow,0,1,0,3,1605502800,1605502800,1
Beccabear8616,0,1,0,7,1580101200,1580101200,1
temporaryjoemam,0,1,0,3,1609131600,1609131600,1
junkflier2,0,1,0,30,1605589200,1605589200,1
n_to_the_n,0,1,0,1,1599710400,1599710400,1
great_tits_,0,1,0,2,1610168400,1610168400,1
thouven,0,1,0,2,1592884800,1592884800,1
Reddit_FTW,0,1,0,1,1598932800,1598932800,1
throwaway55finance,0,1,0,1,1602129600,1602129600,1
cyborgerian,0,1,0,1,1597636800,1597636800,1
IScaldPuppies,0,1,0,4,1594267200,1594267200,1
debridezilla,0,1,0,2,1589860800,1589860800,1
kelggg,0,1,0,17,1608008400,1608008400,1
Em42,0,1,0,14,1605502800,1605502800,1
Intrepid_colors,0,1,0,37,1571544000,1571544000,1
drfrisker,0,1,0,32,1576558800,1576558800,1
Cow_Tse_Tongue,0,1,0,1,1608699600,1608699600,1
I-Identify-Guns,0,1,0,64,1584072000,1584072000,1
juju_biker,0,1,0,11,1572408000,1572408000,1
grubby_armadillo,0,1,0,1,1601956800,1601956800,1
snapy666,0,1,0,1,1424235600,1424235600,1
yrtsapoelc,0,1,0,3,1563249600,1563249600,1
sayidOH,0,1,0,-5,1607576400,1607576400,1
MartinSchou,0,1,0,2,1591243200,1591243200,1
roboslobtron,0,1,0,7,1589428800,1589428800,1
ajsjciencksjckvjd,0,1,0,17,1606366800,1606366800,1
Roger_005,0,1,0,1,1612155600,1612155600,1
kckit,1,0,18,0,1606194000,1606194000,1
moby561,0,1,0,3,1604811600,1604811600,1
hashbrown314,0,1,0,7,1604379600,1604379600,1
heidola,0,1,0,1,1611896400,1611896400,1
stoned_but_not_drunk,0,1,0,6,1609045200,1609045200,1
3mbraceTheV0id,0,1,0,8,1600488000,1600488000,1
TheDarkOnii,1,0,4,0,1599364800,1599364800,1
PEUPPEUPPEUPPEUP,0,1,0,2,1573448400,1573448400,1
Eltaquitobonito,0,1,0,1,1598760000,1598760000,1
Bjorn_The_Bear,0,1,0,1,1604898000,1604898000,1
squirrelboy1225,0,1,0,32,1593230400,1593230400,1
sdnw88,0,1,0,28,1597291200,1597291200,1
pryda22,0,1,0,1,1606626000,1606626000,1
The_Troyminator,0,1,0,2,1600315200,1600315200,1
OutlawRugby,0,1,0,1,1611896400,1611896400,1
TerminallyUseless,0,1,0,2,1606712400,1606712400,1
nozonezone,0,1,0,2,1605070800,1605070800,1
mrsjcava,0,1,0,2,1605934800,1605934800,1
YourUsualSir,0,1,0,12,1604725200,1604725200,1
TheFuturist47,0,1,0,10,1548738000,1548738000,1
Fusion_haa,0,1,0,7,1583125200,1583125200,1
Lololololelelel,0,1,0,1,1607662800,1607662800,1
8380atgmaildotcom,0,1,0,3,1585454400,1585454400,1
amenphasion,0,1,0,2,1603598400,1603598400,1
TenaceErbaccia,0,1,0,3,1600228800,1600228800,1
CoreyOTM,0,1,0,1,1597550400,1597550400,1
talondigital,0,1,0,1,1591243200,1591243200,1
Willing-Suspect6454,0,1,0,11,1605157200,1605157200,1
mescalelf,0,1,0,6,1571544000,1571544000,1
Durpin321,0,1,0,5,1607144400,1607144400,1
EvanTheFallenPrince,0,1,0,2,1606798800,1606798800,1
BroSiLLLYBro,0,1,0,1,1584331200,1584331200,1
Artyloo,0,1,0,49,1606539600,1606539600,1
cheappoet,0,1,0,1,1527134400,1527134400,1
xXRugerManXx,0,1,0,1,1603512000,1603512000,1
kwirky88,0,1,0,1,1607144400,1607144400,1
Eclipse_47,0,1,0,1,1604379600,1604379600,1
Tsimshia,0,1,0,11,1604379600,1604379600,1
Friend_of_Eevee,0,1,0,2,1598241600,1598241600,1
eaja,0,1,0,10,1572408000,1572408000,1
Mopey_Zoo_Lion,0,1,0,1,1600315200,1600315200,1
sunfaller,0,1,0,5,1560571200,1560571200,1
whyrweyelling,0,1,0,41,1609045200,1609045200,1
Neat__Guy,0,1,0,6,1576904400,1576904400,1
ryden2008,0,1,0,4,1572753600,1572753600,1
stevethe33rd,1,0,34,0,1607403600,1607403600,1
remington_420,0,1,0,10,1562472000,1562472000,1
paperwhitney,0,1,0,2,1600920000,1600920000,1
Krasherplot,0,1,0,35,1587268800,1587268800,1
jakson_the_jew,0,1,0,2,1608526800,1608526800,1
ShuttleXpC,0,1,0,7,1580014800,1580014800,1
Tarotdragoon,0,1,0,1,1578805200,1578805200,1
BeeBoyJames,0,1,0,1,1602561600,1602561600,1
frostedRoots,0,1,0,10,1580619600,1580619600,1
BiggieRektPaynish,0,1,0,21,1580792400,1580792400,1
howellinwolf,0,1,0,4,1606626000,1606626000,1
pointedplaying,0,1,0,9,1600142400,1600142400,1
misteraskwhy,0,1,0,3,1573362000,1573362000,1
JoeyDawsonJenPacey,0,1,0,3,1583899200,1583899200,1
th8chsea,0,1,0,1,1603512000,1603512000,1
slanid,0,1,0,18,1609131600,1609131600,1
digitaltransmutation,0,1,0,9,1584676800,1584676800,1
derek_j,0,1,0,2,1591243200,1591243200,1
Nutmagnus,0,1,0,2,1560225600,1560225600,1
Galitan,0,1,0,34,1561348800,1561348800,1
karvanenH,0,1,0,1,1608699600,1608699600,1
TurtleFisher54,0,1,0,1,1600056000,1600056000,1
WRX-Love,0,1,0,1,1573966800,1573966800,1
Johnaco,0,1,0,1,1612069200,1612069200,1
miau_am,0,1,0,1,1570939200,1570939200,1
axberk,0,1,0,2,1580619600,1580619600,1
UntoldEnt,0,1,0,1,1597291200,1597291200,1
GroundbreakingTax259,0,1,0,6,1609131600,1609131600,1
tristanrules,0,1,0,9,1563595200,1563595200,1
Mr_EkShun,0,1,0,2,1603598400,1603598400,1
triponit,0,1,0,6,1569124800,1569124800,1
JimboBUF,0,1,0,2,1606885200,1606885200,1
Lasshandra2,0,1,0,9,1594440000,1594440000,1
GlitteringMood,1,0,54,0,1581138000,1581138000,1
Tacosonthetable,0,1,0,7,1567742400,1567742400,1
saturn-daze,0,1,0,1,1586491200,1586491200,1
nmaster12,0,1,0,9,1559275200,1559275200,1
MakinBacinPancakies,0,1,0,10,1599796800,1599796800,1
dkedy1988,0,1,0,-2,1606539600,1606539600,1
StendhalSyndrome,0,1,0,1,1603598400,1603598400,1
bitterToothbrush,0,1,0,8,1594785600,1594785600,1
STIRofSOULS,0,1,0,17,1599278400,1599278400,1
StableBetaOrbit,0,1,0,9,1563249600,1563249600,1
carrick-sf,0,1,0,58,1605330000,1605330000,1
TheAdvertisement,0,1,0,1,1604379600,1604379600,1
curv4k,0,1,0,4,1607749200,1607749200,1
Jhoccordyan,0,1,0,2,1597377600,1597377600,1
klke8,0,1,0,27,1588824000,1588824000,1
GhandisNuclearWinter,0,1,0,-2,1611982800,1611982800,1
LordScalding,0,1,0,6,1566187200,1566187200,1
mrtouchshriek,0,1,0,3,1577595600,1577595600,1
dinodeanfd,0,1,0,1,1623816000,1623816000,1
835246,0,1,0,7,1606626000,1606626000,1
Phendus,0,1,0,0,1595390400,1595390400,1
goldenlionbeats,0,1,0,6,1595822400,1595822400,1
DocHavelock,0,1,0,5,1601870400,1601870400,1
4A4443,0,1,0,-3,1560657600,1560657600,1
inky03,0,1,0,1,1608267600,1608267600,1
beast920,0,1,0,1,1571630400,1571630400,1
elwebbr23,0,1,0,1,1591329600,1591329600,1
lionfishhead420,0,1,0,2,1567051200,1567051200,1
Anxious_Ad8903,0,1,0,1,1598760000,1598760000,1
liquid_diet,0,1,0,1,1574830800,1574830800,1
gr33nberry,0,1,0,28,1573534800,1573534800,1
BlindDrunkSniper,0,1,0,1,1635652800,1635652800,1
KodakKid3,0,1,0,0,1589947200,1589947200,1
bologma,0,1,0,13,1582261200,1582261200,1
Zermelane,0,1,0,4,1603684800,1603684800,1
belaruski_cyka,0,1,0,1,1596859200,1596859200,1
evonhell,0,1,0,1,1605070800,1605070800,1
Strottman,0,1,0,5,1612069200,1612069200,1
playfultendenxies,0,1,0,2,1575176400,1575176400,1
bspice1,0,1,0,1,1585454400,1585454400,1
IAmHereToOffendYou,0,1,0,1,1600660800,1600660800,1
Mutjny,0,1,0,2,1609045200,1609045200,1
1stonepwn,0,1,0,3,1587268800,1587268800,1
_XUZUL,0,1,0,35,1548133200,1548133200,1
ItsMeAgainF,0,1,0,-8,1587873600,1587873600,1
Wcfleming,0,1,0,12,1607403600,1607403600,1
ekkm,0,1,0,-1,1582088400,1582088400,1
Contra1,0,1,0,1,1599710400,1599710400,1
canadianistan,0,1,0,28,1608699600,1608699600,1
cenariusofficial,1,0,31,0,1605330000,1605330000,1
InsideEmployee,0,1,0,1,1605416400,1605416400,1
jhazmynn,0,1,0,48,1594267200,1594267200,1
notsoshytransgirl,1,0,8,0,1603425600,1603425600,1
TjababaRama,0,1,0,2,1605157200,1605157200,1
oh_turdly,0,1,0,1,1608699600,1608699600,1
kaiboshoko,0,1,0,1,1599364800,1599364800,1
ObsidianEye,1,0,63,0,1595995200,1595995200,1
rewskie,0,1,0,-9,1611982800,1611982800,1
nanviv,0,1,0,24,1595822400,1595822400,1
Owenowens7,1,0,15,0,1574830800,1574830800,1
Elfie07,0,1,0,3,1589342400,1589342400,1
BabyCakesTMCR,0,1,0,2,1574312400,1574312400,1
GeoffGold,0,1,0,5,1578027600,1578027600,1
bigbossperson,0,1,0,0,1591329600,1591329600,1
DeathToTheGlobalists,0,1,0,27,1573448400,1573448400,1
PaanuriEater,0,1,0,32,1604379600,1604379600,1
nycjr,0,1,0,-2,1582779600,1582779600,1
Naib_of_Naibs,0,1,0,13,1605502800,1605502800,1
mlon_eusk12,1,0,8,0,1608181200,1608181200,1
vegansammy,0,1,0,1,1609304400,1609304400,1
omtopus,0,1,0,6,1579064400,1579064400,1
nonameunit,0,1,0,13,1602993600,1602993600,1
craighaney172,0,1,0,2,1599883200,1599883200,1
MrGrix,1,0,7273,0,1603598400,1603598400,1
Disastrous_Quail,1,0,1,0,1587182400,1587182400,1
SubmarineTragedy,0,1,0,1,1569902400,1569902400,1
jreeves231,0,1,0,10,1557806400,1557806400,1
FearMe_Twiizted,0,1,0,84,1594353600,1594353600,1
Ninjroid,0,1,0,-14,1605934800,1605934800,1
manza5012,0,1,0,6,1578027600,1578027600,1
Imbored-Fa,0,1,0,76,1587441600,1587441600,1
MacGrubR,0,1,0,2,1591243200,1591243200,1
Xiiby,0,1,0,1,1605502800,1605502800,1
tensinahnd,0,1,0,1,1585454400,1585454400,1
iShark,0,1,0,-2,1591243200,1591243200,1
Fabulous_James,0,1,0,2,1602216000,1602216000,1
Ema4401,0,1,0,2,1608786000,1608786000,1
Equivalent-Fig1625,0,1,0,5,1608613200,1608613200,1
XLXLAZER,0,1,0,2,1567656000,1567656000,1
Lululeas,0,1,0,2,1591588800,1591588800,1
TheHarridan,0,1,0,314,1590120000,1590120000,1
skwull,0,1,0,1,1591243200,1591243200,1
Hospidallying,0,1,0,8,1585022400,1585022400,1
you_me_fivedollars,0,1,0,7,1581570000,1581570000,1
PressDa,0,1,0,6,1585627200,1585627200,1
sarkanyfarok,0,1,0,-5,1570075200,1570075200,1
bunnynursie,0,1,0,1,1583643600,1583643600,1
Paigelovespages,1,0,21,0,1579064400,1579064400,1
blrftw,0,1,0,8,1589947200,1589947200,1
dft-salt-pasta,0,1,0,17,1604030400,1604030400,1
pencilwithnoeraser,0,1,0,1,1608699600,1608699600,1
viburnum608,0,1,0,1,1607662800,1607662800,1
JKadsderehu,1,0,5,0,1571803200,1571803200,1
onlykaleintown,0,1,0,1,1602907200,1602907200,1
bigdipper125,0,1,0,0,1607317200,1607317200,1
xjcs97sy,0,1,0,16,1598587200,1598587200,1
SweatyGenitals,0,1,0,-2,1607490000,1607490000,1
yallwannasee420,0,1,0,1,1602561600,1602561600,1
celebral_x,0,1,0,2,1598846400,1598846400,1
OW__,0,1,0,5,1564804800,1564804800,1
CaptHowdy78,0,1,0,5,1585972800,1585972800,1
YoudamanSteve,0,1,0,5,1603512000,1603512000,1
kustose33,0,1,0,17,1606453200,1606453200,1
definitemaybe81,0,1,0,6,1586404800,1586404800,1
jlwtrb,0,1,0,1,1585454400,1585454400,1
PM_ME_UR_CLARINET,0,1,0,2,1574917200,1574917200,1
BeatVids,0,1,0,6,1608526800,1608526800,1
AKOZFUSDD,1,0,8,0,1606280400,1606280400,1
LovelyMisanthrope,0,1,0,3,1612069200,1612069200,1
PhrmChemist626,0,1,0,1,1601352000,1601352000,1
Golden_Scarzz,0,1,0,-10,1612069200,1612069200,1
Crystal9845,0,1,0,1,1609650000,1609650000,1
CIMARUTA,0,1,0,5,1561608000,1561608000,1
Varthorne,0,1,0,2,1604030400,1604030400,1
lenexa96,0,1,0,0,1598760000,1598760000,1
bradbarfieldlives,0,1,0,1,1581224400,1581224400,1
Jemsurfer,0,1,0,1,1610686800,1610686800,1
Caitlin1963,0,1,0,41,1606194000,1606194000,1
evilgorillamask,0,1,0,1,1572408000,1572408000,1
PubSIut,0,1,0,100,1596600000,1596600000,1
CooCooMaster_32,0,1,0,1,1614229200,1614229200,1
biggj2k3,0,1,0,-7,1586145600,1586145600,1
StealthMan375,0,1,0,3,1608958800,1608958800,1
narcotickets,0,1,0,1,1604379600,1604379600,1
ScarletGriffin,0,1,0,8,1566360000,1566360000,1
avalancheunited,0,1,0,4,1603512000,1603512000,1
loslunchbox,0,1,0,1,1589860800,1589860800,1
theselumpz,0,1,0,2,1604725200,1604725200,1
mssarcastic22,0,1,0,1,1562299200,1562299200,1
advancedlamb1,0,1,0,26,1577854800,1577854800,1
Wadglobs,0,1,0,1,1584676800,1584676800,1
paypal_me_one_euro,0,1,0,203,1606539600,1606539600,1
QueenOfKarnaca,0,1,0,6,1596600000,1596600000,1
Ozpipeguy,0,1,0,20,1609304400,1609304400,1
dude126,0,1,0,1,1611982800,1611982800,1
InspectorLee2020,1,0,31,0,1584072000,1584072000,1
agudpig,0,1,0,1,1605589200,1605589200,1
triception,0,1,0,-1,1592798400,1592798400,1
Psychological_Gold,0,1,0,7,1582088400,1582088400,1
makeupqueena,0,1,0,2,1572235200,1572235200,1
Sandberg231984,0,1,0,1,1603512000,1603512000,1
Conflicted_CubeDrone,0,1,0,5,1593921600,1593921600,1
TheViewSucks,0,1,0,91,1564891200,1564891200,1
Roosty37,0,1,0,10,1604898000,1604898000,1
Karakuik,0,1,0,-6,1573966800,1573966800,1
LegoTurtle,0,1,0,1,1591243200,1591243200,1
umashikaneko,0,1,0,5,1569384000,1569384000,1
King_Rhymer,0,1,0,16,1580101200,1580101200,1
theshitonthefan,0,1,0,3,1580187600,1580187600,1
kirkgoingham,0,1,0,13,1585022400,1585022400,1
iplaypinball,0,1,0,-1,1600574400,1600574400,1
chronicpyrophobiac,0,1,0,11,1611982800,1611982800,1
tastefullyawkward,1,0,145,0,1584072000,1584072000,1
yukiaddiction,0,1,0,4,1573707600,1573707600,1
Silent3choes,0,1,0,1,1608267600,1608267600,1
lostspiderphallus,0,1,0,-4,1602561600,1602561600,1
brokeassloser,0,1,0,12,1600747200,1600747200,1
Faefae33,0,1,0,2,1604984400,1604984400,1
bonbon_merci,0,1,0,31,1573880400,1573880400,1
TpOnReddit,0,1,0,9,1611896400,1611896400,1
klimorekhov,1,0,1013,0,1588132800,1588132800,1
BigJack1212,0,1,0,4,1606453200,1606453200,1
skier5544,0,1,0,1,1608354000,1608354000,1
Cheesemeister42,0,1,0,3,1608181200,1608181200,1
Sailing8-1,0,1,0,9,1606971600,1606971600,1
tripacklogic,0,1,0,2,1586836800,1586836800,1
2011k,0,1,0,2,1606798800,1606798800,1
SnooCakes9621,0,1,0,0,1602993600,1602993600,1
spongebobtechpants,0,1,0,0,1606626000,1606626000,1
thedankbank1021,0,1,0,1,1608872400,1608872400,1
Madmidge92,0,1,0,1,1605589200,1605589200,1
ChristopherHendricks,0,1,0,10,1575608400,1575608400,1
Konareesa,0,1,0,2,1606021200,1606021200,1
RipMyDikSkinOff,0,1,0,1,1605070800,1605070800,1
CyberiNox,0,1,0,3,1571371200,1571371200,1
It-Resolves,0,1,0,3,1585022400,1585022400,1
Bhawks489,0,1,0,5,1599796800,1599796800,1
TwoPackShakeHer,0,1,0,1,1600574400,1600574400,1
AMDfanboi2018,0,1,0,1,1607058000,1607058000,1
stats_plz,0,1,0,2,1584763200,1584763200,1
IndividualImpress3,0,1,0,8,1606626000,1606626000,1
Darkecho64,1,0,291,0,1602043200,1602043200,1
The_Govnor,0,1,0,7,1587960000,1587960000,1
adriatic_sea75,0,1,0,8,1589169600,1589169600,1
gdhameeja,0,1,0,2,1607835600,1607835600,1
VN_Doc_RK123,0,1,0,3,1601611200,1601611200,1
IamRNG,0,1,0,-35,1579582800,1579582800,1
tom04cz,0,1,0,20,1606971600,1606971600,1
IDoNotOftenReddit,0,1,0,-1,1582779600,1582779600,1
unkie87,0,1,0,6,1606107600,1606107600,1
swflguy92,0,1,0,9,1602648000,1602648000,1
keeldude,0,1,0,1,1601179200,1601179200,1
yourcousinvinny3,0,1,0,1,1585540800,1585540800,1
purplemonkey_123,0,1,0,5,1606021200,1606021200,1
Tandanthedude,0,1,0,1,1606626000,1606626000,1
Legionodeath,0,1,0,3,1553918400,1553918400,1
canad1anbacon,0,1,0,1,1550293200,1550293200,1
TheMojoFlo,0,1,0,2,1603598400,1603598400,1
Prizz9415,0,1,0,0,1611982800,1611982800,1
EHS2,0,1,0,1,1611982800,1611982800,1
livvywith2vs,0,1,0,8,1611810000,1611810000,1
matco5376,0,1,0,1,1577336400,1577336400,1
lordofduct,0,1,0,7,1606885200,1606885200,1
ItzBoogieMan,0,1,0,4,1605502800,1605502800,1
Sabyyr,0,1,0,1,1609390800,1609390800,1
Large_Television,0,1,0,3,1588651200,1588651200,1
Big_Guap_Bag_Grabber,0,1,0,16,1583985600,1583985600,1
nyyankee197072,0,1,0,23,1576126800,1576126800,1
decroh,0,1,0,2,1553140800,1553140800,1
DraciaAnderson,0,1,0,3,1560744000,1560744000,1
Pants__Goblin,0,1,0,2,1603512000,1603512000,1
byrnestj7,0,1,0,1,1604116800,1604116800,1
IntelligentTune5497,0,1,0,1,1599537600,1599537600,1
D3nniz,0,1,0,46,1602043200,1602043200,1
ItsWisnu,0,1,0,0,1598760000,1598760000,1
Equipoisonous,0,1,0,36,1586923200,1586923200,1
caleb-woodard97,0,1,0,8,1579669200,1579669200,1
deeya-b,0,1,0,1,1605934800,1605934800,1
DestituteGoldsmith,0,1,0,4,1606021200,1606021200,1
Shooeytv,0,1,0,-2,1604379600,1604379600,1
Miss-Anthropy66,0,1,0,11,1611810000,1611810000,1
The1ronCurtain,0,1,0,-6,1597636800,1597636800,1
pans_and_pots,0,1,0,56,1599883200,1599883200,1
WaitWhyNot,0,1,0,12,1609390800,1609390800,1
London_Dry,0,1,0,12,1578632400,1578632400,1
marchingclocks,0,1,0,1,1564545600,1564545600,1
epicfunnygamer420,0,1,0,1,1603512000,1603512000,1
billybuttbags,0,1,0,0,1593662400,1593662400,1
CeruIian,0,1,0,258,1603684800,1603684800,1
thoroughlyimpressed,0,1,0,1,1603512000,1603512000,1
Lil-Bugger,0,1,0,3,1607490000,1607490000,1
Jaffool,0,1,0,2,1601265600,1601265600,1
CreatedInError,0,1,0,3,1601956800,1601956800,1
Monkeybolo4231,0,1,0,2,1601870400,1601870400,1
The_GASK,0,1,0,26,1592798400,1592798400,1
rcfox,0,1,0,6,1591243200,1591243200,1
asentientgrape,0,1,0,29,1544245200,1544245200,1
GasDoves,0,1,0,1,1577422800,1577422800,1
chomnker,0,1,0,1,1577163600,1577163600,1
one_rand0m_guy,0,1,0,21,1601697600,1601697600,1
ArghAuguste,0,1,0,1,1605589200,1605589200,1
SUBWAYJAROD,0,1,0,6,1534478400,1534478400,1
DirtyPeppermintPatty,0,1,0,35,1606971600,1606971600,1
Mellonkoli,1,0,22,0,1604898000,1604898000,1
gramapislab,0,1,0,9,1602820800,1602820800,1
dgrace97,0,1,0,3,1575349200,1575349200,1
XtremeCookie,0,1,0,11,1598846400,1598846400,1
bigdummythiccness,1,0,43,0,1611810000,1611810000,1
Bill_Ender_Belichick,0,1,0,1,1600660800,1600660800,1
engelblack,0,1,0,2,1580878800,1580878800,1
Fineshrines2,0,1,0,8,1567828800,1567828800,1
tonystigma,0,1,0,2,1611723600,1611723600,1
dabeanery55,0,1,0,1,1606885200,1606885200,1
Aestheticpsycho,0,1,0,7,1539921600,1539921600,1
vaishk_,0,1,0,5,1546491600,1546491600,1
soapy_margarita,0,1,0,26,1598587200,1598587200,1
manicpixiedreamqueen,0,1,0,1,1557201600,1557201600,1
Nolanus,1,0,6,0,1579842000,1579842000,1
vastle12,0,1,0,7,1607403600,1607403600,1
analfarts69,0,1,0,6,1590379200,1590379200,1
epiclyepiclee,1,0,8,0,1606885200,1606885200,1
crocodileghandi1,0,1,0,1,1598846400,1598846400,1
MadBigote,0,1,0,31,1543035600,1543035600,1
basically-just-beans,0,1,0,9,1575262800,1575262800,1
anti-weeb1,0,1,0,4,1608181200,1608181200,1
wodaji,0,1,0,1,1582434000,1582434000,1
forcesensitivevulcan,0,1,0,6,1583125200,1583125200,1
GardenOrca,1,0,31,0,1577941200,1577941200,1
XenoDrake,0,1,0,11,1585022400,1585022400,1
Astarath,0,1,0,73,1598760000,1598760000,1
Oranje525,0,1,0,3,1606712400,1606712400,1
NotNegate,0,1,0,11,1591761600,1591761600,1
FishWearingAFroWig,0,1,0,6,1599105600,1599105600,1
throwaway189904428,0,1,0,1,1594008000,1594008000,1
WhoTookGrimwhisper,0,1,0,1,1603512000,1603512000,1
Muckdanutzzzz543,0,1,0,3,1603512000,1603512000,1
Spelare_en,0,1,0,-5,1602129600,1602129600,1
Snacheezeisme,0,1,0,-12,1608094800,1608094800,1
engifear,0,1,0,12,1598846400,1598846400,1
Chaski1212,0,1,0,145,1590552000,1590552000,1
dutchnoob420,0,1,0,4,1606280400,1606280400,1
pussmonster69,0,1,0,1,1586664000,1586664000,1
MrMahomey,0,1,0,13,1576126800,1576126800,1
ucsbato2413,1,0,80,0,1591934400,1591934400,1
Ryezer01,0,1,0,14,1584244800,1584244800,1
icedlemons,0,1,0,1,1608872400,1608872400,1
LeBumNotTop1000,0,1,0,35,1573448400,1573448400,1
Boneeskel,1,0,0,0,1601179200,1601179200,1
NeatTrain98,0,1,0,4,1603512000,1603512000,1
IntelligentLocal6,0,1,0,4,1589860800,1589860800,1
EmperorXerro,0,1,0,9,1585281600,1585281600,1
pigmanbearcatdeer,0,1,0,9,1603512000,1603512000,1
Secretagentx,0,1,0,5,1596772800,1596772800,1
prude_eskimo,0,1,0,1,1608181200,1608181200,1
curly_13,0,1,0,2,1591329600,1591329600,1
BellerophonM,0,1,0,62,1607749200,1607749200,1
-Pin_Cushion-,0,1,0,9,1600833600,1600833600,1
CynDoS,0,1,0,1,1573621200,1573621200,1
CarlSpencer,0,1,0,-2,1591243200,1591243200,1
identicalgamer,0,1,0,2,1482987600,1482987600,1
where__didyougo,0,1,0,3,1598068800,1598068800,1
Dragonlfw,0,1,0,13,1605848400,1605848400,1
d-_-bored-_-b,0,1,0,9,1560916800,1560916800,1
HoochieCoochieDude,0,1,0,6,1602648000,1602648000,1
Kiwi-Empress,0,1,0,12,1596859200,1596859200,1
waresmarufy,0,1,0,-11,1600660800,1600660800,1
El-Bugbeeto,0,1,0,6,1568433600,1568433600,1
eliasbagley,0,1,0,63,1602993600,1602993600,1
Mickael_Tarakona,0,1,0,2,1573362000,1573362000,1
nomorepeopleplz,0,1,0,1,1566446400,1566446400,1
ConexV8,0,1,0,20,1600228800,1600228800,1
-Deki-,0,1,0,3,1606366800,1606366800,1
Sostontown,0,1,0,-15,1580619600,1580619600,1
hammy351,0,1,0,2,1606798800,1606798800,1
Realizt80,0,1,0,2,1603598400,1603598400,1
RealMisterPringle,0,1,0,1,1609563600,1609563600,1
Coopetition,0,1,0,36,1598328000,1598328000,1
Nick2the4reaper7,0,1,0,3,1595217600,1595217600,1
capnfappin,0,1,0,1,1584158400,1584158400,1
brokenmarionette,0,1,0,10,1573534800,1573534800,1
VenomRaven,0,1,0,1,1606280400,1606280400,1
HarbingerOfSauce,0,1,0,2,1605589200,1605589200,1
dannybeast,0,1,0,2,1555732800,1555732800,1
tricorehat,0,1,0,9,1604811600,1604811600,1
MARKLAR5,0,1,0,27,1608786000,1608786000,1
skeletonfart,0,1,0,42,1599192000,1599192000,1
sdwvit,0,1,0,1,1605070800,1605070800,1
Hessssel,0,1,0,1,1600660800,1600660800,1
ninjasdad,0,1,0,6,1583298000,1583298000,1
Staggeringpage8,0,1,0,6,1588392000,1588392000,1
Dicey_Mantis,1,0,137,0,1554436800,1554436800,1
fuzzybunnyslipper,0,1,0,7,1597032000,1597032000,1
Dynamaxion,0,1,0,-2,1603166400,1603166400,1
Caledron,0,1,0,7,1570939200,1570939200,1
RealityPowerRanking,0,1,0,12,1612155600,1612155600,1
CanadianWifi468,0,1,0,1,1606107600,1606107600,1
adumblady,0,1,0,31,1566446400,1566446400,1
Evaporationz,0,1,0,1,1604379600,1604379600,1
tr3mbau,0,1,0,1,1608872400,1608872400,1
Granak,0,1,0,5,1555473600,1555473600,1
Australiana69,0,1,0,13,1573016400,1573016400,1
Cashios,0,1,0,-1,1598500800,1598500800,1
1--618,0,1,0,6,1605330000,1605330000,1
YankeeTankEngine,0,1,0,1,1591329600,1591329600,1
moxiekins,0,1,0,1,1581742800,1581742800,1
whiterungaurd,0,1,0,2,1567137600,1567137600,1
Sarge0369,0,1,0,4,1607835600,1607835600,1
jellyypony,0,1,0,2,1605502800,1605502800,1
ruoqiLehTmAI,0,1,0,1,1592798400,1592798400,1
Cautious_Chemistry_5,0,1,0,3,1608181200,1608181200,1
Sufficient_Picture_7,0,1,0,8,1611810000,1611810000,1
bentoboxer7,0,1,0,21,1607230800,1607230800,1
milesralls1,0,1,0,0,1562385600,1562385600,1
jetchohez9,0,1,0,9,1584936000,1584936000,1
FortFighter,0,1,0,6,1599537600,1599537600,1
BigBeagleEars,0,1,0,5,1603684800,1603684800,1
wildbobkitty,0,1,0,22,1599019200,1599019200,1
Genji007,0,1,0,3,1606021200,1606021200,1
conglock,0,1,0,8,1572408000,1572408000,1
freesprite9,0,1,0,8,1584936000,1584936000,1
Two_Tone_Malone_,0,1,0,1,1589688000,1589688000,1
pillpoison,0,1,0,1,1569124800,1569124800,1
CinnabonHotJizz,0,1,0,1,1465617600,1465617600,1
akathescholar,1,0,5,0,1606626000,1606626000,1
MrMisogynist203,1,0,1,0,1589947200,1589947200,1
Easy_flankin,0,1,0,12,1598500800,1598500800,1
yo-i-invented-china,0,1,0,8,1606798800,1606798800,1
wowadrow,0,1,0,29,1611810000,1611810000,1
sorryiwasbornstupid,0,1,0,4,1595131200,1595131200,1
mcphisto2,0,1,0,21,1604898000,1604898000,1
BrilliantEnergy,0,1,0,2,1607749200,1607749200,1
Catfrogdog2,0,1,0,3,1603598400,1603598400,1
liveApple2212,0,1,0,4,1588392000,1588392000,1
HamiIDK,1,0,176,0,1599192000,1599192000,1
konifone,0,1,0,1,1594440000,1594440000,1
addicted_to_golf,0,1,0,4,1608958800,1608958800,1
DangerousKidTurtle,0,1,0,10,1563854400,1563854400,1
winter_fox9,0,1,0,5,1608613200,1608613200,1
Svedjik,0,1,0,10,1586059200,1586059200,1
zoosea,0,1,0,70,1548997200,1548997200,1
FeralCheshireKitten,1,0,112,0,1577250000,1577250000,1
SaunaFucker,0,1,0,-2,1596772800,1596772800,1
iHeidi,0,1,0,1,1607835600,1607835600,1
bigavz,0,1,0,4,1602734400,1602734400,1
Pordyboy,0,1,0,1,1589947200,1589947200,1
Mikewithnoname,0,1,0,4,1600142400,1600142400,1
Jollytruant1,0,1,0,7,1595649600,1595649600,1
BigDickRick77,0,1,0,-7,1606539600,1606539600,1
StanfordBridge,0,1,0,11,1577422800,1577422800,1
WeedNomad69,0,1,0,2,1599192000,1599192000,1
BloodOfThePariah,0,1,0,2,1603598400,1603598400,1
voxov7,0,1,0,2,1611205200,1611205200,1
MalarkeysPoppa,1,0,14,0,1603339200,1603339200,1
elmoo2210,0,1,0,7,1546491600,1546491600,1
sejolly07,0,1,0,23,1607576400,1607576400,1
weirdfeeshes,0,1,0,3,1570593600,1570593600,1
nishinoran,0,1,0,-1,1607576400,1607576400,1
joeglen,0,1,0,2,1603944000,1603944000,1
hopelessness69,0,1,0,2,1578459600,1578459600,1
shieldstormReloaded,0,1,0,1,1606712400,1606712400,1
BlytheRayne,0,1,0,61,1607835600,1607835600,1
BeaStanellosGhost,0,1,0,3,1561694400,1561694400,1
Fishtoots,0,1,0,1,1599883200,1599883200,1
tomblits,0,1,0,1,1570075200,1570075200,1
MoonlightSunx,0,1,0,47,1609390800,1609390800,1
stck123,0,1,0,2,1607922000,1607922000,1
maoejo,0,1,0,2,1599710400,1599710400,1
imgonnamakeyoushake,0,1,0,1,1608872400,1608872400,1
redwhiteyellowblue1,0,1,0,6,1600660800,1600660800,1
knightress_oxhide,0,1,0,1,1602216000,1602216000,1
The_White_Rice,0,1,0,6,1571803200,1571803200,1
Savonarola1452,0,1,0,1,1588996800,1588996800,1
ersteiner,0,1,0,10,1607576400,1607576400,1
Queenie_O,1,0,86,0,1569556800,1569556800,1
itslikeroar,0,1,0,1,1601956800,1601956800,1
SharpenedStinger,0,1,0,9,1570075200,1570075200,1
Help-Im-Dead,0,1,0,3,1587268800,1587268800,1
Adventurous-Towel-26,1,0,49,0,1609477200,1609477200,1
KawhiComeBack,0,1,0,1,1571112000,1571112000,1
fodzerino,0,1,0,2,1600660800,1600660800,1
SpaceDog777,0,1,0,-1,1570507200,1570507200,1
OpenlyFay,0,1,0,2,1566446400,1566446400,1
Clear-Chipmunk,0,1,0,7,1588132800,1588132800,1
-Iamyouandyouareme-,0,1,0,10,1601092800,1601092800,1
foodforthoughts1919,0,1,0,0,1571803200,1571803200,1
SincerePear,0,1,0,1,1598932800,1598932800,1
Vajrayogini_1312,0,1,0,2,1573016400,1573016400,1
strangervisitor,0,1,0,4,1499659200,1499659200,1
peoplearestrangebrew,0,1,0,11,1602043200,1602043200,1
orangafang,0,1,0,5,1606798800,1606798800,1
bb885566,0,1,0,4,1566619200,1566619200,1
degenerate743,0,1,0,5,1574658000,1574658000,1
ToastAdorbs,0,1,0,2,1603598400,1603598400,1
pudgypoultry,0,1,0,15,1605589200,1605589200,1
south-of-eden,0,1,0,1,1599969600,1599969600,1
-sheisspace-,0,1,0,11,1595736000,1595736000,1
Courtyler,0,1,0,7,1601438400,1601438400,1
hampster_toupe,0,1,0,0,1603425600,1603425600,1
goatfarmvt,0,1,0,14,1572753600,1572753600,1
i-puntificate,0,1,0,2,1582174800,1582174800,1
W84MEYALL,0,1,0,54,1604293200,1604293200,1
gia_06,0,1,0,2,1606021200,1606021200,1
StoneyBalognaHomie,0,1,0,7,1582520400,1582520400,1
AFJ150,0,1,0,3,1603512000,1603512000,1
FloridaRaised117,0,1,0,27,1593662400,1593662400,1
Scone_Witch,0,1,0,19,1581310800,1581310800,1
Dilloon_Weid,0,1,0,40,1608181200,1608181200,1
no_just_browsing_thx,0,1,0,8,1606539600,1606539600,1
Halcyon1984,0,1,0,2,1599451200,1599451200,1
fev_dt,0,1,0,2,1599624000,1599624000,1
infantry1944,0,1,0,1,1612242000,1612242000,1
CannibalLector,0,1,0,1,1556424000,1556424000,1
LupoSapien,0,1,0,27,1600833600,1600833600,1
OptimusPrimeTime21,0,1,0,14,1603512000,1603512000,1
ilikeyoohoo,0,1,0,4,1600660800,1600660800,1
TheQuestionsAglet,0,1,0,3,1602648000,1602648000,1
SubatomicMc,0,1,0,2,1563940800,1563940800,1
Nexisa,0,1,0,19,1590206400,1590206400,1
Icy_Celebrationn,0,1,0,1,1609045200,1609045200,1
PrincessAshh,0,1,0,1,1608613200,1608613200,1
V--D,0,1,0,1,1612155600,1612155600,1
Llleblanc1986,1,0,14,0,1547528400,1547528400,1
Nuke_____Dukem,1,0,1364,0,1602734400,1602734400,1
orangeblueorangeblue,0,1,0,2,1591156800,1591156800,1
Math3s2,0,1,0,1,1608354000,1608354000,1
RGBGamingDildo,0,1,0,10,1607835600,1607835600,1
TalkBigShit,0,1,0,13,1595131200,1595131200,1
CrestedShark,0,1,0,26,1571025600,1571025600,1
post-existentialist,1,0,2,0,1608267600,1608267600,1
anafylactic,0,1,0,1,1598846400,1598846400,1
CrustySundays,0,1,0,-5,1597032000,1597032000,1
BoomChocolateLatkes,0,1,0,26,1604030400,1604030400,1
lol_lauren,0,1,0,4,1577941200,1577941200,1
Toadsted,0,1,0,21,1550206800,1550206800,1
ReadAndReddit123,0,1,0,-36,1600228800,1600228800,1
hitemwithahook,0,1,0,3,1603598400,1603598400,1
SnoopDoggsGardener,0,1,0,2,1553659200,1553659200,1
optionalhero,0,1,0,17,1607835600,1607835600,1
pounds_not_dollars,0,1,0,2,1574053200,1574053200,1
OOOOOOOOOOOOOOOOOOO7,0,1,0,30,1602043200,1602043200,1
babel345,0,1,0,0,1591329600,1591329600,1
El_Stupido_Supremo,0,1,0,5,1588651200,1588651200,1
SevenSeasons,0,1,0,2,1595390400,1595390400,1
ViciousAsparagusFart,0,1,0,5,1571716800,1571716800,1
awokendobby,0,1,0,1,1591329600,1591329600,1
bioposadist,0,1,0,13,1587096000,1587096000,1
theindiananarchist,1,0,360,0,1568520000,1568520000,1
BeardedDenim,0,1,0,1,1601870400,1601870400,1
123fass,0,1,0,2,1602734400,1602734400,1
apklps,0,1,0,28,1576040400,1576040400,1
atglobe,0,1,0,15,1608267600,1608267600,1
-Renee,0,1,0,12,1580619600,1580619600,1
typicallchad6,0,1,0,2,1576645200,1576645200,1
NovaFlares,0,1,0,-5,1607662800,1607662800,1
Sogda,0,1,0,5,1599624000,1599624000,1
FearAzrael,0,1,0,-5,1603512000,1603512000,1
drstock,0,1,0,1,1612069200,1612069200,1
yzudi,0,1,0,49,1589256000,1589256000,1
pewqokrsf,0,1,0,5,1585281600,1585281600,1
YandyTheGnome,0,1,0,7,1606971600,1606971600,1
Hereiamfornow1,0,1,0,1,1608008400,1608008400,1
RadioactiveTF2,0,1,0,38,1599451200,1599451200,1
its_a_fishing_show,1,0,8,0,1533009600,1533009600,1
AbesHairyLegs,0,1,0,2,1619150400,1619150400,1
DutchWarDog,0,1,0,1,1609390800,1609390800,1
sdhlMemester,1,0,28,0,1608526800,1608526800,1
eazyabreeze,0,1,0,16,1554264000,1554264000,1
1zo3P192,0,1,0,3,1602820800,1602820800,1
Staytoon,0,1,0,2,1582520400,1582520400,1
lilbugg22,0,1,0,8,1605502800,1605502800,1
TerryTowellinghat,0,1,0,2,1581051600,1581051600,1
IntroSpeccy,0,1,0,1,1603512000,1603512000,1
LordApples1234,0,1,0,0,1608699600,1608699600,1
RehabValedictorian,0,1,0,61,1612069200,1612069200,1
LowLow013,1,0,45,0,1586836800,1586836800,1
Miata667,0,1,0,-13,1565236800,1565236800,1
hcrystls,0,1,0,5,1603684800,1603684800,1
Frisbeeman,0,1,0,8,1578200400,1578200400,1
ScandiSom,0,1,0,-19,1605762000,1605762000,1
AntTuM,0,1,0,1,1591329600,1591329600,1
Holmesary,0,1,0,84,1590465600,1590465600,1
1800leon,0,1,0,1,1578373200,1578373200,1
InMyDarkTimes,0,1,0,10,1574139600,1574139600,1
deedee0214,0,1,0,15,1600660800,1600660800,1
restless_craftsman,0,1,0,22,1608267600,1608267600,1
BeforePizza,0,1,0,1,1602043200,1602043200,1
wise_young_man,0,1,0,1,1604379600,1604379600,1
WhenLeavesFall,0,1,0,27,1603512000,1603512000,1
0ericire0,0,1,0,14,1600315200,1600315200,1
raspberryysherbet,0,1,0,6,1593576000,1593576000,1
VolothampGeddarm,0,1,0,-9,1577854800,1577854800,1
D2dcypher,0,1,0,-7,1605589200,1605589200,1
Dresden890,0,1,0,3,1585454400,1585454400,1
kge92,1,0,53,0,1599796800,1599796800,1
nstuck,0,1,0,2,1573362000,1573362000,1
Sigurlion,0,1,0,2,1585454400,1585454400,1
Jake167,0,1,0,1,1601006400,1601006400,1
Jaymuhz,0,1,0,2,1606280400,1606280400,1
Comrade_Comski,0,1,0,-10,1581310800,1581310800,1
bigcheepi,0,1,0,12,1597204800,1597204800,1
Gatlin07,0,1,0,1,1587355200,1587355200,1
yuzucake,0,1,0,13,1611982800,1611982800,1
adoarns,0,1,0,14,1548219600,1548219600,1
woodrow1922,0,1,0,0,1602907200,1602907200,1
Worker_Democracy,0,1,0,3,1601870400,1601870400,1
Arra_y,1,0,2,0,1600228800,1600228800,1
kandidraygan,1,0,23,0,1606798800,1606798800,1
DigiQuip,0,1,0,26,1585454400,1585454400,1
revolution_meow,0,1,0,0,1599278400,1599278400,1
mathshirtmaster,1,0,508,0,1586577600,1586577600,1
AlienPathfinder,0,1,0,8,1598760000,1598760000,1
DissidentRaptor,0,1,0,6,1585540800,1585540800,1
Neohoe,0,1,0,1,1599969600,1599969600,1
Cbk40,0,1,0,4,1603598400,1603598400,1
britbritfish,0,1,0,2,1603512000,1603512000,1
WindUpSpace,0,1,0,42,1585281600,1585281600,1
Refrelic,0,1,0,2,1602907200,1602907200,1
South_Mud,0,1,0,1,1588219200,1588219200,1
JA1987,0,1,0,1,1528430400,1528430400,1
LegitimateCoyote9,1,0,17,0,1578978000,1578978000,1
eldukae,0,1,0,1,1600660800,1600660800,1
CertainChart,0,1,0,1,1599451200,1599451200,1
aggravating-onion,0,1,0,2,1599364800,1599364800,1
AcidRap69,0,1,0,1,1602648000,1602648000,1
endlessinquiry,0,1,0,-8,1596686400,1596686400,1
Gotta_Ketcham_All,0,1,0,1,1570075200,1570075200,1
know-1_nose,0,1,0,5,1570248000,1570248000,1
BattyforFunkos,0,1,0,72,1600660800,1600660800,1
Unfaltered_Prophet,0,1,0,9,1605589200,1605589200,1
Mcpaulmcnugget,0,1,0,1,1608267600,1608267600,1
Kabboomer,0,1,0,1,1603425600,1603425600,1
RobotLegion,0,1,0,76,1584676800,1584676800,1
shit_poster_69_420,0,1,0,-9,1607317200,1607317200,1
MarBakwas,0,1,0,1,1590120000,1590120000,1
bordercolliesforlife,0,1,0,4,1572843600,1572843600,1
DarthEnvicius,0,1,0,2,1595390400,1595390400,1
APrivatephilosophy,0,1,0,39,1577250000,1577250000,1
anominous27,0,1,0,1,1574139600,1574139600,1
DiaryofaMadman-Tinia,0,1,0,1,1609131600,1609131600,1
coralrefrigerator,0,1,0,1,1602907200,1602907200,1
Ronv5151,0,1,0,1,1594785600,1594785600,1
din0d0nut,0,1,0,24,1590897600,1590897600,1
buttpirate1111,0,1,0,5,1572408000,1572408000,1
CD5X,0,1,0,19,1586836800,1586836800,1
1080ti_Kingpin,0,1,0,1,1585454400,1585454400,1
ZyraunO,0,1,0,2,1599537600,1599537600,1
thiccdoggo_01,0,1,0,1,1600920000,1600920000,1
ATS9194,0,1,0,1,1614315600,1614315600,1
FIVE-SIX56,0,1,0,2,1595649600,1595649600,1
sweetplantveal,0,1,0,-5,1608786000,1608786000,1
redpinkkk,0,1,0,2,1578891600,1578891600,1
vvelp,0,1,0,17,1577336400,1577336400,1
paintypainterson,0,1,0,-7,1594267200,1594267200,1
i_like_the_idea,0,1,0,27,1608008400,1608008400,1
unityindigo,0,1,0,2,1598846400,1598846400,1
nimag42,0,1,0,3,1591329600,1591329600,1
gereffi,0,1,0,2,1575435600,1575435600,1
professor_meatbrick,0,1,0,19,1601611200,1601611200,1
BoundlessTurnip,0,1,0,12,1594699200,1594699200,1
lilmeow_meow,0,1,0,1,1592107200,1592107200,1
Yaerdme,0,1,0,15,1605330000,1605330000,1
YourFavouriteHuman,0,1,0,1,1605157200,1605157200,1
Shitty_IT_Dude,0,1,0,8,1590379200,1590379200,1
gingermagician2,0,1,0,2,1588651200,1588651200,1
silvercloud_,0,1,0,1,1604466000,1604466000,1
abu2411,0,1,0,1,1598673600,1598673600,1
jellybeans3,0,1,0,2,1559188800,1559188800,1
mmm-pistol-whip,0,1,0,1,1600747200,1600747200,1
mysteriousscroller,0,1,0,11,1598673600,1598673600,1
quarterlyresentment,0,1,0,8,1578632400,1578632400,1
definiteGallinule,0,1,0,111,1607403600,1607403600,1
renanalmeida828,0,1,0,3,1551934800,1551934800,1
NerdyBro6,0,1,0,2,1567051200,1567051200,1
lumber-liquidators,0,1,0,2,1606539600,1606539600,1
uhhyikes,1,0,54,0,1594267200,1594267200,1
TheAdaquiteGatsby,0,1,0,3,1592971200,1592971200,1
Skinoob38,0,1,0,7,1612069200,1612069200,1
immanent_critique83,0,1,0,1,1567656000,1567656000,1
rolllwiddit,0,1,0,10,1604203200,1604203200,1
LittleLamb_1,0,1,0,1,1609563600,1609563600,1
fuckedup_ftm,0,1,0,5,1601352000,1601352000,1
disneygal96,0,1,0,4,1601956800,1601956800,1
scabies89,0,1,0,1,1601611200,1601611200,1
dabadeedadie,0,1,0,15,1601697600,1601697600,1
Wissenkraft,0,1,0,1,1635912000,1635912000,1
Notafreakbutageek,0,1,0,2,1596427200,1596427200,1
d0m558,0,1,0,-7,1605589200,1605589200,1
Morphabond,0,1,0,-37,1555041600,1555041600,1
Lord_Archibald_IV,0,1,0,4,1578718800,1578718800,1
HDPro-Res,0,1,0,1,1606626000,1606626000,1
donfdi,0,1,0,18,1595217600,1595217600,1
spoken210,0,1,0,2,1584763200,1584763200,1
dclif27,0,1,0,1,1608267600,1608267600,1
SorosSoldier616,0,1,0,1,1606453200,1606453200,1
Aaraeus,0,1,0,-4,1561608000,1561608000,1
Samula1985,0,1,0,-1,1608526800,1608526800,1
slynkster,0,1,0,2,1604030400,1604030400,1
ConnieLingus24,0,1,0,1,1617422400,1617422400,1
Ungrateful-Biped,0,1,0,1,1582174800,1582174800,1
NoW3rds,0,1,0,1,1604379600,1604379600,1
usernameof2021,0,1,0,1,1603512000,1603512000,1
SleepingCalico,0,1,0,1,1608872400,1608872400,1
chrisdudelydude,0,1,0,1,1601006400,1601006400,1
Bark37971,0,1,0,-1,1585454400,1585454400,1
ElMechacontext,0,1,0,4,1600574400,1600574400,1
ricktor67,0,1,0,-4,1584244800,1584244800,1
AscendMePlease,0,1,0,4,1603339200,1603339200,1
TrenWhoreCokeHabit,0,1,0,6,1563681600,1563681600,1
5kylord,0,1,0,6,1583557200,1583557200,1
kellybelly_22,0,1,0,4,1598673600,1598673600,1
sexyhandsMcGee,0,1,0,3,1560744000,1560744000,1
Justreleasetheupdate,0,1,0,-34,1584590400,1584590400,1
brUndon143,0,1,0,2,1592798400,1592798400,1
joeviper25,0,1,0,1,1598932800,1598932800,1
SwtPeavega5,0,1,0,0,1598760000,1598760000,1
markdotnoble,0,1,0,11,1591588800,1591588800,1
-Blackbriar-,0,1,0,1,1573621200,1573621200,1
DarthTyekanik1,0,1,0,1,1608267600,1608267600,1
nicii02,0,1,0,2,1597982400,1597982400,1
awoloozlefinch,0,1,0,1,1556683200,1556683200,1
LordElfa,0,1,0,10,1589515200,1589515200,1
EscalationChronicle,0,1,0,1,1589256000,1589256000,1
d_e_l_u_x_e,0,1,0,2,1603598400,1603598400,1
Taclis,0,1,0,3,1542258000,1542258000,1
thissux2021,0,1,0,1,1612328400,1612328400,1
semper_crayons,0,1,0,1,1593576000,1593576000,1
cantfindacause,1,0,1,0,1593576000,1593576000,1
ProstHund,0,1,0,1,1593748800,1593748800,1
maolaola,0,1,0,35,1579237200,1579237200,1
kr4t0s007,0,1,0,1,1589860800,1589860800,1
ShiftyJFox,0,1,0,4,1599883200,1599883200,1
DoYouSeeMeEatingMice,0,1,0,17,1585454400,1585454400,1
impspy,0,1,0,1,1575522000,1575522000,1
MeticuIous_,0,1,0,1,1585454400,1585454400,1
Bunlieve,0,1,0,1,1603512000,1603512000,1
jinglefroggy,0,1,0,3,1604116800,1604116800,1
pm-me-happy-vibes,0,1,0,0,1606539600,1606539600,1
Iced_Amethyst_625,0,1,0,1,1593921600,1593921600,1
YeezyVuitton,0,1,0,1,1605762000,1605762000,1
Analog_2_Digital,0,1,0,1,1598068800,1598068800,1
Consssuelo,0,1,0,1,1591243200,1591243200,1
nakarino93,1,0,56,0,1589256000,1589256000,1
invisibleemail,1,0,629,0,1606798800,1606798800,1
renys,0,1,0,3,1568174400,1568174400,1
xcto,0,1,0,0,1599796800,1599796800,1
Viroraptor,1,0,14,0,1584072000,1584072000,1
KangarooInAZoo,0,1,0,-21,1609477200,1609477200,1
sametciftci,1,0,0,0,1539921600,1539921600,1
deathcuresallpain,0,1,0,7,1605848400,1605848400,1
Kn0thingIsTerrible,0,1,0,19,1586836800,1586836800,1
Kheroval,0,1,0,8,1600488000,1600488000,1
elektronical,0,1,0,13,1594872000,1594872000,1
MichaelEuteneuer,0,1,0,1,1555905600,1555905600,1
successfully_failing,0,1,0,11,1607317200,1607317200,1
sugarmess,0,1,0,1,1608526800,1608526800,1
TaxDollarsHardAtWork,0,1,0,0,1581829200,1581829200,1
Herflik90,0,1,0,3,1599105600,1599105600,1
superminhminh,0,1,0,0,1585800000,1585800000,1
kellycook301,0,1,0,2,1606626000,1606626000,1
TwoThirdsGuppy,0,1,0,12,1597291200,1597291200,1
Omirin,0,1,0,7,1606194000,1606194000,1
diablette,0,1,0,1,1593230400,1593230400,1
Thriftfunnel,0,1,0,0,1605848400,1605848400,1
oodyway,0,1,0,1,1565755200,1565755200,1
ifonlyiwasbetter,0,1,0,3,1602475200,1602475200,1
Cobinub,0,1,0,3,1598155200,1598155200,1
tottocotunio,1,0,89,0,1581742800,1581742800,1
dimpleminded,0,1,0,1,1612069200,1612069200,1
blackcatflag,0,1,0,2,1541394000,1541394000,1
Vexilos,0,1,0,3,1607749200,1607749200,1
StaidHatter,0,1,0,1,1594872000,1594872000,1
jamesjoeg,0,1,0,2,1590120000,1590120000,1
gayjewzionist,0,1,0,1,1605675600,1605675600,1
toohumano,0,1,0,1,1605675600,1605675600,1
deadlighta,0,1,0,1,1609045200,1609045200,1
karrotcake69,0,1,0,2,1597809600,1597809600,1
RipcurlNg,0,1,0,11,1609477200,1609477200,1
TheHorseMaskGuy,0,1,0,2,1593316800,1593316800,1
MTGTraner,0,1,0,7,1576645200,1576645200,1
gooblefrump,0,1,0,5,1585108800,1585108800,1
friendlypetshark,0,1,0,11,1612155600,1612155600,1
ComprehensiveRich141,0,1,0,1,1609650000,1609650000,1
Knight_of_Nilhilism,0,1,0,11,1598846400,1598846400,1
DrakeSucks,0,1,0,9,1591243200,1591243200,1
your_comments_say,0,1,0,2,1611982800,1611982800,1
IM_INSIDE_YOUR_HOUSE,0,1,0,1,1600833600,1600833600,1
Something4Dinner,1,0,0,0,1581483600,1581483600,1
theworldbystorm,0,1,0,2,1607576400,1607576400,1
5Skye5,0,1,0,13,1604379600,1604379600,1
mrvolvo,0,1,0,1,1579496400,1579496400,1
PinkLaserUnicorn,0,1,0,1,1553659200,1553659200,1
Smullcutepox,0,1,0,1,1590120000,1590120000,1
andromedavan,0,1,0,2,1580187600,1580187600,1
Aarios827,0,1,0,6,1603512000,1603512000,1
strawberrysweetpea,0,1,0,9,1609304400,1609304400,1
God_REMx,0,1,0,1,1604203200,1604203200,1
poiturr,0,1,0,3,1608786000,1608786000,1
Cedarfoot,0,1,0,7,1592798400,1592798400,1
Robby-B,0,1,0,2,1608958800,1608958800,1
Elmer_adkins,0,1,0,4,1596254400,1596254400,1
isopodsarenice,0,1,0,4,1572667200,1572667200,1
Putrid-Key,0,1,0,6,1592193600,1592193600,1
Waelo246,0,1,0,1,1599624000,1599624000,1
NuttyMcNutbag,0,1,0,5,1574312400,1574312400,1
TobyTrash,0,1,0,17,1592798400,1592798400,1
cheapcheap1,0,1,0,3,1583038800,1583038800,1
kent2441,0,1,0,0,1588564800,1588564800,1
enkiddu,0,1,0,-2,1608267600,1608267600,1
ShananaWeeb,1,0,616,0,1606194000,1606194000,1
Auxcon28,0,1,0,2,1555905600,1555905600,1
CLGarcia02,1,0,55,0,1579582800,1579582800,1
a-soldout,0,1,0,4,1605675600,1605675600,1
Jayvereon,0,1,0,1,1608354000,1608354000,1
MYEYESARERAINING,0,1,0,7,1608613200,1608613200,1
botswannaboogaloo,0,1,0,18,1593662400,1593662400,1
newsreadhjw,0,1,0,1,1597550400,1597550400,1
NickCollective,0,1,0,1,1593316800,1593316800,1
c0d3w1ck,0,1,0,13,1602043200,1602043200,1
gutStatus,0,1,0,1,1605070800,1605070800,1
herbalchii,0,1,0,1,1609304400,1609304400,1
Lation410,0,1,0,2,1603512000,1603512000,1
loryb123,0,1,0,3,1548910800,1548910800,1
craig_prime,0,1,0,64,1577422800,1577422800,1
sadpvssy,0,1,0,5,1601784000,1601784000,1
CottonEyeJoe21,0,1,0,3,1576558800,1576558800,1
MercenAria84,0,1,0,1,1608267600,1608267600,1
WalrusesAreAwesome,0,1,0,1,1606021200,1606021200,1
therealInkINVeins,0,1,0,-8,1583211600,1583211600,1
ButThatsFakeNews,0,1,0,2,1575349200,1575349200,1
xKrossCx,0,1,0,13,1600747200,1600747200,1
burke1503,0,1,0,3,1602993600,1602993600,1
dvalidd,0,1,0,1,1603252800,1603252800,1
Boltzmon,0,1,0,1,1573707600,1573707600,1
charliemismyname,0,1,0,11,1588737600,1588737600,1
DertyMikeNDaBoyz,0,1,0,3,1598760000,1598760000,1
ianarischan,0,1,0,1,1594353600,1594353600,1
wdcd12,0,1,0,3,1604116800,1604116800,1
profishing_0-13,0,1,0,1,1639544400,1639544400,1
xjrsummersx,0,1,0,6,1600747200,1600747200,1
Wifeofwes,0,1,0,14,1577336400,1577336400,1
eddyreese,0,1,0,4,1576818000,1576818000,1
Fearless_fx,0,1,0,43,1607317200,1607317200,1
MaryCockinns,0,1,0,2,1525060800,1525060800,1
Lookeydoo,0,1,0,3,1601524800,1601524800,1
defectivekill,0,1,0,12,1575003600,1575003600,1
Houghpuff,0,1,0,7,1598500800,1598500800,1
DankVectorz,0,1,0,1,1608267600,1608267600,1
zuben_tell,0,1,0,25,1591675200,1591675200,1
84ishmael,0,1,0,9,1594440000,1594440000,1
Psyteq,0,1,0,22,1582606800,1582606800,1
FlagFanatic02,0,1,0,9,1573707600,1573707600,1
Gazpacho_Marx,0,1,0,10,1594008000,1594008000,1
Thisfknguyritehere,0,1,0,2,1606021200,1606021200,1
4OneFever,1,0,23,0,1604638800,1604638800,1
Biggidybo,0,1,0,1,1498363200,1498363200,1
PM-ME-YOUR-HANDBRA,0,1,0,2,1584158400,1584158400,1
deadClifford,0,1,0,2,1591502400,1591502400,1
Buboonem,0,1,0,8,1572408000,1572408000,1
Slavarbetare,0,1,0,1,1570420800,1570420800,1
bostwiek,0,1,0,-7,1606539600,1606539600,1
ruthless_techie,0,1,0,3,1597291200,1597291200,1
terf_fret,0,1,0,1,1608526800,1608526800,1
aspiringwanderer03,0,1,0,2,1607317200,1607317200,1
jaeldi,0,1,0,3,1584763200,1584763200,1
ayevee21,0,1,0,15,1592884800,1592884800,1
kvior1,1,0,6,0,1600574400,1600574400,1
roncadillacisfrickin,0,1,0,-6,1557288000,1557288000,1
LilithImmaculate,0,1,0,5,1608267600,1608267600,1
underfifi,0,1,0,2,1602043200,1602043200,1
IntuitiveStains,0,1,0,1,1603684800,1603684800,1
HashtagHashtagHashtg,1,0,6,0,1433563200,1433563200,1
GuggGugg,0,1,0,8,1594008000,1594008000,1
smollstars33,0,1,0,1,1597464000,1597464000,1
shoemanship,0,1,0,36,1576040400,1576040400,1
zhowell406,0,1,0,1,1572580800,1572580800,1
cactilife,0,1,0,0,1608699600,1608699600,1
dontmutethe513,0,1,0,1,1596686400,1596686400,1
Martell2647,1,0,31,0,1573102800,1573102800,1
flaminboxofhate,0,1,0,2,1572667200,1572667200,1
Matto-san,0,1,0,2,1611810000,1611810000,1
morticiaV,0,1,0,1,1547096400,1547096400,1
AlarmingAffect0,0,1,0,1,1611723600,1611723600,1
Edmonta,0,1,0,1,1604203200,1604203200,1
ZeroVoid_98,0,1,0,1,1582693200,1582693200,1
mjtenveldhuis,0,1,0,1,1585540800,1585540800,1
Just_the_facts_ma_m,0,1,0,0,1585454400,1585454400,1
LungInflator,0,1,0,1,1605502800,1605502800,1
SoggyEmpenadas,0,1,0,1,1603598400,1603598400,1
moosehornman,0,1,0,1,1605502800,1605502800,1
ktamkivimsh,0,1,0,4,1560657600,1560657600,1
NGTTwo,0,1,0,8,1607317200,1607317200,1
qualityspoork,0,1,0,-1,1574312400,1574312400,1
1968Bladerunner,0,1,0,3,1596600000,1596600000,1
new_boi_but_not_noob,0,1,0,2,1596686400,1596686400,1
YOURMOM37,0,1,0,9,1559016000,1559016000,1
civodar,0,1,0,5,1605589200,1605589200,1
LucyHazelRosey50,0,1,0,1,1569988800,1569988800,1
SpudDan,0,1,0,7,1582606800,1582606800,1
squishysalmon,0,1,0,9,1602820800,1602820800,1
jdjdjjddgsfh,0,1,0,2,1573621200,1573621200,1
Gergi_247,0,1,0,1,1574226000,1574226000,1
jordanws18,1,0,42,0,1596600000,1596600000,1
Killuha7,0,1,0,2,1606539600,1606539600,1
Kcajkcaj99,0,1,0,1,1572843600,1572843600,1
gilbergrape,0,1,0,1,1602820800,1602820800,1
spatulaboy,0,1,0,125,1562817600,1562817600,1
1mminentFish,0,1,0,11,1607230800,1607230800,1
BoulderCreature,0,1,0,8,1598068800,1598068800,1
fvvhjjkn-bff-thbgtbb,0,1,0,2,1608267600,1608267600,1
RighteousIndigjason,0,1,0,39,1605762000,1605762000,1
nihilist74,0,1,0,1,1582779600,1582779600,1
rullerofallmarmalade,0,1,0,1,1605157200,1605157200,1
WellFineThenDamn,0,1,0,5,1608267600,1608267600,1
souper13,0,1,0,9,1587096000,1587096000,1
kevingharvey,0,1,0,1,1606021200,1606021200,1
Cookie-Man23,0,1,0,3,1607317200,1607317200,1
EmileWolf,0,1,0,2,1599364800,1599364800,1
Disfuncaoeretil,0,1,0,4,1599710400,1599710400,1
mistadehn,0,1,0,58,1576213200,1576213200,1
T2000BD,0,1,0,4,1594612800,1594612800,1
vegalicious1,0,1,0,4,1552968000,1552968000,1
hjayt,0,1,0,2,1601352000,1601352000,1
arrakisworm75666,0,1,0,2,1594008000,1594008000,1
LankyMention,0,1,0,0,1600660800,1600660800,1
swolatarian,0,1,0,6,1571630400,1571630400,1
WalMartens25,0,1,0,3,1580360400,1580360400,1
Thatsmydollar,0,1,0,1,1600574400,1600574400,1
darkfire621,0,1,0,6,1575349200,1575349200,1
JaconSass,0,1,0,1,1589860800,1589860800,1
Sigma-42,0,1,0,5,1600833600,1600833600,1
tomthede,0,1,0,1,1605330000,1605330000,1
invasionthemes,0,1,0,48,1547010000,1547010000,1
buzzbros2002,0,1,0,5,1589860800,1589860800,1
randomnomber,0,1,0,9,1563854400,1563854400,1
cripple_bastard,0,1,0,22,1595217600,1595217600,1
SadisticYellowBird,0,1,0,1,1611032400,1611032400,1
CanuckWoodchuck,0,1,0,2,1608786000,1608786000,1
axolitl-nicerpls,0,1,0,3,1606971600,1606971600,1
LeluWater,0,1,0,162,1603512000,1603512000,1
hithenameisMatthew,0,1,0,3,1564372800,1564372800,1
jdog1067,0,1,0,62,1597982400,1597982400,1
SatanIsBoring,0,1,0,2,1594180800,1594180800,1
Mudbeard,1,0,109,0,1587614400,1587614400,1
Slippy_Dong_Bag,0,1,0,7,1559016000,1559016000,1
FLINTL0CK,1,0,26,0,1547787600,1547787600,1
sbeadc,0,1,0,59,1575522000,1575522000,1
Stumbling_Corgi,0,1,0,3,1560916800,1560916800,1
albert-the-fish_boi,0,1,0,1,1608008400,1608008400,1
aqualung35,1,0,1936,0,1577941200,1577941200,1
Seathttrail,0,1,0,4,1603512000,1603512000,1
shawn3490,0,1,0,2,1600488000,1600488000,1
Doooomedboi,0,1,0,2,1606539600,1606539600,1
DeadeyeDuncan,0,1,0,31,1598760000,1598760000,1
M0ral_Supp0rt,1,0,23,0,1606107600,1606107600,1
LocalYokelized,0,1,0,20,1571457600,1571457600,1
Tempest_Fugit,0,1,0,1,1605934800,1605934800,1
stardust_lunar,0,1,0,11,1571112000,1571112000,1
Yall-hypocrites,0,1,0,16,1561089600,1561089600,1
rippinmarydarts,0,1,0,10,1560484800,1560484800,1
FinalSniper,0,1,0,1,1608786000,1608786000,1
lebookfairy,0,1,0,3,1609390800,1609390800,1
icedcavern,1,0,1,0,1585454400,1585454400,1
Wrigley953,0,1,0,36,1592539200,1592539200,1
appleearbudssuck,0,1,0,1,1588910400,1588910400,1
ghkijggghjjj,1,0,378,0,1577768400,1577768400,1
oldblueee,0,1,0,2,1601092800,1601092800,1
TzoBco,0,1,0,2,1581397200,1581397200,1
gorilla-soup,0,1,0,9,1591675200,1591675200,1
Bubble_Zealot,0,1,0,5,1581915600,1581915600,1
clouds4all,0,1,0,1,1585800000,1585800000,1
Brandoch_Daha,0,1,0,21,1606280400,1606280400,1
madwitchchu44,0,1,0,3,1603512000,1603512000,1
BrettBrown2020,0,1,0,150,1600488000,1600488000,1
DeathValley-Queen,0,1,0,4,1601870400,1601870400,1
Tinomatutino97,0,1,0,42,1596340800,1596340800,1
Zaliacks,0,1,0,3,1604379600,1604379600,1
l1iji1jl,0,1,0,7,1578459600,1578459600,1
huytrop2,0,1,0,1,1589860800,1589860800,1
Lucid108,0,1,0,1,1582866000,1582866000,1
moxthunder,0,1,0,5,1580792400,1580792400,1
yildirim1337,0,1,0,113,1604811600,1604811600,1
Zooblesnoops,0,1,0,2,1560657600,1560657600,1
DanLewisFW,0,1,0,1,1584763200,1584763200,1
ZealCrown,0,1,0,2,1599796800,1599796800,1
UnfortunatelyIAmMe,0,1,0,1,1584417600,1584417600,1
Very_Cooler,0,1,0,6,1560744000,1560744000,1
thesleepingparrot,0,1,0,2,1589601600,1589601600,1
EntMoose,0,1,0,7,1576299600,1576299600,1
guywitharash,0,1,0,1,1594094400,1594094400,1
torpedorosie,0,1,0,32,1553832000,1553832000,1
n01saround,0,1,0,7,1598760000,1598760000,1
Stevedougs,0,1,0,2,1589947200,1589947200,1
SomehowAnActualAdult,0,1,0,3,1596427200,1596427200,1
Hardcorex,0,1,0,1,1607576400,1607576400,1
LeLuDallas5,0,1,0,14,1573362000,1573362000,1
BreathManuallyNow,0,1,0,0,1562731200,1562731200,1
Papayaflying,0,1,0,-2,1590465600,1590465600,1
AshamedWerewolf,0,1,0,247,1584504000,1584504000,1
BigDykeWithABigByke,0,1,0,1,1583470800,1583470800,1
Ventachinkway,0,1,0,9,1571284800,1571284800,1
litlbool,0,1,0,2,1609390800,1609390800,1
HertzFrequently,0,1,0,1,1569124800,1569124800,1
nitestar95,0,1,0,2,1592193600,1592193600,1
weimading,1,0,76,0,1597550400,1597550400,1
kerricolleen,0,1,0,1,1591329600,1591329600,1
Peachman2000,0,1,0,2,1577941200,1577941200,1
Kordalio,0,1,0,4,1601870400,1601870400,1
AssumingRain,0,1,0,2,1606971600,1606971600,1
Cinnamonbunns2,0,1,0,1,1606626000,1606626000,1
Shryte16,1,0,97,0,1600228800,1600228800,1
waltergiacomo,0,1,0,2,1598760000,1598760000,1
kdmcr,0,1,0,1,1589688000,1589688000,1
peacockwok,0,1,0,-5,1608440400,1608440400,1
cuddlepwince,0,1,0,0,1585454400,1585454400,1
F1D0GG0,0,1,0,17,1605070800,1605070800,1
ogiphearvh,0,1,0,8,1575435600,1575435600,1
TheeJuan,0,1,0,4,1565582400,1565582400,1
AplomadoFalcon,0,1,0,2,1590984000,1590984000,1
drewbob1000,0,1,0,5,1578286800,1578286800,1
joestrandell,1,0,18,0,1541998800,1541998800,1
MarchKick,0,1,0,18,1609304400,1609304400,1
Triple_Stamp_Lloyd,0,1,0,2,1603857600,1603857600,1
cactusfairyprincess,0,1,0,20,1558324800,1558324800,1
1ManFunkBand,0,1,0,3,1582520400,1582520400,1
Shermingonmyface,0,1,0,38,1585713600,1585713600,1
Upset-Ad-2768,0,1,0,1,1601524800,1601524800,1
ArguablyTired,0,1,0,1,1576818000,1576818000,1
gxgx55,0,1,0,4,1585454400,1585454400,1
fyrecrotch,0,1,0,2,1600833600,1600833600,1
ginger-valley,0,1,0,3,1578373200,1578373200,1
spongenny,0,1,0,6,1581397200,1581397200,1
JesseMathison,0,1,0,7,1608354000,1608354000,1
MyBiPolarBearMax,0,1,0,18,1577854800,1577854800,1
GoatontheMountain,0,1,0,3,1606885200,1606885200,1
Captain_Hampockets,0,1,0,60,1597982400,1597982400,1
hydrohotpepper,0,1,0,7,1570075200,1570075200,1
shazzlefizz,0,1,0,3,1531022400,1531022400,1
meathoodie,0,1,0,6,1581397200,1581397200,1
RiceKrispyTreatTrina,0,1,0,7,1574226000,1574226000,1
ViveIn,0,1,0,1,1598760000,1598760000,1
Gorgenon,0,1,0,10,1606626000,1606626000,1
pyrimis,0,1,0,-13,1601092800,1601092800,1
samuryan89,0,1,0,8,1598500800,1598500800,1
Flying_pizza_,0,1,0,-7,1612155600,1612155600,1
DixieFlatline1000101,0,1,0,1,1606626000,1606626000,1
Maephia,0,1,0,1,1576645200,1576645200,1
mvfsullivan,0,1,0,5,1576126800,1576126800,1
paintingsbyO,0,1,0,2,1607662800,1607662800,1
nemoomen,0,1,0,1,1586923200,1586923200,1
alliedeluxe,0,1,0,71,1584158400,1584158400,1
dampkindling,0,1,0,24,1560744000,1560744000,1
SocialAtmosphere,1,0,1,0,1443067200,1443067200,1
Genexism,0,1,0,6,1582088400,1582088400,1
Azuladagio,0,1,0,2,1586491200,1586491200,1
Swagministrator,0,1,0,2,1581915600,1581915600,1
Saint_Scrappy,0,1,0,2,1601611200,1601611200,1
Jelopuddinpop,0,1,0,0,1608699600,1608699600,1
HOMO_POOP_GOBLIN,0,1,0,23,1601784000,1601784000,1
SyrupMonstrosity,0,1,0,21,1575176400,1575176400,1
MashTheTrash,0,1,0,6,1556942400,1556942400,1
LennartGimm,0,1,0,22,1555732800,1555732800,1
BBQ_FETUS,0,1,0,27,1604379600,1604379600,1
cf726,0,1,0,5,1553918400,1553918400,1
MrWapuJapu,0,1,0,11,1575781200,1575781200,1
Jaguardude90,1,0,4,0,1606021200,1606021200,1
notmyrealviews,0,1,0,10,1585022400,1585022400,1
libma,0,1,0,2,1587441600,1587441600,1
ireallyamsomething,1,0,41,0,1600660800,1600660800,1
CCORRIGEN,0,1,0,1,1608872400,1608872400,1
eddielimonov,0,1,0,31,1595736000,1595736000,1
JustAGraphNotebook,0,1,0,1,1595217600,1595217600,1
playboicartier_,0,1,0,1,1593662400,1593662400,1
YanaAGofficial,0,1,0,11,1599710400,1599710400,1
reverseoreo21,0,1,0,-1,1577422800,1577422800,1
Blaster167,0,1,0,1,1578286800,1578286800,1
croatcroatcroat,0,1,0,13,1593057600,1593057600,1
BellEpoch,0,1,0,14,1581915600,1581915600,1
Nonacept,0,1,0,2,1608094800,1608094800,1
alfamerc860,0,1,0,2,1582952400,1582952400,1
vr1252,0,1,0,7,1571976000,1571976000,1
KoolKesh77,0,1,0,1,1591329600,1591329600,1
TheeFapitalist,0,1,0,3,1599796800,1599796800,1
diamondbackmanhunter,0,1,0,5,1575262800,1575262800,1
Sillycats2,0,1,0,2,1603512000,1603512000,1
rajine105,0,1,0,1,1603512000,1603512000,1
TheDankGiraffe,0,1,0,1,1589428800,1589428800,1
Cardea587,0,1,0,8,1603339200,1603339200,1
Arse_Wenderson,0,1,0,5,1606539600,1606539600,1
vi0let-imperfections,0,1,0,61,1555905600,1555905600,1
vanthefunkmeister,0,1,0,38,1608181200,1608181200,1
GrandEmployee,0,1,0,1,1580619600,1580619600,1
wiscomptonite,0,1,0,9,1604030400,1604030400,1
oct0burn,0,1,0,-13,1608267600,1608267600,1
North_Race,0,1,0,-5,1591934400,1591934400,1
BrowninAround,1,0,14,0,1605675600,1605675600,1
JewsDid9-11_14W_88,0,1,0,5,1583557200,1583557200,1
kaboyd87,1,0,652,0,1559880000,1559880000,1
skyrenxrene,0,1,0,1,1603512000,1603512000,1
brianredbanisgood,1,0,1379,0,1611810000,1611810000,1
Grifball_Vet,0,1,0,4,1549342800,1549342800,1
Chairmanca93,0,1,0,2,1598760000,1598760000,1
wizardoftheboats,0,1,0,21,1603684800,1603684800,1
Donnerwurst_,0,1,0,3,1574658000,1574658000,1
TheSquirrelScroll,0,1,0,8,1587528000,1587528000,1
Creatret,0,1,0,3,1581224400,1581224400,1
ItsyouNOme,0,1,0,6,1584676800,1584676800,1
Kukamunga30,0,1,0,3,1602648000,1602648000,1
pythonicusMinimus,0,1,0,1,1585022400,1585022400,1
ComfortableExam,0,1,0,10,1584072000,1584072000,1
ColteesCatCouture,0,1,0,2,1608267600,1608267600,1
furyfromthesky,0,1,0,40,1547182800,1547182800,1
union-city-blue,0,1,0,1,1604379600,1604379600,1
yousaybagelwrong,0,1,0,5,1564027200,1564027200,1
Crotas_Gonads,0,1,0,10,1600747200,1600747200,1
nickalopolis,1,0,8,0,1611810000,1611810000,1
nartb,1,0,4,0,1600488000,1600488000,1
elmachochamaco,0,1,0,2,1611982800,1611982800,1
tophage,0,1,0,122,1611896400,1611896400,1
Cliffratt,0,1,0,12,1570248000,1570248000,1
pompomandben,0,1,0,3,1558843200,1558843200,1
dbino-6969,1,0,2,0,1597896000,1597896000,1
Blossomheed,0,1,0,3,1565582400,1565582400,1
Arachnid_Acne,0,1,0,6,1588564800,1588564800,1
GoldenIngots,0,1,0,6,1608958800,1608958800,1
ModularMagician,0,1,0,3,1575003600,1575003600,1
skittlkiller57,0,1,0,1,1573534800,1573534800,1
petegetsjokes,0,1,0,1,1596945600,1596945600,1
tappirdude,1,0,0,0,1607835600,1607835600,1
tankjones3,0,1,0,5,1590120000,1590120000,1
mmelectronic,0,1,0,20,1570075200,1570075200,1
stripedsnipe,0,1,0,10,1581138000,1581138000,1
AstralDragon1979,0,1,0,-14,1569384000,1569384000,1
gwynie21,0,1,0,1,1604811600,1604811600,1
walmart-home-office,0,1,0,0,1573707600,1573707600,1
urban-bedouin,1,0,148,0,1573448400,1573448400,1
SirCaesar29,0,1,0,-7,1573362000,1573362000,1
gochristengo,1,0,2,0,1586577600,1586577600,1
jackisnotavailable,0,1,0,4,1549342800,1549342800,1
EileenCrown,0,1,0,1,1615179600,1615179600,1
speeduponthedamnramp,0,1,0,14,1556510400,1556510400,1
AjeYemaja,0,1,0,8,1603684800,1603684800,1
Gala0,0,1,0,32,1611810000,1611810000,1
Neon_Lights12,0,1,0,1,1606626000,1606626000,1
CleUrbanist,0,1,0,127,1580274000,1580274000,1
whore-ticulturist,0,1,0,14,1606539600,1606539600,1
BirdFacee,0,1,0,1,1551762000,1551762000,1
snoogins355,0,1,0,3,1585454400,1585454400,1
Drathkai,0,1,0,11,1608008400,1608008400,1
SUW888,0,1,0,24,1603598400,1603598400,1
Firwall1999,0,1,0,3,1539921600,1539921600,1
Velouria_Lemure,1,0,3338,0,1579323600,1579323600,1
thr-away_IdntNeedHlp,0,1,0,13,1569297600,1569297600,1
solidstate125,1,0,23,0,1593403200,1593403200,1
emotional_plague,0,1,0,2,1611810000,1611810000,1
Calsun,0,1,0,3,1560657600,1560657600,1
TeemoIsKill,0,1,0,1,1602475200,1602475200,1
CocotheClown5000,0,1,0,3,1596686400,1596686400,1
BruiserBoy,0,1,0,2,1540180800,1540180800,1
KalBaratheon,0,1,0,5,1608181200,1608181200,1
Chromosomeh,0,1,0,18,1582606800,1582606800,1
joyleaf,0,1,0,56,1606971600,1606971600,1
OutRunMyGun3,0,1,0,2,1600747200,1600747200,1
404040life,1,0,0,0,1593316800,1593316800,1
cefriano,0,1,0,1,1608872400,1608872400,1
BufferNuggets,0,1,0,7,1560916800,1560916800,1
gionni666,0,1,0,2,1609131600,1609131600,1
FlimsyRaisin3,0,1,0,1,1606539600,1606539600,1
NextJungleSuperstar,0,1,0,54,1570161600,1570161600,1
joermunG,0,1,0,8,1594612800,1594612800,1
ranxxerox,1,0,142,0,1559966400,1559966400,1
DLJD,0,1,0,3,1601179200,1601179200,1
sylsau,0,1,0,2,1608786000,1608786000,1
unf4bulous,0,1,0,14,1597118400,1597118400,1
aclowntookthethrone,0,1,0,42,1608786000,1608786000,1
xxMandi_Mausoleumxx,0,1,0,19,1573534800,1573534800,1
Sometimes11b,0,1,0,1,1582779600,1582779600,1
spondgbob,0,1,0,2,1603512000,1603512000,1
HuckleberryWatson,0,1,0,16,1581224400,1581224400,1
Convex_Mirror,0,1,0,2,1555300800,1555300800,1
AdventurousParfait1,0,1,0,1,1591156800,1591156800,1
ac3three,0,1,0,119,1600488000,1600488000,1
onoemzilla,0,1,0,5,1606626000,1606626000,1
PM_YOUR_WALLPAPER,0,1,0,3,1603512000,1603512000,1
jackmans,0,1,0,1,1605589200,1605589200,1
upvote-for-rights,0,1,0,1,1591243200,1591243200,1
Itz_420_Somewhere,0,1,0,2,1608613200,1608613200,1
Sprinkles169,0,1,0,2,1598241600,1598241600,1
ryehawkins,0,1,0,35,1587787200,1587787200,1
HighSpeed_POG,1,0,11,0,1599710400,1599710400,1
saintlupin,0,1,0,14,1574917200,1574917200,1
TotesHittingOnY0u,0,1,0,1,1605589200,1605589200,1
dipdopdipping,0,1,0,1,1609909200,1609909200,1
pippaman,0,1,0,1,1604466000,1604466000,1
thegreatperson2,1,0,2,0,1609131600,1609131600,1
pnt2wheremidastchedu,0,1,0,1,1573534800,1573534800,1
MeatyGonzalles,0,1,0,4,1573362000,1573362000,1
_hi_im_new_here_,1,0,4,0,1588219200,1588219200,1
nazrinz3,0,1,0,3,1571630400,1571630400,1
punkinfacebooklegpie,0,1,0,5,1571371200,1571371200,1
14raymond14,0,1,0,1,1598760000,1598760000,1
icrexqzpgfkamjnwo,1,0,1,0,1456290000,1456290000,1
uncle_jessie,0,1,0,1,1612069200,1612069200,1
Chiliconkarma,0,1,0,1,1601438400,1601438400,1
Karl_and_Kned,0,1,0,2,1637038800,1637038800,1
Scribette_hedon,0,1,0,-1,1602734400,1602734400,1
Smooth-Concentrate,0,1,0,19,1592971200,1592971200,1
rinjii_,0,1,0,1,1603252800,1603252800,1
ALtrocity,0,1,0,4,1569816000,1569816000,1
Platinum_Xero,0,1,0,24,1600488000,1600488000,1
Rooney_83,0,1,0,3,1550725200,1550725200,1
dreamwinder,0,1,0,21,1574398800,1574398800,1
marzipan_plague,0,1,0,3,1601697600,1601697600,1
BigBoiToes,0,1,0,-18,1567742400,1567742400,1
Can_The_SRDine,0,1,0,1,1584331200,1584331200,1
Ripperage,0,1,0,2,1569124800,1569124800,1
SmokeMyDong,0,1,0,1,1605157200,1605157200,1
1Crutchlow,0,1,0,15,1587355200,1587355200,1
crappypost,0,1,0,1,1606021200,1606021200,1
DudeWheresMyRights,0,1,0,1,1597896000,1597896000,1
robinredrunner,0,1,0,1,1580101200,1580101200,1
Maelstrom4ever,0,1,0,25,1607317200,1607317200,1
I84lovemywife83,0,1,0,8,1609131600,1609131600,1
UberChadMamadu,0,1,0,-17,1595044800,1595044800,1
GoldEdit,0,1,0,2,1609390800,1609390800,1
DemoHD7,0,1,0,-2,1598760000,1598760000,1
chaclarke,0,1,0,-2,1608267600,1608267600,1
getyurfuknshnbx,0,1,0,1,1578373200,1578373200,1
kakarikokid89,0,1,0,3,1552795200,1552795200,1
kronmasta,0,1,0,-4,1587355200,1587355200,1
harbisk,0,1,0,4,1595217600,1595217600,1
to_lazy_2_think6,0,1,0,4,1583211600,1583211600,1
MrBloodyshadow,0,1,0,4,1586232000,1586232000,1
ZeusZucchini,0,1,0,0,1611810000,1611810000,1
Aniseanemia,0,1,0,4,1582174800,1582174800,1
PlayingWithTape,0,1,0,1,1579064400,1579064400,1
DontEatTheOctopodes,0,1,0,1,1599883200,1599883200,1
uffjjbgffdghbbuj,0,1,0,1,1598932800,1598932800,1
MicahXCain,0,1,0,4,1586059200,1586059200,1
gogogadgetheartattak,0,1,0,1,1603512000,1603512000,1
common__123,0,1,0,10,1607576400,1607576400,1
dichloroethane,0,1,0,1,1585454400,1585454400,1
vandelt,0,1,0,1,1577163600,1577163600,1
salivationfre,0,1,0,2,1601870400,1601870400,1
psych_rheum,0,1,0,6,1598068800,1598068800,1
kaiyybeee,0,1,0,32,1607317200,1607317200,1
OfficerBlind91,0,1,0,2,1601265600,1601265600,1
hubilation,0,1,0,7,1594267200,1594267200,1
hotwirehybrid,0,1,0,1,1603771200,1603771200,1
ErohaTamaki,0,1,0,1,1607403600,1607403600,1
vedettestar,0,1,0,2,1608181200,1608181200,1
inaruch,1,0,214,0,1603944000,1603944000,1
Zappawhappa,1,0,0,0,1557806400,1557806400,1
Excutient,0,1,0,34,1599624000,1599624000,1
ruptupable,0,1,0,4,1603684800,1603684800,1
samgetdat,0,1,0,1,1592798400,1592798400,1
LoveHateLove969,0,1,0,1,1571889600,1571889600,1
sidewardslydirection,0,1,0,24,1599105600,1599105600,1
5krishnan,0,1,0,0,1604293200,1604293200,1
eleventyseventynine,0,1,0,32,1607490000,1607490000,1
Sleepy_Sleeper,0,1,0,0,1556337600,1556337600,1
let-s-get-this-bread,0,1,0,4,1565409600,1565409600,1
generic_spheroid,0,1,0,18,1604552400,1604552400,1
Kami-BGV,0,1,0,2,1608008400,1608008400,1
Damnyoustupidbrain,0,1,0,3,1591243200,1591243200,1
Adonisus,0,1,0,5,1585195200,1585195200,1
ijustsaynotoyou,0,1,0,3,1606712400,1606712400,1
RoboFleksnes,0,1,0,19,1598328000,1598328000,1
scottyhood,0,1,0,2,1559102400,1559102400,1
TheStonedEconomist,0,1,0,2,1600574400,1600574400,1
bigfootcantimetravel,0,1,0,9,1598760000,1598760000,1
Elaphe82,0,1,0,10,1605589200,1605589200,1
nickeldork,0,1,0,-1,1590897600,1590897600,1
MyBumIsClammy,0,1,0,1,1573621200,1573621200,1
ecboprege,1,0,6,0,1528948800,1528948800,1
LockpickAddict,0,1,0,1,1582347600,1582347600,1
RectalHammock77,1,0,31,0,1588478400,1588478400,1
parrbird88,0,1,0,9,1599624000,1599624000,1
CalamackW,0,1,0,5,1581310800,1581310800,1
TheElusiveJayApe,0,1,0,2,1555992000,1555992000,1
Bustybaggins,0,1,0,1,1593835200,1593835200,1
mrhairy789,0,1,0,1,1605070800,1605070800,1
highmejaime,0,1,0,56,1589860800,1589860800,1
dopeSpaghetti,0,1,0,3,1601438400,1601438400,1
ayoungcmt,0,1,0,3,1591329600,1591329600,1
kydheartless,0,1,0,3,1579582800,1579582800,1
zandimna,0,1,0,5,1595304000,1595304000,1
doofenshmirtz-da-3rd,0,1,0,2,1602561600,1602561600,1
Lavendrina,0,1,0,26,1595908800,1595908800,1
throwawayjobguy1,1,0,11,0,1550898000,1550898000,1
The_Sad_Deku,0,1,0,6,1568520000,1568520000,1
lanrakatheriue,0,1,0,1,1608181200,1608181200,1
SweatyCasual,0,1,0,0,1556596800,1556596800,1
yittiiiiii,0,1,0,1,1607490000,1607490000,1
tabuu_,0,1,0,3,1508990400,1508990400,1
setmos,0,1,0,5,1584504000,1584504000,1
localvagrant,0,1,0,2,1572753600,1572753600,1
thatoneguydudejim,0,1,0,1,1575435600,1575435600,1
mackiediesel,0,1,0,1,1599019200,1599019200,1
Mcbagelflavor,0,1,0,2,1606885200,1606885200,1
CobyLiam,0,1,0,24,1585368000,1585368000,1
finette_micha,0,1,0,2,1571716800,1571716800,1
PastalaVista666,0,1,0,13,1602648000,1602648000,1
HeresyfromIdleness,0,1,0,1,1608267600,1608267600,1
therewillbeniccage,0,1,0,2,1585627200,1585627200,1
iamacraftyhooker,0,1,0,3,1605589200,1605589200,1
itsnuwanda,0,1,0,11,1604379600,1604379600,1
jokkx,0,1,0,1,1578546000,1578546000,1
Some815,0,1,0,-6,1550552400,1550552400,1
AlcoholicInsomniac,0,1,0,1,1600056000,1600056000,1
TSMachine,0,1,0,-6,1606626000,1606626000,1
Totalrecluse,0,1,0,2,1606539600,1606539600,1
soorr,0,1,0,1,1614574800,1614574800,1
sleezy4short,0,1,0,2,1578459600,1578459600,1
lionheartlui,0,1,0,1,1582261200,1582261200,1
Radius8887,0,1,0,2,1600747200,1600747200,1
Parareda8,0,1,0,6,1581570000,1581570000,1
lelmeister123,0,1,0,1,1621224000,1621224000,1
Paper-Fish,0,1,0,5,1586145600,1586145600,1
Felixdad,0,1,0,1,1608267600,1608267600,1
Jitterbugboogie,0,1,0,1,1606021200,1606021200,1
Lazy-Hooks,0,1,0,2,1578891600,1578891600,1
cureforhiccupsat4am,0,1,0,23,1561608000,1561608000,1
imsofuck1ngpoor,0,1,0,5,1599537600,1599537600,1
isycck,0,1,0,1,1578546000,1578546000,1
Throwaway4738289,0,1,0,10,1572148800,1572148800,1
CDClock,0,1,0,1,1611205200,1611205200,1
neurothrall,0,1,0,1,1552449600,1552449600,1
MrBrendino,0,1,0,0,1589947200,1589947200,1
billwood09,0,1,0,2,1600747200,1600747200,1
Gua_Bao,0,1,0,2,1603512000,1603512000,1
the_dalai_mangala,0,1,0,2,1573534800,1573534800,1
serrghi,0,1,0,19,1580274000,1580274000,1
ThrowawaySuicide1337,0,1,0,6,1589860800,1589860800,1
77rtcups,0,1,0,27,1589860800,1589860800,1
queensnipe,0,1,0,5,1607576400,1607576400,1
writesinnottragedy,0,1,0,1,1601179200,1601179200,1
Elviyy,0,1,0,10,1552449600,1552449600,1
24mango,0,1,0,6,1573189200,1573189200,1
EquinoxHope9,0,1,0,24,1601524800,1601524800,1
rslashIcePoseidon,0,1,0,-4,1571284800,1571284800,1
Ephigenia16,0,1,0,3,1606366800,1606366800,1
biggmattdogg,0,1,0,17,1604725200,1604725200,1
Galvsworld,0,1,0,0,1580360400,1580360400,1
Jarppakarppa,0,1,0,5,1603598400,1603598400,1
emma_eee,1,0,124,0,1597809600,1597809600,1
silvercire,0,1,0,1,1606626000,1606626000,1
almistro,0,1,0,0,1600833600,1600833600,1
Egregious_Creations,0,1,0,1,1605762000,1605762000,1
YukioHattori,0,1,0,2,1589688000,1589688000,1
MediumRarePorkChop,0,1,0,5,1609390800,1609390800,1
urgh_i_dont_know,0,1,0,30,1602302400,1602302400,1
TankiesaurusRex,1,0,6147,0,1611896400,1611896400,1
lildaley62,0,1,0,-11,1600228800,1600228800,1
MilkmanBurlur,0,1,0,4,1604984400,1604984400,1
TightwadBlowback,1,0,35,0,1569816000,1569816000,1
Skdn0,0,1,0,1,1608786000,1608786000,1
pialligo,0,1,0,7,1602388800,1602388800,1
GiveMeYourBussy,0,1,0,76,1611982800,1611982800,1
ShinyGoomba,1,0,33,0,1592798400,1592798400,1
GetToWigglin,0,1,0,3,1573189200,1573189200,1
bladedvoid,0,1,0,-6,1574139600,1574139600,1
dalmn99,0,1,0,1,1594699200,1594699200,1
FD435,0,1,0,1,1601870400,1601870400,1
bobbinichols,0,1,0,3,1561435200,1561435200,1
MessisLeftFoot,0,1,0,1,1604116800,1604116800,1
RussianJudge5,0,1,0,6,1576645200,1576645200,1
lil-subhuman,0,1,0,-3,1603512000,1603512000,1
MatthewK3840,0,1,0,2,1589515200,1589515200,1
ohnomyglasseye,1,0,188,0,1600401600,1600401600,1
PerfectChemical,0,1,0,1,1590033600,1590033600,1
Whitespider331,0,1,0,40,1609045200,1609045200,1
Soiboi_Sugoiboi,0,1,0,2,1599364800,1599364800,1
NoodleFlavored,1,0,4,0,1579064400,1579064400,1
Jinkazama21,0,1,0,1,1608354000,1608354000,1
SneakyEnema,0,1,0,156,1551762000,1551762000,1
Gyazo_Bot,0,1,0,1,1534910400,1534910400,1
NorwegianDweller,0,1,0,1,1608699600,1608699600,1
Lazy-Ape,0,1,0,164,1596772800,1596772800,1
IsackB,0,1,0,5,1570075200,1570075200,1
mkennedy119,0,1,0,13,1571112000,1571112000,1
EffectiveExistence,0,1,0,3,1604552400,1604552400,1
Massive_Neat,1,0,4,0,1576126800,1576126800,1
TacosGetMeThrough,0,1,0,15,1605589200,1605589200,1
RyRyReezy2,0,1,0,2,1601438400,1601438400,1
ThreeKnuckShuff1,0,1,0,2,1589860800,1589860800,1
97nobody,0,1,0,1,1573534800,1573534800,1
thomass2s,0,1,0,6,1598846400,1598846400,1
Corvus141,0,1,0,2,1591329600,1591329600,1
so_and_so_phd,0,1,0,13,1576472400,1576472400,1
Lasanhossauro,0,1,0,2,1608181200,1608181200,1
frikkatat,0,1,0,19,1599969600,1599969600,1
til1and1are1,0,1,0,1,1608267600,1608267600,1
thereaper9001,0,1,0,36,1560312000,1560312000,1
Semi_HadrOn,0,1,0,82,1600315200,1600315200,1
hopefullynotabitch,0,1,0,5,1591243200,1591243200,1
CapitalistPear2,0,1,0,13,1598846400,1598846400,1
andersyu31415,0,1,0,6,1555387200,1555387200,1
Brillek,0,1,0,1,1573621200,1573621200,1
ghostfacekhilla,0,1,0,1,1436932800,1436932800,1
LingChi79,0,1,0,3,1559707200,1559707200,1
MapCavalier,0,1,0,2,1595390400,1595390400,1
usugiri,0,1,0,5,1606021200,1606021200,1
TheMiNd,0,1,0,5,1577595600,1577595600,1
nabababibyus,0,1,0,5,1607403600,1607403600,1
Duranel,0,1,0,1,1581397200,1581397200,1
nascentmind,0,1,0,3,1600660800,1600660800,1
poobumstupidcunt,0,1,0,3,1580619600,1580619600,1
shaunoke,0,1,0,1,1605330000,1605330000,1
Gee_rooster,0,1,0,9,1573794000,1573794000,1
SleepyDemon100,0,1,0,4,1609304400,1609304400,1
GlassEyeDucksAss,0,1,0,3,1608094800,1608094800,1
whylime0,0,1,0,5,1592280000,1592280000,1
Cathartic_Art,0,1,0,-10,1591243200,1591243200,1
fuckfuckfuckfvck,0,1,0,1,1600488000,1600488000,1
nude_tayne69,0,1,0,-32,1608958800,1608958800,1
xtremekoolusername,0,1,0,17,1575781200,1575781200,1
Grandfunk14,0,1,0,6,1608526800,1608526800,1
voidHavoc,0,1,0,1,1606626000,1606626000,1
casemodz,0,1,0,1,1585454400,1585454400,1
BDNackNack,0,1,0,1,1605762000,1605762000,1
kahweiwu,0,1,0,1,1588219200,1588219200,1
squiercg,0,1,0,1,1580446800,1580446800,1
wheatfieldcrows,0,1,0,8,1608699600,1608699600,1
nuage420,0,1,0,1,1607922000,1607922000,1
SteelCode,0,1,0,28,1605416400,1605416400,1
jnpw,0,1,0,8,1583384400,1583384400,1
Jaketw96,0,1,0,1,1609045200,1609045200,1
WlmCarlosHemingway,0,1,0,-1,1580014800,1580014800,1
Tooafraidtosay,1,0,9,0,1597636800,1597636800,1
why_are_pancakes,0,1,0,1,1585454400,1585454400,1
gabba_gubbe,0,1,0,-1,1603512000,1603512000,1
Cannavor,0,1,0,41,1571371200,1571371200,1
frigidbitchwithcats,0,1,0,25,1501646400,1501646400,1
TorontoGameDevs,1,0,41,0,1579669200,1579669200,1
Shillef,0,1,0,1,1612069200,1612069200,1
BoLevar,0,1,0,14,1564545600,1564545600,1
Gravediggers,0,1,0,4,1588910400,1588910400,1
hobbeslovesyou,0,1,0,0,1575522000,1575522000,1
simplewalmartwine,1,0,7,0,1606885200,1606885200,1
PixelHomicide,1,0,30,0,1573794000,1573794000,1
punchingbag-buzzard,0,1,0,40,1604030400,1604030400,1
winedrinker94,0,1,0,8,1580274000,1580274000,1
53N3C4,0,1,0,3,1590638400,1590638400,1
supernasty,0,1,0,1,1606626000,1606626000,1
jess9685,0,1,0,98,1611810000,1611810000,1
MassSnapz,0,1,0,3,1598760000,1598760000,1
Slish2512007,0,1,0,8,1604466000,1604466000,1
ThrowRA-3456,1,0,44,0,1609304400,1609304400,1
BiologicalWinter,0,1,0,1,1608267600,1608267600,1
The-YeetCannon-Brony,0,1,0,-6,1594699200,1594699200,1
TheDewyDecimal,0,1,0,14,1606539600,1606539600,1
DrunkenSpock,0,1,0,1,1593921600,1593921600,1
yveltall,0,1,0,2,1592280000,1592280000,1
banana_pencil,0,1,0,1,1608872400,1608872400,1
hyperboleistheworst,0,1,0,4,1608699600,1608699600,1
papaweir,0,1,0,12,1608008400,1608008400,1
Pbobes,1,0,3,0,1589169600,1589169600,1
humanzRtrash,0,1,0,1,1605502800,1605502800,1
ScientistSeven,0,1,0,2,1584849600,1584849600,1
IndianGuy_01,1,0,1,0,1604984400,1604984400,1
secret179,0,1,0,-5,1609390800,1609390800,1
Nazi_Punks_Fuck__Off,0,1,0,1,1607576400,1607576400,1
finallysomegoood,0,1,0,4,1609390800,1609390800,1
Juan_Pump_Chump11,0,1,0,1,1585454400,1585454400,1
duhadventureboi,0,1,0,2,1606453200,1606453200,1
WorkChatz,0,1,0,4,1588737600,1588737600,1
sihtohwemwen,0,1,0,1,1611982800,1611982800,1
geldin,0,1,0,3,1563595200,1563595200,1
Pm__me__your_secrets,0,1,0,1,1591243200,1591243200,1
Hex-a-meter,0,1,0,6,1584504000,1584504000,1
ArtVandelet,0,1,0,2,1611982800,1611982800,1
iplaytheguitarntrip,0,1,0,17,1611982800,1611982800,1
Capn_Frank,0,1,0,2,1550466000,1550466000,1
namakusi,0,1,0,2,1612069200,1612069200,1
smokeweedeatpussy,0,1,0,1,1607230800,1607230800,1
jerseyse410,0,1,0,6,1585454400,1585454400,1
RepliesNice,0,1,0,7,1574917200,1574917200,1
Ayy23,0,1,0,2,1583643600,1583643600,1
stashofgold,0,1,0,2,1586145600,1586145600,1
SluggsMetallis,0,1,0,3,1600747200,1600747200,1
Plz_Discuss_Rampart,0,1,0,0,1601438400,1601438400,1
OddlySpecificOtter,0,1,0,1,1611982800,1611982800,1
blahmarrow20,0,1,0,17,1578373200,1578373200,1
rkyle4288,0,1,0,2,1600142400,1600142400,1
thesupernintendofan,0,1,0,4,1582520400,1582520400,1
Cookieway,0,1,0,1,1601784000,1601784000,1
itsacatslife2013,0,1,0,13,1585713600,1585713600,1
IsThatUMoatilliatta,0,1,0,3,1593489600,1593489600,1
NotebookTheCat,0,1,0,3,1564632000,1564632000,1
servonos89,0,1,0,25,1598500800,1598500800,1
B-_-kala,0,1,0,1,1607835600,1607835600,1
aruanamic,0,1,0,-8,1604030400,1604030400,1
Fossil_RexJaw,0,1,0,1,1606712400,1606712400,1
hyarmen66,0,1,0,1,1572408000,1572408000,1
8-36,0,1,0,13,1563249600,1563249600,1
Thethcelf,0,1,0,0,1604984400,1604984400,1
Sky_Million,0,1,0,11,1596600000,1596600000,1
myFriendEnemy,0,1,0,2,1595736000,1595736000,1
nave3650,0,1,0,1,1609218000,1609218000,1
p-u-s-s-y-e-a-t-e-r,0,1,0,-1,1606626000,1606626000,1
BrainTumor673,0,1,0,-3,1589342400,1589342400,1
radgreek,0,1,0,3,1589342400,1589342400,1
BJJIslove,0,1,0,1,1605502800,1605502800,1
lonlynites,0,1,0,1,1558324800,1558324800,1
lizardlightning,0,1,0,5,1607576400,1607576400,1
phoenixlostarr,0,1,0,8,1592539200,1592539200,1
Appropriate_Effect19,0,1,0,1,1600056000,1600056000,1
shrineofLumbago,0,1,0,10,1597550400,1597550400,1
adoorabledoor,0,1,0,1,1596600000,1596600000,1
Utkar22,0,1,0,1,1575176400,1575176400,1
Predsnerd423,0,1,0,18,1605762000,1605762000,1
Galitine,0,1,0,6,1608786000,1608786000,1
Break-The-Walls,0,1,0,3,1585108800,1585108800,1
superfaceplant47,0,1,0,5,1600315200,1600315200,1
canieldruz,0,1,0,0,1550811600,1550811600,1
simmiauto,0,1,0,3,1580619600,1580619600,1
getoffmypangolyn,0,1,0,18,1573362000,1573362000,1
robertgunt,0,1,0,34,1605934800,1605934800,1
not_so_plausible,0,1,0,62,1586836800,1586836800,1
Humorousul,0,1,0,3,1598760000,1598760000,1
YOUTUBEISDOWNIREPEAT,0,1,0,-1,1570248000,1570248000,1
cookie4524,0,1,0,1,1591329600,1591329600,1
eulershiddenidentity,0,1,0,1,1608786000,1608786000,1
SideMeatOn,0,1,0,3,1578027600,1578027600,1
Winsanity2322,0,1,0,3,1606971600,1606971600,1
Dantheman2010,0,1,0,1,1589083200,1589083200,1
SorcererWithAToaster,1,0,11,0,1411012800,1411012800,1
Merry_Sue,0,1,0,1,1612069200,1612069200,1
MrScaradolfHisFace,0,1,0,2,1573275600,1573275600,1
Antisa1nt,0,1,0,6,1561176000,1561176000,1
Loki_d20,0,1,0,63,1611896400,1611896400,1
filbertbrush,0,1,0,1,1595044800,1595044800,1
Leche_Hombre2828,0,1,0,-2,1559880000,1559880000,1
gurr57,0,1,0,4,1602129600,1602129600,1
tfw_no_pylons,0,1,0,37,1561608000,1561608000,1
AutisticalyDelicious,0,1,0,10,1583038800,1583038800,1
kfmush,0,1,0,7,1559793600,1559793600,1
markruffalosbitch,0,1,0,35,1543208400,1543208400,1
nuttymcnutface,0,1,0,6,1602734400,1602734400,1
wiking85,0,1,0,4,1538020800,1538020800,1
throwawaytraffic7474,0,1,0,7,1594180800,1594180800,1
johnjohn909090,0,1,0,3,1568952000,1568952000,1
mfball,0,1,0,37,1597982400,1597982400,1
Maybe-Its-Ironic,0,1,0,1,1603512000,1603512000,1
flibflabjibberjab,0,1,0,-2,1591243200,1591243200,1
SpyOfNorthKorea,1,0,0,0,1588824000,1588824000,1
kkbell1,0,1,0,7,1565496000,1565496000,1
OlKingCole,0,1,0,5,1611896400,1611896400,1
fatnat,0,1,0,21,1570248000,1570248000,1
EdenPWilliams,0,1,0,2,1601956800,1601956800,1
GreenAyeedMonster,0,1,0,4,1605762000,1605762000,1
the_limerence,0,1,0,1,1605934800,1605934800,1
RummedupPirate,0,1,0,54,1571457600,1571457600,1
vnge72,0,1,0,3,1578978000,1578978000,1
Historywillabsolvem3,0,1,0,1,1587096000,1587096000,1
mister_chainsaw,0,1,0,1,1584244800,1584244800,1
Wander_Whale,0,1,0,2,1607403600,1607403600,1
xxlunahxx,0,1,0,1,1608872400,1608872400,1
SemperFun62,0,1,0,1,1596081600,1596081600,1
PrincessRTFM,0,1,0,100,1608354000,1608354000,1
Destroyerofnoone,0,1,0,3,1566100800,1566100800,1
Purryto,0,1,0,0,1596686400,1596686400,1
rakethund,0,1,0,15,1575176400,1575176400,1
BatSorry,0,1,0,0,1604466000,1604466000,1
Sh1pT0aster,0,1,0,7,1604293200,1604293200,1
Straydog55,0,1,0,6,1592366400,1592366400,1
Gearhead31,0,1,0,3,1594180800,1594180800,1
boredATwirk,0,1,0,6,1581138000,1581138000,1
fforeveryone,0,1,0,9,1602648000,1602648000,1
foreverreyn,1,0,24,0,1600920000,1600920000,1
Based_Commgnunism,0,1,0,1,1607835600,1607835600,1
myrontrap,0,1,0,28,1595822400,1595822400,1
Free_Balling,0,1,0,2,1610773200,1610773200,1
annaxcount,0,1,0,9,1599710400,1599710400,1
theslipguy,0,1,0,14,1598500800,1598500800,1
mitzislippers,0,1,0,2,1583726400,1583726400,1
thatgirlbrina,0,1,0,1,1606798800,1606798800,1
First_Folly,0,1,0,1,1598846400,1598846400,1
Meownowwow,0,1,0,1,1616904000,1616904000,1
U_Sam,0,1,0,103,1572753600,1572753600,1
Sannick_Progress,0,1,0,4,1604379600,1604379600,1
Ijustlivehere4awhile,0,1,0,1,1576818000,1576818000,1
selemenesmilesuponme,0,1,0,6,1599278400,1599278400,1
TwiztidSSG,0,1,0,2,1603512000,1603512000,1
lilgoonnyc,0,1,0,1,1600228800,1600228800,1
aPurpleToad,0,1,0,86,1603512000,1603512000,1
maali74,1,0,176,0,1607576400,1607576400,1
Punchdrunkfool,0,1,0,3,1584676800,1584676800,1
Zziggith,0,1,0,1,1611810000,1611810000,1
13curseyoukhan,0,1,0,3,1607317200,1607317200,1
3row4wy,0,1,0,4,1605157200,1605157200,1
InTheCageWithNicCage,0,1,0,2,1601870400,1601870400,1
cecildominic,0,1,0,1,1589947200,1589947200,1
steakorchicken,0,1,0,8,1608354000,1608354000,1
Hippiethecat124,0,1,0,17,1575176400,1575176400,1
cantseehaters,0,1,0,14,1562904000,1562904000,1
pileofshirtaccount,0,1,0,4,1603339200,1603339200,1
_Emirhan_,0,1,0,-1,1608267600,1608267600,1
BurgerGamer,0,1,0,50,1602820800,1602820800,1
beto_gzzj,0,1,0,1,1597723200,1597723200,1
CaptainExplosions,0,1,0,1,1605589200,1605589200,1
Pyramystik,0,1,0,2,1606971600,1606971600,1
phlegm_de_la_phlegm,0,1,0,10,1604552400,1604552400,1
compugasm,0,1,0,1,1602993600,1602993600,1
Kantotheotter,0,1,0,29,1576818000,1576818000,1
geek_cave,0,1,0,3,1598068800,1598068800,1
trees34562,0,1,0,47,1607230800,1607230800,1
lu_ming,0,1,0,18,1575867600,1575867600,1
Difficult_Plankton_8,0,1,0,2,1605157200,1605157200,1
Shitrake,0,1,0,0,1585454400,1585454400,1
ddwood87,0,1,0,1,1593921600,1593921600,1
MajesticCobraChicken,0,1,0,7,1591156800,1591156800,1
BetancourtHVAC,0,1,0,-1,1562040000,1562040000,1
choochhoo,0,1,0,2,1603425600,1603425600,1
toomuchfrosting,0,1,0,39,1603512000,1603512000,1
jackaria3,0,1,0,43,1574312400,1574312400,1
storm_drenering,0,1,0,0,1609304400,1609304400,1
anomaly_9,0,1,0,21,1585368000,1585368000,1
Thyrez,0,1,0,21,1585454400,1585454400,1
mvffin,0,1,0,8,1603339200,1603339200,1
beaurific,0,1,0,4,1589169600,1589169600,1
jct0064,0,1,0,1,1604466000,1604466000,1
Paper_Hero,0,1,0,3,1592712000,1592712000,1
NOTOBNOXIOUSATALL,0,1,0,1,1601956800,1601956800,1
twistycake,0,1,0,27,1596168000,1596168000,1
thedaylights,0,1,0,1,1580965200,1580965200,1
beepo11en,0,1,0,3,1597982400,1597982400,1
KhajiitKhaleesi,0,1,0,13,1611810000,1611810000,1
Rachel_Underspoon,1,0,45,0,1608786000,1608786000,1
SocialistArkansan,0,1,0,3,1606971600,1606971600,1
erichw23,0,1,0,3,1602820800,1602820800,1
LeCriDesFenetres,0,1,0,16,1597636800,1597636800,1
posit3125,0,1,0,1,1563595200,1563595200,1
TheScribbler01,0,1,0,2,1595304000,1595304000,1
KurryBandit,0,1,0,1,1602561600,1602561600,1
Kradiant,0,1,0,2,1550293200,1550293200,1
fe-fi-fo-throwaway,0,1,0,7,1606885200,1606885200,1
Longjumping_Ad8515,0,1,0,-3,1607662800,1607662800,1
ChaoticArcane,0,1,0,1,1597809600,1597809600,1
laura0407,0,1,0,63,1608526800,1608526800,1
PMfacialsTOme,0,1,0,12,1577509200,1577509200,1
Spideral1,0,1,0,8,1604203200,1604203200,1
igeligel,0,1,0,2,1600920000,1600920000,1
azhao930,0,1,0,1,1606798800,1606798800,1
Urrrrrsherrr,0,1,0,3,1580706000,1580706000,1
stangroundalready,0,1,0,1,1598932800,1598932800,1
derrida_n_shit,0,1,0,2,1594872000,1594872000,1
happy-birthdaynerds,0,1,0,3,1593403200,1593403200,1
novemberkorea,0,1,0,2,1575090000,1575090000,1
Opal_Seal,0,1,0,1,1576645200,1576645200,1
dookieballs69,0,1,0,4,1557720000,1557720000,1
JackLOrtega,0,1,0,-1,1608267600,1608267600,1
cuandos,0,1,0,4,1607403600,1607403600,1
qqkkqk,0,1,0,-3,1596686400,1596686400,1
KeepAmericaSpicy,0,1,0,1,1598760000,1598760000,1
alligatorslippers,0,1,0,14,1554264000,1554264000,1
anej1,1,0,2,0,1580274000,1580274000,1
thefoojoo2,0,1,0,12,1577422800,1577422800,1
KimFakes,0,1,0,2,1603771200,1603771200,1
Orleanian,0,1,0,19,1585022400,1585022400,1
Cryzgnik,0,1,0,1,1567137600,1567137600,1
Zulfiqaar,0,1,0,1,1572235200,1572235200,1
StephanieAliceSmiles,0,1,0,15,1607144400,1607144400,1
liquid-snek,0,1,0,27,1608440400,1608440400,1
TC_Pearl,0,1,0,2,1612069200,1612069200,1
Mtsukino,0,1,0,22,1605934800,1605934800,1
jezebel1997,1,0,47,0,1605762000,1605762000,1
abbienormal28,0,1,0,23,1604984400,1604984400,1
NifiteN7,0,1,0,36,1572667200,1572667200,1
currytacos,0,1,0,2,1575262800,1575262800,1
JimE1127,0,1,0,8,1594353600,1594353600,1
CreeperProxy,0,1,0,1,1600833600,1600833600,1
2pootsofcum,0,1,0,29,1572753600,1572753600,1
ActivelyDrowsed,0,1,0,7,1577077200,1577077200,1
oximaCentauri,0,1,0,0,1601179200,1601179200,1
Babikir205,0,1,0,1,1603512000,1603512000,1
pillowcase99999,0,1,0,7,1609390800,1609390800,1
NoviLii,0,1,0,2,1607749200,1607749200,1
Buy_An_iPhone_Today,0,1,0,-1,1604379600,1604379600,1
xmrq,0,1,0,9,1599710400,1599710400,1
Draguarys,0,1,0,7,1643259600,1643259600,1
Natuurschoonheid,0,1,0,6,1590206400,1590206400,1
embrace-,0,1,0,2,1580446800,1580446800,1
Fluke2win,0,1,0,1,1606626000,1606626000,1
daft-fox,0,1,0,2,1603684800,1603684800,1
Courtnall14,0,1,0,16,1590120000,1590120000,1
SupDoodorinos,0,1,0,21,1589860800,1589860800,1
wizkidace,0,1,0,2,1606280400,1606280400,1
AlwayzIntoSometin95,0,1,0,12,1590638400,1590638400,1
justalazyegg,0,1,0,3,1602820800,1602820800,1
meeeoooooow,0,1,0,3,1582520400,1582520400,1
weRsDf1122,1,0,152,0,1574053200,1574053200,1
Geezlouise20,0,1,0,1,1572062400,1572062400,1
MikeSantos89,0,1,0,6,1594612800,1594612800,1
Nelyris,0,1,0,1,1570507200,1570507200,1
Dizzfizz,0,1,0,5,1598328000,1598328000,1
Flaktrack,0,1,0,4,1560484800,1560484800,1
RaeRoeZta,0,1,0,1,1570507200,1570507200,1
NexVeho,0,1,0,2,1566878400,1566878400,1
Jakes0nAPlane,0,1,0,3,1571544000,1571544000,1
SpicyDoggo1,0,1,0,5,1603598400,1603598400,1
Doctah-Grym,0,1,0,1,1608958800,1608958800,1
p0stmortem,0,1,0,5,1592884800,1592884800,1
Atropa94,0,1,0,1,1579496400,1579496400,1
lithiumdeuteride,0,1,0,7,1603512000,1603512000,1
the_sleaze_,0,1,0,1,1598760000,1598760000,1
YEGLego,0,1,0,3,1580274000,1580274000,1
Sweet-Child,0,1,0,4,1577336400,1577336400,1
dance_apoptosistic,0,1,0,4,1595217600,1595217600,1
TopRandomness,0,1,0,1,1596600000,1596600000,1
Psychedelicluv,0,1,0,1,1605589200,1605589200,1
Jellyswim_,0,1,0,9,1608958800,1608958800,1
cookingforphysicists,0,1,0,25,1592798400,1592798400,1
punkypin,0,1,0,15,1594699200,1594699200,1
justatworkserve,0,1,0,8,1589342400,1589342400,1
MungTao,0,1,0,34,1608526800,1608526800,1
Urriah18,0,1,0,5,1608267600,1608267600,1
ThumpasaurusFlex,0,1,0,5,1607835600,1607835600,1
vikingpoptarts,0,1,0,20,1573534800,1573534800,1
necronomiconnn,0,1,0,1,1609563600,1609563600,1
Pinniped_dancer,0,1,0,2,1601352000,1601352000,1
Eddy-Shmokes,0,1,0,2,1601352000,1601352000,1
peteybob,0,1,0,8,1601870400,1601870400,1
2overworked,1,0,13,0,1598068800,1598068800,1
Shagster529,0,1,0,1,1598328000,1598328000,1
DatAmazingSuperPower,0,1,0,2,1598673600,1598673600,1
kewlsturybrah,0,1,0,1,1606626000,1606626000,1
FourWhiteBars,0,1,0,14,1606366800,1606366800,1
VidKiddo,0,1,0,5,1578546000,1578546000,1
JCO35,0,1,0,135,1581051600,1581051600,1
madschak,0,1,0,4,1609131600,1609131600,1
Deerlines,0,1,0,2,1580706000,1580706000,1
heatingplane,0,1,0,1,1600660800,1600660800,1
internetpizza,0,1,0,2,1539921600,1539921600,1
justAPhoneUsername,0,1,0,2,1606626000,1606626000,1
barkoded99,0,1,0,1,1591329600,1591329600,1
Matcha_Bubble_Tea,0,1,0,1,1606626000,1606626000,1
artemi66,0,1,0,2,1604030400,1604030400,1
Whoisreallyright,0,1,0,2,1585454400,1585454400,1
BigCatPoop,0,1,0,17,1606712400,1606712400,1
monkorn,0,1,0,1,1605502800,1605502800,1
MoarInfo4Me,0,1,0,1,1604293200,1604293200,1
noyakr,0,1,0,2,1549429200,1549429200,1
ionbeam7,0,1,0,10,1596340800,1596340800,1
FieldStatus137,1,0,438,0,1603425600,1603425600,1
Minka_23,0,1,0,1,1594872000,1594872000,1
wkayleigh6,0,1,0,1,1597377600,1597377600,1
theganjaoctopus,0,1,0,53,1603080000,1603080000,1
simplegoatherder,0,1,0,8,1578978000,1578978000,1
Peco_Sr,0,1,0,4,1574139600,1574139600,1
ilixx-,0,1,0,4,1592625600,1592625600,1
LastBaron,0,1,0,2,1603512000,1603512000,1
Ultrackias,0,1,0,8,1588132800,1588132800,1
Bumblebee-k,1,0,181,0,1608786000,1608786000,1
Glacierdust,0,1,0,30,1582779600,1582779600,1
trashwyrm,0,1,0,1,1602907200,1602907200,1
tmsdave,0,1,0,1,1600833600,1600833600,1
not_a_web_developer,0,1,0,2,1594094400,1594094400,1
zabarz1234,0,1,0,2,1582002000,1582002000,1
balticbro,0,1,0,14,1591502400,1591502400,1
kQpounds,1,0,23,0,1548910800,1548910800,1
jake1080,0,1,0,1,1587528000,1587528000,1
imStellar7,0,1,0,2,1570852800,1570852800,1
Iamgodsfather1998,0,1,0,1,1570852800,1570852800,1
crazypeacocke,0,1,0,3,1605589200,1605589200,1
lukalongdickings,0,1,0,1,1604379600,1604379600,1
lilganj710,0,1,0,2,1578805200,1578805200,1
YoLoDrScientist,0,1,0,2,1603598400,1603598400,1
medatascientist,0,1,0,1,1579064400,1579064400,1
mffromaz,0,1,0,2,1599883200,1599883200,1
Jaf1999,0,1,0,5,1595908800,1595908800,1
jjohn7676,0,1,0,14,1587096000,1587096000,1
No-Advance-4273,0,1,0,-3,1598846400,1598846400,1
NuclearLavaLamp,0,1,0,5,1612242000,1612242000,1
IAmZBeast,1,0,283,0,1608872400,1608872400,1
thisismyusername1178,0,1,0,1,1634443200,1634443200,1
ACanadianLeftist,1,0,6,0,1596340800,1596340800,1
TangentFact,0,1,0,1,1589947200,1589947200,1
RandomExactitude,0,1,0,2,1591329600,1591329600,1
Eupho_Rick,0,1,0,2,1605589200,1605589200,1
Yomigi,0,1,0,1,1583470800,1583470800,1
nothingweasel,0,1,0,6,1569124800,1569124800,1
just_another_leftist,0,1,0,1,1593748800,1593748800,1
orphanpink,0,1,0,9,1591761600,1591761600,1
AlbertoDorito,0,1,0,-4,1599537600,1599537600,1
ChristianEconOrg,0,1,0,1,1607662800,1607662800,1
GreatOnion1994,0,1,0,5,1552536000,1552536000,1
Joey_AP2,0,1,0,2,1572580800,1572580800,1
RemainHard,0,1,0,3,1598673600,1598673600,1
SunshineSpite,0,1,0,14,1602129600,1602129600,1
Dobey2013,0,1,0,9,1608526800,1608526800,1
dankmimisxd,0,1,0,1,1598241600,1598241600,1
TuckerShives,1,0,14,0,1583726400,1583726400,1
Owl6,0,1,0,2,1596168000,1596168000,1
Donutbeforetime,0,1,0,3,1601611200,1601611200,1
Dream102345,0,1,0,1,1596340800,1596340800,1
VinegariestToe,1,0,109,0,1596081600,1596081600,1
lost-car-,0,1,0,2,1596772800,1596772800,1
Condom_falls_off,0,1,0,-8,1596686400,1596686400,1
ryw123,0,1,0,5,1602043200,1602043200,1
Jottor,0,1,0,5,1605848400,1605848400,1
pinkmarbleslab,0,1,0,2,1607835600,1607835600,1
HumanPersonDudeGuy,1,0,10,0,1567051200,1567051200,1
YourActorFriend,1,0,28,0,1521518400,1521518400,1
JamesMcNutty,0,1,0,5,1608440400,1608440400,1
AbortedBaconFetus,0,1,0,23,1605848400,1605848400,1
A_Rampaging_Hobo,0,1,0,4,1605416400,1605416400,1
kikazzez,0,1,0,1,1579323600,1579323600,1
odvf,0,1,0,7,1552276800,1552276800,1
comingtobedhoney1,1,0,139,0,1569816000,1569816000,1
HaussingHippo,0,1,0,2,1575003600,1575003600,1
Stonewall30nyr,0,1,0,1,1606021200,1606021200,1
CrockpotHotshot,0,1,0,1,1607403600,1607403600,1
noctilucart,0,1,0,3,1593748800,1593748800,1
TheRealRoach117,0,1,0,24,1594267200,1594267200,1
DaPurpleUnicorn,0,1,0,1,1585108800,1585108800,1
Comrade_Otter,0,1,0,3,1561953600,1561953600,1
growingcodist,0,1,0,7,1588219200,1588219200,1
shazzamwithfiveAs,0,1,0,1,1571976000,1571976000,1
stinkwaffles,0,1,0,10,1607403600,1607403600,1
Marswhalbaconattor,1,0,139,0,1597204800,1597204800,1
khukk,0,1,0,1,1596340800,1596340800,1
Zenzisage,0,1,0,1,1606021200,1606021200,1
KaiCypret,0,1,0,1,1609045200,1609045200,1
Snappel,0,1,0,2,1585454400,1585454400,1
heterod0xical,0,1,0,7,1604203200,1604203200,1
Ocstek,0,1,0,2,1612069200,1612069200,1
NeatBoiIsNeat,1,0,2,0,1578978000,1578978000,1
MelchorTrashman,0,1,0,-1,1608699600,1608699600,1
utnapishtim,0,1,0,281,1558497600,1558497600,1
Chutzvah,0,1,0,5,1576040400,1576040400,1
Nelaur,0,1,0,3,1595822400,1595822400,1
mrsrobertfossil,0,1,0,40,1602043200,1602043200,1
SweetSewerRat,0,1,0,2,1606021200,1606021200,1
Lykurgus_,0,1,0,7,1590120000,1590120000,1
beggsy909,0,1,0,8,1557720000,1557720000,1
lilBloodpeach,0,1,0,20,1571025600,1571025600,1
deicide112,0,1,0,1,1591329600,1591329600,1
kitty-committee,1,0,43,0,1567137600,1567137600,1
frankiesnapea,0,1,0,17,1588132800,1588132800,1
LeonDeCool,0,1,0,43,1549083600,1549083600,1
BigLouie913,0,1,0,1,1592539200,1592539200,1
ds1776,0,1,0,1,1605589200,1605589200,1
mrwilliams117,0,1,0,2,1594440000,1594440000,1
JenDulce,0,1,0,21,1608440400,1608440400,1
wiglyt,0,1,0,5,1611896400,1611896400,1
OneTwothpick,0,1,0,11,1607230800,1607230800,1
slickwonderful,0,1,0,40,1596254400,1596254400,1
Chineserose,0,1,0,2,1520485200,1520485200,1
cliu1222,0,1,0,1,1603425600,1603425600,1
bewbyee,0,1,0,13,1598328000,1598328000,1
DDJ8694,0,1,0,6,1569556800,1569556800,1
ledbottom,0,1,0,0,1581138000,1581138000,1
LifeAndReality85,0,1,0,8,1588996800,1588996800,1
WantonSonor,0,1,0,14,1573448400,1573448400,1
Crazy-Red-Fox,1,0,3,0,1581310800,1581310800,1
badboygoodgrades,0,1,0,2,1596772800,1596772800,1
BandoMemphis,0,1,0,4,1597982400,1597982400,1
lR4PT0RxJ3SUSl,0,1,0,4,1582606800,1582606800,1
HuntforMusic,0,1,0,1,1585972800,1585972800,1
shingdibang,0,1,0,5,1570507200,1570507200,1
greengardenmoss,0,1,0,8,1585454400,1585454400,1
Theta001,0,1,0,4,1604811600,1604811600,1
UndauntedAqua,0,1,0,3,1604293200,1604293200,1
Valentulous,1,0,8,0,1600920000,1600920000,1
Curae,0,1,0,6,1603512000,1603512000,1
gruchalla,0,1,0,1,1570248000,1570248000,1
financequestionsss,0,1,0,1,1606626000,1606626000,1
PeaceisallIwishfor_,0,1,0,2,1573880400,1573880400,1
10spoonsOfSpagetti,0,1,0,1,1603512000,1603512000,1
freshSkat,0,1,0,1,1588996800,1588996800,1
Shouseb1tch13,0,1,0,2,1603598400,1603598400,1
mypoopsocks,0,1,0,1,1588478400,1588478400,1
Marha01,0,1,0,4,1583557200,1583557200,1
Keneemo,0,1,0,3,1612155600,1612155600,1
worcmit,0,1,0,1,1612069200,1612069200,1
Thrye,0,1,0,38,1603684800,1603684800,1
Thoughts_are_things_,0,1,0,1,1605589200,1605589200,1
Insanity945,0,1,0,3,1607317200,1607317200,1
doubleeyepatched,0,1,0,1,1595908800,1595908800,1
the_maximalist,0,1,0,3,1591329600,1591329600,1
Funkypants00,0,1,0,1,1605589200,1605589200,1
Riddla26,0,1,0,19,1609390800,1609390800,1
seply,0,1,0,1,1606626000,1606626000,1
Giggs-,0,1,0,9,1461384000,1461384000,1
shoestars,0,1,0,6,1561089600,1561089600,1
TonedeafShartSocket,0,1,0,1,1582002000,1582002000,1
the-ish-i-say,0,1,0,7,1597118400,1597118400,1
Woopdedooploop,0,1,0,-8,1608267600,1608267600,1
Sweetea404,0,1,0,1,1580619600,1580619600,1
loverboy1347,0,1,0,1,1605589200,1605589200,1
adminandmodsgay,0,1,0,-1,1565755200,1565755200,1
isaiah5417,0,1,0,7,1597118400,1597118400,1
FoundHimNot,1,0,1,0,1562990400,1562990400,1
next89,0,1,0,-8,1575003600,1575003600,1
UsaiyanBolt,0,1,0,2,1607403600,1607403600,1
_devidasi108,0,1,0,1,1603598400,1603598400,1
LemurianStarseed11,0,1,0,3,1607835600,1607835600,1
bryanlvd,0,1,0,3,1576731600,1576731600,1
cryptid-creatures,0,1,0,4,1604898000,1604898000,1
Youngblackandsexy,0,1,0,2,1608181200,1608181200,1
adrienjz888,0,1,0,3,1577422800,1577422800,1
Anonymous_Hazard,0,1,0,4,1572494400,1572494400,1
dummees,0,1,0,67,1602043200,1602043200,1
ciarananchead,0,1,0,14,1604203200,1604203200,1
ignatzami,0,1,0,3,1582174800,1582174800,1
cmaj7flat5,0,1,0,1,1585454400,1585454400,1
ConfusedGuy3260,0,1,0,50,1602302400,1602302400,1
fjaoaoaoao,0,1,0,16,1574917200,1574917200,1
BakedInSpace,0,1,0,4,1567828800,1567828800,1
DrOgdenWernstrom,1,0,240,0,1598500800,1598500800,1
sixgunmaniac,0,1,0,6,1584763200,1584763200,1
kaoticgirl,0,1,0,1,1555905600,1555905600,1
rhods1,0,1,0,2,1587960000,1587960000,1
Surreal-Sicilian,0,1,0,-2,1606539600,1606539600,1
p3rsonaa,0,1,0,3,1586923200,1586923200,1
yoman6333,0,1,0,0,1609477200,1609477200,1
PigNamedBenis,0,1,0,2,1437019200,1437019200,1
big_shins_bob,0,1,0,10,1576731600,1576731600,1
SimpleMannStann,0,1,0,2,1588996800,1588996800,1
Aperfectmoment,0,1,0,1,1606885200,1606885200,1
-this-guy-fucks-,0,1,0,1,1605589200,1605589200,1
324692771,0,1,0,1,1601697600,1601697600,1
KodysNuts,0,1,0,1,1606021200,1606021200,1
watchhergardenontour,0,1,0,9,1587441600,1587441600,1
Shmaaakespeare,0,1,0,3,1601956800,1601956800,1
AnnFlowers,0,1,0,5,1603598400,1603598400,1
Naumzu,0,1,0,27,1581829200,1581829200,1
BeautifulWatercress6,0,1,0,1,1598068800,1598068800,1
Hereddit3,0,1,0,1,1591243200,1591243200,1
notrox,1,0,91,0,1568347200,1568347200,1
SpacemanSkiff,0,1,0,0,1597636800,1597636800,1
Orimuzd,0,1,0,-1,1591243200,1591243200,1
Cur1e,1,0,40,0,1607576400,1607576400,1
rockthots,0,1,0,38,1580446800,1580446800,1
Dowork001,0,1,0,10,1608267600,1608267600,1
wayward_wench,0,1,0,1,1605934800,1605934800,1
westfell,0,1,0,20,1607922000,1607922000,1
Zahrukai,0,1,0,1,1606021200,1606021200,1
hamiltonmechanic,1,0,19,0,1543726800,1543726800,1
Lilbeech,0,1,0,2,1574485200,1574485200,1
HoneyPlumBum,0,1,0,3,1597464000,1597464000,1
Dr_5trangelove,0,1,0,1,1573621200,1573621200,1
squeamish,0,1,0,0,1609390800,1609390800,1
Rad_R0b,0,1,0,14,1607576400,1607576400,1
jKherty,0,1,0,1,1604293200,1604293200,1
5g_QY6m_7f,1,0,1,0,1455685200,1455685200,1
whutwat,0,1,0,23,1584763200,1584763200,1
Dapumama,0,1,0,-4,1605157200,1605157200,1
manolos69,0,1,0,4,1606626000,1606626000,1
TheTrueOppai,0,1,0,3,1567828800,1567828800,1
NihilistFalafel,0,1,0,14,1602907200,1602907200,1
nsfwside8,0,1,0,1,1608699600,1608699600,1
penismelon,0,1,0,34,1549429200,1549429200,1
JohnSmith0202,0,1,0,26,1606626000,1606626000,1
M4tthew999,0,1,0,3,1600401600,1600401600,1
yubbermax,1,0,15,0,1554782400,1554782400,1
ainDaN76,0,1,0,4,1587441600,1587441600,1
see_ya_quesadilla,0,1,0,9,1596859200,1596859200,1
thebasedgirlisback,0,1,0,0,1606885200,1606885200,1
Mesheybabes,0,1,0,6,1606971600,1606971600,1
odraencoded,0,1,0,2,1591156800,1591156800,1
QuintinityTheCoder,0,1,0,3,1586404800,1586404800,1
SewingLifeRe,0,1,0,1,1591329600,1591329600,1
Iamthedarkside,0,1,0,2,1591416000,1591416000,1
solodolo0,0,1,0,3,1601352000,1601352000,1
RavioliConsultant,0,1,0,15,1606539600,1606539600,1
Charlie7Mason,0,1,0,3,1601956800,1601956800,1
theDNCdonkey,0,1,0,1,1572494400,1572494400,1
YourWinter87,0,1,0,1,1601697600,1601697600,1
notgoodbutrying,0,1,0,3,1606194000,1606194000,1
Toph-0,0,1,0,3,1602475200,1602475200,1
lydsbane,0,1,0,3,1550379600,1550379600,1
ILoveDiscussions,0,1,0,16,1607835600,1607835600,1
thinkagainnnn,0,1,0,2,1600315200,1600315200,1
MtarTDi,0,1,0,2,1568779200,1568779200,1
smileyrawmusic,0,1,0,28,1585454400,1585454400,1
flabio42,0,1,0,3,1609045200,1609045200,1
ravaioli,0,1,0,1,1607317200,1607317200,1
BlackPillGhost,0,1,0,7,1580792400,1580792400,1
Spark898,0,1,0,6,1566100800,1566100800,1
yodaofsoda54,1,0,29,0,1583726400,1583726400,1
randomthrowaway6234,0,1,0,17,1593144000,1593144000,1
attic_goat,0,1,0,1,1586491200,1586491200,1
durkdurkdurkdurkdurk,1,0,26,0,1555387200,1555387200,1
QuentinTarzantino,0,1,0,18,1594612800,1594612800,1
AllAlonio,0,1,0,3,1581051600,1581051600,1
beantownbully8,0,1,0,1,1593748800,1593748800,1
pennycroncher,0,1,0,1,1597291200,1597291200,1
adds102,0,1,0,8,1595736000,1595736000,1
Cjamesmarshall,1,0,116,0,1510462800,1510462800,1
GarrusisGod,0,1,0,-4,1587355200,1587355200,1
Ninjanarwhal64,0,1,0,2,1588910400,1588910400,1
GondorsPants,0,1,0,2,1607317200,1607317200,1
nihilismsaves,0,1,0,8,1602907200,1602907200,1
venuszg,0,1,0,-5,1607490000,1607490000,1
TheMagicalMeowstress,0,1,0,2,1571716800,1571716800,1
Permanent_cancer,0,1,0,1,1607662800,1607662800,1
dankem,0,1,0,-4,1588910400,1588910400,1
thetimeisnow,0,1,0,2,1590465600,1590465600,1
EndEternalSeptember,0,1,0,4,1605762000,1605762000,1
cjvadiraj,0,1,0,-3,1596859200,1596859200,1
Coolio_g,0,1,0,1,1610254800,1610254800,1
xrk,0,1,0,-11,1545109200,1545109200,1
jacydo,0,1,0,17,1602907200,1602907200,1
la-femme-noire,0,1,0,2,1586491200,1586491200,1
HardstartkitKevin,0,1,0,1,1600488000,1600488000,1
jrgeregula,0,1,0,3,1604552400,1604552400,1
Howaboutnope1,0,1,0,10,1602129600,1602129600,1
Soldraconis,0,1,0,4,1580619600,1580619600,1
hyoh666,0,1,0,1,1584331200,1584331200,1
salami350,0,1,0,2,1575003600,1575003600,1
can-t-touch,0,1,0,2,1573534800,1573534800,1
rengreen,0,1,0,30,1605502800,1605502800,1
Lecanoscopy,0,1,0,4,1603512000,1603512000,1
J-etais-Roxane,0,1,0,4,1599019200,1599019200,1
colourfulskier,0,1,0,33,1580014800,1580014800,1
helpmestallin,1,0,11,0,1576472400,1576472400,1
shucksx,0,1,0,2,1577422800,1577422800,1
Cynth0,0,1,0,1,1607058000,1607058000,1
ElephantGoesCrazy,0,1,0,8,1605589200,1605589200,1
fonster_mox,0,1,0,14,1604984400,1604984400,1
Prostate,0,1,0,1,1604466000,1604466000,1
RingDangDooWTFIsThat,0,1,0,1,1592452800,1592452800,1
Tootmcoot1,0,1,0,6,1596772800,1596772800,1
simone-,1,0,5,0,1605157200,1605157200,1
FluidDreams_,0,1,0,8,1609390800,1609390800,1
pruvacz,0,1,0,2,1535083200,1535083200,1
N1PZC,0,1,0,1,1603512000,1603512000,1
mazerbean,0,1,0,1,1552622400,1552622400,1
Voodoosoviet,0,1,0,1,1579323600,1579323600,1
artichoke_me_daddy,0,1,0,1,1593748800,1593748800,1
ShadowWolfAlpha101,0,1,0,3,1605589200,1605589200,1
artbypep,0,1,0,12,1569124800,1569124800,1
NostalgicAdolescents,0,1,0,5,1607835600,1607835600,1
palmcoconut,1,0,3,0,1599105600,1599105600,1
Tapir_eyes,0,1,0,7,1597809600,1597809600,1
jarobat,0,1,0,2,1605157200,1605157200,1
smol_kitten_,0,1,0,5,1601265600,1601265600,1
lyringlas,0,1,0,5,1599796800,1599796800,1
dashingtoast,1,0,137,0,1599796800,1599796800,1
dontlickboots,0,1,0,-3,1585195200,1585195200,1
rosapompomgirlande,0,1,0,7,1582693200,1582693200,1
siphtron,0,1,0,1,1600228800,1600228800,1
ak-92,0,1,0,2,1600833600,1600833600,1
jwalk2925,0,1,0,3,1608786000,1608786000,1
FreshPrince3430,0,1,0,7,1574571600,1574571600,1
dosedcheerwine,0,1,0,35,1601179200,1601179200,1
Herp_derpelson,0,1,0,2,1597982400,1597982400,1
BarryBBeenson,1,0,31,0,1602043200,1602043200,1
sangriasky,0,1,0,39,1575781200,1575781200,1
pillowbabeee,0,1,0,2,1600056000,1600056000,1
thriftwisepoundshy,0,1,0,1,1577854800,1577854800,1
HotDamnThatsMyJam,0,1,0,7,1591675200,1591675200,1
u_r_thesweetestcloud,1,0,21,0,1602820800,1602820800,1
shbeet,0,1,0,19,1607662800,1607662800,1
bergskey,0,1,0,3,1603512000,1603512000,1
SkMyBlz,0,1,0,7,1601870400,1601870400,1
illraden,0,1,0,1,1606885200,1606885200,1
simptuto,1,0,1,0,1456635600,1456635600,1
michirod,1,0,13,0,1606971600,1606971600,1
theoracleofosiris,0,1,0,6,1593144000,1593144000,1
robertflannel,0,1,0,5,1582261200,1582261200,1
Viking_In_Training,0,1,0,69,1609304400,1609304400,1
WetBuddhist,0,1,0,1,1589947200,1589947200,1
dog_and_ape,0,1,0,56,1548565200,1548565200,1
OldlogoPSN,0,1,0,17,1577422800,1577422800,1
TrailerTrash4,0,1,0,11,1589428800,1589428800,1
September20191,0,1,0,3,1600142400,1600142400,1
quernika,0,1,0,1,1591329600,1591329600,1
Potatoman365,0,1,0,4,1602648000,1602648000,1
herb0026,0,1,0,2,1578978000,1578978000,1
WatermelonWaterWarts,0,1,0,17,1553313600,1553313600,1
unrepentantbarbarian,0,1,0,4,1588651200,1588651200,1
melancholanie,0,1,0,1,1608699600,1608699600,1
Painterguy1969,0,1,0,2,1588824000,1588824000,1
TheLightwell,0,1,0,8,1605416400,1605416400,1
Bea1Rhyme,0,1,0,5,1594612800,1594612800,1
LeZarathustra,0,1,0,9,1591502400,1591502400,1
Mujokan,0,1,0,20,1605416400,1605416400,1
merma1dbones,0,1,0,9,1526529600,1526529600,1
Sufficient-Piece-335,0,1,0,3,1609477200,1609477200,1
CurrentPrice5,0,1,0,1,1596427200,1596427200,1
ravice41,0,1,0,2,1591502400,1591502400,1
Wetestblanket,0,1,0,2,1596254400,1596254400,1
PerfectZeong,0,1,0,2,1577336400,1577336400,1
CandyKnockout,0,1,0,88,1578805200,1578805200,1
Kiddy_ice,0,1,0,17,1585281600,1585281600,1
tinker_tayler,0,1,0,58,1575954000,1575954000,1
Yentruo,0,1,0,16,1578286800,1578286800,1
Mariposa_Flor,0,1,0,1,1611982800,1611982800,1
urbanbanalities,0,1,0,13,1571284800,1571284800,1
A_Bridgeburner,1,0,13,0,1608354000,1608354000,1
breaking_sane,0,1,0,1,1584072000,1584072000,1
shaddaiguardian,0,1,0,8,1597377600,1597377600,1
Violet_Plum_Tea,0,1,0,7,1553832000,1553832000,1
vezance,0,1,0,25,1577336400,1577336400,1
blackfiskgg,0,1,0,22,1594353600,1594353600,1
Wattyear,0,1,0,1,1578546000,1578546000,1
itsjustmeyaboijesus,1,0,7,0,1595304000,1595304000,1
Senor_dinosaur,0,1,0,23,1581138000,1581138000,1
bc_01,0,1,0,7,1585540800,1585540800,1
glouglounon,0,1,0,3,1606021200,1606021200,1
yellowcedar,0,1,0,11,1581138000,1581138000,1
rememberjanuary,0,1,0,4,1594872000,1594872000,1
serederk1210,0,1,0,1,1598414400,1598414400,1
derpbagels,0,1,0,1,1598932800,1598932800,1
FuckJohnnyGuitar,0,1,0,-13,1598673600,1598673600,1
jaldred_jr,0,1,0,1,1594353600,1594353600,1
Lord_Teemo,0,1,0,3,1584504000,1584504000,1
Miobravo,0,1,0,1,1608872400,1608872400,1
plug_play,0,1,0,5,1607490000,1607490000,1
flinty_day_off,0,1,0,1,1449205200,1449205200,1
darkfrost47,0,1,0,1,1599537600,1599537600,1
aeingers,0,1,0,69,1599796800,1599796800,1
dawgys,0,1,0,1,1581915600,1581915600,1
guccitaint,0,1,0,1,1557720000,1557720000,1
saint_of_the_owl,1,0,296,0,1595044800,1595044800,1
excusemeforliving,0,1,0,3,1606021200,1606021200,1
despondentadult,0,1,0,5,1606366800,1606366800,1
WSGreenway,0,1,0,10,1605502800,1605502800,1
fointy,0,1,0,49,1558497600,1558497600,1
Budderfingerbandit,0,1,0,0,1573362000,1573362000,1
-xXColtonXx-,0,1,0,26,1580619600,1580619600,1
Replicant-512,0,1,0,1,1602302400,1602302400,1
hotbabesnearyou,0,1,0,1,1607662800,1607662800,1
PrestigiousWing4046,0,1,0,1,1634529600,1634529600,1
Grineflip,0,1,0,2,1587614400,1587614400,1
DangerousGain,0,1,0,1,1559016000,1559016000,1
Christian_Anon1280,0,1,0,1,1604203200,1604203200,1
vandersen,0,1,0,13,1576558800,1576558800,1
ThePurityofChaos,0,1,0,1,1586577600,1586577600,1
robertmccluresmith,0,1,0,2,1612069200,1612069200,1
si1965,0,1,0,1,1585886400,1585886400,1
TrevorsMailbox,0,1,0,16,1584504000,1584504000,1
eternaltyro,0,1,0,1,1634961600,1634961600,1
aamb9191,0,1,0,2,1601352000,1601352000,1
jfk-was-openminded,1,0,4,0,1602388800,1602388800,1
social_hermit_crab,0,1,0,1,1568001600,1568001600,1
KittyJPEG,0,1,0,7,1572667200,1572667200,1
SirTreecko,0,1,0,3,1606366800,1606366800,1
Yamidamian,0,1,0,5,1584676800,1584676800,1
DeadlyJaneDoe,0,1,0,7,1588910400,1588910400,1
Derailed94,0,1,0,5,1554350400,1554350400,1
trashbagshitfuck,0,1,0,11,1609304400,1609304400,1
Cudder3000zz,0,1,0,5,1607576400,1607576400,1
GaijinRider,0,1,0,43,1599796800,1599796800,1
awsdr1234,0,1,0,5,1594008000,1594008000,1
kyleisgr8m8,1,0,16,0,1603166400,1603166400,1
icee54,0,1,0,6,1591502400,1591502400,1
niktodetka,0,1,0,1,1597464000,1597464000,1
browsingnewisweird,0,1,0,18,1607490000,1607490000,1
redguards52,0,1,0,13,1605589200,1605589200,1
2WAR,0,1,0,1,1603512000,1603512000,1
EnricoMontez,0,1,0,2,1596772800,1596772800,1
Purple-Yin,0,1,0,6,1570939200,1570939200,1
pettydavis,0,1,0,3,1597896000,1597896000,1
candysteve,0,1,0,4,1594872000,1594872000,1
TIMMAH2,0,1,0,0,1591243200,1591243200,1
Klein-Mort,0,1,0,10,1607576400,1607576400,1
Hallopainyo,0,1,0,1,1611032400,1611032400,1
FlyingLap,0,1,0,1,1611982800,1611982800,1
ageandtype,0,1,0,9,1576040400,1576040400,1
Standard_Fondant,0,1,0,8,1576731600,1576731600,1
twumdeedwumble,0,1,0,4,1567396800,1567396800,1
incelwiz,0,1,0,3,1578459600,1578459600,1
SadSexWorker,0,1,0,1,1636866000,1636866000,1
OneOfTwoWugs,0,1,0,1,1603512000,1603512000,1
MeanwhileOnPluto,0,1,0,1,1585195200,1585195200,1
raeex34,0,1,0,2,1583985600,1583985600,1
Jeb_Jenky,0,1,0,1,1608526800,1608526800,1
Slinth38436,0,1,0,6,1607230800,1607230800,1
Cow_Tipping_Olympian,0,1,0,1,1591329600,1591329600,1
Promiseimnotanidiot,0,1,0,1,1606366800,1606366800,1
dayvekeem,0,1,0,31,1609218000,1609218000,1
Murmur322,0,1,0,7,1585627200,1585627200,1
slipperyfingerss,0,1,0,-4,1570420800,1570420800,1
EckEck704,0,1,0,1,1603771200,1603771200,1
micaelacowper,0,1,0,21,1564372800,1564372800,1
220001314,0,1,0,1,1578286800,1578286800,1
Complex_Pineapplel,0,1,0,1,1607576400,1607576400,1
HelperBot_,0,1,0,2,1535601600,1535601600,1
Nemph-is,0,1,0,10,1606453200,1606453200,1
SqueakyCog,0,1,0,1,1607058000,1607058000,1
trainsnboatsnplanes,0,1,0,2,1597809600,1597809600,1
BringBackBenn,1,0,24,0,1563163200,1563163200,1
KatzPajamz,0,1,0,1,1603857600,1603857600,1
EZMickey,0,1,0,3,1608613200,1608613200,1
WhatArcherWhat,0,1,0,2,1608094800,1608094800,1
Aliusja1990,0,1,0,2,1578546000,1578546000,1
communalistkid,0,1,0,0,1580706000,1580706000,1
LordSyron,0,1,0,0,1603684800,1603684800,1
StellarInferno,0,1,0,3,1600660800,1600660800,1
ABWchance,0,1,0,3,1594612800,1594612800,1
bythog,0,1,0,-3,1607576400,1607576400,1
Iguana_lover1998,0,1,0,-11,1606798800,1606798800,1
Macluawn,0,1,0,9,1607230800,1607230800,1
Yungtranner,1,0,17,0,1606712400,1606712400,1
sun-shinee,0,1,0,7,1557460800,1557460800,1
OliverNodel,0,1,0,4,1605762000,1605762000,1
HeavyWheazing,0,1,0,1,1607576400,1607576400,1
helvetica-sucks,0,1,0,2,1550552400,1550552400,1
NappyLion,0,1,0,13,1592366400,1592366400,1
Sqweacx,0,1,0,1,1583557200,1583557200,1
nugitron,0,1,0,12,1603771200,1603771200,1
pqrx14,0,1,0,13,1602648000,1602648000,1
trin6948,0,1,0,1,1574398800,1574398800,1
RadicalD11,0,1,0,1,1588824000,1588824000,1
judgeyoself,0,1,0,3,1578027600,1578027600,1
Finnobili616,0,1,0,1,1585454400,1585454400,1
trvekvltmaster,0,1,0,3,1575262800,1575262800,1
Pitron9000,0,1,0,3,1585281600,1585281600,1
BetOnWaifu,0,1,0,1,1595908800,1595908800,1
erics1984,0,1,0,1,1603512000,1603512000,1
xxsleepyyxx,0,1,0,1,1600401600,1600401600,1
catpissfromhell,0,1,0,6,1588132800,1588132800,1
sucemabite69,0,1,0,-2,1560916800,1560916800,1
Scary_Zucchini,0,1,0,1,1609045200,1609045200,1
diesel_chevette,0,1,0,8,1600315200,1600315200,1
sebastiangman,0,1,0,1,1613019600,1613019600,1
StingyKarmaWhore,0,1,0,1,1586750400,1586750400,1
No_Work_6000,1,0,1,0,1594353600,1594353600,1
botnona,0,1,0,5,1607490000,1607490000,1
Pauliusvaliuke,0,1,0,1,1555387200,1555387200,1
TheGreatShwa,0,1,0,6,1575954000,1575954000,1
brianMMMMM,0,1,0,5,1585022400,1585022400,1
Pommallow,1,0,6,0,1539921600,1539921600,1
AnxiousCommie,0,1,0,2,1579237200,1579237200,1
d000dle,0,1,0,4,1607403600,1607403600,1
Mercness,0,1,0,5,1472270400,1472270400,1
muscadine33,0,1,0,2,1604811600,1604811600,1
UnderTheS,0,1,0,5,1467777600,1467777600,1
LMGooglyTFY,0,1,0,1,1603512000,1603512000,1
Sir_Fappleton,0,1,0,3,1540094400,1540094400,1
MartianTrinkets,0,1,0,7,1602216000,1602216000,1
FiendForCaffeine,0,1,0,2,1606021200,1606021200,1
billynova9,0,1,0,9,1602043200,1602043200,1
TJ_Marcus,0,1,0,0,1589601600,1589601600,1
Evil-Wayne,0,1,0,1,1580965200,1580965200,1
Consejal,0,1,0,16,1585627200,1585627200,1
crazyhobbitz,0,1,0,1,1591243200,1591243200,1
Psykoi,0,1,0,1,1600142400,1600142400,1
Lobe202,0,1,0,7,1603252800,1603252800,1
smolalmond,0,1,0,41,1565582400,1565582400,1
GoNoGoNoGo,0,1,0,2,1590638400,1590638400,1
turndowntheheat,0,1,0,2,1561089600,1561089600,1
Taboo_LaRasa,0,1,0,5,1578027600,1578027600,1
TheFlood46_-2-_,0,1,0,26,1599019200,1599019200,1
walnutbed94,0,1,0,8,1572930000,1572930000,1
kda255,0,1,0,10,1550293200,1550293200,1
Screap,0,1,0,3,1575349200,1575349200,1
rjhills,0,1,0,1,1594872000,1594872000,1
theskincarelady,0,1,0,1,1576645200,1576645200,1
Macdowell87,0,1,0,61,1607490000,1607490000,1
junkelsplitsy,0,1,0,2,1604203200,1604203200,1
iseekitty,1,0,68,0,1600315200,1600315200,1
MLGteletubbie,0,1,0,3,1539057600,1539057600,1
Ok_Preference1207,0,1,0,53,1606971600,1606971600,1
polyestersoftboi,0,1,0,3,1603512000,1603512000,1
MaBonneVie,0,1,0,11,1584158400,1584158400,1
Yardithbey,0,1,0,1,1579064400,1579064400,1
Adastrous,0,1,0,45,1597809600,1597809600,1
multimeat,0,1,0,1,1608267600,1608267600,1
gigglefang,0,1,0,14,1585886400,1585886400,1
UkshaktheImmortal,0,1,0,9,1607403600,1607403600,1
ligatureblossom,0,1,0,-2,1565236800,1565236800,1
UnSpanishInquisition,0,1,0,1,1603512000,1603512000,1
Hambuchkadv,1,0,1,0,1540008000,1540008000,1
Metalfreak4677,1,0,2,0,1585972800,1585972800,1
Noble-A,0,1,0,13,1576645200,1576645200,1
PillsburyYungBoy,0,1,0,3,1604552400,1604552400,1
1sumanth2,1,0,105,0,1604466000,1604466000,1
Doffs_cap,0,1,0,25,1596340800,1596340800,1
Penguin-a-Tron,0,1,0,2,1549515600,1549515600,1
Metroid_Zard,0,1,0,-19,1588478400,1588478400,1
oOnoNOnoOo,0,1,0,2,1607058000,1607058000,1
lmaolmfaolmaolmfao,0,1,0,2,1577422800,1577422800,1
anuhlynn,0,1,0,2,1574398800,1574398800,1
MacMurdock,0,1,0,1,1547614800,1547614800,1
Dantadow,1,0,74,0,1579669200,1579669200,1
alexsutherland20,0,1,0,17,1606712400,1606712400,1
hypocrisy-detection,0,1,0,-20,1577941200,1577941200,1
richardeid,0,1,0,1,1591243200,1591243200,1
PMME_FIELDRECORDINGS,0,1,0,29,1591156800,1591156800,1
Woodersun,0,1,0,0,1557201600,1557201600,1
lizzzellzzz,0,1,0,7,1603512000,1603512000,1
wavyqueenv,0,1,0,4,1611896400,1611896400,1
devonthorton,0,1,0,1,1603252800,1603252800,1
b95csf,0,1,0,1,1559188800,1559188800,1
Captain19matt,0,1,0,17,1605070800,1605070800,1
ManDoIHateLiving,0,1,0,-5,1597377600,1597377600,1
mazur_not_taken,0,1,0,9,1567051200,1567051200,1
Loudchewer,0,1,0,3,1600574400,1600574400,1
tommytookalook,0,1,0,2,1607144400,1607144400,1
whereverilaymyphone,0,1,0,3,1611810000,1611810000,1
smilingdisgrace,0,1,0,19,1583384400,1583384400,1
Boxic1,0,1,0,1,1603684800,1603684800,1
gerbear69,0,1,0,3,1569556800,1569556800,1
jhood2020,0,1,0,1,1592971200,1592971200,1
Savesomeposts,0,1,0,1,1590379200,1590379200,1
nathanchr55,1,0,0,0,1608699600,1608699600,1
NotANinja252,0,1,0,2,1603944000,1603944000,1
KadenTau,0,1,0,11,1611982800,1611982800,1
TheBloodyPuppet_2,0,1,0,60,1606885200,1606885200,1
Zoobooloobooboop,0,1,0,0,1607835600,1607835600,1
Massacheefa,0,1,0,4,1606798800,1606798800,1
dc678,0,1,0,7,1602648000,1602648000,1
MoronToTheKore,0,1,0,3,1555300800,1555300800,1
theweirdlip,0,1,0,1,1608872400,1608872400,1
mattieren1,0,1,0,3,1570161600,1570161600,1
LolDoofus,1,0,4,0,1608008400,1608008400,1
Ownage2190,0,1,0,5,1584676800,1584676800,1
vlad-z,0,1,0,2,1570075200,1570075200,1
Grandoldste117,0,1,0,1,1573102800,1573102800,1
ryandogsling,0,1,0,1,1590724800,1590724800,1
Lord_Fuzzy_Buns,0,1,0,3,1598414400,1598414400,1
darkgod153,0,1,0,1,1536552000,1536552000,1
PrinceFungus,0,1,0,1,1611810000,1611810000,1
dentist_in_the_dark,0,1,0,1,1583557200,1583557200,1
b0nez_csgo,0,1,0,4,1558411200,1558411200,1
greenskye,0,1,0,16,1593230400,1593230400,1
juancarlosmandingo,0,1,0,14,1601784000,1601784000,1
AnkaraliDeadpool,0,1,0,1,1624766400,1624766400,1
Blythe703,0,1,0,8,1606539600,1606539600,1
Crypto180MGTOW,0,1,0,2,1557460800,1557460800,1
ChubbbyLover39,0,1,0,1,1564113600,1564113600,1
TequieroVerde,0,1,0,0,1601870400,1601870400,1
VaginalPenetrating,0,1,0,1,1598328000,1598328000,1
SnaxwellP,0,1,0,1,1634702400,1634702400,1
Doom_Penguin,0,1,0,1,1598068800,1598068800,1
likeaspaceboy,0,1,0,2,1598241600,1598241600,1
is000c,0,1,0,-4,1593230400,1593230400,1
Roushouse,0,1,0,-26,1592712000,1592712000,1
carterb199,0,1,0,-2,1606626000,1606626000,1
sfendisko,0,1,0,1,1607144400,1607144400,1
scrollhole,0,1,0,6,1574658000,1574658000,1
JSeol360,0,1,0,2,1604725200,1604725200,1
WeFlyHighNoLieYkThis,0,1,0,-1,1604379600,1604379600,1
TheSaltyBiscuit,0,1,0,1,1611982800,1611982800,1
H_Mc,0,1,0,4,1607835600,1607835600,1
throwaway1273-_-,0,1,0,1,1612674000,1612674000,1
Dream_Maker_03,0,1,0,2,1593921600,1593921600,1
James-W-Tate,0,1,0,69,1589860800,1589860800,1
christmasface,0,1,0,18,1601956800,1601956800,1
Danalogtodigital,0,1,0,1,1595476800,1595476800,1
Letmeeatyournosehole,0,1,0,3,1597291200,1597291200,1
dekomaro6,1,0,47,0,1595995200,1595995200,1
LAtransplant505,0,1,0,3,1584244800,1584244800,1
TAS_Snoop,0,1,0,1,1569297600,1569297600,1
Dugongwong,0,1,0,1,1603512000,1603512000,1
huff4bug,1,0,17,0,1559448000,1559448000,1
stuckonusername,0,1,0,9,1595908800,1595908800,1
seizethedayshellymae,0,1,0,9,1603512000,1603512000,1
Awesomer9000,0,1,0,1,1599537600,1599537600,1
marcuschiuph,0,1,0,6,1600920000,1600920000,1
melanie_2015,0,1,0,3,1553313600,1553313600,1
EquippedHalo,1,0,512,0,1608526800,1608526800,1
NormalHumanCreature,0,1,0,8,1603512000,1603512000,1
crumblingchoccookies,0,1,0,6,1611982800,1611982800,1
FSUfan35,0,1,0,5,1605589200,1605589200,1
DeepHorse,0,1,0,2,1605070800,1605070800,1
wilde_foxes,0,1,0,1,1603512000,1603512000,1
colestisjk,0,1,0,-2,1594267200,1594267200,1
jshultz5259,0,1,0,1,1608872400,1608872400,1
domine18,0,1,0,-1,1593662400,1593662400,1
Dusteye,0,1,0,1,1583899200,1583899200,1
KrasnyRed5,0,1,0,27,1585454400,1585454400,1
Biggest_Lebowski,0,1,0,3,1598760000,1598760000,1
LordMangudai,0,1,0,1,1554264000,1554264000,1
Solostie,0,1,0,-9,1604811600,1604811600,1
pf9f8kg8,1,0,25,0,1554609600,1554609600,1
SlowTour,0,1,0,2,1589083200,1589083200,1
Tomaz120,0,1,0,1,1606626000,1606626000,1
Imaginary-Risk,0,1,0,1,1606626000,1606626000,1
Paleanar,0,1,0,1,1573966800,1573966800,1
daemon_afro,0,1,0,-6,1568347200,1568347200,1
poo_22,0,1,0,37,1574398800,1574398800,1
shivaherer,0,1,0,9,1585195200,1585195200,1
sgtsnyder88,0,1,0,1,1480482000,1480482000,1
Thebaywolf,0,1,0,7,1600920000,1600920000,1
ArtPhobic34,0,1,0,5,1604898000,1604898000,1
SK2012SL,0,1,0,3,1573707600,1573707600,1
Trashleopard,0,1,0,4,1601179200,1601179200,1
GrumpkintheGreater,0,1,0,8,1545282000,1545282000,1
PsychoZzzorD,0,1,0,2,1606885200,1606885200,1
keltedfain,0,1,0,7,1568001600,1568001600,1
KomatsuOsaki,0,1,0,5,1560744000,1560744000,1
CandidGuidance,0,1,0,6,1601265600,1601265600,1
fvckinghatemoths,0,1,0,-2,1598760000,1598760000,1
numbersthen0987431,0,1,0,2,1598414400,1598414400,1
TechnTogether,0,1,0,1,1634702400,1634702400,1
SawLine,0,1,0,1,1601524800,1601524800,1
toss_my_potatoes,0,1,0,10,1602820800,1602820800,1
myntt,0,1,0,2,1603080000,1603080000,1
_BetterRedThanDead,0,1,0,9,1598328000,1598328000,1
SensualKoala,0,1,0,3,1582434000,1582434000,1
ihathnosoul,0,1,0,1,1606021200,1606021200,1
brp,0,1,0,14,1598846400,1598846400,1
ahtzib,0,1,0,1,1603512000,1603512000,1
myopinionokay,0,1,0,-2,1593057600,1593057600,1
Shopped_For_Pleasure,0,1,0,5,1612069200,1612069200,1
vajayjayjay,0,1,0,1,1571025600,1571025600,1
JuliaBoC,1,0,1115,0,1553486400,1553486400,1
EvidencePlz,0,1,0,16,1594612800,1594612800,1
va456,0,1,0,1,1581310800,1581310800,1
whazzuppp,0,1,0,-1,1567915200,1567915200,1
SeelX,0,1,0,1,1601870400,1601870400,1
worfres_arec_bawrin,0,1,0,1,1585022400,1585022400,1
ConoryouLegend,0,1,0,41,1592539200,1592539200,1
lactose_con_leche,0,1,0,3,1603512000,1603512000,1
Gorgosaurus-Libratus,0,1,0,1,1580014800,1580014800,1
zensational,0,1,0,3,1574571600,1574571600,1
Arken2121,0,1,0,1,1607317200,1607317200,1
GrimmAria12,0,1,0,17,1600228800,1600228800,1
Ximension,0,1,0,3,1573448400,1573448400,1
kermittheffrog,0,1,0,115,1607749200,1607749200,1
CptBigglesworth,0,1,0,1,1566446400,1566446400,1
UnspokenQuestions,0,1,0,7,1592971200,1592971200,1
edoogy,0,1,0,3,1608872400,1608872400,1
Lukewarm-chocolate,0,1,0,1,1609390800,1609390800,1
Comrade-Cameron,0,1,0,5,1575954000,1575954000,1
Past_Sir,0,1,0,1,1608181200,1608181200,1
Tatmouse,0,1,0,1,1606626000,1606626000,1
Lantern_Eon,0,1,0,1,1635048000,1635048000,1
BojanDoge,1,0,381,0,1605589200,1605589200,1
PMmeCuteArticFoxes,0,1,0,6,1575954000,1575954000,1
Chazzadan,0,1,0,4,1589947200,1589947200,1
mytwentyfifthname,0,1,0,4,1594699200,1594699200,1
sqweegelxxx,0,1,0,23,1606885200,1606885200,1
chugach3dguy,0,1,0,11,1606971600,1606971600,1
PinkWug,1,0,131,0,1605934800,1605934800,1
chainmailnurse,0,1,0,-1,1585454400,1585454400,1
UpsetConfection8033,0,1,0,0,1607317200,1607317200,1
Shine-sun,0,1,0,0,1612155600,1612155600,1
circle_of_lyfe,0,1,0,11,1604203200,1604203200,1
currylambchop,0,1,0,1,1561435200,1561435200,1
Angemin,0,1,0,0,1571803200,1571803200,1
Diavolo__,0,1,0,7,1600833600,1600833600,1
jonnyuta,0,1,0,1,1611982800,1611982800,1
DesktopWebsite,0,1,0,1,1608872400,1608872400,1
ikeepmynipplesdry,0,1,0,2,1605070800,1605070800,1
PlzbuffRakiThenNerf,0,1,0,37,1589860800,1589860800,1
anal_casanova,0,1,0,10,1560571200,1560571200,1
SPACECAT223,0,1,0,1,1576558800,1576558800,1
Emperors_Golden_Boy,0,1,0,1,1576558800,1576558800,1
yendrush,0,1,0,14,1606539600,1606539600,1
like-water,0,1,0,2,1604984400,1604984400,1
Chitown2349r949,0,1,0,-6,1578546000,1578546000,1
dudemanbroguysirplz,0,1,0,1,1585454400,1585454400,1
TerribleCareer8,0,1,0,20,1570939200,1570939200,1
Axriel,0,1,0,3,1591243200,1591243200,1
Anoubis_Ra,0,1,0,56,1598328000,1598328000,1
absolutpalm,0,1,0,23,1581570000,1581570000,1
DeadWeaselRoad,0,1,0,5,1603598400,1603598400,1
Megouski,0,1,0,9,1584763200,1584763200,1
nba123490,0,1,0,-1,1588651200,1588651200,1
AyaPrimrose,0,1,0,3,1608354000,1608354000,1
Jaxtaposition92,0,1,0,13,1561176000,1561176000,1
CyanStripedPantsu,0,1,0,9,1599278400,1599278400,1
HrzGoose,0,1,0,5,1607576400,1607576400,1
OneMan_OneBeard,0,1,0,3,1568606400,1568606400,1
spooder_mang,0,1,0,7,1562040000,1562040000,1
Yohan_Turnipz,1,0,8,0,1576213200,1576213200,1
XanderTheMander,0,1,0,3,1612069200,1612069200,1
Yetanothercrazygirl1,0,1,0,7,1579496400,1579496400,1
SuperMengBoy,0,1,0,15,1558497600,1558497600,1
joshua070,0,1,0,1,1603512000,1603512000,1
MrWesten_94,0,1,0,20,1606194000,1606194000,1
Riksunraksu,0,1,0,2,1604379600,1604379600,1
bluestar105,0,1,0,7,1604116800,1604116800,1
phoenix_flies,0,1,0,5,1586145600,1586145600,1
AlphaNega,0,1,0,3,1606539600,1606539600,1
ReBL93,0,1,0,1,1570939200,1570939200,1
mlranda,0,1,0,6,1566619200,1566619200,1
Hopeforcheese,0,1,0,14,1608699600,1608699600,1
SigmaIgma,0,1,0,0,1585454400,1585454400,1
Noitatsidem,0,1,0,1,1566705600,1566705600,1
MeanDanGreen,1,0,591,0,1591329600,1591329600,1
modifiedtrader,0,1,0,1,1642914000,1642914000,1
thuggytee,0,1,0,2,1600488000,1600488000,1
rollbackprices,0,1,0,1,1603512000,1603512000,1
Congiatta,0,1,0,75,1563163200,1563163200,1
OGBaconwaffles,0,1,0,1,1596513600,1596513600,1
OnionDart,0,1,0,7,1603512000,1603512000,1
Eleglas,0,1,0,2,1603512000,1603512000,1
Joaoarthur,0,1,0,3,1605848400,1605848400,1
Crazyspideyfan,0,1,0,1,1572408000,1572408000,1
cj34z,0,1,0,1,1585195200,1585195200,1
ROCKISASELLOUT,0,1,0,65,1569902400,1569902400,1
Sontaran14,0,1,0,12,1606885200,1606885200,1
manicmidori,0,1,0,1,1603598400,1603598400,1
danknerd69,0,1,0,1,1606971600,1606971600,1
Poonjabr,0,1,0,3,1608699600,1608699600,1
Bootyhole_sniffer,0,1,0,13,1584072000,1584072000,1
InfamousBridge7,1,0,16,0,1553054400,1553054400,1
UpsetCut,0,1,0,1,1540180800,1540180800,1
ElfenTaiga,0,1,0,17,1564977600,1564977600,1
HashbrownSloot1992,0,1,0,2,1603598400,1603598400,1
CaptchaCrunch,0,1,0,11,1553400000,1553400000,1
SweetMousy,0,1,0,5,1563854400,1563854400,1
jerryshaz,0,1,0,1,1599883200,1599883200,1
CatfreshWilly,0,1,0,6,1576386000,1576386000,1
cereal-monogamist,0,1,0,10,1603339200,1603339200,1
threefingerbill,0,1,0,5,1582779600,1582779600,1
Kleptopia,0,1,0,0,1609304400,1609304400,1
heyjunior,0,1,0,-16,1608699600,1608699600,1
unforg1veable,0,1,0,1,1609477200,1609477200,1
AlienBeerChug,0,1,0,0,1594353600,1594353600,1
Uridoz,0,1,0,5,1537156800,1537156800,1
SaintWrightsmire,0,1,0,1,1607922000,1607922000,1
-_Jester_,0,1,0,1,1611982800,1611982800,1
Juggs_gotcha,0,1,0,3,1597723200,1597723200,1
bloodredroses6,1,0,85,0,1602820800,1602820800,1
dudenamedfella,0,1,0,1,1635998400,1635998400,1
lol_camis,0,1,0,1,1591243200,1591243200,1
DeterministDiet,0,1,0,1,1581138000,1581138000,1
JRDruchii,0,1,0,5,1598846400,1598846400,1
Sick-Handle,0,1,0,5,1556510400,1556510400,1
Fyuchanick,0,1,0,6,1585886400,1585886400,1
anndnow,0,1,0,8,1595736000,1595736000,1
iseedeff,0,1,0,7,1576386000,1576386000,1
TerminallyTrill,0,1,0,65,1557979200,1557979200,1
howmanypenises,0,1,0,1,1598760000,1598760000,1
amorousbellylint,0,1,0,1,1612069200,1612069200,1
fraghealer,0,1,0,6,1588996800,1588996800,1
The-Last-Lion-Turtle,0,1,0,-24,1571112000,1571112000,1
prof_the_doom,0,1,0,83,1611810000,1611810000,1
titoblanco,0,1,0,41,1582434000,1582434000,1
PEXowns,0,1,0,-7,1589169600,1589169600,1
Yuyu_hockey_show,0,1,0,2,1584676800,1584676800,1
mrharoharo,0,1,0,2,1572235200,1572235200,1
Judge_Bread_UK,0,1,0,4,1602043200,1602043200,1
Automated-Waffles,0,1,0,-2,1546405200,1546405200,1
Mecal00,0,1,0,11,1602043200,1602043200,1
Aditeuri,0,1,0,1,1591070400,1591070400,1
AhThatsLife,0,1,0,1,1606885200,1606885200,1
J-Logs_HER,0,1,0,1,1585108800,1585108800,1
laboratoryadvice,0,1,0,31,1605330000,1605330000,1
luxveniae,0,1,0,5,1580965200,1580965200,1
evil_with_a_headset,0,1,0,14,1598587200,1598587200,1
Rena1-,0,1,0,7,1598500800,1598500800,1
kakemo_kakemoto,0,1,0,2,1572930000,1572930000,1
RunOnSmoothFrozenIce,0,1,0,1,1569124800,1569124800,1
IAmTheMilk,0,1,0,1,1593316800,1593316800,1
anon86876,0,1,0,13,1561780800,1561780800,1
Kona00,0,1,0,2,1593057600,1593057600,1
dani_useless,1,0,39,0,1575694800,1575694800,1
FluffyMuffins42,0,1,0,33,1593403200,1593403200,1
frankcastlestein,0,1,0,1,1589947200,1589947200,1
JMCatron,0,1,0,9,1601438400,1601438400,1
LunaLina7111,0,1,0,9,1608267600,1608267600,1
ObjectivelyGrayWall,0,1,0,0,1591761600,1591761600,1
Fundevin,0,1,0,5,1608786000,1608786000,1
MidnightLegCramp,0,1,0,1,1608267600,1608267600,1
Gladmerth,0,1,0,2,1577854800,1577854800,1
courtneyisawesome,0,1,0,34,1593576000,1593576000,1
taylorswift98,0,1,0,16,1605589200,1605589200,1
beanabeanabeanabeana,1,0,17,0,1607144400,1607144400,1
redditcdnfanguy,0,1,0,-3,1562990400,1562990400,1
TheGreatOne77,0,1,0,1,1561694400,1561694400,1
KapitalP,0,1,0,1,1609218000,1609218000,1
i_need_launch_codes,0,1,0,15,1605675600,1605675600,1
oh19contp,0,1,0,1,1582606800,1582606800,1
DevilsPajamas,0,1,0,105,1603166400,1603166400,1
Homesandholes,0,1,0,2,1612069200,1612069200,1
Anti-statism,0,1,0,1,1540699200,1540699200,1
Stormedcrown,0,1,0,10,1590897600,1590897600,1
Spiffytown,0,1,0,1,1553400000,1553400000,1
ilikecrabs,0,1,0,5,1585454400,1585454400,1
ooyat,0,1,0,17,1608354000,1608354000,1
internethero12,0,1,0,298,1603512000,1603512000,1
Background_Limit,0,1,0,1,1570593600,1570593600,1
MrDrSpock,1,0,55,0,1584417600,1584417600,1
Roshprops,0,1,0,4,1582088400,1582088400,1
FawnFloura,0,1,0,4,1606539600,1606539600,1
notmymainbabe,0,1,0,4,1567569600,1567569600,1
DallasTheBullsFan,0,1,0,2,1569384000,1569384000,1
OnyxWebb,0,1,0,12,1574398800,1574398800,1
Deep_Grady,0,1,0,179,1611723600,1611723600,1
deezpo,0,1,0,1,1602734400,1602734400,1
Loganserio,0,1,0,2,1580274000,1580274000,1
Blue_Doubt,0,1,0,3,1599364800,1599364800,1
rafaelnorman,0,1,0,1,1553140800,1553140800,1
DetTigers1986,0,1,0,2,1591329600,1591329600,1
HopelessSkeptic,0,1,0,2,1592625600,1592625600,1
HoyasAngel,0,1,0,2,1602820800,1602820800,1
GucciMcChicken,1,0,49,0,1569902400,1569902400,1
halfachainsaw,0,1,0,28,1571371200,1571371200,1
Enemyocd,0,1,0,1,1599019200,1599019200,1
NPC_46765,0,1,0,1,1597032000,1597032000,1
-Rutabaga-,0,1,0,17,1594526400,1594526400,1
heyarea,0,1,0,0,1611896400,1611896400,1
Knaitho,0,1,0,11,1611982800,1611982800,1
kwikidevil,0,1,0,0,1588824000,1588824000,1
Joe_Doblow,0,1,0,1,1606539600,1606539600,1
SweaNoid,1,0,2,0,1606280400,1606280400,1
RedBaron97,0,1,0,5,1579410000,1579410000,1
rovus,0,1,0,2,1609045200,1609045200,1
asininemoralplatitud,0,1,0,5,1607749200,1607749200,1
nuts2fiststyle,0,1,0,6,1605070800,1605070800,1
veganfoobar1,0,1,0,1,1603512000,1603512000,1
Leutnant_Lauch,0,1,0,1,1589947200,1589947200,1
9w_MB2y__,1,0,1,0,1455426000,1455426000,1
Amt4life,0,1,0,41,1597636800,1597636800,1
lolVerbivore,0,1,0,-4,1569988800,1569988800,1
jetoler,0,1,0,5,1588651200,1588651200,1
Miggle-B,0,1,0,1,1618027200,1618027200,1
SpaghettiSunday17,0,1,0,47,1600660800,1600660800,1
volkss,0,1,0,1,1593921600,1593921600,1
dicemonkey,0,1,0,1,1585454400,1585454400,1
minetun,0,1,0,2,1601352000,1601352000,1
VoraciousKoala,0,1,0,9,1606626000,1606626000,1
MyketheTryke,0,1,0,3,1607576400,1607576400,1
wineanddined,0,1,0,3,1608354000,1608354000,1
summonerpaige,0,1,0,2,1581915600,1581915600,1
CamiPatri,0,1,0,3,1567137600,1567137600,1
Durende,0,1,0,6,1600315200,1600315200,1
dfghjkmu,0,1,0,9,1596686400,1596686400,1
iisakho,0,1,0,-8,1612155600,1612155600,1
ImportantRope,0,1,0,1,1594180800,1594180800,1
riiichie,0,1,0,1,1573966800,1573966800,1
sentientwizard,0,1,0,9,1581483600,1581483600,1
gimme_that_egg,0,1,0,1,1606107600,1606107600,1
zischt,0,1,0,1,1572843600,1572843600,1
divinocomediante,0,1,0,3,1588651200,1588651200,1
Apeckofpickledpeen,0,1,0,1,1603512000,1603512000,1
TB1289,0,1,0,3,1554264000,1554264000,1
MasterofNoneZero,0,1,0,47,1587614400,1587614400,1
Jinnis84,0,1,0,1,1608267600,1608267600,1
GCanuck,0,1,0,14,1594353600,1594353600,1
bn1979,0,1,0,1,1606021200,1606021200,1
ColumbianGeneral,0,1,0,1,1608181200,1608181200,1
Efficient-Echidna-30,0,1,0,9,1603425600,1603425600,1
JesuswasanAnCom,0,1,0,6,1579582800,1579582800,1
Peter12535,0,1,0,12,1603684800,1603684800,1
Fire_to_Ice,0,1,0,8,1599710400,1599710400,1
xcrossbyw,0,1,0,232,1580014800,1580014800,1
Buffalo__Buffalo,0,1,0,15,1462680000,1462680000,1
hwbaby,0,1,0,126,1605589200,1605589200,1
TheFlean,0,1,0,1,1598760000,1598760000,1
A3gis,0,1,0,26,1586577600,1586577600,1
MrChainsaw27,0,1,0,2,1580360400,1580360400,1
fvcklife_love,0,1,0,7,1600142400,1600142400,1
ActionSchmaction,0,1,0,30,1560916800,1560916800,1
BigSpinSpecial,0,1,0,1,1609304400,1609304400,1
JonnyMofoMurillo,0,1,0,1,1600920000,1600920000,1
TigKris,1,0,84,0,1605762000,1605762000,1
SirHarry,0,1,0,2,1573707600,1573707600,1
PickleDaddyxxx,0,1,0,2,1574744400,1574744400,1
disgracejones,0,1,0,2,1602129600,1602129600,1
RufusOfTheCelery,0,1,0,3,1595649600,1595649600,1
NAbberman,0,1,0,2,1603684800,1603684800,1
Gullible-Patience-97,0,1,0,16,1608008400,1608008400,1
DareToZamora,0,1,0,2,1603512000,1603512000,1
zimmermannS,0,1,0,-4,1602648000,1602648000,1
Pensacola_Peej,0,1,0,2,1600401600,1600401600,1
av3_atque_vale,0,1,0,1,1600747200,1600747200,1
Zymo_D,0,1,0,0,1601352000,1601352000,1
darkcookie333,0,1,0,1,1585022400,1585022400,1
jeb64w,0,1,0,3,1602734400,1602734400,1
ForgotOtherAccsPass,0,1,0,1,1608872400,1608872400,1
IFUCKINGHATELANDLORD,0,1,0,26,1588824000,1588824000,1
TheTokenBon,0,1,0,1,1591329600,1591329600,1
woodcannon,0,1,0,1,1601870400,1601870400,1
elephuntdude,0,1,0,3,1576040400,1576040400,1
donniellama,0,1,0,-6,1576558800,1576558800,1
jdspurgeon,0,1,0,1,1595304000,1595304000,1
Rootedetchasketch,0,1,0,3,1589428800,1589428800,1
Either-Sundae,0,1,0,5,1605589200,1605589200,1
KitsyBlue,0,1,0,22,1597636800,1597636800,1
georgi9714,0,1,0,1,1605157200,1605157200,1
PM_ME_LOIS_GRIFFIN,0,1,0,4,1573534800,1573534800,1
HordeShadowPriest,0,1,0,5,1571284800,1571284800,1
ConspicuousPineapple,0,1,0,3,1556596800,1556596800,1
GlowyStuffs,0,1,0,7,1606712400,1606712400,1
sad_Joe-,0,1,0,2,1567656000,1567656000,1
Partisode,0,1,0,9,1595563200,1595563200,1
daysinnroom203,0,1,0,10,1584763200,1584763200,1
strike4yourlife,0,1,0,3,1603166400,1603166400,1
MurgleMcGurgle,0,1,0,4,1603598400,1603598400,1
Koppurp,0,1,0,3,1599796800,1599796800,1
Crow180,0,1,0,3,1600920000,1600920000,1
Tim-in-CA,0,1,0,1,1608872400,1608872400,1
fawndofyou,0,1,0,47,1611982800,1611982800,1
GraffitiMan,1,0,153,0,1576126800,1576126800,1
Rogue_Kat15,0,1,0,14,1578632400,1578632400,1
Brownkidswag22,1,0,400,0,1608526800,1608526800,1
JhinMyLove,0,1,0,3,1607835600,1607835600,1
Own-Deer7547,1,0,2,0,1596686400,1596686400,1
Tor_Tor_Tor,0,1,0,3,1603598400,1603598400,1
Gizzy0213,0,1,0,2,1608699600,1608699600,1
LongestUsernameAllo,0,1,0,1,1481259600,1481259600,1
yogalift,0,1,0,-5,1571976000,1571976000,1
yuzhnan,0,1,0,13,1608181200,1608181200,1
Cara_Rowland,0,1,0,-8,1600228800,1600228800,1
Wellmyusernamethisis,0,1,0,2,1605070800,1605070800,1
FunkMeister1,0,1,0,4,1572667200,1572667200,1
tattedBOH,0,1,0,-1,1587960000,1587960000,1
j0eExis,0,1,0,7,1606280400,1606280400,1
buzzybeeking,0,1,0,3,1566446400,1566446400,1
mooo333,0,1,0,-5,1598846400,1598846400,1
kanase7,0,1,0,1,1599192000,1599192000,1
slimyprincelimey,0,1,0,-2,1596772800,1596772800,1
I_Am_Okonkwo,0,1,0,6,1591502400,1591502400,1
Snow-haunt,0,1,0,1,1603425600,1603425600,1
vantage247,0,1,0,1,1589947200,1589947200,1
hulkman,0,1,0,2,1606626000,1606626000,1
Whatsmyp,0,1,0,10,1604898000,1604898000,1
n-x,0,1,0,10,1565582400,1565582400,1
Samandis,0,1,0,1,1635307200,1635307200,1
Ironborn_Vigilance,0,1,0,2,1564372800,1564372800,1
icescaled,0,1,0,-2,1578027600,1578027600,1
TheRealThr33,0,1,0,-1,1591243200,1591243200,1
NigelMK,0,1,0,2,1581310800,1581310800,1
Sbmurray09,0,1,0,2,1569124800,1569124800,1
giwhS,0,1,0,3,1584244800,1584244800,1
antitheticaltheresa,1,0,135,0,1574744400,1574744400,1
solargrayson,0,1,0,3,1599192000,1599192000,1
Amareldys,0,1,0,1,1607576400,1607576400,1
Verstandgeist,0,1,0,1,1606021200,1606021200,1
mogar43,0,1,0,6,1605848400,1605848400,1
gce7607,0,1,0,6,1575176400,1575176400,1
Pookaball,0,1,0,0,1611982800,1611982800,1
desmondl12,0,1,0,1,1585454400,1585454400,1
C15H25N3OO,0,1,0,3,1579928400,1579928400,1
Autumn_Sweater_,0,1,0,3,1551070800,1551070800,1
angelazraeljade,0,1,0,2,1558584000,1558584000,1
hankhillism,0,1,0,2,1618891200,1618891200,1
WillBloodworth,0,1,0,1,1608786000,1608786000,1
_iamreallytired_,1,0,13,0,1593230400,1593230400,1
lisaemc2,0,1,0,1,1614142800,1614142800,1
svacct2,0,1,0,4,1541998800,1541998800,1
1nteresting_username,0,1,0,12,1576040400,1576040400,1
redtedosd,0,1,0,1,1610773200,1610773200,1
Jacrazy101,0,1,0,2,1591588800,1591588800,1
SomethingFit4aQueen,1,0,1071,0,1605330000,1605330000,1
somecallmemike,0,1,0,4,1607576400,1607576400,1
softero,0,1,0,16,1556942400,1556942400,1
kaaooss,0,1,0,2,1556164800,1556164800,1
foxx_boxx4,0,1,0,94,1600660800,1600660800,1
WhyRtheresomanyofU,0,1,0,1,1603512000,1603512000,1
handsupdb,0,1,0,1,1579064400,1579064400,1
Sapplecat,0,1,0,3,1565496000,1565496000,1
Fun-Ad-9278,0,1,0,2,1603512000,1603512000,1
orionsmom75,0,1,0,6,1608008400,1608008400,1
Theyellowking7,0,1,0,6,1581224400,1581224400,1
thatonepersoniam,0,1,0,2,1563854400,1563854400,1
Mezurashii5,0,1,0,2,1595736000,1595736000,1
lynxbuckler,0,1,0,2,1597032000,1597032000,1
palesnowrider1,0,1,0,5,1609304400,1609304400,1
Zelcron,0,1,0,62,1598846400,1598846400,1
Proud_Apocalypse,0,1,0,1,1606021200,1606021200,1
Ooutoout,0,1,0,1,1608440400,1608440400,1
foongis,0,1,0,22,1602648000,1602648000,1
fort_wendy,0,1,0,7,1604898000,1604898000,1
SpamEater007,0,1,0,2,1602734400,1602734400,1
Thann,0,1,0,111,1605934800,1605934800,1
kapolani,0,1,0,-6,1571112000,1571112000,1
rippenzack,0,1,0,51,1583125200,1583125200,1
Metalicks,0,1,0,21,1591243200,1591243200,1
IONaut,0,1,0,23,1611982800,1611982800,1
blitzkrieg2k6,0,1,0,2,1562299200,1562299200,1
jtsposterra,0,1,0,1,1603512000,1603512000,1
exoclipse,0,1,0,3,1572667200,1572667200,1
QTBloom,0,1,0,1,1606971600,1606971600,1
ChaosKodiak,0,1,0,1,1608267600,1608267600,1
phaiz55,0,1,0,6,1603512000,1603512000,1
GIGANTIC__DICK,0,1,0,8,1607576400,1607576400,1
dagsub,0,1,0,3,1608613200,1608613200,1
Kobekopter,0,1,0,1,1596081600,1596081600,1
qgenez,0,1,0,7,1598760000,1598760000,1
AClassyTurtle,0,1,0,14,1607749200,1607749200,1
MooseMerkin,0,1,0,2,1603425600,1603425600,1
Doomstahhh,0,1,0,28,1597118400,1597118400,1
cosmikpigeon,0,1,0,5,1579064400,1579064400,1
Zimbobwei,0,1,0,3,1611810000,1611810000,1
DecentHumanAttempt,0,1,0,1,1605070800,1605070800,1
StereoMushroom,0,1,0,3,1534651200,1534651200,1
TheRiverNiall,0,1,0,5,1598673600,1598673600,1
leadoffbalk,0,1,0,1,1599796800,1599796800,1
coldenbu,0,1,0,23,1547874000,1547874000,1
SneakStock,0,1,0,-2,1605589200,1605589200,1
_shammy,0,1,0,13,1588651200,1588651200,1
Hijinx_MacGillicuddy,0,1,0,-13,1575694800,1575694800,1
JMMN2020,0,1,0,-6,1602216000,1602216000,1
MrMACHOMAN84,0,1,0,4,1602907200,1602907200,1
taeyang_ssaem,0,1,0,1,1603598400,1603598400,1
nocautiontaken,1,0,87,0,1577163600,1577163600,1
capnwally14,0,1,0,1,1606626000,1606626000,1
usernameforatwork,0,1,0,19,1567569600,1567569600,1
tacosforsocrates,0,1,0,16,1611896400,1611896400,1
Dr_McKay,0,1,0,4,1605070800,1605070800,1
assslap49,0,1,0,-19,1593921600,1593921600,1
Scaulbielausis_Jim,0,1,0,4,1598760000,1598760000,1
UniversalNoir,0,1,0,1,1585454400,1585454400,1
Straight_V8,1,0,5,0,1569211200,1569211200,1
alyingcat220,0,1,0,3,1586404800,1586404800,1
Lekar,0,1,0,2,1603684800,1603684800,1
goingguide,0,1,0,2,1568174400,1568174400,1
trgdr090,0,1,0,2,1594872000,1594872000,1
Dreuh2001,0,1,0,3,1607576400,1607576400,1
advice4knowitall,0,1,0,2,1586145600,1586145600,1
bellyTWOTHREE,0,1,0,8,1590724800,1590724800,1
Leenolyak,0,1,0,2,1602907200,1602907200,1
Anxious_Perspective6,0,1,0,-2,1607922000,1607922000,1
ally_wankenobi,0,1,0,6,1607144400,1607144400,1
meekcrab,0,1,0,14,1609218000,1609218000,1
Cat_Herder62,0,1,0,1,1587528000,1587528000,1
puty784,0,1,0,17,1605330000,1605330000,1
SandManic42,0,1,0,1,1607662800,1607662800,1
ChallengerReproaches,0,1,0,18,1576299600,1576299600,1
espeonagee,0,1,0,10,1587528000,1587528000,1
booksrequired,0,1,0,5,1597896000,1597896000,1
whynautalex,0,1,0,11,1607576400,1607576400,1
KevinBaconIsNotReal,0,1,0,1,1585454400,1585454400,1
jiymoney,0,1,0,2,1597896000,1597896000,1
NuWuX,0,1,0,4,1603080000,1603080000,1
Maiq_Da_Liar,0,1,0,1,1580101200,1580101200,1
myth1n,0,1,0,1,1593057600,1593057600,1
LivingDiscount,0,1,0,5,1603512000,1603512000,1
Joeb667,0,1,0,4,1571457600,1571457600,1
comegeturmoney,0,1,0,1,1605070800,1605070800,1
Quinton_Quarentino,1,0,28,0,1585540800,1585540800,1
thedarknight2002,0,1,0,33,1602820800,1602820800,1
Malakai0013,0,1,0,55,1597636800,1597636800,1
miloray66,0,1,0,3,1604725200,1604725200,1
Poopxpunk,0,1,0,1,1590724800,1590724800,1
csxnewbie,0,1,0,5,1599883200,1599883200,1
MarcusOReallyYes,0,1,0,1,1608526800,1608526800,1
Skea_and_Tittles,0,1,0,5,1588305600,1588305600,1
KMK7110,0,1,0,2,1598932800,1598932800,1
xtpd,0,1,0,3,1567915200,1567915200,1
guibmaster,0,1,0,8,1612155600,1612155600,1
Typhlosion43,0,1,0,-16,1606280400,1606280400,1
ToeCtter,0,1,0,3,1609045200,1609045200,1
onbius,0,1,0,1,1608526800,1608526800,1
MajorScrotum,0,1,0,8,1603771200,1603771200,1
dukesoflonghorns,0,1,0,2,1600056000,1600056000,1
Acidsplash4fun,0,1,0,1,1597204800,1597204800,1
mittens82,0,1,0,5,1583557200,1583557200,1
Infector101,0,1,0,-1,1585454400,1585454400,1
bjalland,0,1,0,45,1603598400,1603598400,1
Aquatico_,0,1,0,21,1611982800,1611982800,1
perpedfto0,1,0,17,0,1541044800,1541044800,1
Johnpacow,0,1,0,8,1604811600,1604811600,1
Vixen1920,0,1,0,1,1603512000,1603512000,1
nicojk,0,1,0,8,1604466000,1604466000,1
crfs,0,1,0,505,1580014800,1580014800,1
redbeansandrice3000,0,1,0,9,1584676800,1584676800,1
FabricofSpaceandTime,0,1,0,1,1599796800,1599796800,1
nkfianfurbjskjsofnej,0,1,0,4,1599278400,1599278400,1
Throwawaybackup2018,0,1,0,0,1575435600,1575435600,1
DistortedAesthetic,0,1,0,1,1571544000,1571544000,1
Stoneheart7,0,1,0,3,1598673600,1598673600,1
-2loves-,0,1,0,1,1591329600,1591329600,1
Its_A_Secret_duh,0,1,0,1,1591329600,1591329600,1
magnumstrike,0,1,0,1,1573966800,1573966800,1
GondorfTheG,0,1,0,9,1606971600,1606971600,1
cutthroatink15,0,1,0,1,1606366800,1606366800,1
no-caps-deep-down,0,1,0,1,1606021200,1606021200,1
delightful_caprese,0,1,0,1,1573966800,1573966800,1
Mr_Peeper_Number,0,1,0,137,1602388800,1602388800,1
teegan_anya,0,1,0,2,1581224400,1581224400,1
99boats,0,1,0,2,1600228800,1600228800,1
BrianGurges,0,1,0,-27,1609045200,1609045200,1
cuckedbaseman0905,0,1,0,0,1594699200,1594699200,1
Forgetful_Suzy,0,1,0,7,1577941200,1577941200,1
RobynZombie,0,1,0,-12,1589860800,1589860800,1
Commiesod,0,1,0,4,1606366800,1606366800,1
rightenquirer,0,1,0,13,1573016400,1573016400,1
mario_almada,0,1,0,2,1600574400,1600574400,1
Heartattaq,0,1,0,1,1572235200,1572235200,1
jw-by,0,1,0,-1,1608181200,1608181200,1
tzage,0,1,0,1,1552276800,1552276800,1
curiousengineer601,0,1,0,1,1595563200,1595563200,1
Either_Dig,1,0,12,0,1572843600,1572843600,1
racoonnova,0,1,0,10,1599105600,1599105600,1
TheEyeChild,0,1,0,1,1603512000,1603512000,1
RGirl297,1,0,14,0,1574226000,1574226000,1
Chrome_X_of_Hyrule,0,1,0,2,1609477200,1609477200,1
CreatedInQuarantine,1,0,43,0,1597118400,1597118400,1
skejl,0,1,0,1,1585454400,1585454400,1
skylos2000,0,1,0,3,1572930000,1572930000,1
CinnamonArmin,0,1,0,1,1607662800,1607662800,1
Ethel12,0,1,0,1,1570593600,1570593600,1
bergijo,0,1,0,1,1583985600,1583985600,1
TBR23122,0,1,0,3,1598500800,1598500800,1
StotheD,0,1,0,1,1589860800,1589860800,1
SnooEagles5657,0,1,0,1,1605243600,1605243600,1
dagenj,0,1,0,1,1580360400,1580360400,1
bobo-brockins,0,1,0,-1,1606626000,1606626000,1
SantaHatBro,0,1,0,2,1605157200,1605157200,1
lernem,0,1,0,2,1568692800,1568692800,1
CaptainSeagul,0,1,0,-3,1589860800,1589860800,1
Stereotypical_Stan,0,1,0,5,1586318400,1586318400,1
longearredpin,0,1,0,6,1609390800,1609390800,1
equityjurisp,0,1,0,1,1575522000,1575522000,1
BubbleMushroom,0,1,0,10,1609045200,1609045200,1
fjeden_alta,0,1,0,3,1578459600,1578459600,1
dracoomega,0,1,0,2,1604030400,1604030400,1
MrConor212,0,1,0,4,1596340800,1596340800,1
Sonck-The-Hedgeman,0,1,0,5,1565236800,1565236800,1
Ekaterian50,0,1,0,2,1570507200,1570507200,1
Kumiankka1,0,1,0,1,1576645200,1576645200,1
Lem_Tuoni,0,1,0,1,1571025600,1571025600,1
shutupmokuba313,0,1,0,1,1596168000,1596168000,1
daydreams77,1,0,1850,0,1565496000,1565496000,1
manleija,0,1,0,1,1578114000,1578114000,1
La_Symboliste,0,1,0,2,1603425600,1603425600,1
Teddyzipper,0,1,0,1,1611810000,1611810000,1
pridefucked,0,1,0,4,1591070400,1591070400,1
Brave-Midnight,0,1,0,9,1591329600,1591329600,1
soda202020222,0,1,0,1,1602129600,1602129600,1
Aesthetics_Supernal,0,1,0,1,1596600000,1596600000,1
OriginalName12345679,0,1,0,24,1590033600,1590033600,1
Zerosummath,0,1,0,0,1585713600,1585713600,1
Jlossa,0,1,0,1,1588824000,1588824000,1
Polish_Assasin,0,1,0,0,1608267600,1608267600,1
StayBee,0,1,0,9,1567396800,1567396800,1
XXX-XXX-XXX,0,1,0,14,1584676800,1584676800,1
pm_me_ur_fitment,0,1,0,4,1550552400,1550552400,1
HeinrichNeuhausser5,0,1,0,7,1608786000,1608786000,1
getreal2021,0,1,0,1,1611982800,1611982800,1
djhfjdjjdjdjddjdh,0,1,0,4,1599019200,1599019200,1
LoneArcher96,0,1,0,26,1580187600,1580187600,1
metriczulu,0,1,0,1,1573362000,1573362000,1
Cloverfrost_,0,1,0,7,1598068800,1598068800,1
EEEEJJH,0,1,0,3,1611982800,1611982800,1
mushnu,0,1,0,24,1601092800,1601092800,1
FortySevenLifestyle,0,1,0,6,1607058000,1607058000,1
tigertoxins,0,1,0,1,1627444800,1627444800,1
isaikyaki,0,1,0,3,1603425600,1603425600,1
Shionkron,0,1,0,1,1608872400,1608872400,1
Char0224,0,1,0,1,1560052800,1560052800,1
bakedpotatopiguy,0,1,0,22,1575435600,1575435600,1
Hentai-Overlord,0,1,0,1,1619928000,1619928000,1
Gnosticide,0,1,0,2,1572753600,1572753600,1
Cyclone_1,1,0,14,0,1473048000,1473048000,1
fumblesmcdrum,0,1,0,2,1577941200,1577941200,1
WalrusDubstep,0,1,0,129,1569988800,1569988800,1
MachinaDeusEx,0,1,0,1,1606021200,1606021200,1
getupandfunction,0,1,0,-4,1585972800,1585972800,1
thegeneralmousewars,0,1,0,-4,1589688000,1589688000,1
bravofoolish,0,1,0,13,1586923200,1586923200,1
Aerospacen1nja,0,1,0,1,1579150800,1579150800,1
Mercy--Main,0,1,0,6,1603425600,1603425600,1
Did_Not_Qualify,0,1,0,7,1584072000,1584072000,1
RedintheHead12,0,1,0,-32,1593748800,1593748800,1
Horny20yrold,0,1,0,204,1602907200,1602907200,1
thegalli,0,1,0,2,1606021200,1606021200,1
Smitterzz,1,0,1,0,1605070800,1605070800,1
OzBonus,0,1,0,10,1604811600,1604811600,1
dgfhsdgfhsdgfhsdgfh,0,1,0,33,1604293200,1604293200,1
no1airfixfan,0,1,0,1,1578286800,1578286800,1
diarrhea_shnitzel,0,1,0,15,1574917200,1574917200,1
Soviet_Russia321,0,1,0,5,1588737600,1588737600,1
LoganLePage,0,1,0,2,1600574400,1600574400,1
thecrucibull,0,1,0,19,1576386000,1576386000,1
Ziekial4404,0,1,0,19,1553486400,1553486400,1
_true_love_waits,0,1,0,2,1606453200,1606453200,1
soy-boix,0,1,0,21,1598068800,1598068800,1
TooDreamy89,0,1,0,-5,1609045200,1609045200,1
Felatio_Sanz,0,1,0,1,1603512000,1603512000,1
mikepassal,0,1,0,2,1593230400,1593230400,1
wallmadeoffloor,0,1,0,2,1596168000,1596168000,1
Frank2027,1,0,1,0,1581224400,1581224400,1
LELANDYEE,0,1,0,1,1607922000,1607922000,1
spartans22,0,1,0,18,1575435600,1575435600,1
xyz214,0,1,0,2,1552194000,1552194000,1
flippindemolition,0,1,0,4,1579237200,1579237200,1
CLJ462,0,1,0,3,1585022400,1585022400,1
BigPasghetti,0,1,0,2,1607490000,1607490000,1
itsschillaryy,0,1,0,42,1595217600,1595217600,1
Bludgeonedkittens,0,1,0,1,1554609600,1554609600,1
Utopiophile,0,1,0,1,1577595600,1577595600,1
EpickChicken,0,1,0,1,1608699600,1608699600,1
TangledinVines,0,1,0,1,1608699600,1608699600,1
kitaree00,0,1,0,6,1593576000,1593576000,1
Daemonicatron,0,1,0,3,1608699600,1608699600,1
happygocrazee,0,1,0,1,1607058000,1607058000,1
noocarehtretto,0,1,0,3,1582606800,1582606800,1
drbooom,0,1,0,0,1569729600,1569729600,1
LakeFog,0,1,0,102,1593144000,1593144000,1
cowboy_kermit,0,1,0,2,1593057600,1593057600,1
artemisRiverborn,0,1,0,3,1601956800,1601956800,1
moonrider18,0,1,0,3,1592539200,1592539200,1
eorabs,0,1,0,28,1573707600,1573707600,1
cromew,0,1,0,3,1552194000,1552194000,1
Mysticune,0,1,0,19,1559188800,1559188800,1
jvstnmh,0,1,0,0,1608526800,1608526800,1
FacelessGrunt,0,1,0,11,1607922000,1607922000,1
GiantPurplePen15,0,1,0,6,1584417600,1584417600,1
dill_rob,0,1,0,23,1575090000,1575090000,1
z4rn1w00p,0,1,0,2,1597291200,1597291200,1
-Paraprax-,0,1,0,23,1576990800,1576990800,1
CivilizedGravy,0,1,0,3,1569902400,1569902400,1
jewdai,0,1,0,2,1603512000,1603512000,1
Kibix,0,1,0,17,1584676800,1584676800,1
Gastay,0,1,0,-2,1605502800,1605502800,1
DaSpood,0,1,0,-1,1604030400,1604030400,1
Dominos_SouthAfrica,0,1,0,1,1600315200,1600315200,1
Separate-Fan-6242,0,1,0,0,1598760000,1598760000,1
curvedlines,0,1,0,1,1592107200,1592107200,1
bobadad23,0,1,0,1,1584158400,1584158400,1
goldwinds,0,1,0,1,1572930000,1572930000,1
CaptainOzyakup,0,1,0,11,1604552400,1604552400,1
IT_Gibbed,0,1,0,1,1598760000,1598760000,1
HutchUnit,0,1,0,9,1609477200,1609477200,1
Yoguert024,0,1,0,1,1600747200,1600747200,1
qwerty1312,0,1,0,6,1577854800,1577854800,1
stuff_gets_taken,0,1,0,-8,1605502800,1605502800,1
IslewardMan,0,1,0,1,1604379600,1604379600,1
7K60FXD,0,1,0,-2,1609131600,1609131600,1
ragnraph,0,1,0,1,1606021200,1606021200,1
SunosUnix,0,1,0,2,1608872400,1608872400,1
GiantFartMonster,0,1,0,1,1583643600,1583643600,1
very_ok_,0,1,0,7,1595304000,1595304000,1
sandwich_breath,0,1,0,-29,1607144400,1607144400,1
shrek3official,0,1,0,1,1599710400,1599710400,1
hotwired24,0,1,0,1,1585627200,1585627200,1
xXSoulPatchXx,0,1,0,3,1578459600,1578459600,1
ProfessorShnacktime,0,1,0,4,1608094800,1608094800,1
caged-by-comfort,0,1,0,21,1591156800,1591156800,1
TrynetTruer,0,1,0,69,1596772800,1596772800,1
grins,0,1,0,9,1608613200,1608613200,1
ripoegk,0,1,0,10,1609304400,1609304400,1
dolphinsrdumb,0,1,0,5,1599364800,1599364800,1
Doc_Donna25,1,0,7,0,1599105600,1599105600,1
Jimbo_Dankins,0,1,0,27,1603339200,1603339200,1
emperatrizyuiza,0,1,0,1,1581051600,1581051600,1
DandyBliss,0,1,0,1,1604898000,1604898000,1
Massiah89,0,1,0,6,1594699200,1594699200,1
thathagat,0,1,0,7,1598760000,1598760000,1
imsuperhungry,0,1,0,20,1579323600,1579323600,1
GeneralKenobi05,0,1,0,2,1549515600,1549515600,1
Geetar42069,0,1,0,1,1606971600,1606971600,1
TheKingSpin213,0,1,0,1,1600142400,1600142400,1
VickyVanGale,0,1,0,3,1579669200,1579669200,1
Alt2-ElectricBogaloo,0,1,0,3,1611810000,1611810000,1
crazycat68,0,1,0,4,1580965200,1580965200,1
mariawalbeck88,0,1,0,1,1561867200,1561867200,1
Dusticlez13,0,1,0,1,1585195200,1585195200,1
Notarandomthrowaway1,0,1,0,2,1595304000,1595304000,1
Lobster_Messiah,0,1,0,-8,1605502800,1605502800,1
listeria-wayne,0,1,0,11,1604466000,1604466000,1
knucklepoetry,0,1,0,14,1574398800,1574398800,1
KomradeKlassics,0,1,0,4,1600574400,1600574400,1
Lockeness843,0,1,0,3,1585540800,1585540800,1
rainydaymonday30,0,1,0,2,1571889600,1571889600,1
OverthrowGreedyPigs,0,1,0,4,1560916800,1560916800,1
godzillabobber,0,1,0,3,1589169600,1589169600,1
thegenuinensa,0,1,0,1,1576645200,1576645200,1
Pure_Village4778,0,1,0,1,1606626000,1606626000,1
m65fieldjacket,0,1,0,11,1583470800,1583470800,1
teejay_vanslyke,0,1,0,-2,1585972800,1585972800,1
justtryintosee,0,1,0,1,1600833600,1600833600,1
LatinChad2020,0,1,0,1,1592539200,1592539200,1
GlumCity,0,1,0,0,1603684800,1603684800,1
StaticSignal,0,1,0,9,1595649600,1595649600,1
Jazz_Man_123570,0,1,0,1,1604466000,1604466000,1
RI0117,0,1,0,8,1597032000,1597032000,1
riingodesu,0,1,0,33,1582520400,1582520400,1
MManco,0,1,0,91,1578632400,1578632400,1
TheDutchNorwegian,0,1,0,-1,1608267600,1608267600,1
CVH91,0,1,0,4,1584244800,1584244800,1
HotandJuicy93,0,1,0,76,1584763200,1584763200,1
Cant_Think_Of_UserID,0,1,0,9,1596686400,1596686400,1
zanoma,0,1,0,1,1586232000,1586232000,1
die_alabaster,0,1,0,20,1577941200,1577941200,1
Regular-Reddit-User,0,1,0,1,1591329600,1591329600,1
Gr4ph0n,0,1,0,-1,1606539600,1606539600,1
RezFox,0,1,0,4,1597291200,1597291200,1
kolbywashere,0,1,0,1,1591329600,1591329600,1
DontTrustCERN,0,1,0,5,1605934800,1605934800,1
mentaltrollissues,0,1,0,3,1594440000,1594440000,1
HyperHampster,0,1,0,2,1585886400,1585886400,1
shithandle,0,1,0,12,1604898000,1604898000,1
tortillathepun,0,1,0,0,1603425600,1603425600,1
Orange9345,1,0,597,0,1599969600,1599969600,1
CabinKaiser69,0,1,0,60,1611896400,1611896400,1
pdizzle1250,0,1,0,3,1581224400,1581224400,1
Foxymemes,0,1,0,2,1560225600,1560225600,1
krenfro23,0,1,0,-7,1595217600,1595217600,1
brewly,0,1,0,1,1569556800,1569556800,1
NEET_retired_at_35,0,1,0,1,1578114000,1578114000,1
hsuaishdhdhhdjd,0,1,0,-1,1591243200,1591243200,1
youngling9797,0,1,0,3,1598500800,1598500800,1
Hennaflowers,0,1,0,13,1585800000,1585800000,1
klein432,0,1,0,5,1563336000,1563336000,1
numtel,0,1,0,2,1561608000,1561608000,1
xaznxchicx,0,1,0,47,1573534800,1573534800,1
asanti0,0,1,0,3,1606280400,1606280400,1
NO_SNOWFLAKES,0,1,0,1,1583557200,1583557200,1
cheetotheman,0,1,0,3,1563422400,1563422400,1
Peanut__Daisy_,0,1,0,1,1611982800,1611982800,1
Captain-Stamey,0,1,0,1,1606971600,1606971600,1
suckitsuckiteveryday,0,1,0,3,1599451200,1599451200,1
obxsunseeker,0,1,0,3,1600488000,1600488000,1
evil-kaweasel,0,1,0,2,1601352000,1601352000,1
MLApprentice,0,1,0,1,1567051200,1567051200,1
TummyRubs57,0,1,0,1,1603512000,1603512000,1
Badpythonbot,0,1,0,2,1593835200,1593835200,1
julianapauki,0,1,0,-15,1607835600,1607835600,1
xag42,0,1,0,79,1590897600,1590897600,1
n3rdgir7,0,1,0,2,1603598400,1603598400,1
danikpapad,0,1,0,-10,1581224400,1581224400,1
Obsessivefrugality,1,0,139,0,1606798800,1606798800,1
doesntmeanathing,0,1,0,1,1593921600,1593921600,1
Lard-Sack,0,1,0,1,1576645200,1576645200,1
CMDR_Michael_Aagaard,0,1,0,1,1596340800,1596340800,1
BayBel,0,1,0,2,1604898000,1604898000,1
nemophilist13,0,1,0,3,1609477200,1609477200,1
delightkay,0,1,0,1,1609045200,1609045200,1
HelpfulGlove,0,1,0,65,1596081600,1596081600,1
FilthyMike720,0,1,0,1,1589947200,1589947200,1
eddydbod,0,1,0,1,1584676800,1584676800,1
LookingForwardToDie,0,1,0,1,1597204800,1597204800,1
Zipper9807,0,1,0,3,1586404800,1586404800,1
HisOrHerpes,0,1,0,2,1603598400,1603598400,1
brtfrce,0,1,0,1,1596945600,1596945600,1
duofliprocks,0,1,0,1,1594094400,1594094400,1
newcomer_ts,0,1,0,1,1606626000,1606626000,1
Bitchtonne,0,1,0,8,1584763200,1584763200,1
Dubabear,0,1,0,3,1608526800,1608526800,1
kreiast,0,1,0,25,1598846400,1598846400,1
blacmsoul,0,1,0,1,1576472400,1576472400,1
shadybusinessgoat,0,1,0,14,1579582800,1579582800,1
Narrativeoverall,0,1,0,3,1579064400,1579064400,1
Acestus1539,0,1,0,1,1609131600,1609131600,1
aka_thejoker,0,1,0,11,1607403600,1607403600,1
intangibleTangelo,0,1,0,1,1581829200,1581829200,1
DispJob,0,1,0,14,1601524800,1601524800,1
reasonabledimensi0n,0,1,0,1,1607230800,1607230800,1
LazyPancake,0,1,0,6,1608008400,1608008400,1
i_am_the_xr,0,1,0,5,1572494400,1572494400,1
ComeOnManYouKnow,0,1,0,1,1589083200,1589083200,1
atticus185,0,1,0,8,1606885200,1606885200,1
Kevinmajere,0,1,0,7,1605502800,1605502800,1
nerd-chic,0,1,0,1,1612069200,1612069200,1
PeterKrucker,0,1,0,40,1609045200,1609045200,1
creditl3ss,0,1,0,1,1634270400,1634270400,1
snakesliketohiss,0,1,0,2,1575176400,1575176400,1
WhosTheJohnsonNow,0,1,0,4,1589256000,1589256000,1
Careful_Judgment4741,0,1,0,3,1608267600,1608267600,1
bizmanon,0,1,0,1,1600833600,1600833600,1
Key-Self-4212,0,1,0,5,1609045200,1609045200,1
lacamak,1,0,0,0,1601956800,1601956800,1
Cr33pyLake,0,1,0,3,1596254400,1596254400,1
_phospholipid_,0,1,0,2,1549515600,1549515600,1
ACuteSadKitty,0,1,0,3,1602388800,1602388800,1
khughy,0,1,0,1,1603512000,1603512000,1
faxfinn,0,1,0,4,1603598400,1603598400,1
JustinTheCheetah,0,1,0,3,1581915600,1581915600,1
prncss_pchy,0,1,0,3,1548910800,1548910800,1
Harcott,0,1,0,5,1579150800,1579150800,1
Kabusanlu,0,1,0,1,1594872000,1594872000,1
ricklyle,0,1,0,1,1607576400,1607576400,1
Babytemptress,0,1,0,8,1580619600,1580619600,1
idrinkcoldcoffee,0,1,0,1,1567137600,1567137600,1
TheProfessor01,0,1,0,6,1579496400,1579496400,1
Honestlynina,0,1,0,5,1566792000,1566792000,1
Nab_Baggins,0,1,0,5,1585108800,1585108800,1
Kangaroorob,0,1,0,11,1600056000,1600056000,1
rainbowsixtrash,0,1,0,2,1571716800,1571716800,1
canyounotmaybe,0,1,0,-3,1586491200,1586491200,1
uhmusing,0,1,0,2,1599105600,1599105600,1
m995075,0,1,0,186,1583038800,1583038800,1
120DaysOfMe,0,1,0,4,1599624000,1599624000,1
silverhammer96,0,1,0,1,1608872400,1608872400,1
lonewombat,0,1,0,1,1612069200,1612069200,1
IAWOC,0,1,0,1,1601956800,1601956800,1
TD4WHoboCop,0,1,0,2,1605502800,1605502800,1
bingobongobingobingo,0,1,0,3,1599192000,1599192000,1
Siberiatundrafire,0,1,0,25,1596427200,1596427200,1
Rypkord,0,1,0,4,1603598400,1603598400,1
LikesBreakfast,0,1,0,16,1593403200,1593403200,1
Cosmic_Sands,0,1,0,1,1566619200,1566619200,1
lazyrepublik,0,1,0,1,1605070800,1605070800,1
heyitsbobwehadababy,0,1,0,-1,1571371200,1571371200,1
MochiChef,0,1,0,5,1607662800,1607662800,1
Jsotshanti,0,1,0,6,1564632000,1564632000,1
REDDIT_CEO_OFFICIAL,0,1,0,3,1597291200,1597291200,1
ParalyzeTheAnalysis,0,1,0,580,1601265600,1601265600,1
ReizorcMC,0,1,0,26,1572408000,1572408000,1
seriouslyFUCKthatdud,0,1,0,5,1597291200,1597291200,1
Wugfuzzler,1,0,34,0,1577941200,1577941200,1
SmallBalIs,0,1,0,0,1586491200,1586491200,1
yeah_it_was_personal,0,1,0,14,1604030400,1604030400,1
SUB_05,0,1,0,1,1562644800,1562644800,1
l3v1athaN_,0,1,0,7,1591934400,1591934400,1
YarrowDelmonico,0,1,0,1,1603512000,1603512000,1
ThisMainAccount,0,1,0,1,1602820800,1602820800,1
GTRivern,0,1,0,14,1559793600,1559793600,1
somewhere_pheen,0,1,0,1,1582779600,1582779600,1
lpfield,0,1,0,3,1606021200,1606021200,1
hardcore_gamer1,0,1,0,0,1603684800,1603684800,1
maiwandacle,0,1,0,3,1606366800,1606366800,1
Zachdp1518,0,1,0,3,1608872400,1608872400,1
Ukinari1,0,1,0,4,1603684800,1603684800,1
Necovjek,0,1,0,5,1576299600,1576299600,1
ikwtif,0,1,0,7,1591329600,1591329600,1
serotonin-sausage,0,1,0,3,1600574400,1600574400,1
chingy_meh_wingy,0,1,0,2,1567828800,1567828800,1
know-you,0,1,0,0,1599364800,1599364800,1
cabezon8,0,1,0,1,1603512000,1603512000,1
bastiVS,0,1,0,-13,1591243200,1591243200,1
DrTommyNotMD,0,1,0,10,1612155600,1612155600,1
queenofcheebah,0,1,0,1,1599278400,1599278400,1
Eliteryan22,0,1,0,1,1605589200,1605589200,1
havanablues,0,1,0,12,1560571200,1560571200,1
hunakaii,0,1,0,1,1588564800,1588564800,1
DieSchadenfreude,0,1,0,2,1605589200,1605589200,1
luke11331133,0,1,0,-3,1581224400,1581224400,1
z0mbiemechanic,0,1,0,2,1574658000,1574658000,1
SomolianButtPirate,0,1,0,2,1598673600,1598673600,1
hardcorehurdler,0,1,0,2,1608181200,1608181200,1
DamirHK,0,1,0,3,1585454400,1585454400,1
RedPaddles,0,1,0,20,1583899200,1583899200,1
OrannisAlpha,0,1,0,41,1582434000,1582434000,1
Dances_With_Assholes,0,1,0,5,1582088400,1582088400,1
drow_ssa,1,0,1,0,1489208400,1489208400,1
Karrieal,1,0,46,0,1565928000,1565928000,1
RedditorInCh1ef,0,1,0,3,1611896400,1611896400,1
SohndesRheins,0,1,0,0,1568865600,1568865600,1
F4Z3_G04T,0,1,0,2,1571803200,1571803200,1
toxicshock999,0,1,0,3,1603771200,1603771200,1
notinclinedtoresign,0,1,0,7,1584590400,1584590400,1
HPLsauce,0,1,0,11,1559793600,1559793600,1
Igot2papers,0,1,0,2,1605589200,1605589200,1
Z3rx3s,0,1,0,3,1571889600,1571889600,1
LeftyRaydy-,0,1,0,2,1587355200,1587355200,1
Maleficent_Bat,0,1,0,17,1570075200,1570075200,1
morefetus,0,1,0,1,1604552400,1604552400,1
sleepyworm,0,1,0,2,1573794000,1573794000,1
Candid_Crab4638,0,1,0,3,1609304400,1609304400,1
cav78au,0,1,0,1,1608267600,1608267600,1
MostlyQueso,0,1,0,7,1574744400,1574744400,1
Pokiehl108,0,1,0,67,1586836800,1586836800,1
TheColombian916,0,1,0,2,1596600000,1596600000,1
gossfunkel,0,1,0,7,1567396800,1567396800,1
CounterproductiveCan,0,1,0,1,1595476800,1595476800,1
DJjazzyjose,0,1,0,-19,1606539600,1606539600,1
WeirdSpaghetties,0,1,0,15,1606885200,1606885200,1
redemily25,0,1,0,2,1447131600,1447131600,1
marc962,0,1,0,3,1605848400,1605848400,1
Primarily-Daddy,0,1,0,18,1603425600,1603425600,1
JEDI_DJ,0,1,0,1,1577941200,1577941200,1
Plain_Tostitos,0,1,0,2,1585800000,1585800000,1
TexasStateStunna,0,1,0,0,1550379600,1550379600,1
flashingcurser,0,1,0,17,1612069200,1612069200,1
donkboi,0,1,0,7,1539921600,1539921600,1
Bad_Idea_Fairy,0,1,0,4,1575349200,1575349200,1
DDoctor11,0,1,0,9,1595131200,1595131200,1
BloodyCut,0,1,0,17,1582520400,1582520400,1
Rubb3rChick3nCircu1t,0,1,0,0,1607490000,1607490000,1
dukerenegade,0,1,0,1,1608267600,1608267600,1
carrotmayonaise,0,1,0,1,1608872400,1608872400,1
nuffinthegreat,0,1,0,0,1596168000,1596168000,1
Timmitei,0,1,0,3,1592798400,1592798400,1
riffahs_ira,0,1,0,5,1584158400,1584158400,1
whatsnextforus123,1,0,10,0,1598414400,1598414400,1
upboats4u,0,1,0,4,1577336400,1577336400,1
trevy_trev,0,1,0,1,1603512000,1603512000,1
-Fog-,0,1,0,6,1604203200,1604203200,1
redditmansam,0,1,0,4,1599969600,1599969600,1
magico0g,0,1,0,1,1603252800,1603252800,1
Popermo,0,1,0,0,1603684800,1603684800,1
dude_person,0,1,0,4,1576904400,1576904400,1
idk_whatev,0,1,0,7,1597032000,1597032000,1
SageIon666,0,1,0,4,1587182400,1587182400,1
RandomArtMan,0,1,0,3,1585281600,1585281600,1
mrswordhold,0,1,0,-5,1593748800,1593748800,1
AmazingAssholeReturn,0,1,0,18,1605762000,1605762000,1
trezenx,0,1,0,49,1600574400,1600574400,1
THE_KITTENS_MITTENS,0,1,0,-1,1606885200,1606885200,1
SNIPE07,0,1,0,1,1609304400,1609304400,1
The_crazy_Baker419,0,1,0,13,1588478400,1588478400,1
churntolive2,0,1,0,2,1606626000,1606626000,1
the_creature_walks,0,1,0,3,1599192000,1599192000,1
freyaandmurphie,0,1,0,1,1578286800,1578286800,1
Oz1227,0,1,0,29,1584158400,1584158400,1
Facultymeeting,0,1,0,9,1597032000,1597032000,1
UncleSam420,0,1,0,3,1600574400,1600574400,1
keropokemans,0,1,0,9,1587441600,1587441600,1
geojerrod,0,1,0,3,1603512000,1603512000,1
student-debt-is-wack,0,1,0,3,1597982400,1597982400,1
redingerforcongress,0,1,0,1,1591329600,1591329600,1
chefjpv,0,1,0,1,1573534800,1573534800,1
bloodxandxrank,0,1,0,4,1607749200,1607749200,1
seriouslynotabird,1,0,34,0,1612069200,1612069200,1
lisardofoz,1,0,10,0,1582779600,1582779600,1
deathl0k,0,1,0,73,1578632400,1578632400,1
vahouzn,0,1,0,3,1577682000,1577682000,1
Guitarpanda1,0,1,0,3,1550379600,1550379600,1
heartsongaming,0,1,0,12,1577854800,1577854800,1
birdsofterrordise,0,1,0,1,1567396800,1567396800,1
GeraAG,0,1,0,6,1603944000,1603944000,1
toomuchblood,0,1,0,5,1607403600,1607403600,1
Sir_Ironbacon,0,1,0,1,1582088400,1582088400,1
Thehelloman0,0,1,0,1,1598760000,1598760000,1
bradbrad12908,0,1,0,5,1586836800,1586836800,1
PeterPansSyndrome,0,1,0,1,1608613200,1608613200,1
Jamlastsforages,0,1,0,4,1576126800,1576126800,1
gracchusBaby,0,1,0,0,1556596800,1556596800,1
_LampLighter,0,1,0,4,1576645200,1576645200,1
presentdayidiotbard,0,1,0,3,1594180800,1594180800,1
SeveralInsurance2,0,1,0,1,1596513600,1596513600,1
_wholly,0,1,0,3,1585627200,1585627200,1
Arakhis_,0,1,0,1,1613797200,1613797200,1
doubleNonlife,0,1,0,10,1601611200,1601611200,1
Isaiah233345,1,0,18,0,1601265600,1601265600,1
GymTanLoiter,0,1,0,1,1585454400,1585454400,1
Jubenheim,0,1,0,16,1572580800,1572580800,1
nervousbadger,0,1,0,1,1607922000,1607922000,1
mixeslifeupwithmovie,0,1,0,1,1598846400,1598846400,1
thebalmang,0,1,0,1,1608613200,1608613200,1
Barrel_Trollz,0,1,0,2,1588478400,1588478400,1
cakebytheocean,1,0,15,0,1580274000,1580274000,1
shakemaster9012,0,1,0,17,1573362000,1573362000,1
prancerbot,0,1,0,13,1595217600,1595217600,1
Royal-Loquat,0,1,0,29,1579928400,1579928400,1
mmh-yadayda,0,1,0,1,1591329600,1591329600,1
Wafflebot17,0,1,0,1,1552363200,1552363200,1
junesglooms,0,1,0,1,1596772800,1596772800,1
bruteneighbors,0,1,0,1,1597982400,1597982400,1
SaphirePhenux,0,1,0,2,1598500800,1598500800,1
undeadmaruchan,0,1,0,45,1593662400,1593662400,1
Smunchbar,0,1,0,1,1602129600,1602129600,1
420VHS,0,1,0,11,1579928400,1579928400,1
sheepyowl,0,1,0,8,1602734400,1602734400,1
hechacker1,0,1,0,2,1611982800,1611982800,1
Danny-LaRusso,0,1,0,3,1559361600,1559361600,1
BigCoffeeEnergy,0,1,0,1,1603512000,1603512000,1
OGJASKA,0,1,0,1,1608699600,1608699600,1
morecatslesspeople,0,1,0,26,1580965200,1580965200,1
indires,0,1,0,10,1579410000,1579410000,1
ZombieBobDole,0,1,0,5,1559707200,1559707200,1
johngalt504,0,1,0,5,1606453200,1606453200,1
thomas1599,0,1,0,3,1606453200,1606453200,1
Responsenotfound,0,1,0,22,1605157200,1605157200,1
Curdz-019,0,1,0,0,1593662400,1593662400,1
Tyrion69Lannister,0,1,0,1,1602734400,1602734400,1
dickusmaksimus,0,1,0,1,1595563200,1595563200,1
Flylle,0,1,0,3,1603512000,1603512000,1
Mrnessalk,0,1,0,68,1603339200,1603339200,1
spaghettilikecurls,0,1,0,14,1597118400,1597118400,1
ShhhhhhImAtWork,0,1,0,1,1598587200,1598587200,1
Hundike,0,1,0,10,1605589200,1605589200,1
-AceCooper-,0,1,0,1,1608267600,1608267600,1
whatsmypasswordplz,0,1,0,2,1595476800,1595476800,1
panamafloyd,0,1,0,3,1574226000,1574226000,1
TragicomedyOfErrors,0,1,0,12,1569988800,1569988800,1
lennoxonnell,0,1,0,27,1607230800,1607230800,1
m00t_vdb,0,1,0,1,1611982800,1611982800,1
RobotArtichoke,0,1,0,2,1592798400,1592798400,1
ExcitedPassionFruit,0,1,0,0,1602129600,1602129600,1
science_and_beer,0,1,0,0,1604379600,1604379600,1
DrKrepz,0,1,0,12,1606626000,1606626000,1
SwissCheeseSecurity,0,1,0,9,1612155600,1612155600,1
ThatCatfulCat,0,1,0,10,1600660800,1600660800,1
sunshine_rex,0,1,0,4,1582174800,1582174800,1
Joetoise,0,1,0,1,1608786000,1608786000,1
sovietmur,0,1,0,4,1597636800,1597636800,1
jbawgs,0,1,0,1,1567051200,1567051200,1
chuck_cranston,0,1,0,1,1570075200,1570075200,1
jascri,0,1,0,-4,1584244800,1584244800,1
AloysiusC044,0,1,0,10,1602993600,1602993600,1
wheresbreakfast,0,1,0,2,1594699200,1594699200,1
PeterSimple99,0,1,0,2,1575435600,1575435600,1
Beprma,0,1,0,2,1608526800,1608526800,1
Saucerino_,0,1,0,3,1598846400,1598846400,1
Aestheticuss,0,1,0,10,1601524800,1601524800,1
thepoptartkid47,0,1,0,2,1608699600,1608699600,1
dontcalmdown,0,1,0,65,1604898000,1604898000,1
heatherdunbar,0,1,0,1,1549515600,1549515600,1
dustofshadow,0,1,0,2,1570161600,1570161600,1
Raveen396,0,1,0,2,1607403600,1607403600,1
mayday5757,0,1,0,1,1605070800,1605070800,1
2hundred20,0,1,0,15,1611896400,1611896400,1
BlueBlakedPotato,0,1,0,0,1603425600,1603425600,1
ibz646,0,1,0,30,1574398800,1574398800,1
Asahiburger,0,1,0,8,1605589200,1605589200,1
themedievalsnowman,0,1,0,39,1581742800,1581742800,1
DesertEagleZapCarry,0,1,0,1,1590206400,1590206400,1
Mulark_gro-Krognak,0,1,0,5,1552708800,1552708800,1
grazyone,0,1,0,3,1607403600,1607403600,1
VeeTheBee86,0,1,0,2,1603598400,1603598400,1
jbag2812,1,0,9819,0,1577336400,1577336400,1
artiume,0,1,0,1,1597636800,1597636800,1
PavelBertuzzi4413,0,1,0,6,1604379600,1604379600,1
i_and_eye,0,1,0,10,1609218000,1609218000,1
honorable__bigpony,0,1,0,1,1608267600,1608267600,1
Agolf_Twittler,0,1,0,5,1608008400,1608008400,1
cindyfitzgibbon,0,1,0,3,1606626000,1606626000,1
Boppythewitch,0,1,0,1,1599796800,1599796800,1
tomcattyboi,0,1,0,1,1598760000,1598760000,1
ChewyMuchentuchen,0,1,0,2,1606885200,1606885200,1
CptDaddyNapier,0,1,0,5,1576645200,1576645200,1
HumanLevelHard,0,1,0,1,1605589200,1605589200,1
Slann777,0,1,0,-1,1606021200,1606021200,1
Typical_Equipment_69,0,1,0,1,1606021200,1606021200,1
1sildurr,0,1,0,6,1573707600,1573707600,1
xibme,0,1,0,1,1605070800,1605070800,1
melonoatmeal,1,0,7,0,1581915600,1581915600,1
solesouI,0,1,0,1,1572062400,1572062400,1
archenemy,0,1,0,1,1465963200,1465963200,1
Total-Sky-1932,0,1,0,1,1608958800,1608958800,1
NarrowJury,0,1,0,2,1598155200,1598155200,1
retal1ator,0,1,0,1,1607490000,1607490000,1
XPW2020,0,1,0,1,1594699200,1594699200,1
CoolestGuyOnMars,0,1,0,1,1612155600,1612155600,1
54mike,0,1,0,1,1608872400,1608872400,1
CripticSilver,0,1,0,1,1597982400,1597982400,1
jbglol,0,1,0,1,1585368000,1585368000,1
Space_Ace,0,1,0,2,1606539600,1606539600,1
repfam4life,0,1,0,5,1588996800,1588996800,1
PristineReputation,0,1,0,8,1594353600,1594353600,1
NerdErrant,0,1,0,8,1592625600,1592625600,1
niks_15,0,1,0,1,1606626000,1606626000,1
theleaderisgood2,0,1,0,2,1437105600,1437105600,1
itsaname123456789,0,1,0,13,1608094800,1608094800,1
artificialn0cturne,0,1,0,1,1595304000,1595304000,1
koavf,0,1,0,3,1596254400,1596254400,1
Belephron,0,1,0,4,1581829200,1581829200,1
aiarossi,0,1,0,3,1594612800,1594612800,1
Theodorakis,0,1,0,1,1603512000,1603512000,1
AbeEarner,0,1,0,14,1598328000,1598328000,1
PostPreacherLife,0,1,0,8,1580619600,1580619600,1
zerobones,0,1,0,7,1602648000,1602648000,1
ILoveCornbread420,0,1,0,3,1603512000,1603512000,1
billybones11,0,1,0,0,1559707200,1559707200,1
slouchmeister5000,0,1,0,1,1572408000,1572408000,1
jerbear201,0,1,0,4,1588996800,1588996800,1
israelregardie,1,0,3,0,1473652800,1473652800,1
emilylime27,0,1,0,34,1550379600,1550379600,1
b_rent90,0,1,0,1,1594872000,1594872000,1
thelifestain,0,1,0,6,1596513600,1596513600,1
Wombat1892,0,1,0,1,1608267600,1608267600,1
teknoramus,0,1,0,1,1604379600,1604379600,1
Ecstatic-Point,1,0,0,0,1585972800,1585972800,1
PaxRomanan,0,1,0,3,1567569600,1567569600,1
AllYouNIL,0,1,0,12,1551157200,1551157200,1
SirBensalot,0,1,0,3,1605070800,1605070800,1
EchoState,0,1,0,2,1577250000,1577250000,1
SameIPasLastTime,0,1,0,1,1592798400,1592798400,1
yet-another-emily,0,1,0,1,1603684800,1603684800,1
BillyBobBaffles,0,1,0,-12,1598500800,1598500800,1
astrolijah21,1,0,219,0,1604725200,1604725200,1
rolandblais,0,1,0,1,1608181200,1608181200,1
Bowsernight,0,1,0,2,1608440400,1608440400,1
mikejhood,1,0,172,0,1606539600,1606539600,1
mrjarnottman,0,1,0,3,1594872000,1594872000,1
renaissance_weirdo,0,1,0,10,1588824000,1588824000,1
tony___bologna,0,1,0,3,1560484800,1560484800,1
L0ng-Dick_Johnson,0,1,0,1,1603684800,1603684800,1
mr-msm,0,1,0,2,1601956800,1601956800,1
EmancipationOfMe,1,0,49,0,1603339200,1603339200,1
kripkriperson,0,1,0,-4,1607835600,1607835600,1
Dam_Kids,0,1,0,10,1565150400,1565150400,1
AwsmCrprs,0,1,0,2,1556164800,1556164800,1
Aboutaverage4,1,0,14,0,1592971200,1592971200,1
Luke_starkiller34,0,1,0,1,1607835600,1607835600,1
ChaoSXDemon,0,1,0,2,1609390800,1609390800,1
DOG_BUTTHOLE,1,0,0,0,1592971200,1592971200,1
GrazeTheRoof,0,1,0,3,1604030400,1604030400,1
ssracer,0,1,0,1,1566360000,1566360000,1
Unchanged-,0,1,0,2,1605589200,1605589200,1
25_timesthefine,0,1,0,9,1596513600,1596513600,1
myballsaregone,0,1,0,1,1582952400,1582952400,1
LiamCSK,1,0,66,0,1579410000,1579410000,1
Bondsmith_Nephi,1,0,3,0,1581742800,1581742800,1
jimbojonesonham,0,1,0,1,1600315200,1600315200,1
mantismantis-,0,1,0,1,1586836800,1586836800,1
i_cut_like_a_buffalo,0,1,0,17,1606885200,1606885200,1
Robo-,0,1,0,10,1606626000,1606626000,1
seedypete,0,1,0,1,1600574400,1600574400,1
Soy_Bun,0,1,0,2,1589860800,1589860800,1
Ishmael15,0,1,0,3,1603598400,1603598400,1
str8killinitdawg,0,1,0,1,1608526800,1608526800,1
connorwatkins,0,1,0,4,1602648000,1602648000,1
1965wasalongtimeago,0,1,0,17,1571457600,1571457600,1
laxninja117,0,1,0,9,1605070800,1605070800,1
Jacareadam,0,1,0,7,1593057600,1593057600,1
baamice,0,1,0,8,1573707600,1573707600,1
EDP458,0,1,0,2,1611723600,1611723600,1
terminhell,0,1,0,4,1578373200,1578373200,1
ghostsofafuturelost,0,1,0,55,1575262800,1575262800,1
thebrandedman,0,1,0,5,1604116800,1604116800,1
killerwale44,0,1,0,2,1593316800,1593316800,1
john_browns_ghost,0,1,0,2,1589947200,1589947200,1
chvmbered,0,1,0,10,1582174800,1582174800,1
OneTrueYahweh,0,1,0,-4,1596686400,1596686400,1
Angry_Cossacks,0,1,0,-1,1607749200,1607749200,1
G_reth,0,1,0,-3,1550293200,1550293200,1
ChelseaFromLA,0,1,0,2,1599969600,1599969600,1
TheOcifferNasty,0,1,0,4,1603512000,1603512000,1
NecrisRO,0,1,0,1,1589515200,1589515200,1
wonderwaffle407,0,1,0,1,1607922000,1607922000,1
tlynni,0,1,0,2,1566446400,1566446400,1
themsc190,0,1,0,5,1595217600,1595217600,1
KiloLee,0,1,0,-17,1599537600,1599537600,1
bluwaffleglitterfart,0,1,0,5,1582952400,1582952400,1
waywardbristolian,0,1,0,4,1582779600,1582779600,1
IronEP,0,1,0,2,1552536000,1552536000,1
shapeofjunktocome,0,1,0,1,1501992000,1501992000,1
n0fucksleft2020,1,0,190,0,1608354000,1608354000,1
DokiElly,0,1,0,2,1602820800,1602820800,1
TampaGrampa39,0,1,0,-17,1542603600,1542603600,1
Extraltodeus,0,1,0,7,1564804800,1564804800,1
CptSoban,0,1,0,1,1603512000,1603512000,1
oddajbox,0,1,0,11,1597118400,1597118400,1
DontDoDrugs316,0,1,0,8,1584676800,1584676800,1
sabresguy,0,1,0,33,1605330000,1605330000,1
Lucio88,0,1,0,1,1587096000,1587096000,1
gwydion_black,1,0,20,0,1587700800,1587700800,1
sitdowndrinktea,0,1,0,12,1562558400,1562558400,1
Fossilhog,0,1,0,5,1600056000,1600056000,1
stilllikelypooping,0,1,0,1,1589947200,1589947200,1
cmc42,0,1,0,23,1576299600,1576299600,1
TrishPanda18,0,1,0,12,1602820800,1602820800,1
fatoldsunn,0,1,0,1,1605243600,1605243600,1
rememberaj,0,1,0,2,1602820800,1602820800,1
Thenachopacho,0,1,0,2,1601352000,1601352000,1
CutesyJ,0,1,0,21,1605157200,1605157200,1
kissmykittenpaws,0,1,0,2,1592539200,1592539200,1
howdy71475,0,1,0,1,1591243200,1591243200,1
argilla11,0,1,0,6,1594699200,1594699200,1
Kancho_Ninja,0,1,0,52,1535860800,1535860800,1
Lopsided_Drop,0,1,0,-12,1557633600,1557633600,1
BlindDogLee,0,1,0,2,1574139600,1574139600,1
Persona_Insomnia,0,1,0,1,1576213200,1576213200,1
dorkylibrarian,0,1,0,5,1601611200,1601611200,1
Tsarkips,0,1,0,0,1571025600,1571025600,1
sDotAgain,0,1,0,-8,1576386000,1576386000,1
gabbath,0,1,0,19,1599796800,1599796800,1
milkpump,0,1,0,89,1575608400,1575608400,1
exotic_hang_glider,0,1,0,2,1566964800,1566964800,1
JEs4,0,1,0,17,1596600000,1596600000,1
TruthInBlack,0,1,0,2,1601956800,1601956800,1
bowpicker,0,1,0,1,1553572800,1553572800,1
Backstage_Warfare,0,1,0,1,1608872400,1608872400,1
Moonwomb,0,1,0,230,1585454400,1585454400,1
terriblejukebox,0,1,0,1,1579064400,1579064400,1
Darkdruid11,0,1,0,36,1603339200,1603339200,1
sweet1william,0,1,0,1,1608699600,1608699600,1
rnew76,0,1,0,3,1595304000,1595304000,1
yankee4357,1,0,270,0,1568692800,1568692800,1
Stay_scheming_,0,1,0,6,1605070800,1605070800,1
RedTheWolf,0,1,0,2,1605070800,1605070800,1
N0R5E,0,1,0,1,1603771200,1603771200,1
mohit88,0,1,0,1,1550725200,1550725200,1
onetwothreefourk,0,1,0,1,1604552400,1604552400,1
acrid_killer,1,0,0,0,1608440400,1608440400,1
disasteroidd420,0,1,0,3,1608872400,1608872400,1
Olympic1L19,0,1,0,4,1592539200,1592539200,1
Jimbobwhales,0,1,0,1,1584763200,1584763200,1
meusnomenestiesus,0,1,0,19,1578891600,1578891600,1
my_user_wastaken,0,1,0,3,1597464000,1597464000,1
PunkCPA,0,1,0,0,1556596800,1556596800,1
llamareform,0,1,0,1,1598846400,1598846400,1
panicattheben,0,1,0,11,1594440000,1594440000,1
filesers,0,1,0,1,1589860800,1589860800,1
Anonn540,0,1,0,10,1550898000,1550898000,1
GollyDolly,0,1,0,9,1565409600,1565409600,1
13luemoons,0,1,0,9,1604984400,1604984400,1
allgoodandtrue,0,1,0,15,1604293200,1604293200,1
VoyagingVulture,0,1,0,15,1608267600,1608267600,1
ZylphiaAncap,0,1,0,10,1578632400,1578632400,1
CommanderStrike1,0,1,0,9,1546578000,1546578000,1
Crabcaked,0,1,0,17,1604811600,1604811600,1
LGBTVanguard,0,1,0,11,1592971200,1592971200,1
Chief_Kief,0,1,0,2,1559016000,1559016000,1
7thPwnist,0,1,0,1,1579928400,1579928400,1
BrokenBatWings,0,1,0,1,1566964800,1566964800,1
Wheatiesflake,0,1,0,5,1606107600,1606107600,1
ultrazaero,0,1,0,3,1584590400,1584590400,1
ajlposh,0,1,0,9,1607317200,1607317200,1
Jatt_Mackie,0,1,0,2,1576040400,1576040400,1
M1K3jr,0,1,0,6,1587441600,1587441600,1
andros310797,0,1,0,-4,1588910400,1588910400,1
wowie21,0,1,0,5,1595649600,1595649600,1
onceiwasnothing,0,1,0,16,1579669200,1579669200,1
NeoJoe731,0,1,0,1,1608267600,1608267600,1
aufkeinsten,0,1,0,1,1571371200,1571371200,1
kittenkain,0,1,0,1,1602216000,1602216000,1
SILVAAABR,0,1,0,12,1597550400,1597550400,1
FightClubAlumni,0,1,0,9,1597809600,1597809600,1
Finger_Trapz,0,1,0,5,1583812800,1583812800,1
FanndisTS,0,1,0,3,1600228800,1600228800,1
CptMisery,0,1,0,-76,1577509200,1577509200,1
godwick22,0,1,0,2,1582779600,1582779600,1
bolsheada,0,1,0,2,1572235200,1572235200,1
spazmcgee1,0,1,0,1,1606366800,1606366800,1
thiago_28x,0,1,0,2,1518584400,1518584400,1
Doukon76,0,1,0,-1,1599105600,1599105600,1
PCNUT,0,1,0,1,1603512000,1603512000,1
Kronorn,0,1,0,31,1571198400,1571198400,1
lonmoer,0,1,0,1,1584763200,1584763200,1
Expensive-Confection,0,1,0,4,1579928400,1579928400,1
SteadfastWormo,0,1,0,6,1602216000,1602216000,1
AdditionalSomewhere2,0,1,0,3,1582779600,1582779600,1
1l1ke2party,0,1,0,5,1585195200,1585195200,1
Imperial4Physics_,0,1,0,7,1570420800,1570420800,1
LunarFangs,0,1,0,3,1587096000,1587096000,1
ali4509,0,1,0,1,1606885200,1606885200,1
quonton-soup420-weed,0,1,0,1,1572843600,1572843600,1
Braingrave666,1,0,14,0,1580533200,1580533200,1
andiinvasion,1,0,7,0,1568001600,1568001600,1
KnockoutMouse420,0,1,0,8,1482037200,1482037200,1
LogiBe,1,0,59,0,1579496400,1579496400,1
Pseudonym0101,0,1,0,3,1601870400,1601870400,1
dontfretlove,0,1,0,12,1577422800,1577422800,1
MrFuture2,0,1,0,2,1605589200,1605589200,1
malapicka,0,1,0,1,1599537600,1599537600,1
DarkMarz,0,1,0,1,1608699600,1608699600,1
Buckhidebreeches,0,1,0,-2,1607662800,1607662800,1
AJewforBacon,0,1,0,2,1584158400,1584158400,1
Rooster_Ties,0,1,0,14,1603512000,1603512000,1
KeyAssumptionTA,0,1,0,6,1607230800,1607230800,1
duggy609,0,1,0,3,1593230400,1593230400,1
BeyondChaosHope,0,1,0,2,1592712000,1592712000,1
TitsOnAUnicorn,0,1,0,2,1609131600,1609131600,1
VespasianTheMortal,0,1,0,4,1608872400,1608872400,1
Kvive_Demes,0,1,0,2,1481605200,1481605200,1
jodobaggins26,0,1,0,39,1605675600,1605675600,1
niceguy_gone_cad,0,1,0,1,1608526800,1608526800,1
Ill-Resort-926,0,1,0,7,1605934800,1605934800,1
too_far_from_space,0,1,0,2,1592971200,1592971200,1
horizontalcracker,0,1,0,2,1592798400,1592798400,1
abcdq96,0,1,0,1,1608699600,1608699600,1
Zeke-Freek,0,1,0,45,1606971600,1606971600,1
Goalie_deacon,0,1,0,5,1581138000,1581138000,1
WonderfulBug7,0,1,0,6,1602388800,1602388800,1
gkru,0,1,0,6,1585108800,1585108800,1
daekle,0,1,0,6,1582347600,1582347600,1
alexandrialwilson,0,1,0,3,1587700800,1587700800,1
SonOfAgathocles,0,1,0,7,1589774400,1589774400,1
Quemo0,1,0,136,0,1602561600,1602561600,1
GetReady4Action,0,1,0,9,1584676800,1584676800,1
djeezuskryste,0,1,0,-1,1594440000,1594440000,1
druidsandhorses,0,1,0,2,1605589200,1605589200,1
QuirkyGengar,0,1,0,1,1643259600,1643259600,1
Ripped_Glutes,0,1,0,0,1582779600,1582779600,1
i_hate_android_p,0,1,0,3,1598155200,1598155200,1
DopeyPear,0,1,0,1,1563768000,1563768000,1
hazelnutchai86646,0,1,0,3,1580792400,1580792400,1
JTLockaby,0,1,0,283,1572667200,1572667200,1
Cymatilis,0,1,0,48,1606971600,1606971600,1
Sad-Baron,0,1,0,1,1589083200,1589083200,1
Selene716,0,1,0,8,1603771200,1603771200,1
TickleZeePickle,0,1,0,11,1561003200,1561003200,1
FictionalDudeWanted,0,1,0,3,1605934800,1605934800,1
SolidMeltsAirAndSoOn,0,1,0,3,1555300800,1555300800,1
harumi_aizawa,0,1,0,1,1599192000,1599192000,1
ArmchairAnalyst,0,1,0,1,1589774400,1589774400,1
absurd_maxim,0,1,0,1,1570075200,1570075200,1
DenseMix5,0,1,0,5,1580360400,1580360400,1
ZeroFlippinCool,0,1,0,1,1582002000,1582002000,1
Grow_Some_Food,0,1,0,1,1585454400,1585454400,1
RageMuffin69,0,1,0,12,1596859200,1596859200,1
MoshiMoshi93,0,1,0,14,1586145600,1586145600,1
IncendiaNex,0,1,0,59,1565582400,1565582400,1
threearmsman,0,1,0,4,1579669200,1579669200,1
basyt,0,1,0,5,1586145600,1586145600,1
Much_Difficulty8010,0,1,0,1,1617163200,1617163200,1
dawgwaddup,1,0,38,0,1574658000,1574658000,1
Wiugraduate17,0,1,0,10,1589428800,1589428800,1
TheBigPhilbowski,0,1,0,1,1608786000,1608786000,1
Arkadans,1,0,38,0,1598673600,1598673600,1
trivletrav,0,1,0,6,1602734400,1602734400,1
dishwatta,1,0,25,0,1607230800,1607230800,1
_cortex,0,1,0,7,1560657600,1560657600,1
Haistur,0,1,0,6,1565668800,1565668800,1
WirbelwindFlakpanzer,0,1,0,-1,1582779600,1582779600,1
ComprehensiveGolf3,0,1,0,4,1590638400,1590638400,1
blueberries97,0,1,0,1,1589169600,1589169600,1
Michael_looney1,0,1,0,2,1600228800,1600228800,1
Mielus77,1,0,126,0,1606280400,1606280400,1
Mmmmkmmmm,0,1,0,21,1557633600,1557633600,1
Gambion,0,1,0,3,1582779600,1582779600,1
TCG_Archer,0,1,0,6,1611810000,1611810000,1
hoxhagoat,0,1,0,1,1572667200,1572667200,1
Viperien,0,1,0,2,1601352000,1601352000,1
Redyum,0,1,0,1,1606626000,1606626000,1
krzybae4u,0,1,0,2,1603684800,1603684800,1
furiouswaterbear,0,1,0,3,1587355200,1587355200,1
vexedvelvetvoice,0,1,0,171,1563163200,1563163200,1
Girthquake23,0,1,0,1,1606021200,1606021200,1
ArcWolf713,0,1,0,9,1606971600,1606971600,1
Ducks_Are_Not_Real,0,1,0,1,1572408000,1572408000,1
I3umblePumpkin,0,1,0,11,1601179200,1601179200,1
Steavee,0,1,0,222,1585713600,1585713600,1
ShiftingStar,0,1,0,2,1607230800,1607230800,1
MaldonHammer,0,1,0,1,1600747200,1600747200,1
PecanParmesan,0,1,0,1,1583470800,1583470800,1
Narrow-Aspect,1,0,17,0,1579842000,1579842000,1
stinkyfart2095,0,1,0,3,1596859200,1596859200,1
OldKeystone,0,1,0,0,1571371200,1571371200,1
BallisWife,0,1,0,5,1568347200,1568347200,1
jashpiel0,1,0,103,0,1602734400,1602734400,1
upornicorn,0,1,0,2,1605934800,1605934800,1
blue2tuesday,0,1,0,9,1606539600,1606539600,1
mitch0acan,0,1,0,52,1608958800,1608958800,1
nikatknight,0,1,0,5,1604030400,1604030400,1
devinmays,0,1,0,3,1603080000,1603080000,1
Daxmar29,0,1,0,29,1585195200,1585195200,1
xenokilla,0,1,0,5,1553227200,1553227200,1
CyclonicKing,0,1,0,-8,1599278400,1599278400,1
Lumami_Juvisado,0,1,0,-3,1604898000,1604898000,1
doctorctrl,0,1,0,-1,1598760000,1598760000,1
ph2K8kePtetobU577IV3,0,1,0,4,1605502800,1605502800,1
HappyHiker2381,0,1,0,1,1603512000,1603512000,1
RubbelDieKatz94,0,1,0,2,1578459600,1578459600,1
HoneySparks,0,1,0,6,1604379600,1604379600,1
dustygenes,0,1,0,1,1570075200,1570075200,1
mrmeatcastle,0,1,0,-5,1581224400,1581224400,1
Gundam14,0,1,0,4,1603512000,1603512000,1
Civil-Repeat-9128,0,1,0,1,1608354000,1608354000,1
postmankad,0,1,0,82,1603339200,1603339200,1
bandotrain,0,1,0,-2,1608699600,1608699600,1
circleofblood,0,1,0,4,1607922000,1607922000,1
Dism_mp4,0,1,0,3,1597982400,1597982400,1
comrade_z82,0,1,0,90,1575435600,1575435600,1
ketbrah,0,1,0,1,1576213200,1576213200,1
Astroboticals,0,1,0,3,1539748800,1539748800,1
danrk,0,1,0,0,1571457600,1571457600,1
awfulVariableNames,0,1,0,0,1585454400,1585454400,1
SherSinghz,0,1,0,12,1570939200,1570939200,1
Spaifu,0,1,0,9,1593835200,1593835200,1
letmeusespaces,0,1,0,19,1585454400,1585454400,1
cancerous_176,0,1,0,-6,1554523200,1554523200,1
Jsc_TG,0,1,0,3,1603598400,1603598400,1
RubikTetris,0,1,0,0,1591934400,1591934400,1
j0shred1,0,1,0,1,1576645200,1576645200,1
snuka,0,1,0,6,1575003600,1575003600,1
greedyboy61,0,1,0,1,1597723200,1597723200,1
attackADS,0,1,0,371,1611810000,1611810000,1
Violences,0,1,0,2,1541998800,1541998800,1
uuser9346,0,1,0,1,1608267600,1608267600,1
neverenoughgay,0,1,0,0,1582088400,1582088400,1
RIP_Fun,0,1,0,1,1554609600,1554609600,1
duplicitous,0,1,0,3,1554696000,1554696000,1
iNeverTilt,0,1,0,1,1596859200,1596859200,1
Deanoram1,0,1,0,1,1586836800,1586836800,1
YubYubNubNub,0,1,0,1,1608267600,1608267600,1
stoned_ocelot,0,1,0,33,1603080000,1603080000,1
morejamsthanjimin,0,1,0,21,1595131200,1595131200,1
MattyRobb83,0,1,0,-18,1589774400,1589774400,1
veryplumpcat,0,1,0,7,1591934400,1591934400,1
odrik,0,1,0,1,1574139600,1574139600,1
Faulgor,0,1,0,3,1576386000,1576386000,1
labpleb,0,1,0,2,1606971600,1606971600,1
AWHMinZalera,0,1,0,1,1594267200,1594267200,1
Tolvat,0,1,0,4,1602648000,1602648000,1
Silberzahntiger,0,1,0,1,1599019200,1599019200,1
Sliceef,0,1,0,3,1599796800,1599796800,1
MyGreatandGoodFriend,0,1,0,22,1606107600,1606107600,1
AtomicTidalWaveLady,0,1,0,1,1591502400,1591502400,1
dynosaurpaws,0,1,0,3,1611810000,1611810000,1
wu-Tangbang,0,1,0,13,1593576000,1593576000,1
veg-ghosty,0,1,0,21,1576472400,1576472400,1
JanusMichaelVincent,0,1,0,12,1579928400,1579928400,1
Theblythelife,0,1,0,0,1587355200,1587355200,1
Reptisessive,0,1,0,1,1608094800,1608094800,1
ronflair,0,1,0,2,1609477200,1609477200,1
12theimplication12,0,1,0,1,1606626000,1606626000,1
uhaveshittaste,0,1,0,4,1602475200,1602475200,1
throwawaywork9594359,0,1,0,6,1566273600,1566273600,1
Nolsoth,0,1,0,2,1600228800,1600228800,1
91Bolt,0,1,0,3,1605934800,1605934800,1
AltMayne,0,1,0,2,1594785600,1594785600,1
Yung_greeji,0,1,0,50,1609390800,1609390800,1
offtrailrunning,0,1,0,1,1573621200,1573621200,1
basedblackfem,0,1,0,7,1582866000,1582866000,1
SimplifiOfficial,1,0,4,0,1559707200,1559707200,1
anolouge_trash,1,0,225,0,1603252800,1603252800,1
granakthefighter,1,0,14,0,1555387200,1555387200,1
Loekaz_spider,0,1,0,15,1597291200,1597291200,1
SpewnFromTheEarth,0,1,0,21,1606280400,1606280400,1
abcdgoldfishh,0,1,0,2,1582779600,1582779600,1
KingKenobi5,0,1,0,1,1603598400,1603598400,1
svkermit,0,1,0,3,1600056000,1600056000,1
Actinida,0,1,0,8,1606539600,1606539600,1
ThirtySecondsOut,0,1,0,3,1600660800,1600660800,1
yoiwantin,0,1,0,2,1584590400,1584590400,1
DoctorWholigian,0,1,0,1,1571716800,1571716800,1
Chibberchubber,0,1,0,2,1600660800,1600660800,1
sigmatize,0,1,0,4,1595476800,1595476800,1
Littlemack2,0,1,0,1,1603512000,1603512000,1
Manburpig,0,1,0,0,1593835200,1593835200,1
Professional_Mode664,0,1,0,0,1606798800,1606798800,1
TIFUbyregistering,0,1,0,1,1608872400,1608872400,1
abaiert,0,1,0,8,1608786000,1608786000,1
knee_bro,0,1,0,3,1579064400,1579064400,1
Princepal04,0,1,0,8,1603252800,1603252800,1
ehlee5597,0,1,0,2,1574744400,1574744400,1
starstripper,0,1,0,5,1587268800,1587268800,1
St3b,0,1,0,2,1572930000,1572930000,1
turbo-moist,0,1,0,3,1572148800,1572148800,1
Manic_Sloth,0,1,0,2,1608872400,1608872400,1
decisionthrowaw1235,0,1,0,2,1601092800,1601092800,1
ttam281,0,1,0,5,1577336400,1577336400,1
RainFlower243,0,1,0,1,1585800000,1585800000,1
joeblo111,0,1,0,4,1571716800,1571716800,1
Sunorichi-san,0,1,0,2,1600574400,1600574400,1
PriestPrey,0,1,0,5,1542603600,1542603600,1
Jernor,0,1,0,1,1607835600,1607835600,1
EradicateWhiteness,0,1,0,8,1606626000,1606626000,1
Rhiro,0,1,0,1,1606280400,1606280400,1
matthewgola,0,1,0,25,1572062400,1572062400,1
premierplaysgames,0,1,0,1,1601352000,1601352000,1
OoO_bubbles,0,1,0,3,1588046400,1588046400,1
erdnax_x,0,1,0,1,1605589200,1605589200,1
MAZZZIAN02,0,1,0,5,1580878800,1580878800,1
Winglessdargon,0,1,0,1,1634270400,1634270400,1
coldwar252,0,1,0,1,1608181200,1608181200,1
wilfulmarlin,0,1,0,6,1579150800,1579150800,1
Warrior77777,0,1,0,1,1586923200,1586923200,1
shikki93,0,1,0,3,1572753600,1572753600,1
tentativeness,0,1,0,2,1606453200,1606453200,1
uncleanaccount,0,1,0,7,1591934400,1591934400,1
Amazing_Albatross,0,1,0,29,1594267200,1594267200,1
jer2468,1,0,2892,0,1595476800,1595476800,1
charlie523,0,1,0,1,1585627200,1585627200,1
TediousSign,0,1,0,1,1589947200,1589947200,1
calou_kneeslap,0,1,0,0,1608786000,1608786000,1
dagothdoom,0,1,0,3,1580706000,1580706000,1
heroin_father,0,1,0,3,1557115200,1557115200,1
IvoryRae,0,1,0,1,1600833600,1600833600,1
dbhaugen,0,1,0,42,1595908800,1595908800,1
DrunkestManAlive,0,1,0,69,1596600000,1596600000,1
Mammayeywyy,0,1,0,1,1579669200,1579669200,1
apatheticNapper,0,1,0,1,1591243200,1591243200,1
benjamiah777,0,1,0,1,1607835600,1607835600,1
lost_goblin,0,1,0,9,1595822400,1595822400,1
scarletnumberzz,0,1,0,3,1606798800,1606798800,1
lucius_p3,0,1,0,1,1578373200,1578373200,1
astraeos118,0,1,0,2,1591243200,1591243200,1
Macfearsnone01,0,1,0,-13,1595304000,1595304000,1
sonicduckman,0,1,0,14,1591243200,1591243200,1
hiimdevin7,0,1,0,2,1608786000,1608786000,1
quaffee,0,1,0,7,1590465600,1590465600,1
falvaroz,0,1,0,1,1605934800,1605934800,1
buddythepickle,0,1,0,2,1605070800,1605070800,1
theuniversalshere,0,1,0,1,1606798800,1606798800,1
Marooned-Mind,0,1,0,1,1609045200,1609045200,1
sayyyge,0,1,0,28,1573362000,1573362000,1
TheRnegade,0,1,0,134,1601179200,1601179200,1
KNessJM,0,1,0,1,1589428800,1589428800,1
toomuchsoup,0,1,0,2,1577077200,1577077200,1
misklik,0,1,0,1,1608267600,1608267600,1
nbharakey,0,1,0,7,1581570000,1581570000,1
Poopikaki,0,1,0,1,1603512000,1603512000,1
Dirtnastii,0,1,0,1,1607835600,1607835600,1
LeetcodeSlayer69,0,1,0,1,1572148800,1572148800,1
corkboy,0,1,0,21,1576558800,1576558800,1
nionvox,0,1,0,2,1609390800,1609390800,1
Laq,0,1,0,12,1557633600,1557633600,1
WonkyTelescope,0,1,0,-6,1600833600,1600833600,1
sometimes_troll,0,1,0,0,1580101200,1580101200,1
saoausor,0,1,0,2,1601352000,1601352000,1
yosb,0,1,0,10,1606280400,1606280400,1
alltaken12345678,0,1,0,5,1608958800,1608958800,1
dvaldes21,1,0,11,0,1608354000,1608354000,1
epiultra,0,1,0,0,1578978000,1578978000,1
Suukorak,0,1,0,2,1605934800,1605934800,1
the_avo_girl,0,1,0,2,1541566800,1541566800,1
SisyphusAmericanus,0,1,0,5,1603512000,1603512000,1
markdermont,0,1,0,3,1571112000,1571112000,1
OldBuildingsSmell,0,1,0,0,1579064400,1579064400,1
w7prtUaB,0,1,0,10,1583899200,1583899200,1
constamonsta,0,1,0,2,1602475200,1602475200,1
yeetintoxisitence,0,1,0,1,1600660800,1600660800,1
arbmosbag,0,1,0,5,1584936000,1584936000,1
Lazy_Title7050,0,1,0,1,1617336000,1617336000,1
proutler,0,1,0,1,1585454400,1585454400,1
Skeo188,1,0,38,0,1593576000,1593576000,1
October_Rust5000,0,1,0,3,1608008400,1608008400,1
IJragon,0,1,0,-22,1592107200,1592107200,1
libtardannihilator,0,1,0,1,1591243200,1591243200,1
mac_trap_clack_back,0,1,0,2,1600747200,1600747200,1
polishfurseatingass,0,1,0,93,1589860800,1589860800,1
kempeasoup,0,1,0,14,1571025600,1571025600,1
piccolalila,0,1,0,1,1606971600,1606971600,1
Netcooler,0,1,0,26,1580965200,1580965200,1
Danatov,0,1,0,-4,1608699600,1608699600,1
CAPTAIN_BL0WHARD,0,1,0,50,1611896400,1611896400,1
Regnasam,0,1,0,0,1600056000,1600056000,1
Wandering_Box,0,1,0,1,1563940800,1563940800,1
Meganstefanie,0,1,0,13,1576472400,1576472400,1
LegitimateParsnip,0,1,0,50,1604379600,1604379600,1
honkums,1,0,102,0,1583985600,1583985600,1
Sassmafrass,0,1,0,1,1538539200,1538539200,1
Jonluw,0,1,0,8,1608786000,1608786000,1
Bifrons,0,1,0,1,1608786000,1608786000,1
208327,0,1,0,6,1609477200,1609477200,1
HackersGonnaHack,0,1,0,1,1603512000,1603512000,1
7Sevan_Elevan11,0,1,0,1,1600142400,1600142400,1
JitGoinHam,0,1,0,-16,1605330000,1605330000,1
ClonialTrial,0,1,0,1,1605157200,1605157200,1
satansboyussy,0,1,0,4,1591243200,1591243200,1
Spncrgmn,0,1,0,12,1606626000,1606626000,1
xFaro,0,1,0,0,1608354000,1608354000,1
uhohlisa,0,1,0,3,1588910400,1588910400,1
HappyLittleTriangles,0,1,0,6,1599796800,1599796800,1
Stormgator,0,1,0,-7,1604984400,1604984400,1
greenbackedheron,0,1,0,2,1606539600,1606539600,1
Nigel_Peppercock,0,1,0,3,1607058000,1607058000,1
TheAprilFool99,0,1,0,2,1589947200,1589947200,1
la_virgen_del_pilar,0,1,0,3,1593748800,1593748800,1
CauseyOfItAll,0,1,0,24,1571803200,1571803200,1
MaxImageBot,0,1,0,1,1566878400,1566878400,1
SassafrassRomance,0,1,0,4,1596340800,1596340800,1
AeveryHawk,0,1,0,14,1558238400,1558238400,1
smoke4sanity,0,1,0,1,1438747200,1438747200,1
alexia_muriel,0,1,0,35,1561867200,1561867200,1
KeepsFallingDown,0,1,0,3,1605934800,1605934800,1
matjew8123,0,1,0,2,1551416400,1551416400,1
Jezeff,0,1,0,-22,1588478400,1588478400,1
Bringoh,0,1,0,3,1557892800,1557892800,1
Lash-whip,0,1,0,1,1606885200,1606885200,1
HolyBatTokes,0,1,0,2,1605934800,1605934800,1
ThatMadFlow,0,1,0,5,1608181200,1608181200,1
Iamatustic,0,1,0,1,1609304400,1609304400,1
dd_78,0,1,0,1,1543554000,1543554000,1
travling_trav,0,1,0,3,1584936000,1584936000,1
DefNotCompensating,0,1,0,1,1608699600,1608699600,1
creatureonableacher,0,1,0,1,1562817600,1562817600,1
BoilerBear,0,1,0,1,1583726400,1583726400,1
Ok_County1328,0,1,0,3,1603598400,1603598400,1
sniffing_dog,0,1,0,4,1571976000,1571976000,1
natalie2012,0,1,0,1,1596168000,1596168000,1
Mega---Moo,0,1,0,1,1598155200,1598155200,1
Barondonvito,0,1,0,2,1579669200,1579669200,1
WhatIsDevonn,0,1,0,3,1606712400,1606712400,1
MRDUDE395,0,1,0,4,1605589200,1605589200,1
maievsha,0,1,0,2,1589947200,1589947200,1
homerq,0,1,0,4,1569297600,1569297600,1
NafinBong,0,1,0,1,1580446800,1580446800,1
Naytosan,0,1,0,2,1597723200,1597723200,1
HandZongHong,0,1,0,3,1602475200,1602475200,1
chaiscool,0,1,0,1,1585454400,1585454400,1
Fukallthis,0,1,0,-2,1591243200,1591243200,1
TranquilloByTheKilo,0,1,0,1,1598068800,1598068800,1
catsnooutside,1,0,9,0,1599624000,1599624000,1
sociopathicnihilist,0,1,0,8,1568174400,1568174400,1
dawkin5,0,1,0,5,1590379200,1590379200,1
SwordsToPlowshares,0,1,0,3,1590724800,1590724800,1
rylinu,0,1,0,3,1568779200,1568779200,1
VoteForSfindex,0,1,0,1,1579496400,1579496400,1
Maeggykins,0,1,0,1,1596945600,1596945600,1
littlelionsfoot,0,1,0,5,1588478400,1588478400,1
Elbombshell,0,1,0,10,1594612800,1594612800,1
sentimental_cherry,0,1,0,1,1610859600,1610859600,1
StockAL3Xj,0,1,0,5,1607403600,1607403600,1
Fabulous-Cricket9469,0,1,0,1,1607230800,1607230800,1
MadMinded,0,1,0,2,1554782400,1554782400,1
cheaptrainride,0,1,0,67,1608786000,1608786000,1
steven1204,0,1,0,1,1592280000,1592280000,1
IAmTheEventHorizon,0,1,0,1,1598155200,1598155200,1
cc71cc,0,1,0,9,1606539600,1606539600,1
pixelgoldfish,1,0,54,0,1548738000,1548738000,1
JPDunn1996,0,1,0,46,1608008400,1608008400,1
PleasantAdvertising,0,1,0,6,1585454400,1585454400,1
egoandherown,0,1,0,3,1553572800,1553572800,1
discountedeggs,0,1,0,26,1590120000,1590120000,1
the_malaysianmamba,0,1,0,2,1603598400,1603598400,1
accidental_superman,0,1,0,4,1566446400,1566446400,1
eeeaah,0,1,0,-7,1604898000,1604898000,1
BigBlueArtichoke,0,1,0,0,1611982800,1611982800,1
Moaath_93,0,1,0,1,1607922000,1607922000,1
Illendiel,1,0,56,0,1581051600,1581051600,1
Billbloblly,0,1,0,1,1604379600,1604379600,1
astromild,0,1,0,2,1599364800,1599364800,1
ThatWomanYeah,0,1,0,2,1573966800,1573966800,1
deltadelta199,0,1,0,2,1573794000,1573794000,1
8696David,0,1,0,12,1599969600,1599969600,1
Salix63,0,1,0,1,1609045200,1609045200,1
everythingsadream,0,1,0,-9,1573102800,1573102800,1
Educational_Macaron_,0,1,0,1,1609390800,1609390800,1
bloxrocks789,0,1,0,4,1582693200,1582693200,1
TheGuyWhoNeverWins,0,1,0,1,1601352000,1601352000,1
Reyzouz,0,1,0,1,1597291200,1597291200,1
Zeroequalsnada,0,1,0,8,1595304000,1595304000,1
Lonely_Plenty3857,0,1,0,1,1606626000,1606626000,1
Pyrostark,0,1,0,1,1592798400,1592798400,1
Derekjon35,0,1,0,23,1607490000,1607490000,1
uroboris,0,1,0,-5,1612069200,1612069200,1
spacedogg,0,1,0,2,1585281600,1585281600,1
Dont_Push_The_Button,0,1,0,-1,1599105600,1599105600,1
boneman1982,0,1,0,2,1580014800,1580014800,1
batboy132,0,1,0,72,1584504000,1584504000,1
Betabimbo,0,1,0,1,1573362000,1573362000,1
Ogfatkid,0,1,0,1,1608872400,1608872400,1
Alpaca64,0,1,0,18,1608440400,1608440400,1
MemeAuthor,0,1,0,994,1608181200,1608181200,1
Colossus252,0,1,0,2,1602388800,1602388800,1
Iwouldbeacat,0,1,0,2,1585195200,1585195200,1
sienfiekdsa,0,1,0,1,1596772800,1596772800,1
nachobuttons,0,1,0,9,1570939200,1570939200,1
DollarSignDouche,0,1,0,1,1606626000,1606626000,1
abbyj3228,1,0,17,0,1568260800,1568260800,1
FALGSAS-C,0,1,0,13,1602475200,1602475200,1
KimJong-rodman,0,1,0,3,1563768000,1563768000,1
robusn,0,1,0,3,1611896400,1611896400,1
housestark1980,0,1,0,2,1588737600,1588737600,1
hotdogman420,0,1,0,9,1608354000,1608354000,1
PredatorAvPFan,1,0,237,0,1600833600,1600833600,1
anxious_oasis,0,1,0,7,1600228800,1600228800,1
Reddyeh,0,1,0,11,1602734400,1602734400,1
Aware_Willingness156,0,1,0,1,1606626000,1606626000,1
californiajetset,0,1,0,26,1608786000,1608786000,1
Dakeers,0,1,0,1,1601870400,1601870400,1
ZenMechanist,0,1,0,6,1600315200,1600315200,1
Comander-07,0,1,0,1,1608699600,1608699600,1
RVP2019,0,1,0,2,1603512000,1603512000,1
korsie13,0,1,0,1,1567051200,1567051200,1
Titografer,0,1,0,1,1576472400,1576472400,1
Imy_of_the_Sea,0,1,0,1,1623038400,1623038400,1
hai_letionic,0,1,0,3,1607403600,1607403600,1
kaenorr,0,1,0,58,1603684800,1603684800,1
buitenkraan,0,1,0,2,1596945600,1596945600,1
lolwut_17,0,1,0,1,1574398800,1574398800,1
tinypawslilwhiskers,0,1,0,87,1594094400,1594094400,1
TRON0314,0,1,0,1,1603512000,1603512000,1
Rick_Key,0,1,0,1,1588219200,1588219200,1
Rabbid_Muskrat,0,1,0,2,1578373200,1578373200,1
Leftist_DM,0,1,0,12,1607576400,1607576400,1
chickensmoker,0,1,0,1,1583557200,1583557200,1
IKilledYourBabyToday,0,1,0,19,1576386000,1576386000,1
Steakman765,0,1,0,0,1608267600,1608267600,1
Lurkandhide,0,1,0,-2,1589688000,1589688000,1
BaronWiggle,0,1,0,1,1608872400,1608872400,1
blaisems,1,0,224,0,1608440400,1608440400,1
Asiras,0,1,0,2,1592366400,1592366400,1
0ut0fBoundsException,0,1,0,2,1555041600,1555041600,1
vietbound,0,1,0,1,1603512000,1603512000,1
JRuiz1775,0,1,0,3,1598760000,1598760000,1
preapocalyptictimes,0,1,0,6,1600315200,1600315200,1
ThouArtUtmostlyGay,0,1,0,2,1609995600,1609995600,1
Byter09,0,1,0,5,1584244800,1584244800,1
Miserable_Cheek,0,1,0,-1,1583125200,1583125200,1
eggie82,0,1,0,1,1608699600,1608699600,1
DismalPresence,1,0,106,0,1571112000,1571112000,1
ace425,0,1,0,105,1572843600,1572843600,1
44Nein4,0,1,0,8,1577595600,1577595600,1
Overly_Underwhelmed,0,1,0,1,1605589200,1605589200,1
MapleHamwich,0,1,0,7,1578373200,1578373200,1
peachyyqu,1,0,212,0,1582693200,1582693200,1
blackjackgabbiani,0,1,0,2,1585022400,1585022400,1
Tha_shnizzler,0,1,0,3,1584763200,1584763200,1
IamG2,0,1,0,5,1605243600,1605243600,1
dmbdrummer21,0,1,0,-6,1589860800,1589860800,1
V_Monsch,0,1,0,12,1585108800,1585108800,1
Impossible_Advisor_2,0,1,0,1,1606712400,1606712400,1
mcac,0,1,0,15,1606021200,1606021200,1
R0B34U,0,1,0,113,1604116800,1604116800,1
backgroundplant2866,0,1,0,13,1601870400,1601870400,1
IndomitableINFJ,0,1,0,-7,1609477200,1609477200,1
miriena,0,1,0,7,1598500800,1598500800,1
diarrheaisnice,0,1,0,6,1585886400,1585886400,1
thorleyc3,0,1,0,8,1608958800,1608958800,1
paraworlds,0,1,0,6,1604293200,1604293200,1
Stunning-Brave,0,1,0,8,1602561600,1602561600,1
pe1irrojo,0,1,0,11,1606280400,1606280400,1
justasapling,0,1,0,6,1609131600,1609131600,1
ohlookanothercat,0,1,0,19,1585886400,1585886400,1
ConqueefStador,0,1,0,2,1590897600,1590897600,1
LysergicMerlin,0,1,0,1,1605589200,1605589200,1
chopping_livers,0,1,0,2,1603512000,1603512000,1
HermeticAlchemist,0,1,0,1,1581656400,1581656400,1
LouQuacious,0,1,0,3,1603598400,1603598400,1
Comeandseemeforonce,0,1,0,2,1581051600,1581051600,1
th3st,0,1,0,8,1608699600,1608699600,1
TheOrigRayofSunshine,0,1,0,1,1597291200,1597291200,1
SPACED__MAN,0,1,0,16,1583470800,1583470800,1
Costos,0,1,0,0,1583557200,1583557200,1
DynoMikea2,0,1,0,2,1595131200,1595131200,1
CheapCharlie,0,1,0,3,1423976400,1423976400,1
toddrough,0,1,0,1,1611982800,1611982800,1
nippynip345,0,1,0,2,1603598400,1603598400,1
turtlesandlesbians,0,1,0,3,1594008000,1594008000,1
prgmti,0,1,0,2,1600488000,1600488000,1
jackyboybrizzle,1,0,2,0,1597896000,1597896000,1
perdlet,0,1,0,1,1577077200,1577077200,1
fishstickilicious,0,1,0,1,1580878800,1580878800,1
Quinten_Lewis,0,1,0,0,1584158400,1584158400,1
fruiteaterz,0,1,0,1,1568347200,1568347200,1
Spanglecrotch,1,0,2,0,1585108800,1585108800,1
ForcedWings,0,1,0,18,1596427200,1596427200,1
Mwsherlock,0,1,0,2,1574226000,1574226000,1
mewloz,0,1,0,6,1564891200,1564891200,1
miichannel,0,1,0,9,1580792400,1580792400,1
Subiiaaco,0,1,0,3,1588824000,1588824000,1
robloxspider,0,1,0,4,1581224400,1581224400,1
Milky_T33Ts,0,1,0,-1,1607662800,1607662800,1
Barbiter3,0,1,0,1,1575262800,1575262800,1
xenophobe3691,0,1,0,6,1582434000,1582434000,1
remodelguy110,0,1,0,12,1606539600,1606539600,1
MMAGodPunchyFace,0,1,0,1,1591329600,1591329600,1
Vivid_Assistant_4846,0,1,0,1,1608267600,1608267600,1
1LordOfAwesome,0,1,0,3,1561089600,1561089600,1
kmack2k,0,1,0,1,1605589200,1605589200,1
Sjerd,0,1,0,99,1607576400,1607576400,1
sfwwizard,0,1,0,11,1429848000,1429848000,1
jvandy17,0,1,0,12,1586059200,1586059200,1
thehightiger,0,1,0,2,1603339200,1603339200,1
AquarianScientist,1,0,22,0,1605157200,1605157200,1
DameonRaye,1,0,33,0,1590120000,1590120000,1
somestaystill,0,1,0,2,1595044800,1595044800,1
neko_loliighoul,0,1,0,2,1561262400,1561262400,1
bear-rah,0,1,0,2,1587268800,1587268800,1
waywardwinnie,0,1,0,2,1591243200,1591243200,1
mnm315,0,1,0,2,1573362000,1573362000,1
Chipsnsalsa86,0,1,0,17,1609218000,1609218000,1
robo_robb,0,1,0,4,1594008000,1594008000,1
series-hybrid,0,1,0,1,1605243600,1605243600,1
creeps_for_you,0,1,0,3,1573794000,1573794000,1
urueueydusysud,0,1,0,2,1605502800,1605502800,1
JypsiCaine,0,1,0,7,1608440400,1608440400,1
Zor369,0,1,0,1,1570420800,1570420800,1
mrscratch05,0,1,0,1,1599710400,1599710400,1
WaitingToBeTriggered,0,1,0,5,1562126400,1562126400,1
Technoist,0,1,0,2,1557201600,1557201600,1
TriggeringChapoCucks,1,0,0,0,1561608000,1561608000,1
monalisafrank,0,1,0,5,1570075200,1570075200,1
Issajokefams,0,1,0,1,1608267600,1608267600,1
BoringNormalGuy,0,1,0,1,1563768000,1563768000,1
greypiper1,0,1,0,15,1597636800,1597636800,1
KingValdyrI,0,1,0,1,1608267600,1608267600,1
DaGhost520,0,1,0,6,1565582400,1565582400,1
Darkesper995,1,0,12,0,1599624000,1599624000,1
TheDustOfMen,0,1,0,80,1611896400,1611896400,1
Et12355,0,1,0,1,1608699600,1608699600,1
Throwawaysector003,0,1,0,1,1595304000,1595304000,1
iadmitdefeat,0,1,0,1,1586145600,1586145600,1
Anders_1314,0,1,0,2,1607662800,1607662800,1
ptgauth,0,1,0,3,1596168000,1596168000,1
amidoingthisright11,0,1,0,2,1601697600,1601697600,1
z3anon,0,1,0,32,1574398800,1574398800,1
dakblaster,0,1,0,2,1598587200,1598587200,1
howdy_bc,0,1,0,2,1593835200,1593835200,1
SnicklefritzSkad,0,1,0,3,1598760000,1598760000,1
DexTheMidnightRunner,0,1,0,1,1590292800,1590292800,1
Zonyxe,0,1,0,3,1576645200,1576645200,1
jduder107,0,1,0,1,1589947200,1589947200,1
Ubertoast123,0,1,0,1,1552536000,1552536000,1
teh_obsolete,0,1,0,4,1539835200,1539835200,1
Krjhg,0,1,0,5,1583038800,1583038800,1
SayYourPieceNow,0,1,0,5,1596772800,1596772800,1
Burken16,1,0,102,0,1611982800,1611982800,1
T_Anon_,0,1,0,4,1607403600,1607403600,1
Heavyweighsthecrown,0,1,0,12,1545109200,1545109200,1
easternrivercooter,0,1,0,15,1599105600,1599105600,1
JormanDollan,0,1,0,5,1557979200,1557979200,1
RootinTootinScootinn,0,1,0,1,1605675600,1605675600,1
sweat_n_low,0,1,0,4,1595390400,1595390400,1
NishikinoPussycat,0,1,0,2,1559361600,1559361600,1
Valo-FfM,0,1,0,13,1584504000,1584504000,1
Rootiematootie,0,1,0,2,1605157200,1605157200,1
spiderinatophat,0,1,0,11,1605675600,1605675600,1
TheEscuelas,0,1,0,2,1570334400,1570334400,1
OldResin59,0,1,0,2,1579669200,1579669200,1
Forward-Hovercraft,0,1,0,7,1605070800,1605070800,1
gulag_elonmusk,0,1,0,-7,1596945600,1596945600,1
dieselwurst,0,1,0,6,1585454400,1585454400,1
lapislazli,0,1,0,-1,1598241600,1598241600,1
ThoughtfulSmegma,0,1,0,10,1607058000,1607058000,1
SimsAreShims,0,1,0,3,1602734400,1602734400,1
MY_MOMS_PHAT_COCK,0,1,0,3,1590638400,1590638400,1
Pastafarianextremist,0,1,0,5,1556596800,1556596800,1
DripsOnAnalogs,0,1,0,4,1599969600,1599969600,1
tressforsuccess,0,1,0,10,1607922000,1607922000,1
j-quigs,0,1,0,1,1612155600,1612155600,1
myoco,1,0,3,0,1580792400,1580792400,1
SirTiberius48,0,1,0,2,1595908800,1595908800,1
Process_Dude,0,1,0,2,1610341200,1610341200,1
trimwicks,0,1,0,10,1538971200,1538971200,1
Hamsters_4life,0,1,0,14,1611982800,1611982800,1
Raiden-fujin,0,1,0,2,1606626000,1606626000,1
emrythelion,0,1,0,7,1602820800,1602820800,1
skankintickle,0,1,0,1,1578286800,1578286800,1
davelab6,0,1,0,7,1546059600,1546059600,1
Midnightblue9444,1,0,7,0,1600142400,1600142400,1
nooitniet,0,1,0,4,1600747200,1600747200,1
fribbas,0,1,0,2,1603684800,1603684800,1
-Lightsong-,0,1,0,-8,1597982400,1597982400,1
MisterlyDude,1,0,14,0,1547010000,1547010000,1
FullstopCoding,0,1,0,-8,1604030400,1604030400,1
throwawaylethargic,0,1,0,7,1575262800,1575262800,1
actual_mall_goth,0,1,0,3,1576818000,1576818000,1
renjo689,0,1,0,14,1568001600,1568001600,1
TrippyNT,0,1,0,14,1598414400,1598414400,1
uradonkey003,0,1,0,5,1611982800,1611982800,1
ArchStanten,0,1,0,2,1557028800,1557028800,1
Novalene_Wildheart,0,1,0,1,1600660800,1600660800,1
JIVEprinting,0,1,0,1,1554264000,1554264000,1
N1CET1M,0,1,0,28,1577854800,1577854800,1
cobigguy,0,1,0,-7,1578373200,1578373200,1
TinyAbsol,0,1,0,3,1592107200,1592107200,1
gopack123,0,1,0,4,1596600000,1596600000,1
NONsynth,0,1,0,6,1594526400,1594526400,1
radioOCTAVE,0,1,0,10,1595390400,1595390400,1
Griclav,0,1,0,18,1596427200,1596427200,1
shrekoncrakk,0,1,0,3,1581138000,1581138000,1
-gestern-,0,1,0,16,1584763200,1584763200,1
IsawRed9,0,1,0,2,1576213200,1576213200,1
boon4376,0,1,0,54,1576299600,1576299600,1
Truth-is-absolution,0,1,0,1,1605848400,1605848400,1
Poezenboot,0,1,0,1,1584936000,1584936000,1
43richierich43,0,1,0,1,1604030400,1604030400,1
MilkWasAPoorChoice,0,1,0,2,1605589200,1605589200,1
ronaldhino10,1,0,22,0,1606194000,1606194000,1
SeriousAssistant7173,0,1,0,15,1605762000,1605762000,1
walphin45,0,1,0,4,1574485200,1574485200,1
AmazingActive9,0,1,0,1,1572753600,1572753600,1
CanYouDiglettIt,0,1,0,0,1580101200,1580101200,1
Gustavo2nd,0,1,0,3,1587614400,1587614400,1
djangowolf90,0,1,0,4,1585627200,1585627200,1
realdavidguitar,0,1,0,13,1569124800,1569124800,1
waylo96,1,0,175,0,1571889600,1571889600,1
run_free_orla_kitty,0,1,0,4,1597809600,1597809600,1
AmyRumhouse,0,1,0,5,1604984400,1604984400,1
HeitorMonte,0,1,0,12,1604725200,1604725200,1
CaptainEarlobe,0,1,0,1,1608094800,1608094800,1
fix-me-up,0,1,0,59,1590033600,1590033600,1
celiseninsan,0,1,0,9,1583298000,1583298000,1
AboveZoom,0,1,0,28,1588737600,1588737600,1
badeljamso,0,1,0,1,1562904000,1562904000,1
ravenously_red,0,1,0,1,1582952400,1582952400,1
sdj2,0,1,0,5,1609045200,1609045200,1
4xOptic,0,1,0,1,1623556800,1623556800,1
captainwaffles,0,1,0,22,1587096000,1587096000,1
username2348,0,1,0,20,1601611200,1601611200,1
Muhdirtythrowaway,0,1,0,2,1575003600,1575003600,1
sinyxer,0,1,0,11,1599192000,1599192000,1
OrderlyPanic,0,1,0,21,1602820800,1602820800,1
TheGlave,0,1,0,1,1602475200,1602475200,1
wmamos,0,1,0,-21,1571025600,1571025600,1
SeabrookDreamin,0,1,0,2,1561867200,1561867200,1
nizzy2k11,0,1,0,1,1604466000,1604466000,1
TheM0nsterY0uMade,0,1,0,-38,1564718400,1564718400,1
awstenstrashcan,0,1,0,81,1576126800,1576126800,1
aaxme,0,1,0,9,1573880400,1573880400,1
IsoOfYourLife,0,1,0,1,1585454400,1585454400,1
moonlyte71,0,1,0,1,1572408000,1572408000,1
avapepper,0,1,0,2,1554696000,1554696000,1
thesekt,0,1,0,7,1608613200,1608613200,1
Braavo3,0,1,0,2,1588564800,1588564800,1
DrBBQ,0,1,0,16,1578286800,1578286800,1
HuntinoBino,0,1,0,1,1603512000,1603512000,1
-RicFlair,0,1,0,1,1606626000,1606626000,1
Littlegrem,0,1,0,6,1586664000,1586664000,1
Chicken-Queso,0,1,0,-2,1612155600,1612155600,1
jorsixo,0,1,0,-14,1584244800,1584244800,1
Hunter_Slime,0,1,0,3,1578978000,1578978000,1
mryauch,0,1,0,12,1576558800,1576558800,1
TheJasonRoss,0,1,0,26,1549602000,1549602000,1
Karahass,0,1,0,1,1610859600,1610859600,1
Jakewake52,0,1,0,21,1570075200,1570075200,1
hsuaiian,0,1,0,58,1571976000,1571976000,1
Sweatandvomit,0,1,0,1,1600228800,1600228800,1
keestuinman,0,1,0,14,1608094800,1608094800,1
The_Krickett_,0,1,0,7,1603512000,1603512000,1
thelowendtheory2012,0,1,0,4,1609304400,1609304400,1
MobocraticEgoist,0,1,0,1,1567310400,1567310400,1
williams1753,0,1,0,1,1606626000,1606626000,1
SSZidane,0,1,0,2,1605934800,1605934800,1
menerell,0,1,0,1,1600660800,1600660800,1
facelessindividual,0,1,0,5,1608786000,1608786000,1
honeysucklesweet,0,1,0,42,1595390400,1595390400,1
emarko1,0,1,0,1,1602820800,1602820800,1
Amruslin,0,1,0,1,1603512000,1603512000,1
puq123,0,1,0,11,1598846400,1598846400,1
benergiser,1,0,1,0,1604379600,1604379600,1
NorthernVashishta,0,1,0,1,1603512000,1603512000,1
YarbleCutter,0,1,0,10,1565668800,1565668800,1
Difficult-Towel,0,1,0,4,1580878800,1580878800,1
Boneal171,0,1,0,1,1592020800,1592020800,1
ImperfComp,0,1,0,6,1611896400,1611896400,1
hajjersuro,0,1,0,3,1603512000,1603512000,1
Lyshina,0,1,0,2,1603512000,1603512000,1
soulshinesam,0,1,0,10,1600401600,1600401600,1
redditkarmadog,0,1,0,1,1606021200,1606021200,1
MaLiCoUsChEeSe,0,1,0,2,1600833600,1600833600,1
TrimiPejes,0,1,0,10,1565755200,1565755200,1
Daddy_Pris,0,1,0,1,1584331200,1584331200,1
headinabook87,0,1,0,1,1596427200,1596427200,1
Narsuaq,1,0,32,0,1581829200,1581829200,1
reginellaa,0,1,0,1,1595131200,1595131200,1
SocialistPandaDreams,0,1,0,41,1609045200,1609045200,1
kaths660,0,1,0,2,1605589200,1605589200,1
Internal_Orange_5872,0,1,0,1,1603512000,1603512000,1
MudslimeCleaner,0,1,0,14,1603512000,1603512000,1
CagneytheCarnation,0,1,0,30,1572494400,1572494400,1
DonJuanMateus,0,1,0,1,1574917200,1574917200,1
yamanamawa,0,1,0,2,1600315200,1600315200,1
cabbytabby,0,1,0,1,1605589200,1605589200,1
Lux256,0,1,0,29,1538884800,1538884800,1
StoneAgeSorceror210,0,1,0,5,1607490000,1607490000,1
mari3,0,1,0,55,1578286800,1578286800,1
Empariz,0,1,0,6,1550293200,1550293200,1
KaptainKlein,0,1,0,5,1597636800,1597636800,1
redwithblackspots527,0,1,0,204,1609131600,1609131600,1
SpicyChippos,0,1,0,2,1574658000,1574658000,1
softhazy_space,0,1,0,4,1579582800,1579582800,1
svguerin3,0,1,0,-1,1576645200,1576645200,1
mctoastus,0,1,0,1,1583125200,1583125200,1
AllStoriesAreTrue,0,1,0,1,1581224400,1581224400,1
AriaoftheNight,0,1,0,6,1601870400,1601870400,1
TheFerretman,0,1,0,1,1580446800,1580446800,1
crazyzjm,0,1,0,1,1583038800,1583038800,1
Mrjonezy,0,1,0,8,1573880400,1573880400,1
Bitfy,0,1,0,10,1596859200,1596859200,1
aure__entuluva,0,1,0,2,1584590400,1584590400,1
blackhills714138,0,1,0,1,1585454400,1585454400,1
Bangarando,0,1,0,1,1607662800,1607662800,1
internetwhitegirl,0,1,0,11,1579582800,1579582800,1
glaster,0,1,0,1,1579064400,1579064400,1
kickopotomus,0,1,0,1,1589947200,1589947200,1
thunderstruck025,0,1,0,1,1573707600,1573707600,1
Freddy_T_Squared,0,1,0,13,1580619600,1580619600,1
seleucusVII,0,1,0,1,1600747200,1600747200,1
Baraqek,0,1,0,2,1594785600,1594785600,1
Decent_Trainer,0,1,0,14,1606194000,1606194000,1
AerisG,0,1,0,7,1600056000,1600056000,1
Willhelm53,0,1,0,1,1581570000,1581570000,1
HeroinChicWannabe,0,1,0,2,1598760000,1598760000,1
kevinated,0,1,0,7,1607576400,1607576400,1
seraphsrage,0,1,0,2,1611982800,1611982800,1
Mission_Quail,0,1,0,1,1605934800,1605934800,1
zaprutertape,0,1,0,7,1594440000,1594440000,1
Cyninombie,0,1,0,4,1607662800,1607662800,1
sachos345,0,1,0,1,1587096000,1587096000,1
fashbashingcatgirl,0,1,0,28,1570593600,1570593600,1
GalPacino,0,1,0,6,1566014400,1566014400,1
blasterhimen,0,1,0,14,1575522000,1575522000,1
anons-a-moose,0,1,0,3,1600660800,1600660800,1
pattio123,0,1,0,-60,1592366400,1592366400,1
noblueface,0,1,0,112,1612155600,1612155600,1
GojiKing72,0,1,0,1,1599019200,1599019200,1
hole_in_the_boat,0,1,0,6,1607576400,1607576400,1
Yukigami47,0,1,0,3,1586059200,1586059200,1
OrdinaryIntroduction,0,1,0,1,1589601600,1589601600,1
Premonitions33,0,1,0,1,1611637200,1611637200,1
Kingdramanyz,0,1,0,1,1603512000,1603512000,1
Darft,0,1,0,366,1609131600,1609131600,1
lizardaliens,0,1,0,1,1603598400,1603598400,1
gloerkh,0,1,0,1,1606539600,1606539600,1
spoonlover69,0,1,0,1,1602734400,1602734400,1
Amatolhorror,0,1,0,1,1609045200,1609045200,1
citizend8,1,0,14,0,1601956800,1601956800,1
Time_to_rope_up,0,1,0,-5,1578978000,1578978000,1
maxigold,0,1,0,53,1578114000,1578114000,1
cybercobra,0,1,0,1,1603598400,1603598400,1
FaveBlade,0,1,0,1,1606626000,1606626000,1
roach_bitch,0,1,0,16,1607058000,1607058000,1
RA_Phoenix97,0,1,0,8,1572494400,1572494400,1
synovial_fluid,0,1,0,23,1589860800,1589860800,1
andre3kthegiant,0,1,0,1,1606626000,1606626000,1
Carrotsforfree,0,1,0,4,1602648000,1602648000,1
DGrantVH,0,1,0,2,1581138000,1581138000,1
thesoloronin,0,1,0,9,1611896400,1611896400,1
flythefriend,0,1,0,1,1588478400,1588478400,1
garry_kitchen,0,1,0,1,1596686400,1596686400,1
TAB1996,0,1,0,24,1611810000,1611810000,1
HMWWaWChChIaWChCChW,0,1,0,1,1592107200,1592107200,1
Poshtotty13,0,1,0,2,1601438400,1601438400,1
FRlDAY,0,1,0,5,1568520000,1568520000,1
kaelieth,1,0,2,0,1611896400,1611896400,1
IrisSV,0,1,0,45,1552708800,1552708800,1
Master_Bastard87,0,1,0,18,1588564800,1588564800,1
AllistairT,0,1,0,1,1610514000,1610514000,1
AFluffleOfRabbits,1,0,7366,0,1594699200,1594699200,1
disintgration,0,1,0,1,1611982800,1611982800,1
dabrajones,0,1,0,6,1606453200,1606453200,1
4RG4d4AK3LdH,0,1,0,1,1610686800,1610686800,1
TheShayminex,0,1,0,12,1607576400,1607576400,1
giallojello,0,1,0,19,1575608400,1575608400,1
friedeggsandtoast,0,1,0,1,1607144400,1607144400,1
dancfontaine,0,1,0,1,1595822400,1595822400,1
Direct-Skin,0,1,0,2,1601956800,1601956800,1
Electrified_Pickle,0,1,0,6,1561694400,1561694400,1
carole0708,0,1,0,2,1599364800,1599364800,1
nootandcanoodle,0,1,0,15,1607576400,1607576400,1
brenpickle6,0,1,0,-1,1548306000,1548306000,1
Weinbergkm3,0,1,0,1,1608872400,1608872400,1
maddawg_2000,0,1,0,2,1541566800,1541566800,1
techiya,0,1,0,0,1594353600,1594353600,1
Avangeliz,0,1,0,8,1583726400,1583726400,1
west1132,0,1,0,1,1599364800,1599364800,1
Iridized-Ethanite,0,1,0,2,1601006400,1601006400,1
Blackberries11,0,1,0,2,1599624000,1599624000,1
sunsh1n3d4ydr34m,0,1,0,5,1577854800,1577854800,1
MsSapphireMuppet,0,1,0,10,1557460800,1557460800,1
pizzaisbad,0,1,0,3,1604898000,1604898000,1
devyReddit,0,1,0,3,1591329600,1591329600,1
strike2counter,0,1,0,11,1595131200,1595131200,1
StickyPine207,0,1,0,2,1571976000,1571976000,1
DarthSillyDucks,0,1,0,22,1564372800,1564372800,1
Aprocalyptic,0,1,0,2,1566878400,1566878400,1
Teen-Ninja-Turtle,0,1,0,6,1581483600,1581483600,1
BearishSpirit,0,1,0,2,1585454400,1585454400,1
NoEucalyptus,0,1,0,1,1603598400,1603598400,1
watghedeal,0,1,0,3,1599105600,1599105600,1
Veilpop,0,1,0,9,1571976000,1571976000,1
theLsyoutake,0,1,0,10,1581915600,1581915600,1
moonmana,0,1,0,5,1586577600,1586577600,1
maybenot3,0,1,0,2,1572667200,1572667200,1
noaffects,0,1,0,14,1573189200,1573189200,1
BuildingArmor,0,1,0,7,1584763200,1584763200,1
arnoldinio,0,1,0,-22,1600920000,1600920000,1
MagoModerno,0,1,0,3,1607749200,1607749200,1
neeveeann,0,1,0,8,1578632400,1578632400,1
marsianer,0,1,0,-49,1607922000,1607922000,1
camjc96,0,1,0,2,1605502800,1605502800,1
BagofPain,0,1,0,1,1604898000,1604898000,1
taitina94,0,1,0,1,1606453200,1606453200,1
First_Foundationeer,0,1,0,5,1596859200,1596859200,1
Ylfjsufrn,0,1,0,1,1611982800,1611982800,1
nihilomin,0,1,0,4,1605762000,1605762000,1
KeyTwo9,0,1,0,3,1592366400,1592366400,1
SYNTHWAVE2,0,1,0,6,1608699600,1608699600,1
p003rm,0,1,0,5,1585540800,1585540800,1
twinering,0,1,0,1,1585454400,1585454400,1
any_random_impiety,0,1,0,15,1605243600,1605243600,1
nibblepie,1,0,12,0,1585886400,1585886400,1
MommysSalami,0,1,0,2,1607835600,1607835600,1
naslam74,0,1,0,1,1607922000,1607922000,1
Paddy92od,0,1,0,25,1589083200,1589083200,1
bigpoppapump98,0,1,0,3,1599105600,1599105600,1
squizzy1961,0,1,0,-55,1601438400,1601438400,1
bleachedagnus,0,1,0,10,1577422800,1577422800,1
HERSKO,0,1,0,1,1594699200,1594699200,1
mama_emily,0,1,0,15,1603512000,1603512000,1
DustyJangles,0,1,0,1,1607058000,1607058000,1
patamonrs,0,1,0,4,1585454400,1585454400,1
MBDTFTLOPYEEZUS,0,1,0,2,1600660800,1600660800,1
Daggywaggy1,0,1,0,24,1585454400,1585454400,1
abclucid,0,1,0,3,1576558800,1576558800,1
Regulus2020,0,1,0,3,1596168000,1596168000,1
maschingon405,0,1,0,8,1597032000,1597032000,1
Coydog7,0,1,0,1,1592193600,1592193600,1
Aresson480,0,1,0,12,1599537600,1599537600,1
Naja42,0,1,0,7,1592193600,1592193600,1
conspiracyambassador,0,1,0,1,1611982800,1611982800,1
PingDawg,0,1,0,2,1575522000,1575522000,1
swunt7,0,1,0,0,1578373200,1578373200,1
guessesurjobforfood,0,1,0,1,1578546000,1578546000,1
NotElizaHenry,0,1,0,8,1578373200,1578373200,1
TriangleLife,0,1,0,1,1635912000,1635912000,1
usul1112,0,1,0,5,1608181200,1608181200,1
OrgianalCuntent,0,1,0,3,1595736000,1595736000,1
popejupiter,0,1,0,-2,1612069200,1612069200,1
75percentsociopath,0,1,0,1,1603944000,1603944000,1
sheepfreedom,0,1,0,11,1559102400,1559102400,1
UmbraDryad,0,1,0,5,1603944000,1603944000,1
Nash_home,0,1,0,-1,1606626000,1606626000,1
dlmuerte,0,1,0,3,1596945600,1596945600,1
31425364Y,0,1,0,1,1585540800,1585540800,1
RockBoy3,0,1,0,1,1605762000,1605762000,1
Norsgrim,0,1,0,2,1605502800,1605502800,1
Aquatic_Ceremony,0,1,0,2,1604898000,1604898000,1
HerrBerg,0,1,0,2,1601352000,1601352000,1
BayMind,0,1,0,1,1566532800,1566532800,1
kathleenmedium,0,1,0,2,1577768400,1577768400,1
Toyan_Dicch,0,1,0,0,1408507200,1408507200,1
Newbdesigner,0,1,0,18,1577422800,1577422800,1
free_will_is_arson,0,1,0,6,1563249600,1563249600,1
Weak-Presentation-72,0,1,0,1,1611810000,1611810000,1
patrick119,0,1,0,8,1590033600,1590033600,1
incomingTaurenMill,0,1,0,1,1606971600,1606971600,1
indiecore,0,1,0,21,1604379600,1604379600,1
canyoulikenot_dothat,0,1,0,3,1605934800,1605934800,1
NIOandTESLABULL,0,1,0,1,1615953600,1615953600,1
Senpai16222,0,1,0,1,1580101200,1580101200,1
PBR_and_PBX,0,1,0,-1,1606539600,1606539600,1
wageslave960654,0,1,0,43,1580533200,1580533200,1
codebeagle,0,1,0,6,1607230800,1607230800,1
OhBlame,0,1,0,1,1602043200,1602043200,1
wilsonator501,0,1,0,2,1551589200,1551589200,1
Sorryimlikethisxxx,0,1,0,12,1585627200,1585627200,1
MN_Logan,0,1,0,16,1597204800,1597204800,1
Defiant-Canary-2716,0,1,0,1,1605934800,1605934800,1
sh444iikoGod,0,1,0,-49,1593489600,1593489600,1
asEZasPi,0,1,0,7,1559534400,1559534400,1
NonsensicalBS,0,1,0,159,1558411200,1558411200,1
Quintron47,0,1,0,1,1608699600,1608699600,1
Opticalypse,0,1,0,3,1593057600,1593057600,1
ooh_lala_ah_weewee,0,1,0,11,1593057600,1593057600,1
Saucery89,0,1,0,1,1591243200,1591243200,1
iloveironmales,0,1,0,1,1642827600,1642827600,1
comradekate316,0,1,0,8,1593662400,1593662400,1
JaminRoyale,0,1,0,0,1579064400,1579064400,1
aquafinababy,0,1,0,2,1609390800,1609390800,1
Axii2827,0,1,0,-4,1582779600,1582779600,1
classylone,0,1,0,1,1597204800,1597204800,1
teeny_tina,0,1,0,37,1571025600,1571025600,1
thunderpachachi,0,1,0,28,1566360000,1566360000,1
N30nb3ar,0,1,0,4,1591243200,1591243200,1
timoyster,0,1,0,20,1582866000,1582866000,1
teacup_whiskey,0,1,0,2,1596254400,1596254400,1
-ADDSN-,0,1,0,7,1576558800,1576558800,1
bazerFish,0,1,0,1,1598500800,1598500800,1
Kellyryanobrien,0,1,0,1,1571457600,1571457600,1
dahu2004,0,1,0,1,1594699200,1594699200,1
ZANY_ALL_CAPS_NAME,1,0,1,0,1574312400,1574312400,1
DISCARDFROMME,0,1,0,1,1599019200,1599019200,1
get_a_pet_duck,0,1,0,1,1592539200,1592539200,1
K_Fred,0,1,0,1,1580446800,1580446800,1
Schwarzy1,0,1,0,6,1576472400,1576472400,1
Dropbeatdad,0,1,0,1,1569470400,1569470400,1
fobfromgermany,0,1,0,9,1603339200,1603339200,1
coffeeclichehere,0,1,0,9,1600747200,1600747200,1
Alwaysdeadly,0,1,0,2,1608181200,1608181200,1
Apollinaire1312,0,1,0,8,1605070800,1605070800,1
Sanctimonius,0,1,0,33,1603512000,1603512000,1
Marshall_Lawson,0,1,0,4,1589515200,1589515200,1
theatrepunch,0,1,0,6,1607835600,1607835600,1
loogawa,0,1,0,29,1597982400,1597982400,1
Shotaro-Kaneda,0,1,0,2,1608699600,1608699600,1
BunnyDoCrime,0,1,0,1,1599883200,1599883200,1
kvothe5688,0,1,0,1,1600660800,1600660800,1
thownaway55664400,0,1,0,1,1594353600,1594353600,1
ursoulprophet,1,0,1,0,1607230800,1607230800,1
yototheno,0,1,0,1,1600574400,1600574400,1
MaybeNascent,0,1,0,5,1596081600,1596081600,1
TheTinyBookworm89,0,1,0,7,1564545600,1564545600,1
Willuknight,0,1,0,3,1590379200,1590379200,1
puckmugger,0,1,0,1,1572494400,1572494400,1
anythingloud,0,1,0,2,1464840000,1464840000,1
MissionLingonberry,0,1,0,1,1602648000,1602648000,1
PupusaPounder,0,1,0,1,1609045200,1609045200,1
-Two_Sox-,0,1,0,12,1595649600,1595649600,1
justinlcw,0,1,0,5,1585627200,1585627200,1
britspythonmoment,0,1,0,5,1605243600,1605243600,1
Clairixxa,0,1,0,1,1590292800,1590292800,1
JPowBrrrr,0,1,0,2,1591329600,1591329600,1
DantesEdmond,0,1,0,9,1608958800,1608958800,1
oldwornpath,0,1,0,3,1604293200,1604293200,1
titutatu,0,1,0,0,1602820800,1602820800,1
abs820,0,1,0,4,1575262800,1575262800,1
Emperor__Aurelius,0,1,0,4,1596340800,1596340800,1
blackheart_ghost,0,1,0,3,1600833600,1600833600,1
Kognityon,0,1,0,7,1607403600,1607403600,1
lmarc001,0,1,0,11,1578891600,1578891600,1
biggerfasterstrong,0,1,0,-10,1605416400,1605416400,1
rumorzcoffee,0,1,0,1,1573275600,1573275600,1
Amendus,0,1,0,1,1599192000,1599192000,1
slightlyobsessed7,0,1,0,24,1577336400,1577336400,1
principe_ali,1,0,9,0,1463284800,1463284800,1
Viandemoisie,0,1,0,7,1603512000,1603512000,1
KangVsKodos,0,1,0,2,1599710400,1599710400,1
wahuisland1,0,1,0,1,1608267600,1608267600,1
Glitterfist,0,1,0,42,1560139200,1560139200,1
RazBerry925,0,1,0,1,1596859200,1596859200,1
DataGuru314,1,0,614,0,1603598400,1603598400,1
FeistyZucchini1,0,1,0,-3,1587355200,1587355200,1
pleckofish,0,1,0,1,1594872000,1594872000,1
PM_ME_CANS_OF_SOUP,0,1,0,2,1608440400,1608440400,1
Pikalika,0,1,0,0,1607835600,1607835600,1
araxiethepoet,0,1,0,3,1587182400,1587182400,1
Benderisabadnickname,0,1,0,43,1596945600,1596945600,1
everybody_eats,0,1,0,37,1594440000,1594440000,1
Mitraileuse,0,1,0,8,1576990800,1576990800,1
sneakypedia,0,1,0,7,1555905600,1555905600,1
blue5109,0,1,0,1,1606107600,1606107600,1
Mostly-Moving,0,1,0,28,1587528000,1587528000,1
Thrannn,0,1,0,7,1608008400,1608008400,1
daytonatrbo,0,1,0,1,1583125200,1583125200,1
MayorFasi,0,1,0,0,1598673600,1598673600,1
maxo458,0,1,0,5,1603684800,1603684800,1
MauMauMaia,0,1,0,2,1578114000,1578114000,1
uoftcs12345,0,1,0,2,1605675600,1605675600,1
Test-Tackles,0,1,0,1,1608872400,1608872400,1
Teddyxr420,0,1,0,1,1611896400,1611896400,1
pickazoo,0,1,0,13,1602734400,1602734400,1
Taz-dragon,0,1,0,36,1567569600,1567569600,1
balkdotcom,0,1,0,1,1602993600,1602993600,1
orderofspies,0,1,0,1,1604030400,1604030400,1
Kore624,0,1,0,-4,1576558800,1576558800,1
MrZfrogs,0,1,0,24,1594353600,1594353600,1
ArmySpirited365,0,1,0,1,1603512000,1603512000,1
InnerChemist,0,1,0,1,1608699600,1608699600,1
lovebubbles,0,1,0,47,1600142400,1600142400,1
TheTrashKween,1,0,197,0,1573794000,1573794000,1
bearwitayellowbeanie,0,1,0,1,1588737600,1588737600,1
greekgodxTYLER1,0,1,0,1,1556942400,1556942400,1
turdor,0,1,0,1,1605589200,1605589200,1
bastardson9090,0,1,0,1,1592971200,1592971200,1
galoder,1,0,0,0,1608613200,1608613200,1
sadcorvid,0,1,0,10,1609390800,1609390800,1
runinaway,0,1,0,15,1522382400,1522382400,1
SonicTheSSJNinja,0,1,0,2,1606453200,1606453200,1
BreadTubeForever,1,0,91,0,1597464000,1597464000,1
girlpower0823,1,0,32,0,1605848400,1605848400,1
aaf192,0,1,0,119,1609304400,1609304400,1
havoc8154,0,1,0,4,1603512000,1603512000,1
blurryvision,0,1,0,1,1600660800,1600660800,1
alter-eagle,0,1,0,11,1583557200,1583557200,1
huffliest_puff,0,1,0,7,1603512000,1603512000,1
JoetheBlue217,0,1,0,1,1589860800,1589860800,1
Responsible-Finger89,0,1,0,0,1603512000,1603512000,1
DeNir8,0,1,0,1,1598760000,1598760000,1
vektorog,0,1,0,1,1577336400,1577336400,1
EnthusiasmAshamed542,0,1,0,3,1605589200,1605589200,1
jesusandpals777,0,1,0,2,1605070800,1605070800,1
Lostmypants69,0,1,0,1,1605589200,1605589200,1
Brassow,0,1,0,2,1575003600,1575003600,1
CarolinaShark,0,1,0,3,1597636800,1597636800,1
Gothic_Spirit,0,1,0,2,1567396800,1567396800,1
Brundar,0,1,0,29,1593662400,1593662400,1
eatingclass,0,1,0,1,1608699600,1608699600,1
Hisekoi,0,1,0,1,1599192000,1599192000,1
UnicornOnMeth,0,1,0,3,1578632400,1578632400,1
robjones86,0,1,0,0,1584676800,1584676800,1
Honorable_Sasuke,0,1,0,3,1591156800,1591156800,1
yuck-yuck,0,1,0,3,1592539200,1592539200,1
exmachinalibertas,0,1,0,8,1609304400,1609304400,1
quizno,0,1,0,3,1584331200,1584331200,1
Ed_Son_Cam4,0,1,0,1,1594094400,1594094400,1
TerkRockerfeller,0,1,0,1,1573794000,1573794000,1
ExsolutionLamellae,0,1,0,2,1591243200,1591243200,1
schne120,0,1,0,149,1593576000,1593576000,1
StartingFresh2020,0,1,0,-14,1605157200,1605157200,1
sircatwaff3l,0,1,0,4,1572930000,1572930000,1
vodkabottledream,0,1,0,1,1582088400,1582088400,1
Remebond,0,1,0,3,1591329600,1591329600,1
KingPimpCommander,0,1,0,5,1605157200,1605157200,1
Razirra,0,1,0,1,1571889600,1571889600,1
arachnophilia,0,1,0,3,1588824000,1588824000,1
LOLatEWE,0,1,0,1,1591243200,1591243200,1
shreament,0,1,0,1,1611896400,1611896400,1
Swag_Holocaust,0,1,0,5,1576558800,1576558800,1
TheInvisiblePen,0,1,0,0,1605070800,1605070800,1
quesawhatta,0,1,0,10,1602302400,1602302400,1
BettyDare,0,1,0,1,1609477200,1609477200,1
TripperDay,0,1,0,3,1563422400,1563422400,1
LonelyVenturer,0,1,0,3,1603857600,1603857600,1
bentheboat,0,1,0,1,1599537600,1599537600,1
ThunderousDesperado_,1,0,5,0,1606194000,1606194000,1
BigDogz42,0,1,0,2,1591329600,1591329600,1
rojoyalaizquierda,0,1,0,1,1602043200,1602043200,1
seriouslycitrus,0,1,0,-2,1604379600,1604379600,1
FuckinWaySheGoes309,0,1,0,2,1585454400,1585454400,1
Zealousideal_Owl_424,0,1,0,1,1601438400,1601438400,1
Zephryl,1,0,27,0,1423976400,1423976400,1
Leo_is_me,0,1,0,1,1591329600,1591329600,1
perpetualennui,0,1,0,12,1508126400,1508126400,1
RednBlack55,0,1,0,8,1608267600,1608267600,1
Disillusioned23,1,0,99,0,1546059600,1546059600,1
AXBRAX,0,1,0,27,1573966800,1573966800,1
555MenTal_PaTienT555,0,1,0,1,1606021200,1606021200,1
Reddit_Buff,0,1,0,1,1606107600,1606107600,1
vos990,0,1,0,5,1593748800,1593748800,1
directorheart,0,1,0,23,1597291200,1597291200,1
CaptainHindsight212,0,1,0,2,1619755200,1619755200,1
itsactuallyobama,0,1,0,2,1603512000,1603512000,1
Daniel_A_Johnson,0,1,0,9,1602043200,1602043200,1
notyetm8,0,1,0,1,1596427200,1596427200,1
Wergoingtobeyuge,0,1,0,5,1552536000,1552536000,1
LexusKitsune,0,1,0,2,1563681600,1563681600,1
FindingFlow33,0,1,0,1,1574485200,1574485200,1
nimybi,0,1,0,1,1572580800,1572580800,1
DannyWadders123,0,1,0,7,1605675600,1605675600,1
MrLexPennridge,0,1,0,2,1606798800,1606798800,1
shantih19,0,1,0,2,1579064400,1579064400,1
hao3969,1,0,5,0,1606885200,1606885200,1
Adept_Introduction18,0,1,0,1,1642482000,1642482000,1
Plaid_Kaleidoscope,0,1,0,2,1605157200,1605157200,1
GhostofMarat,0,1,0,8,1608699600,1608699600,1
PeeledGrape72,0,1,0,1,1550293200,1550293200,1
ElvisDumbledore,1,0,1,0,1608699600,1608699600,1
Lyraea,0,1,0,10,1595304000,1595304000,1
marrarabf,0,1,0,0,1593662400,1593662400,1
entgegner,0,1,0,2,1605589200,1605589200,1
agoodmanis,0,1,0,-2,1558497600,1558497600,1
InterventionPenguin,0,1,0,1,1561780800,1561780800,1
MaDRSQ,0,1,0,3,1595908800,1595908800,1
MasochistCoder,0,1,0,1,1584936000,1584936000,1
Yimmy42,0,1,0,64,1584763200,1584763200,1
AcceptableCream,0,1,0,23,1584763200,1584763200,1
2836nwchim,0,1,0,19,1584244800,1584244800,1
KinkyLittleParadox,1,0,46,0,1596600000,1596600000,1
11Shiru_JaNuS,0,1,0,9,1605589200,1605589200,1
ownagemountain,0,1,0,12,1573534800,1573534800,1
ConsciousPhoenix,1,0,0,0,1611982800,1611982800,1
gerginborisov,0,1,0,1,1606021200,1606021200,1
doubtga,0,1,0,2,1584158400,1584158400,1
elhampion,0,1,0,8,1592280000,1592280000,1
madmaxonline,0,1,0,0,1561953600,1561953600,1
drgnpr0nz69,1,0,41,0,1597809600,1597809600,1
FiggNewton,0,1,0,1,1585022400,1585022400,1
niners1000,0,1,0,2,1584676800,1584676800,1
ohw1794,0,1,0,1,1600660800,1600660800,1
Snidg3,0,1,0,1,1605589200,1605589200,1
jmangiggity,0,1,0,1,1589947200,1589947200,1
wangofjenus,0,1,0,2,1605070800,1605070800,1
Separate-Wheel-3961,0,1,0,1,1605589200,1605589200,1
autox3c,0,1,0,2,1603339200,1603339200,1
masterkhat,0,1,0,2,1604984400,1604984400,1
handicaphandgun,0,1,0,1,1608008400,1608008400,1
WiyerGFY,0,1,0,1,1564113600,1564113600,1
dfabb,0,1,0,3,1576990800,1576990800,1
-ptolemy-,0,1,0,7,1574658000,1574658000,1
TooSweetCaroline,0,1,0,1,1609390800,1609390800,1
deepoutdoors,0,1,0,31,1570593600,1570593600,1
ChefCobra,0,1,0,2,1588737600,1588737600,1
Zugnutz,0,1,0,1,1635134400,1635134400,1
MynTYleef,0,1,0,3,1554523200,1554523200,1
Troutback,0,1,0,15,1603080000,1603080000,1
PumpYaGooch,0,1,0,3,1583899200,1583899200,1
chuckyourla,0,1,0,3,1553918400,1553918400,1
arka0415,0,1,0,8,1606366800,1606366800,1
pigbeerman,0,1,0,1,1589947200,1589947200,1
cce29555,0,1,0,37,1606798800,1606798800,1
scenicsmell,0,1,0,7,1584417600,1584417600,1
andytheangryfrail,0,1,0,13,1559620800,1559620800,1
SafetyDanceInMyPants,0,1,0,1,1612069200,1612069200,1
thedirtys,0,1,0,3,1609390800,1609390800,1
whatareeggs,0,1,0,2,1550552400,1550552400,1
Shigg,0,1,0,21,1575522000,1575522000,1
Niku-Man,0,1,0,1,1584244800,1584244800,1
Father_Chewy_Louis,0,1,0,5,1592539200,1592539200,1
n3rv0u5,0,1,0,31,1589860800,1589860800,1
imrunningfromthecops,0,1,0,1,1558670400,1558670400,1
sylect,0,1,0,1,1593316800,1593316800,1
Evil-Acer,0,1,0,7,1604984400,1604984400,1
kitkaty98,0,1,0,2,1602734400,1602734400,1
Faizan24839,0,1,0,65,1595649600,1595649600,1
DigitalScetis,0,1,0,1,1559620800,1559620800,1
anras,0,1,0,2,1574139600,1574139600,1
rodney_jerkins,0,1,0,1,1572843600,1572843600,1
Inspector-Radiant,0,1,0,-2,1599537600,1599537600,1
sofuckinggreat,0,1,0,2,1600574400,1600574400,1
a_gentlebot,0,1,0,9,1580792400,1580792400,1
Udonov,0,1,0,2,1576818000,1576818000,1
Mahaloth,0,1,0,5,1604293200,1604293200,1
Your_ImaginaryFriend,0,1,0,4,1570680000,1570680000,1
bigjfuller,0,1,0,10,1602043200,1602043200,1
SargePeppr,0,1,0,1,1616731200,1616731200,1
AlphaPooch,0,1,0,18,1602475200,1602475200,1
dragosb112,0,1,0,-9,1557288000,1557288000,1
GeeGym,0,1,0,2,1603080000,1603080000,1
Miguel30Locs,0,1,0,5,1604811600,1604811600,1
Anush5524,0,1,0,1,1607662800,1607662800,1
Logica1Improvement,0,1,0,0,1587528000,1587528000,1
Ivenousername,0,1,0,20,1576818000,1576818000,1
ThrowingQs,0,1,0,3,1561003200,1561003200,1
TristanIsSpiffy,0,1,0,7,1567483200,1567483200,1
mwest555,0,1,0,5,1584763200,1584763200,1
b00gersugar,0,1,0,51,1608786000,1608786000,1
Karlmarcs27,0,1,0,-7,1583812800,1583812800,1
paloofthesanto,0,1,0,3,1582779600,1582779600,1
Sticres,0,1,0,18,1571112000,1571112000,1
EastBayRae,0,1,0,2,1589860800,1589860800,1
oligobop,0,1,0,12,1591156800,1591156800,1
kaspar1230,0,1,0,297,1604203200,1604203200,1
jingleghost,0,1,0,4,1605502800,1605502800,1
koi-kafir,1,0,6,0,1574226000,1574226000,1
iamaddictedtocock,1,0,2,0,1600401600,1600401600,1
MangledMailMan,0,1,0,1,1591243200,1591243200,1
UMaryland,0,1,0,13,1582261200,1582261200,1
West_Vet,0,1,0,1,1578373200,1578373200,1
sergeantdempsy,0,1,0,2,1596168000,1596168000,1
NeedHelpWithExcel,0,1,0,64,1584244800,1584244800,1
periscope-suks,0,1,0,10,1585454400,1585454400,1
padraigd,0,1,0,0,1571630400,1571630400,1
WildestWilderbeast,0,1,0,50,1574226000,1574226000,1
loveroffish2017,0,1,0,1,1603512000,1603512000,1
BlueJetYT,0,1,0,1,1601006400,1601006400,1
alan_greyjoy,0,1,0,1,1600142400,1600142400,1
Razbo14,0,1,0,-5,1603339200,1603339200,1
briceconquersall,0,1,0,3,1580274000,1580274000,1
HailSatanFuckYall,0,1,0,8,1596513600,1596513600,1
molokodrnch,0,1,0,40,1599710400,1599710400,1
lordheart,0,1,0,58,1607317200,1607317200,1
cainrok,0,1,0,1,1589947200,1589947200,1
elibutton,0,1,0,1,1595908800,1595908800,1
Amolk2207,0,1,0,2,1606626000,1606626000,1
Silver-Detective-17,1,0,1265,0,1598932800,1598932800,1
FairBombazine,0,1,0,3,1576040400,1576040400,1
dragonfly609,0,1,0,1,1578459600,1578459600,1
FckRedddit,0,1,0,-5,1598846400,1598846400,1
tyalanm,0,1,0,1,1590033600,1590033600,1
lil_tina29,1,0,13,0,1594353600,1594353600,1
Losha260,0,1,0,-8,1576904400,1576904400,1
oxfordcommaordeath,0,1,0,1,1591416000,1591416000,1
Jacuzzi9,0,1,0,4,1607144400,1607144400,1
ejvboy02,0,1,0,10,1606539600,1606539600,1
improvised-scholar,1,0,12,0,1607403600,1607403600,1
AccordingRespect2519,0,1,0,1,1635134400,1635134400,1
theprozacfairy,0,1,0,3,1596772800,1596772800,1
FoundLacking,0,1,0,2,1579755600,1579755600,1
ThiagoDagoRojo,0,1,0,5,1600315200,1600315200,1
AffectionateSleep877,0,1,0,3,1611723600,1611723600,1
Bethanyedilla,0,1,0,2,1585454400,1585454400,1
mathmare,0,1,0,4,1590897600,1590897600,1
knight_who_says_knee,0,1,0,-5,1589860800,1589860800,1
godessayla,0,1,0,1,1634702400,1634702400,1
Marathustra,0,1,0,1,1591243200,1591243200,1
1Proton1,0,1,0,1,1596686400,1596686400,1
Bluedandi,0,1,0,2,1579582800,1579582800,1
jaketm1998,0,1,0,1,1608872400,1608872400,1
fforw,0,1,0,-3,1573362000,1573362000,1
hvyclouds2015,0,1,0,1,1608872400,1608872400,1
yesterdaysfave,0,1,0,1,1591156800,1591156800,1
oceanslut,0,1,0,1,1576990800,1576990800,1
GuruAntarSingh,0,1,0,2,1606366800,1606366800,1
McSOUS,0,1,0,14,1605934800,1605934800,1
littleredryanhood,0,1,0,5,1587182400,1587182400,1
pie504,0,1,0,13,1582261200,1582261200,1
blackskirtwhitecat,0,1,0,4,1605589200,1605589200,1
tophutti,0,1,0,1,1612069200,1612069200,1
dwodhghemonhswes,0,1,0,2,1599105600,1599105600,1
bsinger28,0,1,0,1,1568952000,1568952000,1
onlypositivity,0,1,0,-6,1577595600,1577595600,1
distilledwill,0,1,0,6,1603512000,1603512000,1
Delta616,0,1,0,2,1585800000,1585800000,1
Hans_H0rst,0,1,0,2,1611982800,1611982800,1
KingOfTyinKnots,0,1,0,1,1599796800,1599796800,1
JJ_BB_SS,0,1,0,1,1603252800,1603252800,1
fo234,0,1,0,2,1590638400,1590638400,1
ok-punk,0,1,0,13,1576386000,1576386000,1
MAGAMAN692020,0,1,0,-3,1579669200,1579669200,1
The1nonlyno1,0,1,0,1,1606626000,1606626000,1
Interesting_Sale_468,0,1,0,1,1601265600,1601265600,1
Trumpsmicropenis33,0,1,0,7,1574571600,1574571600,1
TheNorthComesWithMe,0,1,0,6,1578891600,1578891600,1
ishouldhaveshutup,0,1,0,1,1600833600,1600833600,1
Pudn79,0,1,0,1,1592798400,1592798400,1
WhatsWork4,1,0,13,0,1593835200,1593835200,1
Flummoxedaphid,0,1,0,3,1598846400,1598846400,1
malwaremayhem,0,1,0,1,1589169600,1589169600,1
wooooos,0,1,0,-1,1573621200,1573621200,1
ergerlerd,0,1,0,1,1607403600,1607403600,1
lps2,0,1,0,10,1570075200,1570075200,1
ACrazyMind91,0,1,0,34,1587873600,1587873600,1
K2LP,0,1,0,2,1606626000,1606626000,1
loddi0708,0,1,0,1,1604030400,1604030400,1
FBI_AGENT26,0,1,0,2,1573621200,1573621200,1
thewandtheywant,0,1,0,12,1600228800,1600228800,1
frinans,0,1,0,-19,1553140800,1553140800,1
crackeddryice,0,1,0,2,1594785600,1594785600,1
FIRE2027,0,1,0,37,1596600000,1596600000,1
ADuskett,0,1,0,1,1576904400,1576904400,1
i_make_people_angry,0,1,0,3,1603771200,1603771200,1
the-Hall-way,0,1,0,3,1586923200,1586923200,1
icedoctor480,0,1,0,7,1605330000,1605330000,1
MutagensRS,0,1,0,1,1603512000,1603512000,1
mdousts,0,1,0,1,1609131600,1609131600,1
Ok_Reporter_9838,0,1,0,31,1602820800,1602820800,1
Aurarus,0,1,0,9,1584763200,1584763200,1
probsthrowaway2,0,1,0,1,1598068800,1598068800,1
101000100000,0,1,0,0,1605502800,1605502800,1
ChefboyRD33,0,1,0,1,1591329600,1591329600,1
Xw_Seifer,0,1,0,3,1589601600,1589601600,1
axivate,0,1,0,1,1597723200,1597723200,1
brisbanebreakfastboi,0,1,0,39,1571803200,1571803200,1
bianchi12,0,1,0,1,1591329600,1591329600,1
Fragrant_Potential81,0,1,0,1,1603512000,1603512000,1
youcantdrinkthat,0,1,0,1,1590638400,1590638400,1
tripathi92,1,0,191,0,1588392000,1588392000,1
Soul137,0,1,0,7,1602302400,1602302400,1
cocsukah,0,1,0,0,1564286400,1564286400,1
dycegunner,0,1,0,2,1603857600,1603857600,1
ObsidianLion,0,1,0,5,1581915600,1581915600,1
boredatwork2082,0,1,0,1,1605589200,1605589200,1
Clearskies37,0,1,0,-3,1596772800,1596772800,1
foreverrickandmorty,0,1,0,41,1575349200,1575349200,1
_2loves_,0,1,0,1,1585454400,1585454400,1
_mach,0,1,0,1,1597118400,1597118400,1
Porn_research_acct,0,1,0,1,1605762000,1605762000,1
Raffello,0,1,0,21,1605416400,1605416400,1
vyvyvyvyv,0,1,0,4,1603512000,1603512000,1
utfr,0,1,0,15,1597464000,1597464000,1
JennyAnyDot,0,1,0,-1,1600401600,1600401600,1
AntKaren,0,1,0,2,1583899200,1583899200,1
a_meme_or_somesuch,0,1,0,31,1558497600,1558497600,1
sbdavi,0,1,0,2,1588392000,1588392000,1
tweezy558,0,1,0,7,1579496400,1579496400,1
HissAtOwnAss,0,1,0,19,1584158400,1584158400,1
420JimLahey,0,1,0,1,1605589200,1605589200,1
staygoodtorg,0,1,0,1,1603598400,1603598400,1
Him570,0,1,0,1,1606626000,1606626000,1
roonilwazlib1981,1,0,11,0,1593403200,1593403200,1
nkzuz,0,1,0,2,1568779200,1568779200,1
Meowgi-pai,0,1,0,2,1547010000,1547010000,1
kaymcgrointals,0,1,0,1,1594094400,1594094400,1
Figure8onabight,0,1,0,2,1599796800,1599796800,1
Ayotunde1010,0,1,0,1,1578373200,1578373200,1
Puuksu,0,1,0,1,1605589200,1605589200,1
cevinlo23,0,1,0,4,1600574400,1600574400,1
ThePersnicketyBitch,0,1,0,1,1603512000,1603512000,1
CommunistQuark,0,1,0,4,1579582800,1579582800,1
Oakdog1007,0,1,0,91,1605243600,1605243600,1
DazzaBazza,1,0,0,0,1590552000,1590552000,1
Markronom,0,1,0,1,1610254800,1610254800,1
Xzenergy,0,1,0,2,1598760000,1598760000,1
MediocreAcoustic,0,1,0,2,1608094800,1608094800,1
PayDaPrice,0,1,0,4,1595217600,1595217600,1
rinard94,0,1,0,20,1568692800,1568692800,1
SmackedWookiee,0,1,0,1,1601697600,1601697600,1
lexi_kahn,0,1,0,-2,1609390800,1609390800,1
sparkylocal3,0,1,0,1,1589860800,1589860800,1
amandatorychase,0,1,0,11,1596945600,1596945600,1
holytarar,0,1,0,4,1580533200,1580533200,1
TheSutphin,0,1,0,24,1546405200,1546405200,1
YakityYakOG,0,1,0,8,1539921600,1539921600,1
Bueller0627,1,0,15,0,1598932800,1598932800,1
jessietl,0,1,0,8,1558497600,1558497600,1
geronymo4p,0,1,0,5,1597204800,1597204800,1
danfish_77,0,1,0,2,1596081600,1596081600,1
madam_zeroni,0,1,0,1,1601179200,1601179200,1
WalterGripp,0,1,0,80,1576040400,1576040400,1
kataz13,0,1,0,2,1591934400,1591934400,1
csasker,0,1,0,1,1578805200,1578805200,1
ultima103,0,1,0,2,1623384000,1623384000,1
Lord_Jashin,0,1,0,2,1572235200,1572235200,1
coconutdreamin,0,1,0,1,1605848400,1605848400,1
vanishingtact,0,1,0,4,1585454400,1585454400,1
survivalmany,0,1,0,1,1603771200,1603771200,1
lastjediwasamistake,0,1,0,0,1579410000,1579410000,1
humanescum,0,1,0,4,1600142400,1600142400,1
Time_Two,1,0,1,0,1586145600,1586145600,1
ClaptrASS,1,0,274,0,1602388800,1602388800,1
DylanSpaceBean,0,1,0,1,1606021200,1606021200,1
nunca_digas_nada,0,1,0,2,1611896400,1611896400,1
blackheart901,0,1,0,17,1580187600,1580187600,1
skh7272,0,1,0,0,1598760000,1598760000,1
TheJimiBones,0,1,0,14,1564027200,1564027200,1
Bleebus611,0,1,0,4,1603425600,1603425600,1
geusebio,0,1,0,14,1599451200,1599451200,1
GameMasterChris,0,1,0,7,1606107600,1606107600,1
destinofiquenoite,0,1,0,4,1585627200,1585627200,1
Plebe-Uchiha,0,1,0,3,1609131600,1609131600,1
Shiny_Shedinja,0,1,0,2,1584676800,1584676800,1
ro_rabbit,0,1,0,4,1578373200,1578373200,1
v3spasian,0,1,0,0,1581138000,1581138000,1
JustForGayPorn420,0,1,0,0,1605848400,1605848400,1
iTellUeveryting,0,1,0,1,1551848400,1551848400,1
Pavery47,0,1,0,0,1604379600,1604379600,1
kimpan13,0,1,0,1,1606626000,1606626000,1
hakuin80,0,1,0,1,1572235200,1572235200,1
King_of_the_pirEnts,0,1,0,17,1594267200,1594267200,1
muchbester,1,0,168,0,1597377600,1597377600,1
TheDunk67,0,1,0,3,1571630400,1571630400,1
Vahlerie,0,1,0,1,1584244800,1584244800,1
LewdLittleLoli,0,1,0,5,1571544000,1571544000,1
jmercy2k1,0,1,0,1,1603512000,1603512000,1
acid_etched,0,1,0,6,1577422800,1577422800,1
Flexer_MC1,0,1,0,7,1606107600,1606107600,1
BuckFutter422,0,1,0,1,1585454400,1585454400,1
Amity827,0,1,0,85,1606626000,1606626000,1
usual_unusual,0,1,0,10,1563336000,1563336000,1
Visser946,0,1,0,6,1478754000,1478754000,1
Prophet_Of_Loss,0,1,0,3,1603512000,1603512000,1
l-ll-ll-lL,0,1,0,-2,1604030400,1604030400,1
DarkRedDiscomfort,0,1,0,1,1557806400,1557806400,1
anthro28,0,1,0,-5,1576299600,1576299600,1
MarkMew,0,1,0,1,1612328400,1612328400,1
bballjones9241,0,1,0,4,1603598400,1603598400,1
whatevenidk888,0,1,0,1,1560830400,1560830400,1
DrEnufBoy,0,1,0,5,1579755600,1579755600,1
InnapropriateBobRoss,0,1,0,17,1579410000,1579410000,1
CrazedHedgeHog,0,1,0,6,1585368000,1585368000,1
kittensinatrenchcoat,0,1,0,1,1603512000,1603512000,1
TishthaDish,0,1,0,1,1589860800,1589860800,1
warmcorntortilla,0,1,0,2,1594353600,1594353600,1
quanathan,0,1,0,1,1595304000,1595304000,1
SuperstitiousSpiders,0,1,0,1,1585108800,1585108800,1
PM_ME_CUTE_ANIMALS_0,0,1,0,1,1585454400,1585454400,1
INDRID_COLD67,0,1,0,2,1607576400,1607576400,1
Angercrank,0,1,0,3,1595908800,1595908800,1
anon_nonapplicable,0,1,0,1,1589860800,1589860800,1
junipersnake,0,1,0,1,1588046400,1588046400,1
adamboyce556,0,1,0,5,1595390400,1595390400,1
sparkle72r,0,1,0,5,1576645200,1576645200,1
TacoOrgy,0,1,0,13,1603512000,1603512000,1
KMack_64,0,1,0,1,1572235200,1572235200,1
Im_your_real_dad,0,1,0,3,1570075200,1570075200,1
QueensMorningBiscuit,0,1,0,1,1589947200,1589947200,1
MikeMikeMike27,0,1,0,6,1581224400,1581224400,1
JuFo2707,0,1,0,1,1597896000,1597896000,1
bearbarebere,0,1,0,3,1611982800,1611982800,1
ziggzz84,0,1,0,1,1608526800,1608526800,1
etsatlo,0,1,0,1,1608267600,1608267600,1
freedcreativity,0,1,0,14,1606280400,1606280400,1
Chaoslab,0,1,0,1,1605675600,1605675600,1
lilbithippie,0,1,0,15,1604984400,1604984400,1
thelesbiannextdoor,0,1,0,13,1570593600,1570593600,1
DroppinBird,0,1,0,2,1604898000,1604898000,1
p0tat0p0tat0,0,1,0,2,1604811600,1604811600,1
JRDH,0,1,0,6,1609477200,1609477200,1
Avrangor,0,1,0,8,1595304000,1595304000,1
UnicornSuffering,0,1,0,1,1605243600,1605243600,1
DaGr8Bungholio,0,1,0,3,1594699200,1594699200,1
sonic260,0,1,0,3,1603512000,1603512000,1
Mammoth_Exchange2588,0,1,0,1,1613970000,1613970000,1
Psichinu,0,1,0,2,1563249600,1563249600,1
Twonuggshuggin,0,1,0,2,1606885200,1606885200,1
BeingJoeBu,0,1,0,7,1592625600,1592625600,1
DestituteJournalist,0,1,0,1,1560657600,1560657600,1
Luminous_Fantasy,0,1,0,1,1571630400,1571630400,1
Idolmistress,0,1,0,4,1582606800,1582606800,1
robdabear,0,1,0,19,1600401600,1600401600,1
WizWitch42,0,1,0,1,1576040400,1576040400,1
alextheelf24,0,1,0,1,1599796800,1599796800,1
Helloiamhernaldo,0,1,0,4,1593230400,1593230400,1
SeymorKrelborn,0,1,0,1,1608526800,1608526800,1
OmniMute,0,1,0,6,1562212800,1562212800,1
OnceAndForever,0,1,0,104,1606453200,1606453200,1
common_tater,0,1,0,1,1605243600,1605243600,1
blanccetstate,0,1,0,1,1605330000,1605330000,1
9_speeds,0,1,0,1,1608267600,1608267600,1
Mcdaddybigballs602,0,1,0,2,1582779600,1582779600,1
Anon01938,0,1,0,6,1547528400,1547528400,1
pruplehoneybee226,0,1,0,1,1604898000,1604898000,1
Marko_govo,0,1,0,10,1573189200,1573189200,1
iwasmeanttofly,0,1,0,16,1582606800,1582606800,1
jackarywoo,0,1,0,8,1599451200,1599451200,1
AtomicIndividual,0,1,0,0,1572321600,1572321600,1
Pupper_Wolf,0,1,0,3,1576645200,1576645200,1
adamfleisch,0,1,0,-16,1607058000,1607058000,1
MayorLemonRow,0,1,0,1,1562817600,1562817600,1
comradesad,0,1,0,4,1605243600,1605243600,1
Gregathol,0,1,0,6,1585886400,1585886400,1
taukki,0,1,0,1,1607835600,1607835600,1
SickleMode,0,1,0,1,1604379600,1604379600,1
darkhorse8419,0,1,0,1,1606194000,1606194000,1
ZaviaGenX,0,1,0,3,1570939200,1570939200,1
LoganE23,0,1,0,3,1605243600,1605243600,1
Insect-Competitive,1,0,64,0,1604552400,1604552400,1
chingy_daily100,0,1,0,9,1609390800,1609390800,1
throwawaycrossstitch,0,1,0,2,1603512000,1603512000,1
Opeerus,0,1,0,5,1548133200,1548133200,1
PeKKer0_0,0,1,0,2,1541394000,1541394000,1
Bajablastmybrainsout,0,1,0,2,1603771200,1603771200,1
trynafindaradio,0,1,0,10,1585454400,1585454400,1
Brofistulation,0,1,0,1,1585454400,1585454400,1
a_winrar_isyou,0,1,0,7,1554696000,1554696000,1
flip__heck,0,1,0,26,1593057600,1593057600,1
CommanderEagles,0,1,0,1,1561435200,1561435200,1
turingmachine29,0,1,0,13,1589169600,1589169600,1
enki_22,0,1,0,1,1593748800,1593748800,1
duckcowboy,0,1,0,11,1603425600,1603425600,1
Ivbrizhiki,0,1,0,8,1607230800,1607230800,1
Pariente99,0,1,0,1,1592280000,1592280000,1
Yo_Soy_Dabesss,0,1,0,6,1606971600,1606971600,1
Badgers_or_Bust,0,1,0,13,1597809600,1597809600,1
Nugget203,0,1,0,3,1584763200,1584763200,1
ikr7,0,1,0,-1,1605934800,1605934800,1
Docsquirrell,0,1,0,1,1585454400,1585454400,1
0mdzs,0,1,0,1,1605675600,1605675600,1
HelpPliz410,0,1,0,1,1605416400,1605416400,1
flamin_burritoz,0,1,0,3,1605157200,1605157200,1
agithecaca,0,1,0,5,1605502800,1605502800,1
Worldisoyster,0,1,0,3,1593057600,1593057600,1
gophergun,0,1,0,1,1576386000,1576386000,1
NotMurderItsKetchup,0,1,0,3,1601956800,1601956800,1
MostlyStoned,0,1,0,-4,1571889600,1571889600,1
MeterInch,0,1,0,4,1593230400,1593230400,1
allofthelites,1,0,70,0,1594353600,1594353600,1
SendMoreCoffee,0,1,0,5,1605502800,1605502800,1
CJGlassman,1,0,49,0,1604030400,1604030400,1
Altourus,0,1,0,-3,1605416400,1605416400,1
drinkerofmilk,0,1,0,11,1598241600,1598241600,1
Malik_V,0,1,0,42,1605157200,1605157200,1
remedialrob,0,1,0,3,1596859200,1596859200,1
Gunningagap77,0,1,0,15,1609045200,1609045200,1
JoshTheWoodsman,0,1,0,11,1603684800,1603684800,1
fuuuursure,0,1,0,2,1607835600,1607835600,1
Virgee,0,1,0,1,1607490000,1607490000,1
killmenawwwww,0,1,0,3,1604116800,1604116800,1
butters091,0,1,0,3,1606021200,1606021200,1
umiryu,0,1,0,9,1599624000,1599624000,1
CleanFaithlessness,0,1,0,1,1579496400,1579496400,1
vagipalooza,0,1,0,1,1599364800,1599364800,1
invisible-anarchist,0,1,0,11,1611896400,1611896400,1
kegsjug,0,1,0,1,1591329600,1591329600,1
NigelThornberry2,0,1,0,-2,1577422800,1577422800,1
Taskinar,0,1,0,2,1603598400,1603598400,1
Beau-nugget,0,1,0,4,1585454400,1585454400,1
KaiEdwardBannon,0,1,0,2,1602734400,1602734400,1
Rit_Zien,0,1,0,22,1572148800,1572148800,1
EireOfTheNorth,0,1,0,11,1564891200,1564891200,1
WanderingDeveloper,0,1,0,3,1612069200,1612069200,1
adamrego,0,1,0,673,1598587200,1598587200,1
cockblock13579,0,1,0,5,1607922000,1607922000,1
crazyg93,0,1,0,57,1574571600,1574571600,1
Sprucecaboose2,0,1,0,3,1592539200,1592539200,1
DarkAnalyser,0,1,0,1,1607835600,1607835600,1
ComradeCunt18,0,1,0,2,1603512000,1603512000,1
Historical-Egg-2220,0,1,0,0,1604811600,1604811600,1
foggynotion,0,1,0,2,1474689600,1474689600,1
SantaDog_,0,1,0,7,1583470800,1583470800,1
NetSage,0,1,0,23,1593662400,1593662400,1
ElectricFuneralHome,0,1,0,1,1603684800,1603684800,1
luckyprime,0,1,0,1,1603771200,1603771200,1
crafty_shark,0,1,0,8,1587096000,1587096000,1
Steammaster1234,0,1,0,41,1577854800,1577854800,1
theweatheringwizard,0,1,0,-7,1587355200,1587355200,1
ElectCatsNotFascists,0,1,0,1,1551934800,1551934800,1
DroAwayDankccount,1,0,152,0,1545973200,1545973200,1
alamohero,0,1,0,1,1573707600,1573707600,1
Godfather-Morlock,0,1,0,31,1566360000,1566360000,1
AtheistBard,0,1,0,3,1598155200,1598155200,1
Chizmiz1994,0,1,0,1,1612069200,1612069200,1
Zeonic_Front,0,1,0,17,1549515600,1549515600,1
OwnbiggestFan,0,1,0,1,1573362000,1573362000,1
Just1ncase4658,0,1,0,1,1597982400,1597982400,1
Fkital,0,1,0,22,1578632400,1578632400,1
Mythbrand,0,1,0,1,1584244800,1584244800,1
BarklyWooves,0,1,0,25,1611982800,1611982800,1
rainborambo,0,1,0,3,1605934800,1605934800,1
OkanGeelsareeth,0,1,0,1,1602820800,1602820800,1
KC5ohTree_,0,1,0,-10,1570248000,1570248000,1
Prestigious_Button92,0,1,0,2,1603512000,1603512000,1
Muggle_penguin,0,1,0,1,1595908800,1595908800,1
sneak102,0,1,0,1,1604552400,1604552400,1
Rando_Calrissiano,0,1,0,19,1608526800,1608526800,1
TheWolfwithToast,0,1,0,1,1578114000,1578114000,1
sp0iledr0tt3n,0,1,0,45,1607662800,1607662800,1
_RobbStark,0,1,0,34,1606885200,1606885200,1
Valennyn,0,1,0,6,1603598400,1603598400,1
migistia,0,1,0,-1,1585454400,1585454400,1
l94xxx,0,1,0,1,1606626000,1606626000,1
Malguf,0,1,0,2,1572667200,1572667200,1
4AmBallotDump,0,1,0,1,1611982800,1611982800,1
Ryinann,0,1,0,9,1603252800,1603252800,1
CCisbored,0,1,0,1,1606107600,1606107600,1
Iaintthe-1,0,1,0,1,1604379600,1604379600,1
yeetrock2,0,1,0,4,1588478400,1588478400,1
TheGrapeMeister,0,1,0,1,1634616000,1634616000,1
thewomandefender,0,1,0,2,1580101200,1580101200,1
JXTUCK006,0,1,0,8,1607230800,1607230800,1
maxlan,0,1,0,-19,1581138000,1581138000,1
RealTime_RS,0,1,0,37,1606798800,1606798800,1
OWN1883,0,1,0,54,1599105600,1599105600,1
RonaldRaygun2024,0,1,0,5,1604811600,1604811600,1
NonAxiomaticKneecaps,0,1,0,1,1613365200,1613365200,1
GnowledgedGnome,0,1,0,2,1603512000,1603512000,1
AreYouReadyToPotato,0,1,0,1,1606885200,1606885200,1
-aether-,0,1,0,13,1576299600,1576299600,1
ankn223,1,0,40,0,1545022800,1545022800,1
ibeatu85x,0,1,0,28,1578632400,1578632400,1
lieutenanthoss,0,1,0,1,1608267600,1608267600,1
superfly512,0,1,0,-3,1584244800,1584244800,1
LookAtThisRhino,0,1,0,4,1568001600,1568001600,1
MsInquisitor,0,1,0,17,1566360000,1566360000,1
titsonaduck,0,1,0,2,1597550400,1597550400,1
butterytelevision,0,1,0,14,1602302400,1602302400,1
multihedra,0,1,0,4,1579842000,1579842000,1
Mattpi2003,0,1,0,1,1598587200,1598587200,1
Zeltron3131,0,1,0,1,1574312400,1574312400,1
Canadasnewarmy,0,1,0,11,1585022400,1585022400,1
PalePat,0,1,0,2,1606798800,1606798800,1
Backlog_Overflow,0,1,0,0,1585022400,1585022400,1
thecandicorn,0,1,0,2,1566273600,1566273600,1
Fran5oisLeFrancais,0,1,0,-4,1602648000,1602648000,1
slapmewithacactus,0,1,0,1,1607490000,1607490000,1
rubbingtheruby,1,0,30,0,1584763200,1584763200,1
wanderous-boi,0,1,0,1,1603512000,1603512000,1
arussell232,0,1,0,1,1602820800,1602820800,1
DrDilatory,0,1,0,2,1599019200,1599019200,1
karissasrose,0,1,0,1,1594094400,1594094400,1
chestofpoop,0,1,0,8,1608526800,1608526800,1
chippy94,0,1,0,111,1606798800,1606798800,1
himynamesgod,0,1,0,-2,1576558800,1576558800,1
aquafreshwhitening,0,1,0,2,1586232000,1586232000,1
Chaiking,0,1,0,31,1606453200,1606453200,1
mandakc,0,1,0,1,1603512000,1603512000,1
ArtRoomWindow,1,0,3,0,1606712400,1606712400,1
alsesilangiu,0,1,0,4,1605848400,1605848400,1
covettonhouse,0,1,0,1,1605934800,1605934800,1
chill_in,0,1,0,3,1562040000,1562040000,1
branshort,1,0,132,0,1595908800,1595908800,1
Habibi024,0,1,0,2,1589947200,1589947200,1
haboku,0,1,0,2,1593835200,1593835200,1
escobetle,0,1,0,18,1605416400,1605416400,1
Cornycash,0,1,0,2,1570334400,1570334400,1
grandemperormichael,0,1,0,1,1604466000,1604466000,1
Niska-Osoba-V2,0,1,0,1,1608786000,1608786000,1
mrlinkwii,0,1,0,1,1575522000,1575522000,1
anddicksays,0,1,0,-1,1585454400,1585454400,1
wise-raven,1,0,58,0,1577077200,1577077200,1
Madmaxtrw2,0,1,0,5,1602388800,1602388800,1
Thenightsaresolong_,0,1,0,13,1608354000,1608354000,1
fuzzylilbunnies,0,1,0,-1,1582779600,1582779600,1
Pandalrac,0,1,0,37,1579755600,1579755600,1
Thai_Perky555,0,1,0,0,1604116800,1604116800,1
mrhouse1101,1,0,137,0,1569902400,1569902400,1
thewittyrobin,0,1,0,1,1606626000,1606626000,1
ManaMayhemMike,0,1,0,3,1559102400,1559102400,1
jlreedy,0,1,0,15,1601352000,1601352000,1
uglybuttfuck,0,1,0,1,1589688000,1589688000,1
PP_Hole_Overbite,0,1,0,3,1604030400,1604030400,1
skartreuse,0,1,0,2,1607662800,1607662800,1
AlvinBlah,0,1,0,3,1603512000,1603512000,1
JustAPeakyBlinder,0,1,0,2,1584590400,1584590400,1
frenchpressfan,0,1,0,5,1600660800,1600660800,1
carrotjournalist,0,1,0,3,1606539600,1606539600,1
Bashcypher,0,1,0,4,1604984400,1604984400,1
Adama0001,0,1,0,6,1585454400,1585454400,1
sadslore,0,1,0,12,1574485200,1574485200,1
SugondeseAmbassador,0,1,0,1,1607662800,1607662800,1
DavidG-LA,0,1,0,8,1603598400,1603598400,1
wristcontrol,0,1,0,5,1609390800,1609390800,1
IamTehOSRSLgend,0,1,0,2,1581224400,1581224400,1
RisingAce,0,1,0,33,1608440400,1608440400,1
rainbowfalafel,0,1,0,4,1596340800,1596340800,1
Bendrake,0,1,0,1,1603512000,1603512000,1
fuckallthatshitbro,0,1,0,1,1592712000,1592712000,1
_Renegade_Sock_,0,1,0,2,1605502800,1605502800,1
MayOverexplain,0,1,0,5,1594699200,1594699200,1
bahooba,0,1,0,1,1600660800,1600660800,1
CrucifiedKitten,0,1,0,17,1576731600,1576731600,1
willymoeSR,0,1,0,9,1595822400,1595822400,1
grvtitudegoddess,0,1,0,5,1590379200,1590379200,1
KitSlander,0,1,0,2,1584849600,1584849600,1
Omatic15,0,1,0,1,1597204800,1597204800,1
iamagoldengod84,0,1,0,1,1605589200,1605589200,1
36monsters,0,1,0,10,1558238400,1558238400,1
iqxfnyorpkaewdtgj,1,0,1,0,1456894800,1456894800,1
Zagorlicious,0,1,0,41,1591588800,1591588800,1
Deadsotc,0,1,0,1,1572148800,1572148800,1
javuh1,0,1,0,3,1600488000,1600488000,1
_sweeezy,0,1,0,9,1599105600,1599105600,1
jawshoeaw,0,1,0,2,1605589200,1605589200,1
nightcycling,0,1,0,1,1583643600,1583643600,1
_CUMSALOT_,0,1,0,1,1603512000,1603512000,1
RednaxNewo,0,1,0,2,1603512000,1603512000,1
DarthDonutwizard,0,1,0,1,1607230800,1607230800,1
alianse77,0,1,0,1,1605070800,1605070800,1
Llegoelbrujo,0,1,0,3,1585454400,1585454400,1
SuiXi3D,0,1,0,3,1608958800,1608958800,1
skramboney,0,1,0,1,1582002000,1582002000,1
degasel_,0,1,0,1,1606539600,1606539600,1
ramonstr,0,1,0,6,1575003600,1575003600,1
poorboyflynn,0,1,0,1,1598760000,1598760000,1
Chibi_rox3393,0,1,0,7,1559361600,1559361600,1
sammiantha,0,1,0,1,1563249600,1563249600,1
commiecosmo,0,1,0,4,1595476800,1595476800,1
commie_1983,0,1,0,2,1613538000,1613538000,1
neocola,0,1,0,18,1599883200,1599883200,1
lonely_wiseblood,0,1,0,4,1604984400,1604984400,1
FoodBasedLubricant,0,1,0,2,1608526800,1608526800,1
ssshhhhhhhhhhhhh,0,1,0,2,1585454400,1585454400,1
UCLAlex,0,1,0,14,1608699600,1608699600,1
violetsofdawn,0,1,0,9,1602993600,1602993600,1
poopshit420,0,1,0,15,1599192000,1599192000,1
1paleghost,0,1,0,1,1602216000,1602216000,1
henri1921,0,1,0,1,1554523200,1554523200,1
eyesrepeat,0,1,0,5,1605589200,1605589200,1
ShroominBruin,0,1,0,4,1607922000,1607922000,1
sapphire_glow,0,1,0,14,1603684800,1603684800,1
Sir_Lolz,0,1,0,2,1587355200,1587355200,1
zaradyk,0,1,0,1,1599451200,1599451200,1
Environmental-Rain34,0,1,0,-8,1599019200,1599019200,1
Jimbot80,0,1,0,-10,1606626000,1606626000,1
P-O-O-P_B-I-B,0,1,0,7,1576904400,1576904400,1
dashaomazing,0,1,0,5,1553227200,1553227200,1
MakinbaconGreasyagin,0,1,0,4,1578891600,1578891600,1
turboklenk,0,1,0,-4,1608440400,1608440400,1
atbprod,0,1,0,1,1576558800,1576558800,1
Real_Rotard,0,1,0,5,1607749200,1607749200,1
lippyboy,0,1,0,3,1572235200,1572235200,1
nerve2030,0,1,0,4,1577509200,1577509200,1
jegodric,0,1,0,1,1599796800,1599796800,1
alacp1234,0,1,0,43,1600228800,1600228800,1
sunshineandcloudyday,0,1,0,2,1585540800,1585540800,1
El_Dud3r1n0,0,1,0,11,1592193600,1592193600,1
MeggieFolchart,0,1,0,2,1600488000,1600488000,1
echo6golf,0,1,0,0,1598760000,1598760000,1
haffbaked,0,1,0,11,1598846400,1598846400,1
KleborpTheRetard,0,1,0,11,1581570000,1581570000,1
halucnatr,0,1,0,15,1601956800,1601956800,1
Inburrito,0,1,0,1,1607835600,1607835600,1
CosmicBlitz,1,0,16,0,1571198400,1571198400,1
kevinasfk,0,1,0,23,1593489600,1593489600,1
____REDACTED_____,1,0,97,0,1611723600,1611723600,1
threwit5159,0,1,0,2,1603080000,1603080000,1
driftdownriver,0,1,0,9,1608094800,1608094800,1
DeepInTheCheeks,0,1,0,2,1601006400,1601006400,1
Potoodles,0,1,0,1,1605589200,1605589200,1
JasontheFuzz,0,1,0,20,1605070800,1605070800,1
Gregor-Schmidt,0,1,0,1,1607662800,1607662800,1
ApplicableSongLyric,0,1,0,2,1407211200,1407211200,1
SpikeTun,1,0,22,0,1578891600,1578891600,1
joekiid65,1,0,7,0,1589169600,1589169600,1
FunGuy0622,0,1,0,1,1603512000,1603512000,1
k8m100,0,1,0,2,1588910400,1588910400,1
DeadFutureGhost,0,1,0,2,1604725200,1604725200,1
MrMoscarda,0,1,0,17,1609045200,1609045200,1
Timeforanotheracct51,0,1,0,1,1591243200,1591243200,1
chipchagotna,1,0,12,0,1574226000,1574226000,1
NotMiyu,0,1,0,3,1586923200,1586923200,1
Huge_Cookie,1,0,46,0,1593230400,1593230400,1
Bertez,0,1,0,7,1571544000,1571544000,1
Always_Searching_,1,0,8,0,1574830800,1574830800,1
moneylearner,0,1,0,1,1585281600,1585281600,1
Scary_Contribution_5,0,1,0,3,1603598400,1603598400,1
shtbrcks,0,1,0,1,1600315200,1600315200,1
MagpieJuly,0,1,0,1,1593316800,1593316800,1
Flyboy1901,0,1,0,0,1579928400,1579928400,1
ferzetto,0,1,0,20,1578805200,1578805200,1
TheAnimusRex,0,1,0,1,1610254800,1610254800,1
Blue_umbo,0,1,0,1,1584590400,1584590400,1
Lorenzo_BR,1,0,28,0,1596772800,1596772800,1
embeddedpotato,0,1,0,2,1596081600,1596081600,1
Acatinmylap,1,0,12,0,1605157200,1605157200,1
Am_I_Outside,0,1,0,1,1603512000,1603512000,1
Jonruy,0,1,0,0,1601524800,1601524800,1
Clarku-San,0,1,0,1,1557028800,1557028800,1
jerebear39,0,1,0,11,1601611200,1601611200,1
watcherof_theskies,0,1,0,2,1492920000,1492920000,1
the3rdtea,0,1,0,10,1598760000,1598760000,1
NuteCoob,0,1,0,10,1611982800,1611982800,1
lilgibblet,0,1,0,4,1570248000,1570248000,1
Commercial-Average,0,1,0,2,1589947200,1589947200,1
Mechamon91,0,1,0,1,1600920000,1600920000,1
Meek_mewey,0,1,0,16,1602734400,1602734400,1
relativityboy,0,1,0,0,1608354000,1608354000,1
SaneMalfunction,0,1,0,2,1571371200,1571371200,1
freethewimple,0,1,0,8,1602734400,1602734400,1
SavedKriss,0,1,0,13,1602388800,1602388800,1
sleepiestghost,0,1,0,29,1597982400,1597982400,1
Hiluicoatl,0,1,0,3,1562731200,1562731200,1
zimmy21o6,0,1,0,1,1601265600,1601265600,1
webdevverman,0,1,0,0,1608354000,1608354000,1
Anthony_A,0,1,0,21,1586404800,1586404800,1
HappyLilNoodle,0,1,0,5,1577422800,1577422800,1
doublevea,0,1,0,11,1553486400,1553486400,1
SobBagat,0,1,0,1,1585454400,1585454400,1
BlueAcequia,0,1,0,1,1608872400,1608872400,1
foxnewsnetwork,0,1,0,13,1603339200,1603339200,1
KidsWiththeChemicals,1,0,14,0,1606366800,1606366800,1
HughHoney_VicVinegar,0,1,0,2,1606194000,1606194000,1
IAmMattnificent,0,1,0,2,1605934800,1605934800,1
magus2003,0,1,0,1,1601352000,1601352000,1
dfBishop,0,1,0,3,1605157200,1605157200,1
userunknowned,0,1,0,19,1577595600,1577595600,1
justlose,0,1,0,1,1608872400,1608872400,1
Sweet_Classic,0,1,0,0,1598760000,1598760000,1
DoctorProfessorTaco,0,1,0,2,1608699600,1608699600,1
Furious_Flames,0,1,0,30,1605589200,1605589200,1
low-zen,0,1,0,2,1607922000,1607922000,1
oureyes,0,1,0,6,1582088400,1582088400,1
honeyboo311,0,1,0,6,1571457600,1571457600,1
474r4x14,0,1,0,4,1554955200,1554955200,1
N8ThaGrate,0,1,0,24,1573016400,1573016400,1
i_was_compromised,0,1,0,3,1605934800,1605934800,1
Positive-Idea,0,1,0,3,1609390800,1609390800,1
pattonado,0,1,0,7,1608181200,1608181200,1
IceGiantHelga,0,1,0,10,1580619600,1580619600,1
BoxoMorons,0,1,0,1,1593662400,1593662400,1
ISwearImKarl,0,1,0,1,1585454400,1585454400,1
FBIorange,0,1,0,0,1587873600,1587873600,1
creepy_crepes,0,1,0,1,1595304000,1595304000,1
Nouris,0,1,0,1,1598673600,1598673600,1
princevegeta951,0,1,0,1,1579582800,1579582800,1
gruntledjoejr,0,1,0,2,1611896400,1611896400,1
MintyGame,0,1,0,1,1607490000,1607490000,1
Wasabicannon,0,1,0,1,1591329600,1591329600,1
justuravg2,0,1,0,3,1579237200,1579237200,1
Fuhrious520,0,1,0,-11,1577336400,1577336400,1
radicalabacus,0,1,0,15,1569643200,1569643200,1
TrashCatTrashCat,0,1,0,2,1608181200,1608181200,1
threecatsdancing,0,1,0,7,1585627200,1585627200,1
ISwearImCis,0,1,0,3,1577422800,1577422800,1
ThirdWorldWorker,0,1,0,8,1598846400,1598846400,1
Raishinz,0,1,0,1,1604811600,1604811600,1
Erkonomics,0,1,0,9,1606626000,1606626000,1
ZonMen23,0,1,0,1,1603598400,1603598400,1
Man_Bear_Beaver,0,1,0,2,1600660800,1600660800,1
doubtsinlife,0,1,0,6,1593662400,1593662400,1
Artfreak221,0,1,0,3,1592625600,1592625600,1
Gomey608,0,1,0,136,1588651200,1588651200,1
rainbowcouscous,1,0,29,0,1573794000,1573794000,1
Nodens_Dagon,0,1,0,3,1607835600,1607835600,1
kryptonite1975,0,1,0,-2,1595476800,1595476800,1
MaxwellCunninghamVII,0,1,0,2,1591329600,1591329600,1
seaniedan,1,0,0,0,1611810000,1611810000,1
what_it_dude,0,1,0,14,1596772800,1596772800,1
meowsjacobson,0,1,0,1,1585454400,1585454400,1
4c1f78940b78485bae4d,0,1,0,1,1608699600,1608699600,1
ones_mama,0,1,0,1,1589688000,1589688000,1
melodicprophet,0,1,0,15,1596945600,1596945600,1
feelingmeanbcgreen,0,1,0,11,1564200000,1564200000,1
Sanityisoverrated1,0,1,0,19,1599105600,1599105600,1
anliyix,1,0,70,0,1554609600,1554609600,1
EveOfTwilight,0,1,0,15,1584763200,1584763200,1
Cainmak,0,1,0,1,1601870400,1601870400,1
Calamariecalender,0,1,0,17,1607490000,1607490000,1
DylanMartin97,0,1,0,8,1594699200,1594699200,1
hajhjd,0,1,0,15,1588737600,1588737600,1
SippingTeaInYoHood,0,1,0,2,1608440400,1608440400,1
ddarner,0,1,0,2,1602561600,1602561600,1
Ben_T_Willy,0,1,0,5,1608526800,1608526800,1
evolino,0,1,0,2,1588305600,1588305600,1
zenby_tigger,0,1,0,29,1608786000,1608786000,1
Zzyzzy_Zzyzzyson,0,1,0,7,1581742800,1581742800,1
Nekosama7734,0,1,0,1,1607490000,1607490000,1
five_speed_mazdarati,0,1,0,1,1573189200,1573189200,1
WithoutaClue2,0,1,0,2,1611032400,1611032400,1
AquariumStatic,0,1,0,1,1583211600,1583211600,1
JimSteak,0,1,0,1,1606021200,1606021200,1
Pmmenothing444,0,1,0,11,1605502800,1605502800,1
confusedofwhattodo,0,1,0,1,1559880000,1559880000,1
Gmdmaster,1,0,262,0,1571371200,1571371200,1
mjxii,0,1,0,1,1598760000,1598760000,1
Forgottenshadowed,1,0,14,0,1604984400,1604984400,1
jcm95,0,1,0,17,1608181200,1608181200,1
loulan,0,1,0,319,1597809600,1597809600,1
skizoids,0,1,0,2,1585540800,1585540800,1
redditiscensored69,0,1,0,-13,1609218000,1609218000,1
jkj1993,0,1,0,14,1549342800,1549342800,1
kayli_thor,0,1,0,8,1597809600,1597809600,1
Helpmefindthem101,0,1,0,4,1596168000,1596168000,1
jollytoes,0,1,0,1,1589947200,1589947200,1
nekomushii,0,1,0,8,1608526800,1608526800,1
tupkuk,0,1,0,2,1590552000,1590552000,1
Batetrick_Patman,0,1,0,108,1608440400,1608440400,1
nikhilrosh,0,1,0,2,1606971600,1606971600,1
williamIvanorange,0,1,0,1,1545627600,1545627600,1
tbeele01,0,1,0,3,1611810000,1611810000,1
sniklefritz5,0,1,0,18,1570420800,1570420800,1
Emergency_Repair5286,0,1,0,1,1634443200,1634443200,1
CryptoInvestor777,0,1,0,2,1580965200,1580965200,1
seriouspants1111,0,1,0,-7,1578632400,1578632400,1
mrbezly,0,1,0,1,1586232000,1586232000,1
Anruz,0,1,0,7,1603512000,1603512000,1
Axeperson,0,1,0,12,1555300800,1555300800,1
GayNudistFurry,0,1,0,375,1574571600,1574571600,1
Tornadus-T,0,1,0,-2,1606453200,1606453200,1
Isotomic,0,1,0,1,1606366800,1606366800,1
gawain62,0,1,0,1,1605848400,1605848400,1
roycegracieda5-9,0,1,0,3,1604466000,1604466000,1
Lost_Conclusion5357,0,1,0,1,1604379600,1604379600,1
Sun0101,0,1,0,1,1600747200,1600747200,1
X-86_86-X,0,1,0,1,1585195200,1585195200,1
SirWhiptongue,0,1,0,1,1598846400,1598846400,1
MConnolly92,1,0,7,0,1587355200,1587355200,1
Fasnoozle,1,0,95,0,1578632400,1578632400,1
H1tMonTop,0,1,0,81,1588392000,1588392000,1
NikkiThunderdik,0,1,0,-8,1602129600,1602129600,1
Kypriako,1,0,4,0,1555128000,1555128000,1
Cub3nsis,0,1,0,53,1576990800,1576990800,1
girlshero,0,1,0,7,1593921600,1593921600,1
badz21,0,1,0,1,1575694800,1575694800,1
shidoger,0,1,0,1,1601438400,1601438400,1
atetuna,0,1,0,5,1598760000,1598760000,1
justnivek,0,1,0,1,1589601600,1589601600,1
goldenkloudzzz,0,1,0,3,1570334400,1570334400,1
TouchOfA_,0,1,0,4,1600574400,1600574400,1
thx4gold,0,1,0,61,1601265600,1601265600,1
Athio,0,1,0,25,1598414400,1598414400,1
blue_coal_miner,0,1,0,11,1590120000,1590120000,1
toobusyreadingcomics,1,0,59,0,1576299600,1576299600,1
Karate_Prom,0,1,0,2,1554350400,1554350400,1
dc-redpanda,0,1,0,3,1603598400,1603598400,1
openminder,0,1,0,1,1603512000,1603512000,1
Snapjutsu,0,1,0,1,1590206400,1590206400,1
Insert_Person_Here,0,1,0,-7,1566878400,1566878400,1
ClutterEater,0,1,0,1,1599969600,1599969600,1
WellIGuesItsAName,0,1,0,1,1601956800,1601956800,1
OmniXBoxBoy,1,0,8,0,1603339200,1603339200,1
kngbainz,0,1,0,3,1569211200,1569211200,1
xxxxNikita,0,1,0,1,1594699200,1594699200,1
Aikano9,0,1,0,1,1591243200,1591243200,1
riley68,0,1,0,5,1594612800,1594612800,1
MissMissingno,1,0,48,0,1554782400,1554782400,1
AnalMohawk,0,1,0,2,1562212800,1562212800,1
DandyZebra,0,1,0,1,1603512000,1603512000,1
FuntimeLuke0531,0,1,0,3,1591416000,1591416000,1
dantestaco,0,1,0,2,1589860800,1589860800,1
DeflateGape,0,1,0,15,1595563200,1595563200,1
SleepiestGrove,0,1,0,1,1581224400,1581224400,1
halibuthalibut,0,1,0,2,1609304400,1609304400,1
epicly_noob,0,1,0,21,1597982400,1597982400,1
OneWaterPlease,1,0,264,0,1595476800,1595476800,1
DingusVonPringis,0,1,0,-10,1595217600,1595217600,1
GebPloxi,0,1,0,2,1605070800,1605070800,1
DallasWasHere1st,0,1,0,23,1560312000,1560312000,1
Team-Redundancy-Team,0,1,0,4,1585454400,1585454400,1
Clever_Name_87,0,1,0,4,1557633600,1557633600,1
-4-a-,0,1,0,1,1571803200,1571803200,1
merirastelan,0,1,0,17,1603512000,1603512000,1
SketchinUp,0,1,0,5,1607403600,1607403600,1
aliensnumbs,0,1,0,-1,1604293200,1604293200,1
Lone_Digger123,0,1,0,2,1608786000,1608786000,1
unipegacorn,0,1,0,62,1572667200,1572667200,1
throwaway5874cccght,0,1,0,2,1574485200,1574485200,1
Jc6666,0,1,0,1,1602388800,1602388800,1
NepDoll,0,1,0,2,1583899200,1583899200,1
DearYou-,1,0,86,0,1611982800,1611982800,1
destinaaa,0,1,0,5,1572930000,1572930000,1
ragezruss,0,1,0,2,1608440400,1608440400,1
FreddieOuthouse,0,1,0,4,1604725200,1604725200,1
2four,0,1,0,3,1571112000,1571112000,1
THERAGINGCYCLOPS,0,1,0,28,1607576400,1607576400,1
WillTwerk4Karma,1,0,48,0,1595908800,1595908800,1
CurlyWS,0,1,0,1,1583125200,1583125200,1
fdrowell,0,1,0,0,1572494400,1572494400,1
Carthonn,0,1,0,1,1599883200,1599883200,1
goldeagle9,0,1,0,41,1601524800,1601524800,1
Mandaj92,0,1,0,5,1600488000,1600488000,1
visionhandles,0,1,0,1,1585454400,1585454400,1
CharlieNutGrabber,0,1,0,9,1606539600,1606539600,1
ur_wcws_mcm,0,1,0,17,1605848400,1605848400,1
nome_j,0,1,0,11,1598846400,1598846400,1
Winteriscomingg,0,1,0,1,1612328400,1612328400,1
Skywave650,0,1,0,30,1589860800,1589860800,1
ThePeaceDoctot,0,1,0,7,1585108800,1585108800,1
RafRafRafRafRafRaf,0,1,0,17,1545368400,1545368400,1
Fordello,0,1,0,2,1583643600,1583643600,1
kkk868652,0,1,0,1,1599019200,1599019200,1
bhairava,0,1,0,18,1579928400,1579928400,1
RutgerSaturday,0,1,0,3,1568347200,1568347200,1
blackfish89,0,1,0,-1,1581742800,1581742800,1
thismessisaplace,0,1,0,1,1597118400,1597118400,1
Rynn23,0,1,0,10,1567656000,1567656000,1
ragnarokfps,0,1,0,1,1601006400,1601006400,1
princesspeach722,0,1,0,4,1602907200,1602907200,1
UninteractiveBrokers,0,1,0,9,1597723200,1597723200,1
Vinceboi,0,1,0,4,1588219200,1588219200,1
hashbits,0,1,0,1,1637211600,1637211600,1
Gina2604,0,1,0,9,1565150400,1565150400,1
TheBigShackleford,0,1,0,1,1578373200,1578373200,1
Ristoncor,0,1,0,48,1597291200,1597291200,1
masstransience,0,1,0,1,1612069200,1612069200,1
AJ_LA1313,1,0,10,0,1579842000,1579842000,1
velcro_and_foam,0,1,0,6,1612328400,1612328400,1
Skriger,0,1,0,12,1608354000,1608354000,1
Jake_Kanning99,0,1,0,-1,1588996800,1588996800,1
hermiticus,0,1,0,25,1608786000,1608786000,1
blackopsbarbie,0,1,0,7,1575522000,1575522000,1
LemonBar001,0,1,0,2,1557892800,1557892800,1
spentag,0,1,0,5,1568347200,1568347200,1
drjinglesMD,0,1,0,-2,1608094800,1608094800,1
EightWhiskey,0,1,0,29,1576645200,1576645200,1
grandmamarigold,0,1,0,1,1579669200,1579669200,1
OoogaOoogaYoink,0,1,0,2,1416891600,1416891600,1
piepokemon,0,1,0,7,1599537600,1599537600,1
NSFWobuffett,0,1,0,36,1609304400,1609304400,1
SarcasmIsSaviour,0,1,0,1,1563595200,1563595200,1
black_cat_crossing,0,1,0,13,1565668800,1565668800,1
shvik42,0,1,0,13,1600488000,1600488000,1
justtreewizard,0,1,0,12,1606366800,1606366800,1
ShaGayGay,0,1,0,1,1606626000,1606626000,1
DelaSquanch,0,1,0,6,1585627200,1585627200,1
Rando-Calrissio-,0,1,0,2,1607835600,1607835600,1
Ajaws2414,0,1,0,2,1608526800,1608526800,1
Thomartemis,0,1,0,0,1605848400,1605848400,1
glutamane,0,1,0,2,1576904400,1576904400,1
MRtenbux,0,1,0,2,1585454400,1585454400,1
kjimbro,0,1,0,29,1598414400,1598414400,1
JitteryJay,0,1,0,7,1604898000,1604898000,1
--Antitheist--,1,0,490,0,1602648000,1602648000,1
iBoutard,0,1,0,2,1599710400,1599710400,1
cozy_tesla,0,1,0,3,1544590800,1544590800,1
socratessue,0,1,0,5,1608440400,1608440400,1
LexGonGiveItToYa,0,1,0,9,1587441600,1587441600,1
Fluffyson,0,1,0,-10,1574658000,1574658000,1
AntiExistence000,0,1,0,2,1608699600,1608699600,1
camerabird,0,1,0,4,1598414400,1598414400,1
KokoSabreScruffy,0,1,0,110,1603512000,1603512000,1
jeevesdgk,0,1,0,1,1596600000,1596600000,1
matike,0,1,0,83,1574744400,1574744400,1
Adatisumobear,1,0,1121,0,1607317200,1607317200,1
v_jade,0,1,0,1,1608699600,1608699600,1
BreitbartWasMurdered,0,1,0,0,1585627200,1585627200,1
Muted_Gas,0,1,0,1,1607749200,1607749200,1
lexicalwabbit,0,1,0,35,1606539600,1606539600,1
pwiwjemswpw,0,1,0,5,1552276800,1552276800,1
just_a_bumblebro,0,1,0,2,1594958400,1594958400,1
fatandfly,0,1,0,4,1590465600,1590465600,1
_Asshole_Fuck_,0,1,0,3,1598328000,1598328000,1
b1gb0ss1,0,1,0,12,1579410000,1579410000,1
ffcpm,0,1,0,1,1597723200,1597723200,1
Stov333,0,1,0,1,1589860800,1589860800,1
TheBiglyOrangeTurd,0,1,0,32,1576472400,1576472400,1
Erektionsite,0,1,0,12,1606021200,1606021200,1
Butttouche,0,1,0,11,1609304400,1609304400,1
GreenAro115,0,1,0,3,1596859200,1596859200,1
corkythecactus,0,1,0,1,1611982800,1611982800,1
HexagonStorms,0,1,0,1,1589169600,1589169600,1
McWipes,0,1,0,6,1608440400,1608440400,1
sarcaster632,0,1,0,7,1566446400,1566446400,1
ahab3,0,1,0,2,1430971200,1430971200,1
funnylunch08,0,1,0,2,1578373200,1578373200,1
Cunicularius,0,1,0,1,1606798800,1606798800,1
kurajantteri69,0,1,0,64,1575608400,1575608400,1
Fl333r,0,1,0,10,1606194000,1606194000,1
Deadlock542,0,1,0,2,1593748800,1593748800,1
LoneWolf5570,0,1,0,5,1607922000,1607922000,1
SomePeopleJuggleGees,0,1,0,3,1481950800,1481950800,1
denwomudf,1,0,1,0,1456549200,1456549200,1
xanthine_junkie,0,1,0,1,1580360400,1580360400,1
akbrag91,0,1,0,1,1546405200,1546405200,1
oneobjection,0,1,0,1,1608699600,1608699600,1
0Ps-Mom,0,1,0,3,1564632000,1564632000,1
Asmatarar,0,1,0,2,1608872400,1608872400,1
Balsamiczebra,0,1,0,1,1585627200,1585627200,1
lindseyangela,0,1,0,24,1605589200,1605589200,1
leo2242,0,1,0,-3,1605330000,1605330000,1
PokemonGO_____,0,1,0,3,1585454400,1585454400,1
SyntheticManiac,0,1,0,1,1588651200,1588651200,1
I_SmellCinnamonRolls,0,1,0,2,1594180800,1594180800,1
itchyspiderbutthole,0,1,0,2,1566446400,1566446400,1
scarcieth,0,1,0,52,1586404800,1586404800,1
GameKyuubi,0,1,0,2,1608094800,1608094800,1
bh119911,0,1,0,1,1590724800,1590724800,1
rainstore,0,1,0,1,1598846400,1598846400,1
gaminghobbit94,0,1,0,1,1605762000,1605762000,1
Munkeyz,0,1,0,11,1596340800,1596340800,1
NoNicheNecessary,0,1,0,2,1575262800,1575262800,1
YourLocalAnarch,0,1,0,1,1606280400,1606280400,1
kjacka19,0,1,0,1,1604638800,1604638800,1
Protokan,0,1,0,21,1562126400,1562126400,1
HERBERT_224,0,1,0,1,1601352000,1601352000,1
Cinikle,0,1,0,-6,1591761600,1591761600,1
GossamerGTP,0,1,0,62,1579150800,1579150800,1
greenwolf_12,0,1,0,9,1583985600,1583985600,1
AlmostUnder,0,1,0,9,1572753600,1572753600,1
Delphinium_Opheliac,0,1,0,8,1578718800,1578718800,1
sunsetketchup,1,0,18,0,1606194000,1606194000,1
HowAmIHere2000,0,1,0,9,1598760000,1598760000,1
tjpoe,0,1,0,3,1572843600,1572843600,1
Lotus_82,0,1,0,3,1592971200,1592971200,1
poffin,0,1,0,1,1589860800,1589860800,1
cartlightskream,0,1,0,23,1592366400,1592366400,1
abstrakte_namen,0,1,0,5,1580014800,1580014800,1
havocgreef,0,1,0,1,1608872400,1608872400,1
myballzhuert,0,1,0,2,1608267600,1608267600,1
ExcellentTraffic123,0,1,0,3,1601524800,1601524800,1
CerebroAssassin,0,1,0,9,1606107600,1606107600,1
Bruins654,0,1,0,1,1603512000,1603512000,1
Existent_,0,1,0,2,1593230400,1593230400,1
Spirited_Initiative,0,1,0,2,1574312400,1574312400,1
BLACKMANFROMFUTURE,0,1,0,-1,1585627200,1585627200,1
davidshiu,0,1,0,3,1613624400,1613624400,1
CorvosCorax,0,1,0,4,1605848400,1605848400,1
tBrenna,0,1,0,3,1579064400,1579064400,1
Quay-Z,0,1,0,12,1567224000,1567224000,1
jiggaboi69,0,1,0,1,1599710400,1599710400,1
lippencott,0,1,0,1,1588219200,1588219200,1
weyoun47,0,1,0,16,1595908800,1595908800,1
bearingtons1859,0,1,0,1,1598241600,1598241600,1
CherenkovRadiator,1,0,25,0,1448427600,1448427600,1
Resil12,0,1,0,1,1603339200,1603339200,1
lisaferthefirst,0,1,0,5,1591329600,1591329600,1
JRDax,0,1,0,12,1592798400,1592798400,1
Cananbaum,0,1,0,3,1583643600,1583643600,1
a-girl-named-bob,0,1,0,6,1585454400,1585454400,1
queen-of-yeet,0,1,0,2,1580187600,1580187600,1
MillerSVK,0,1,0,10,1603771200,1603771200,1
Spacecommander5,0,1,0,1,1608526800,1608526800,1
strugglebus3,1,0,34,0,1584763200,1584763200,1
kbean826,0,1,0,1,1606021200,1606021200,1
Ther-Sha,0,1,0,2,1576213200,1576213200,1
DryBop,0,1,0,2,1609218000,1609218000,1
KindPlastic1,0,1,0,-8,1606539600,1606539600,1
PurityByImmolation,0,1,0,-1,1585454400,1585454400,1
FalloutFan-2,0,1,0,1,1580014800,1580014800,1
___Alexander___,0,1,0,1,1599883200,1599883200,1
CogsWerthCat,0,1,0,25,1594872000,1594872000,1
_thechapman406,0,1,0,-1,1608526800,1608526800,1
pip_lup_pip934,0,1,0,5,1606885200,1606885200,1
coldcrankcase,0,1,0,1,1588305600,1588305600,1
Lazrath,0,1,0,4,1575435600,1575435600,1
yggdrasil9652,0,1,0,12,1594699200,1594699200,1
DM-ME-DUCKLING-PICS,0,1,0,1,1602993600,1602993600,1
Jonathundaaaaaa,0,1,0,3,1607662800,1607662800,1
Updwardtrendz,0,1,0,1,1608267600,1608267600,1
udes1516,0,1,0,19,1611896400,1611896400,1
spifftt,0,1,0,5,1571716800,1571716800,1
Alone-Pound,0,1,0,-23,1579496400,1579496400,1
suffocatinginlife,0,1,0,2,1579237200,1579237200,1
Triass777,0,1,0,2,1569211200,1569211200,1
geoffery_jefferson,0,1,0,0,1604898000,1604898000,1
OngtheOvatar,1,0,27,0,1583643600,1583643600,1
Oshawott51,0,1,0,7,1594526400,1594526400,1
Pinheaded_nightmare,0,1,0,6,1608958800,1608958800,1
gbr_23,0,1,0,2,1604030400,1604030400,1
ColdStoneAustinStev3,0,1,0,1,1539057600,1539057600,1
ElektronDale,0,1,0,4,1603598400,1603598400,1
Teraxias,0,1,0,3,1592971200,1592971200,1
iss_is_radical,0,1,0,1,1562904000,1562904000,1
TheLesbianAgenda,0,1,0,9,1569816000,1569816000,1
BunnyAwesome,0,1,0,2,1603598400,1603598400,1
ExPatWharfRat,0,1,0,-1,1582088400,1582088400,1
assemblethenation,0,1,0,8,1589256000,1589256000,1
morgs0626,0,1,0,2,1589947200,1589947200,1
Pixelated_Dick,0,1,0,1,1605762000,1605762000,1
Jaalke,0,1,0,1,1590552000,1590552000,1
House_Of_Tides,0,1,0,1,1609477200,1609477200,1
blueblaez,0,1,0,12,1594353600,1594353600,1
Alvareux,0,1,0,1,1606626000,1606626000,1
raptswastaken,0,1,0,1,1600315200,1600315200,1
etraymond,0,1,0,5,1611810000,1611810000,1
CmmdrYarbles,0,1,0,-1,1596168000,1596168000,1
Sandersadventures,0,1,0,5,1599019200,1599019200,1
CarlMarksthespot,1,0,10,0,1574917200,1574917200,1
Haemorrdroid,0,1,0,8,1596254400,1596254400,1
Tuguy420,0,1,0,2,1611982800,1611982800,1
Onikage999,0,1,0,3,1599883200,1599883200,1
Loaffi,0,1,0,6,1580706000,1580706000,1
NeuroticHeroine,0,1,0,5,1567396800,1567396800,1
Fly_U_Fools,0,1,0,1,1608267600,1608267600,1
IAMG222,0,1,0,0,1569124800,1569124800,1
ImageZealousideal338,0,1,0,139,1608872400,1608872400,1
apewithcrayon,1,0,8,0,1595390400,1595390400,1
m0uzer22,0,1,0,5,1600488000,1600488000,1
Waffleworshipper,0,1,0,6,1568260800,1568260800,1
Ohnoyo123,1,0,34,0,1565841600,1565841600,1
ktka,0,1,0,1,1612069200,1612069200,1
Subjectobserver,0,1,0,3,1569124800,1569124800,1
The_De-Lesbianizer,0,1,0,-2,1573966800,1573966800,1
BokChoy71,0,1,0,1,1606798800,1606798800,1
asininedervish,0,1,0,1,1581224400,1581224400,1
Ok_Mathematician2799,0,1,0,1,1599710400,1599710400,1
Follow64,0,1,0,1,1606626000,1606626000,1
MonkeyJunky5,0,1,0,2,1608267600,1608267600,1
Millermatic252,0,1,0,12,1553227200,1553227200,1
DrippyDom,0,1,0,17,1576386000,1576386000,1
SARBEAU34,0,1,0,1,1581051600,1581051600,1
pizzasarehot,0,1,0,1,1600056000,1600056000,1
RideTheRevolution,0,1,0,9,1606021200,1606021200,1
sydneypershaw5,0,1,0,3,1556510400,1556510400,1
ShoutKappa,1,0,15,0,1580014800,1580014800,1
CryingInMySpaghetti,1,0,460,0,1605848400,1605848400,1
davenportboat,0,1,0,5,1576731600,1576731600,1
EUREKAvSEVEN,0,1,0,1,1605589200,1605589200,1
ghostdog1975,0,1,0,2,1557720000,1557720000,1
cereal_number,0,1,0,23,1605675600,1605675600,1
darksomos,0,1,0,10,1606539600,1606539600,1
IronGin,0,1,0,1,1605589200,1605589200,1
gamedevdummy,0,1,0,1,1603512000,1603512000,1
Tullyshodo,0,1,0,1,1604466000,1604466000,1
DanielJomaa,0,1,0,0,1568865600,1568865600,1
Mortadda,0,1,0,-1,1585454400,1585454400,1
realdognoway,0,1,0,2,1608526800,1608526800,1
Zyros_,0,1,0,1,1549342800,1549342800,1
NEETzschean,0,1,0,1,1586404800,1586404800,1
celestialteapotter,1,0,34,0,1574658000,1574658000,1
meowmeowpuff2,0,1,0,1,1593230400,1593230400,1
WideLoquat,0,1,0,4,1599019200,1599019200,1
TopHatFish,0,1,0,1,1596945600,1596945600,1
badboy0101010101,0,1,0,-1,1606626000,1606626000,1
ranqr,0,1,0,3,1579323600,1579323600,1
TYC4,0,1,0,13,1594353600,1594353600,1
YaBoy930,0,1,0,-24,1591502400,1591502400,1
ClashOrCrashman,0,1,0,13,1590120000,1590120000,1
idktheanswers,0,1,0,3,1584936000,1584936000,1
Valkyrja009,0,1,0,1,1606626000,1606626000,1
lemaddog,0,1,0,1,1594267200,1594267200,1
StreetToBeach,0,1,0,0,1594440000,1594440000,1
SamePlace0,0,1,0,-1,1582174800,1582174800,1
SpookySpaghetti420,0,1,0,1,1573794000,1573794000,1
LazyContest,0,1,0,1,1606453200,1606453200,1
ceroproxy,0,1,0,1,1606021200,1606021200,1
LaneKiffinsAlterEgo,0,1,0,2,1590638400,1590638400,1
may_june_july,0,1,0,7,1579755600,1579755600,1
Cvep2,0,1,0,3,1603598400,1603598400,1
GenericMonarchistGuy,0,1,0,7,1560571200,1560571200,1
Stewy_434,0,1,0,8,1606021200,1606021200,1
jedthehedge,0,1,0,2,1605589200,1605589200,1
Harbarbalar,0,1,0,3,1585454400,1585454400,1
Tomachela,0,1,0,1,1585454400,1585454400,1
badrabbitman,0,1,0,2,1589256000,1589256000,1
mmnnumbabedumbumbede,0,1,0,1,1606021200,1606021200,1
insidiousdelight,0,1,0,1,1608267600,1608267600,1
HS-Destroyer,0,1,0,3,1585108800,1585108800,1
pineal_activated,0,1,0,2,1611723600,1611723600,1
klyde_donovan,0,1,0,90,1573966800,1573966800,1
ConradtheMagnificent,0,1,0,2,1606539600,1606539600,1
WookieeSteakIsChewie,0,1,0,0,1611982800,1611982800,1
SanchyCheeks,0,1,0,1,1603512000,1603512000,1
timewast3r,0,1,0,13,1612155600,1612155600,1
Flum3n,0,1,0,8,1551762000,1551762000,1
Z4N0,0,1,0,1,1602129600,1602129600,1
FranklintheTMNT,0,1,0,24,1593403200,1593403200,1
SatanTheMayor,0,1,0,24,1589428800,1589428800,1
OfficialChrsLxndr,1,0,358,0,1611896400,1611896400,1
Hbombera,0,1,0,1,1608267600,1608267600,1
NotATrueRedHead,0,1,0,21,1596168000,1596168000,1
Nire_Dier,0,1,0,-4,1582866000,1582866000,1
DystopianPrince212,0,1,0,8,1588564800,1588564800,1
squirrel8296,0,1,0,3,1589947200,1589947200,1
sneaksafe,0,1,0,1,1600660800,1600660800,1
Tosters1,0,1,0,-6,1606194000,1606194000,1
Simple_Tin,1,0,48,0,1605848400,1605848400,1
eeninety2,0,1,0,1,1578891600,1578891600,1
catdafritz,0,1,0,2,1578200400,1578200400,1
randomgenerator235,0,1,0,2,1576213200,1576213200,1
CitNotCat001,1,0,327,0,1583812800,1583812800,1
inspiredinsanity,0,1,0,45,1600401600,1600401600,1
_General_KenOC_,0,1,0,-2,1606626000,1606626000,1
future_srb,0,1,0,6,1597204800,1597204800,1
noclasshero,0,1,0,68,1604638800,1604638800,1
joeyfromhackers,1,0,171,0,1606021200,1606021200,1
maggot_therapy,0,1,0,3,1603425600,1603425600,1
winedine619,0,1,0,3,1601179200,1601179200,1
Affectionate-Mood382,0,1,0,7,1611896400,1611896400,1
sageway,0,1,0,13,1609045200,1609045200,1
Michento,0,1,0,3,1516856400,1516856400,1
queendead2march19,0,1,0,2,1594180800,1594180800,1
CaptainChalky,0,1,0,16,1605502800,1605502800,1
iamawesomesauc3,0,1,0,3,1608181200,1608181200,1
lunilii,0,1,0,0,1600747200,1600747200,1
Induhcouch,0,1,0,6,1605416400,1605416400,1
Away-Towel6249,0,1,0,1,1637643600,1637643600,1
princecome,0,1,0,1,1592366400,1592366400,1
Unionelectrician136,0,1,0,2,1597032000,1597032000,1
FlyingFluffySocks,0,1,0,1,1596772800,1596772800,1
xm202OAndA,0,1,0,57,1592625600,1592625600,1
RugDaniels,0,1,0,85,1597636800,1597636800,1
GoneGrimdark,0,1,0,3,1579755600,1579755600,1
sproggwoggy,0,1,0,-37,1582693200,1582693200,1
Araneae192,0,1,0,21,1573102800,1573102800,1
Audus_Isaiah,0,1,0,18,1607230800,1607230800,1
mackh11,0,1,0,2,1606626000,1606626000,1
Shellac99,0,1,0,2,1583812800,1583812800,1
faroutc,0,1,0,1,1611982800,1611982800,1
Fire-Flowers,0,1,0,3,1429243200,1429243200,1
Machmann,0,1,0,1,1540353600,1540353600,1
Cephas11,1,0,8,0,1597636800,1597636800,1
TAFFERATU,0,1,0,2,1600660800,1600660800,1
NeonSeal,0,1,0,10,1548392400,1548392400,1
MK0625,0,1,0,2,1606280400,1606280400,1
fdsfhksudfjsmndjhgc,0,1,0,9,1597204800,1597204800,1
zombie-oliver,0,1,0,3,1568520000,1568520000,1
GGExMachina,0,1,0,1,1571284800,1571284800,1
Abceedeeznuz,0,1,0,19,1570766400,1570766400,1
churrosrule,0,1,0,19,1575522000,1575522000,1
Lupinohthelupin,0,1,0,4,1579582800,1579582800,1
VinnieTheVoyeur,0,1,0,1,1597896000,1597896000,1
duckenthusiast17,0,1,0,33,1608354000,1608354000,1
Gonewiththevin,0,1,0,1,1582779600,1582779600,1
vrts,0,1,0,2,1579842000,1579842000,1
JayJay1191,0,1,0,4,1562817600,1562817600,1
cableboi117,0,1,0,1,1606626000,1606626000,1
thisisastupidname,0,1,0,3,1607662800,1607662800,1
strange_fellow,0,1,0,41,1572667200,1572667200,1
Walkerotto,0,1,0,-1,1547269200,1547269200,1
Cave_dweller123,0,1,0,3,1608440400,1608440400,1
morguemutt,0,1,0,1,1602648000,1602648000,1
bbbruh57,0,1,0,1,1608786000,1608786000,1
banjodoctor,0,1,0,5,1612069200,1612069200,1
Spiraljaguar1231,0,1,0,5,1612069200,1612069200,1
Tezos_2018,0,1,0,84,1542949200,1542949200,1
Wizzle_Pizzle_420,0,1,0,1,1603684800,1603684800,1
phrostbyt,0,1,0,5,1585627200,1585627200,1
_logic_victim,0,1,0,7,1592884800,1592884800,1
ComplexFUBAR,0,1,0,3,1590811200,1590811200,1
Grahauk,0,1,0,20,1566705600,1566705600,1
frecklepair,0,1,0,4,1593489600,1593489600,1
Ginfly,0,1,0,2,1471665600,1471665600,1
redscull,0,1,0,1,1608267600,1608267600,1
IXI_FondleBalls_IXI,0,1,0,2,1586577600,1586577600,1
reyx121,0,1,0,14,1553918400,1553918400,1
ManillaEnvelope77,0,1,0,10,1550293200,1550293200,1
Gr8whale,0,1,0,1,1557115200,1557115200,1
samplist,0,1,0,1,1601524800,1601524800,1
CluelessFlunky,0,1,0,1,1607662800,1607662800,1
arden30,1,0,20,0,1567656000,1567656000,1
Nokuto,0,1,0,1,1599278400,1599278400,1
CrocodileCutie143,1,0,5711,0,1606712400,1606712400,1
getspun97,0,1,0,8,1601179200,1601179200,1
WFMthrowaway-1,1,0,23,0,1584244800,1584244800,1
cynetri,0,1,0,5,1599019200,1599019200,1
wockyman,0,1,0,1,1572062400,1572062400,1
Frequent-Professor-8,0,1,0,7,1611896400,1611896400,1
kpdvr4lyfe,0,1,0,292,1574658000,1574658000,1
aunt_snorlax,0,1,0,1,1564113600,1564113600,1
fully_torqued6,0,1,0,7,1556856000,1556856000,1
KoppaHeyHey,0,1,0,-11,1596686400,1596686400,1
warwickmainz,0,1,0,1,1603080000,1603080000,1
IllegalbeagleCO,0,1,0,1,1606626000,1606626000,1
Runaway_5,0,1,0,1,1605157200,1605157200,1
someweeder,1,0,76,0,1588651200,1588651200,1
Konsortium853,0,1,0,1,1593921600,1593921600,1
spitebarf,0,1,0,1,1600660800,1600660800,1
Necrofidelity,1,0,483,0,1608094800,1608094800,1
RaHxRaH,0,1,0,5,1571976000,1571976000,1
schrodinger_s_kitten,0,1,0,7,1569902400,1569902400,1
andrewherrera16,0,1,0,1,1589860800,1589860800,1
Good200000,0,1,0,-1,1599019200,1599019200,1
AtmanPerez,0,1,0,2,1582347600,1582347600,1
hallofames,0,1,0,1,1605934800,1605934800,1
TheSecondFulfillment,0,1,0,1,1593921600,1593921600,1
TheNewPlagueHasBegun,0,1,0,4,1582606800,1582606800,1
bee144,0,1,0,1,1598846400,1598846400,1
FOXHNTR,0,1,0,6,1609131600,1609131600,1
Fuck_This_Guy_Up,0,1,0,26,1611896400,1611896400,1
peniel987,0,1,0,1,1571889600,1571889600,1
Nuckles_56,0,1,0,7,1570075200,1570075200,1
Motleycruefan73,0,1,0,68,1600574400,1600574400,1
SinthoseXanataz,0,1,0,-1,1603684800,1603684800,1
Bidiggity,0,1,0,16,1611896400,1611896400,1
QQZY,0,1,0,1,1591243200,1591243200,1
VikingOfMidgard,0,1,0,522,1580274000,1580274000,1
Ejdoomsday,0,1,0,9,1575694800,1575694800,1
h_lp-m_,0,1,0,3,1596859200,1596859200,1
Panzer_Tank,0,1,0,1,1556424000,1556424000,1
johnsonman1,0,1,0,1,1584417600,1584417600,1
maroonion,0,1,0,1,1605675600,1605675600,1
fakefalsofake,0,1,0,3,1609304400,1609304400,1
chainsawcal87,0,1,0,3,1573448400,1573448400,1
Mendelson_Magic,0,1,0,2,1598846400,1598846400,1
RadioMelon,0,1,0,21,1603598400,1603598400,1
apeach3,0,1,0,1,1560916800,1560916800,1
watchingweeds,0,1,0,3,1572494400,1572494400,1
BernardoBarrabaz,0,1,0,1,1581310800,1581310800,1
thatoneguy512,0,1,0,2,1603512000,1603512000,1
opiunn17,0,1,0,1,1606971600,1606971600,1
akiratoriyamamama,0,1,0,8,1589947200,1589947200,1
taricon,0,1,0,0,1608267600,1608267600,1
ABaadPun,0,1,0,2,1603080000,1603080000,1
ramonmartelle,0,1,0,9,1598241600,1598241600,1
Jaabram,0,1,0,2,1593316800,1593316800,1
Dsly98,0,1,0,1,1608267600,1608267600,1
girdedloins,0,1,0,13,1573794000,1573794000,1
BentoMan,0,1,0,1,1603512000,1603512000,1
littlefishworld,0,1,0,7,1575090000,1575090000,1
fetch28,0,1,0,3,1584072000,1584072000,1
Bluepuck03,0,1,0,-6,1573275600,1573275600,1
DyLnd,0,1,0,398,1591329600,1591329600,1
Wonichtslepzig,0,1,0,2,1609218000,1609218000,1
suirdna,0,1,0,19,1597809600,1597809600,1
LooseTable,1,0,27,0,1568088000,1568088000,1
Pokefan_Van,0,1,0,1,1604466000,1604466000,1
funhater_69,0,1,0,4,1578373200,1578373200,1
alexamurillo,1,0,16,0,1604293200,1604293200,1
JudeMarshal,0,1,0,-8,1603425600,1603425600,1
angelxe1,0,1,0,1,1603512000,1603512000,1
TheFloridaLeague,0,1,0,1,1584504000,1584504000,1
jinisjin12,0,1,0,1,1635134400,1635134400,1
toddthefrog,0,1,0,58,1602043200,1602043200,1
themagalanium,0,1,0,3,1549688400,1549688400,1
SonOfTK421,0,1,0,6,1605157200,1605157200,1
thrakayouface,0,1,0,1,1605589200,1605589200,1
RepressedSpinach,0,1,0,5,1575349200,1575349200,1
Mk1Md1,0,1,0,32,1601870400,1601870400,1
whatisthisgoddamnson,0,1,0,5,1591416000,1591416000,1
mwb1234,0,1,0,4,1597377600,1597377600,1
commentsonyankees,0,1,0,2,1594440000,1594440000,1
BerntMacklin,0,1,0,8,1608181200,1608181200,1
nikovagu,0,1,0,2,1606280400,1606280400,1
_Saxxon_,0,1,0,1,1570680000,1570680000,1
fukredditadmins77,0,1,0,1,1589947200,1589947200,1
TheBlyatMun,0,1,0,2,1579064400,1579064400,1
DozyApeth,1,0,41,0,1559707200,1559707200,1
Spatial__Hatu,0,1,0,2,1565323200,1565323200,1
nornidentity,0,1,0,1,1592798400,1592798400,1
nothingnadazilch,0,1,0,6,1578286800,1578286800,1
yoyoping,0,1,0,1,1605934800,1605934800,1
roachwarrior,0,1,0,258,1608526800,1608526800,1
KVMechelen,0,1,0,2,1608699600,1608699600,1
Freethrowawayer,0,1,0,7,1568001600,1568001600,1
crappy_days,0,1,0,4,1582347600,1582347600,1
D34throooolz,0,1,0,3,1604379600,1604379600,1
myearlymorning,0,1,0,1,1570939200,1570939200,1
patientpump54,0,1,0,5,1597636800,1597636800,1
dasredditnoob,0,1,0,2,1603944000,1603944000,1
nuggetinabiscuit,0,1,0,1,1642827600,1642827600,1
Wellbidlo,0,1,0,3,1604293200,1604293200,1
minutegongcoughs,1,0,101,0,1553054400,1553054400,1
Baltomire,0,1,0,1,1603512000,1603512000,1
thebodyelectrical,0,1,0,50,1578978000,1578978000,1
Shitspear,0,1,0,1,1611982800,1611982800,1
TPSreportsPro,0,1,0,1,1585454400,1585454400,1
Vessecora,0,1,0,45,1611896400,1611896400,1
petunia777,0,1,0,2,1579323600,1579323600,1
I_drive_all_over,0,1,0,1,1602820800,1602820800,1
deusflac,0,1,0,2,1578373200,1578373200,1
SillySausage30,0,1,0,3,1587355200,1587355200,1
AntomoV10,0,1,0,3,1608613200,1608613200,1
Dave_Portnoy,0,1,0,1,1585454400,1585454400,1
Gratterz,0,1,0,1,1558238400,1558238400,1
princessangry83,0,1,0,6,1567483200,1567483200,1
KoekjeHebbe,0,1,0,2,1604898000,1604898000,1
JettisonedJetsam,0,1,0,1,1571889600,1571889600,1
TheDylMonster,0,1,0,0,1582088400,1582088400,1
AbductedFromVoid,0,1,0,8,1563336000,1563336000,1
geed17,0,1,0,1,1605589200,1605589200,1
OtherCaiflower24,0,1,0,-43,1596600000,1596600000,1
sxuiii,0,1,0,6,1600660800,1600660800,1
Tobesity,0,1,0,77,1603339200,1603339200,1
slixx_06,0,1,0,-2,1597723200,1597723200,1
PM_ME_UR_LEFT_NOSE,0,1,0,1,1606626000,1606626000,1
ImperceptibleVolt,0,1,0,5,1608267600,1608267600,1
sevenpointfiveinches,0,1,0,5,1607490000,1607490000,1
huyimara,0,1,0,2,1599624000,1599624000,1
kevoizjawesome,0,1,0,5,1598760000,1598760000,1
tsmcdona,0,1,0,1,1604552400,1604552400,1
Nidsog,0,1,0,5,1601092800,1601092800,1
CaptainDiqhedd,0,1,0,2,1583812800,1583812800,1
Coloursoft,0,1,0,4,1573534800,1573534800,1
Infomusviews1985,0,1,0,2,1606626000,1606626000,1
JuanDifoool,0,1,0,1,1600660800,1600660800,1
bananaphophesy,0,1,0,2,1606626000,1606626000,1
redbulladdict123,1,0,101,0,1607230800,1607230800,1
deadguy88,0,1,0,45,1586836800,1586836800,1
vin_issues,0,1,0,10,1575349200,1575349200,1
dresstokill,0,1,0,14,1603166400,1603166400,1
Whathappened2site13,0,1,0,-2,1606626000,1606626000,1
Lanyxd,0,1,0,2,1590811200,1590811200,1
skeletontipsy,0,1,0,8,1582347600,1582347600,1
Royce222,0,1,0,3,1555905600,1555905600,1
dvlas118,0,1,0,5,1587096000,1587096000,1
thatsabood,0,1,0,37,1595822400,1595822400,1
Enragedsun,0,1,0,11,1584244800,1584244800,1
Htowntillidrownx,0,1,0,5,1598587200,1598587200,1
oleooreo,0,1,0,1,1573707600,1573707600,1
Im-Bad-Lol,0,1,0,-23,1608699600,1608699600,1
flowerboy85,0,1,0,7,1606885200,1606885200,1
kengork_,0,1,0,5,1589428800,1589428800,1
OdoLegIt,0,1,0,6,1572843600,1572843600,1
Ken-Popcorn,0,1,0,3,1575694800,1575694800,1
velociraptorjax,0,1,0,1,1548651600,1548651600,1
YogiTy1988,0,1,0,-1,1593748800,1593748800,1
ribrars,0,1,0,2,1582520400,1582520400,1
Gurukush,0,1,0,3,1606626000,1606626000,1
devon_price,0,1,0,21,1602734400,1602734400,1
loveWithAmedusa,0,1,0,1,1605589200,1605589200,1
SHASUI1,0,1,0,2,1591070400,1591070400,1
tr0lerz,0,1,0,1,1604379600,1604379600,1
MagicMudpuppy,0,1,0,1,1587355200,1587355200,1
nazipuncher86,0,1,0,2,1592798400,1592798400,1
Ronnie_1990,0,1,0,-1,1598500800,1598500800,1
CageyLabRat,0,1,0,3,1597550400,1597550400,1
is-it-a-bot,0,1,0,2,1539662400,1539662400,1
SarahMerigold,0,1,0,1,1598760000,1598760000,1
jyfjdjgfdhgfdfds,0,1,0,-1,1600228800,1600228800,1
Arbiterze,0,1,0,-3,1607576400,1607576400,1
The_Dankinator,0,1,0,4,1579237200,1579237200,1
AulFella,0,1,0,6,1605762000,1605762000,1
fresh-cucumbers,0,1,0,7,1579669200,1579669200,1
preutneuker,0,1,0,6,1599451200,1599451200,1
Electronic_Owl_9819,0,1,0,2,1642136400,1642136400,1
AccountancyAcount,1,0,15,0,1609390800,1609390800,1
more_load_comments,0,1,0,4,1606021200,1606021200,1
CatLick-Carwash,0,1,0,2,1593057600,1593057600,1
mallad,0,1,0,1,1606626000,1606626000,1
Bobbyhomeless87,0,1,0,7,1607662800,1607662800,1
kama94,0,1,0,2,1582779600,1582779600,1
Your_New_Overlord,0,1,0,13,1607576400,1607576400,1
iodbh,1,0,23,0,1466913600,1466913600,1
0neSock,0,1,0,4,1602648000,1602648000,1
HORRIBLE_a_names,0,1,0,1,1589947200,1589947200,1
flamingitch,0,1,0,7,1606021200,1606021200,1
UpgradedGamer,0,1,0,32,1608958800,1608958800,1
InternetAccount04,0,1,0,2,1590033600,1590033600,1
FartingGerbil,0,1,0,10,1591243200,1591243200,1
Weisshuf,0,1,0,22,1599624000,1599624000,1
dangusmaximus,0,1,0,1,1608267600,1608267600,1
Fingers0689,0,1,0,1,1609304400,1609304400,1
mattiwha,0,1,0,1,1609045200,1609045200,1
WafflesMc,0,1,0,0,1582866000,1582866000,1
lsagan123,0,1,0,2,1605070800,1605070800,1
GreenPlumbus,0,1,0,1,1577077200,1577077200,1
LF_Pats,0,1,0,-1,1581224400,1581224400,1
tillersaurus,0,1,0,1,1588305600,1588305600,1
krishkun,1,0,42,0,1606280400,1606280400,1
cassius0427,0,1,0,1,1592798400,1592798400,1
ItsDanielFTW,0,1,0,-1,1577422800,1577422800,1
Madaman333,0,1,0,2,1550379600,1550379600,1
FluffyLlama04,0,1,0,2,1597032000,1597032000,1
SamBBMe,0,1,0,1,1605502800,1605502800,1
christianispaco,0,1,0,10,1574139600,1574139600,1
IWantToBeTheBoshy,0,1,0,0,1582779600,1582779600,1
vellummoon,0,1,0,4,1602820800,1602820800,1
OSRSRedditAlt,0,1,0,-2,1598155200,1598155200,1
WeaponizedAutoism,0,1,0,-4,1598068800,1598068800,1
ImpressivePlace8,0,1,0,5,1595908800,1595908800,1
hoteppeter,0,1,0,0,1608354000,1608354000,1
aaron8781,0,1,0,3,1571976000,1571976000,1
biffgrifffifth,0,1,0,1,1603512000,1603512000,1
gaixi0sh,0,1,0,2,1573016400,1573016400,1
friedchickensandwish,1,0,52,0,1606712400,1606712400,1
notpreposterous,1,0,74,0,1607230800,1607230800,1
CharmingAnimal,1,0,8,0,1568001600,1568001600,1
Yellowhairdontcare,1,0,15,0,1566964800,1566964800,1
FunCube,0,1,0,5,1598414400,1598414400,1
rototito,0,1,0,14,1600315200,1600315200,1
LOLXDRANDOMFUNNY,0,1,0,3,1606194000,1606194000,1
f_ckingandpunching,0,1,0,0,1604638800,1604638800,1
AD1080p,0,1,0,8,1608267600,1608267600,1
Visca87,0,1,0,2,1579410000,1579410000,1
Alone-Carpenter-3201,0,1,0,1,1600920000,1600920000,1
fennomaani,0,1,0,0,1591329600,1591329600,1
nelsnelson,0,1,0,17,1559102400,1559102400,1
Amazing-Squash,0,1,0,1,1589515200,1589515200,1
LawrencePreacher,0,1,0,2,1634529600,1634529600,1
Dishwasher9500,0,1,0,184,1612155600,1612155600,1
Incredible_Witness,0,1,0,5,1608354000,1608354000,1
TalktotheJITB,0,1,0,2,1606798800,1606798800,1
cvantass,0,1,0,1,1581051600,1581051600,1
bbpr120,0,1,0,3,1570420800,1570420800,1
herecomethehotpepper,0,1,0,1,1605589200,1605589200,1
darkmorpha71,0,1,0,2,1591329600,1591329600,1
Isontre,1,0,21,0,1600315200,1600315200,1
anon_girlie369,0,1,0,5,1569384000,1569384000,1
NocturnalNympho,0,1,0,12,1592193600,1592193600,1
DobryDobrodziej,0,1,0,1,1563336000,1563336000,1
sit_giRL,0,1,0,2,1600747200,1600747200,1
mariatoyou,0,1,0,1,1583470800,1583470800,1
SDelectricity,0,1,0,2,1569124800,1569124800,1
DoctorAMDC,0,1,0,1,1637902800,1637902800,1
Flargnoogle,0,1,0,2,1607749200,1607749200,1
theDoblin,0,1,0,2,1603512000,1603512000,1
SweetCans928,0,1,0,8,1603684800,1603684800,1
IAmHavox,0,1,0,1,1612069200,1612069200,1
spikewalls,0,1,0,152,1607490000,1607490000,1
PowerPCGamer,0,1,0,-5,1603512000,1603512000,1
Snorrep,0,1,0,3,1596600000,1596600000,1
worthysmash,0,1,0,4,1598414400,1598414400,1
Delanorix,0,1,0,14,1576386000,1576386000,1
kordhell_,0,1,0,1,1599451200,1599451200,1
bwad40,1,0,10,0,1595390400,1595390400,1
garwil,0,1,0,2,1597809600,1597809600,1
NetflixAndZzzzzz,0,1,0,8,1586404800,1586404800,1
cookster123,0,1,0,1,1612069200,1612069200,1
bayo1,0,1,0,1,1602734400,1602734400,1
TheWierdGuy,0,1,0,-97,1605070800,1605070800,1
pkreilley,0,1,0,19,1582866000,1582866000,1
akelabrood,0,1,0,16,1596168000,1596168000,1
Cashmere_and_Wine,0,1,0,2,1572321600,1572321600,1
cc7rip,0,1,0,9,1601438400,1601438400,1
frankmontanasosa,0,1,0,3,1602302400,1602302400,1
DankerThanAWanker,0,1,0,2,1607230800,1607230800,1
JonkersTwix,0,1,0,17,1586836800,1586836800,1
_TheUnluckyDuckling_,0,1,0,0,1585454400,1585454400,1
skharppi,0,1,0,13,1578373200,1578373200,1
jooooonnny,0,1,0,2,1603512000,1603512000,1
jsha11,0,1,0,3,1569816000,1569816000,1
girlfeud,1,0,585,0,1558584000,1558584000,1
YangPolicyBot,0,1,0,4,1566187200,1566187200,1
JuiceAndJews,0,1,0,11,1583643600,1583643600,1
AdelineRose-,0,1,0,5,1599710400,1599710400,1
foomits,0,1,0,3,1606539600,1606539600,1
Xandicapped,0,1,0,1,1602129600,1602129600,1
Nearby_Airline_1209,1,0,2,0,1607749200,1607749200,1
defectivememelord,0,1,0,-4,1607662800,1607662800,1
bleachtiger,0,1,0,13,1611896400,1611896400,1
cygnusness,0,1,0,31,1600401600,1600401600,1
seductive_radish,0,1,0,0,1546578000,1546578000,1
Minus-Celsius,0,1,0,1,1603598400,1603598400,1
shanelomax,0,1,0,2,1599451200,1599451200,1
AutoCrosspostBot,1,0,1,0,1601870400,1601870400,1
rockcyka,0,1,0,2,1608526800,1608526800,1
PaidToBeRedditing,0,1,0,-3,1547614800,1547614800,1
derperella23,0,1,0,5,1606539600,1606539600,1
RootlessBoots,0,1,0,4,1566446400,1566446400,1
whittgud,1,0,0,0,1577077200,1577077200,1
Mulley-It-Over,0,1,0,1,1588996800,1588996800,1
AgletsHowDoTheyWork,0,1,0,12,1567051200,1567051200,1
MerchantDrip6,0,1,0,3,1600833600,1600833600,1
biggystigs1086,0,1,0,1,1596340800,1596340800,1
Somegeezer,0,1,0,36,1599451200,1599451200,1
_yoshimi_,1,0,596,0,1587960000,1587960000,1
bigmoneybass,0,1,0,1,1580619600,1580619600,1
1999Jh,1,0,822,0,1599883200,1599883200,1
harpon-baleine,0,1,0,1,1604116800,1604116800,1
queen_bean5,0,1,0,28,1603512000,1603512000,1
KronoakSCG,0,1,0,1,1604466000,1604466000,1
Subapical,0,1,0,2,1609131600,1609131600,1
chinesetakeout91,0,1,0,1,1606626000,1606626000,1
disenchantedbrony,0,1,0,22,1575003600,1575003600,1
Pacers31Colts18,0,1,0,1,1612069200,1612069200,1
-Tazz-,0,1,0,10,1581656400,1581656400,1
comraderonin,0,1,0,2,1572753600,1572753600,1
imjp,0,1,0,-2,1606539600,1606539600,1
ruffolution,1,0,12,0,1449982800,1449982800,1
Akitz,0,1,0,-2,1604898000,1604898000,1
captncobalt,0,1,0,1,1605589200,1605589200,1
-peepee-poopoo-,0,1,0,3,1597204800,1597204800,1
smolbeanerino,0,1,0,5,1579755600,1579755600,1
lurkyllama,0,1,0,6,1588478400,1588478400,1
Bluesteel447,0,1,0,2,1583726400,1583726400,1
juansch,0,1,0,7,1560744000,1560744000,1
NotHighEnuf,0,1,0,2,1599105600,1599105600,1
Gen-Jinjur,0,1,0,8,1597809600,1597809600,1
bartlebae-is-dog,0,1,0,16,1608699600,1608699600,1
lifeisatripimstoned,0,1,0,3,1609218000,1609218000,1
FartsMcPoo,0,1,0,2,1583125200,1583125200,1
Doiq,0,1,0,16,1602129600,1602129600,1
LarrySGx,0,1,0,14,1572580800,1572580800,1
max-tronco,0,1,0,54,1592366400,1592366400,1
Big3gg,0,1,0,1,1608526800,1608526800,1
GQJustfly,0,1,0,1,1608267600,1608267600,1
polaris100k,0,1,0,1,1606280400,1606280400,1
No_Return_From_86,0,1,0,1,1579410000,1579410000,1
myjornut88,0,1,0,-1,1582779600,1582779600,1
snarkyBtch,0,1,0,1,1606626000,1606626000,1
destroyer_of_fascism,0,1,0,2,1574053200,1574053200,1
stormiesturchin,0,1,0,1,1606280400,1606280400,1
kafircake,0,1,0,7,1602129600,1602129600,1
FondantFick,0,1,0,4,1605589200,1605589200,1
Leapday14,0,1,0,-12,1594353600,1594353600,1
dice726,0,1,0,3,1604811600,1604811600,1
corviphobia,0,1,0,28,1559793600,1559793600,1
showmustgo,1,0,119,0,1583298000,1583298000,1
Turtlleson,0,1,0,9,1571716800,1571716800,1
lordover123,0,1,0,2,1598328000,1598328000,1
justadude0144,0,1,0,1,1599019200,1599019200,1
Splinter1591,0,1,0,2,1574398800,1574398800,1
zabtown,0,1,0,4,1557288000,1557288000,1
FuriousManatee242,1,0,138,0,1570766400,1570766400,1
Mattdehaven,0,1,0,2,1603598400,1603598400,1
Shannooty,0,1,0,1,1583985600,1583985600,1
Ginger4life23,0,1,0,1,1596254400,1596254400,1
Kenexxa,1,0,678,0,1593403200,1593403200,1
Mrwtldrop,0,1,0,28,1608181200,1608181200,1
LowSelfEsteemButFine,0,1,0,24,1605589200,1605589200,1
beans_lel,0,1,0,13,1573707600,1573707600,1
toasties1000,0,1,0,1,1597291200,1597291200,1
niels_henrik_abel,0,1,0,14,1534824000,1534824000,1
GlitteringGas4,0,1,0,8,1598241600,1598241600,1
sasajack,0,1,0,1,1606280400,1606280400,1
jaffacookie,0,1,0,14,1589428800,1589428800,1
arod1909,0,1,0,1,1591329600,1591329600,1
MusiKube,0,1,0,1,1604466000,1604466000,1
GloomyData,0,1,0,1,1600833600,1600833600,1
harrytheghoul,0,1,0,6,1577509200,1577509200,1
krunchwrap_supreme1,0,1,0,1,1605589200,1605589200,1
iamtheguythatis23,0,1,0,1,1604984400,1604984400,1
Fireandbud,1,0,58,0,1592798400,1592798400,1
drewskadoowecan2,0,1,0,2,1578286800,1578286800,1
Fion_Shono,0,1,0,3,1568865600,1568865600,1
PaulMorphyForPrez,0,1,0,2,1605243600,1605243600,1
Thrakioti,0,1,0,0,1578891600,1578891600,1
oddular,0,1,0,3,1598155200,1598155200,1
Smooth_Ad_4631,0,1,0,3,1607835600,1607835600,1
LVKiller420,0,1,0,1,1604552400,1604552400,1
Ozymandias_III,0,1,0,4,1576213200,1576213200,1
Daneww,0,1,0,2,1596859200,1596859200,1
Mushroomgirl_7,0,1,0,2,1552968000,1552968000,1
certstatus,0,1,0,11,1571630400,1571630400,1
Wonkeyfingers,0,1,0,1,1603684800,1603684800,1
dancingnutria,0,1,0,14,1608094800,1608094800,1
CountMiracula,0,1,0,1,1608699600,1608699600,1
anotherpenguin229,0,1,0,13,1604030400,1604030400,1
TheAverage_American,0,1,0,4,1588392000,1588392000,1
Creedofrest,0,1,0,18,1587441600,1587441600,1
nythnggs4590,0,1,0,2,1607662800,1607662800,1
snewsefar,0,1,0,1,1594785600,1594785600,1
TheRileyss,0,1,0,3,1578114000,1578114000,1
utack,0,1,0,9,1603512000,1603512000,1
kimbooley90,0,1,0,2,1567051200,1567051200,1
Mikecool51,0,1,0,2,1602907200,1602907200,1
BuildingNoBookCase,0,1,0,10,1606366800,1606366800,1
_pinaexpress,0,1,0,1,1580101200,1580101200,1
left_click,0,1,0,1,1608872400,1608872400,1
skinnyhikes,0,1,0,58,1577336400,1577336400,1
Nom_de_Guerre_23,0,1,0,3,1570334400,1570334400,1
jr8787,0,1,0,7,1592366400,1592366400,1
premifcom,1,0,1,0,1456635600,1456635600,1
VanHoy,1,0,7,0,1606107600,1606107600,1
spac3_cadet12,0,1,0,1,1588392000,1588392000,1
BelleVieLime,0,1,0,2,1608526800,1608526800,1
Accomplished_Hat_576,0,1,0,4,1601352000,1601352000,1
The_Station_Agent,0,1,0,1,1605416400,1605416400,1
Random--someone,0,1,0,1,1597636800,1597636800,1
xochitlmariposa,1,0,451,0,1593921600,1593921600,1
tmoney99211,0,1,0,-5,1607835600,1607835600,1
Responsible-Meringue,0,1,0,1,1607317200,1607317200,1
LovecraftianBeyBlade,0,1,0,1,1564545600,1564545600,1
Fox-and-Sons,0,1,0,2,1606626000,1606626000,1
Elamachino,0,1,0,2,1579064400,1579064400,1
xserenity520,0,1,0,5,1575522000,1575522000,1
greenleefs,0,1,0,2,1576386000,1576386000,1
internetheroxD,0,1,0,28,1573534800,1573534800,1
Flowertree1,0,1,0,1,1599710400,1599710400,1
randomq17,0,1,0,6,1575349200,1575349200,1
Kalbo_Masamang-tao,0,1,0,5,1607144400,1607144400,1
kohasz,0,1,0,1,1601265600,1601265600,1
DaywalkerLight,0,1,0,1,1607317200,1607317200,1
Hakv7,0,1,0,4,1597723200,1597723200,1
Turkpowered,0,1,0,1,1607922000,1607922000,1
Lcards943,0,1,0,2,1580878800,1580878800,1
fleetwoodchick,1,0,15,0,1561867200,1561867200,1
Faerbera,0,1,0,7,1608526800,1608526800,1
abnruby,0,1,0,6,1573534800,1573534800,1
MattyBfan1502,0,1,0,-1,1580360400,1580360400,1
Avbitten,0,1,0,4,1556424000,1556424000,1
TumblrInGarbage,0,1,0,2,1603512000,1603512000,1
there_and_square,0,1,0,3,1539921600,1539921600,1
12FeetSpacers,0,1,0,49,1597809600,1597809600,1
use-your-choosername,0,1,0,2,1588824000,1588824000,1
adsarepropaganda,0,1,0,1,1599105600,1599105600,1
sirenCiri,0,1,0,39,1611810000,1611810000,1
GentleDaoist,0,1,0,2,1590120000,1590120000,1
rjpdlc,0,1,0,2,1597896000,1597896000,1
sm3llslikevict0ry,0,1,0,2,1600574400,1600574400,1
NepalesePasta,0,1,0,6,1565236800,1565236800,1
redbabypanda,0,1,0,12,1545454800,1545454800,1
CJ090,0,1,0,1,1582088400,1582088400,1
numberduck,0,1,0,7,1581224400,1581224400,1
tramtramtramtram,0,1,0,3,1608008400,1608008400,1
2TeraByteTom,0,1,0,1,1555387200,1555387200,1
rhysdeschain,1,0,252,0,1600142400,1600142400,1
Dustin_B,0,1,0,1,1582174800,1582174800,1
itsprofessork,0,1,0,1,1604811600,1604811600,1
pixie_wrangler_,0,1,0,-15,1593230400,1593230400,1
RM-13,0,1,0,17,1576645200,1576645200,1
RaiderMan1,0,1,0,2,1611982800,1611982800,1
doomsword6,0,1,0,1,1602734400,1602734400,1
flmay,1,0,18,0,1582174800,1582174800,1
KittyLikeAFlatTire,0,1,0,12,1589342400,1589342400,1
shnitzie247,0,1,0,2,1606885200,1606885200,1
BDownsy,0,1,0,-2,1605934800,1605934800,1
Fortinue_,0,1,0,-1,1609218000,1609218000,1
Clymbz,0,1,0,1,1569211200,1569211200,1
Itsallsomagical,0,1,0,12,1580014800,1580014800,1
lostkarma4anonymity,0,1,0,1,1608526800,1608526800,1
Bexi_,0,1,0,6,1574658000,1574658000,1
WritesInGregg,0,1,0,2,1612069200,1612069200,1
joejoeaz,0,1,0,1,1589947200,1589947200,1
onalonelyisland,0,1,0,55,1564977600,1564977600,1
Ziaki,0,1,0,1,1573794000,1573794000,1
Aartid2,0,1,0,1,1588046400,1588046400,1
SavageDriller,0,1,0,1,1608613200,1608613200,1
ElegantElephant42,0,1,0,35,1572667200,1572667200,1
aurinotari,0,1,0,2,1587182400,1587182400,1
TridentWielder,0,1,0,2,1597982400,1597982400,1
Whistler_V6T,0,1,0,4,1603425600,1603425600,1
queenaslaug2,0,1,0,9,1584763200,1584763200,1
rzr-shrp_crck-rdr,0,1,0,1,1598155200,1598155200,1
lizardbear7,0,1,0,2,1574053200,1574053200,1
xylit25,0,1,0,3,1597204800,1597204800,1
tehache,0,1,0,1,1605589200,1605589200,1
Hypersapien503,0,1,0,1,1597723200,1597723200,1
Curb5Enthusiasm,0,1,0,40,1607403600,1607403600,1
person144,0,1,0,5,1600488000,1600488000,1
TKM421,0,1,0,1,1574571600,1574571600,1
locri,0,1,0,2,1601524800,1601524800,1
EyeAmYouAreMe,0,1,0,3,1598068800,1598068800,1
anynominus,0,1,0,1,1608267600,1608267600,1
ecidarrac,0,1,0,-6,1604811600,1604811600,1
Significant_Quote341,1,0,1,0,1609390800,1609390800,1
PuppetShowJustice,0,1,0,1,1603512000,1603512000,1
marcusjackson1995,0,1,0,2,1597982400,1597982400,1
TTenker,0,1,0,100,1596081600,1596081600,1
Luda_Chris_,0,1,0,2,1603512000,1603512000,1
GenuineSounds,0,1,0,2,1602475200,1602475200,1
A_one_legged_man,0,1,0,1,1552449600,1552449600,1
foxtrout-uniform,0,1,0,2,1579496400,1579496400,1
buttWILLyou,0,1,0,1,1600660800,1600660800,1
teeks-a-million,0,1,0,15,1606971600,1606971600,1
ZoidGerg,0,1,0,9,1597118400,1597118400,1
NoxTempus,0,1,0,11,1603598400,1603598400,1
oneloveonelove,0,1,0,4,1591588800,1591588800,1
Mr_Trumps__Wild_Ride,0,1,0,-1,1577336400,1577336400,1
SgtBadManners,0,1,0,13,1585540800,1585540800,1
BaroniPhoneRepair,0,1,0,9,1609390800,1609390800,1
OF_Jehuty,0,1,0,126,1609045200,1609045200,1
ichooserum,0,1,0,4,1607490000,1607490000,1
iok,0,1,0,2,1587096000,1587096000,1
NetPie22,0,1,0,11,1578373200,1578373200,1
Gibsonites,0,1,0,8,1585454400,1585454400,1
ThisIsGoobly,0,1,0,11,1576386000,1576386000,1
Forfucksakesreally,0,1,0,15,1580792400,1580792400,1
cretaokada,0,1,0,2,1609390800,1609390800,1
dynamic_logic,0,1,0,8,1584936000,1584936000,1
thebetterpolitician,0,1,0,0,1604379600,1604379600,1
ErchamionHS,0,1,0,3,1596772800,1596772800,1
_Ophelianix78,0,1,0,6,1588392000,1588392000,1
mpwiley,0,1,0,3,1603771200,1603771200,1
kanakot33,0,1,0,1,1598155200,1598155200,1
Violinjuggler,0,1,0,20,1607662800,1607662800,1
goofandaspoof,0,1,0,9,1598673600,1598673600,1
hotpinkhoe,0,1,0,11,1566273600,1566273600,1
QuinntoB3an,0,1,0,5,1611896400,1611896400,1
heroesforsale,0,1,0,4,1597896000,1597896000,1
the-ox1921,0,1,0,6,1573534800,1573534800,1
Nytfa11,0,1,0,2,1589947200,1589947200,1
jarinatorman,0,1,0,1,1612069200,1612069200,1
ReflexEight,0,1,0,16,1605848400,1605848400,1
SnowflakesAloft,0,1,0,35,1604466000,1604466000,1
rjp17,0,1,0,5,1587268800,1587268800,1
Dont420blazemebruh,0,1,0,9,1579669200,1579669200,1
Mr_Turret,0,1,0,23,1592193600,1592193600,1
PEACHYSTING,0,1,0,-13,1581397200,1581397200,1
WhackedDestiny,0,1,0,1,1591329600,1591329600,1
terroristteddy,0,1,0,1,1606712400,1606712400,1
nia_399,1,0,24,0,1599105600,1599105600,1
WylFyre,0,1,0,1,1600488000,1600488000,1
sleepdeprivedwizard,0,1,0,2,1590465600,1590465600,1
Rhinocerotic,0,1,0,1,1605070800,1605070800,1
azgreta,1,0,115,0,1607662800,1607662800,1
screamchalklimited,0,1,0,9,1558065600,1558065600,1
thinkaboutspace,0,1,0,3,1572843600,1572843600,1
fishymonster_,0,1,0,1,1594353600,1594353600,1
NOWORKNIBA,1,0,19,0,1578459600,1578459600,1
Alarming_Challenge,0,1,0,0,1604116800,1604116800,1
Hanayama0,0,1,0,2,1580965200,1580965200,1
foulafine_btX,0,1,0,1,1585627200,1585627200,1
beaudha,0,1,0,1,1584244800,1584244800,1
Gerterd,0,1,0,6,1593144000,1593144000,1
strangelove77,0,1,0,4,1604293200,1604293200,1
agentCDE,0,1,0,5,1555041600,1555041600,1
Whatamensch,0,1,0,2,1597982400,1597982400,1
dontknowwhyim,0,1,0,2,1608699600,1608699600,1
ReconIsMy2ndWidow,0,1,0,1,1585454400,1585454400,1
DaGoob,0,1,0,1,1640062800,1640062800,1
Whatzit_Tuuyah,0,1,0,2,1597723200,1597723200,1
DrBageltron,0,1,0,2,1578373200,1578373200,1
PM_ME_NUDES_PLEEZ,0,1,0,1,1605848400,1605848400,1
wzd_cracks,0,1,0,27,1602820800,1602820800,1
pinkfriend007,1,0,11,0,1599451200,1599451200,1
oompaloompafoompa,0,1,0,19,1551157200,1551157200,1
uriboo,0,1,0,3,1605934800,1605934800,1
chairman-me0w,0,1,0,150,1575090000,1575090000,1
StreamCrossedLovers,0,1,0,10,1573102800,1573102800,1
guylakian,0,1,0,1,1579928400,1579928400,1
donuteatmycake,0,1,0,125,1588132800,1588132800,1
Just-A-Tax-Folder,0,1,0,1,1605589200,1605589200,1
myrrhbeast,1,0,11,0,1476158400,1476158400,1
udayserection,0,1,0,2,1601524800,1601524800,1
ThieveOfPrinces,0,1,0,1,1603512000,1603512000,1
moogle3,0,1,0,1,1570075200,1570075200,1
ConvertedTaco,0,1,0,1,1605589200,1605589200,1
Tak_Jaehon,0,1,0,7,1606280400,1606280400,1
Hoitaa,0,1,0,1,1585454400,1585454400,1
illegalqueer,1,0,150,0,1544677200,1544677200,1
Wihmdy,0,1,0,0,1606885200,1606885200,1
pilgrim1812,0,1,0,1,1591329600,1591329600,1
ionlywanttobewithyou,0,1,0,3,1599278400,1599278400,1
capnflapjack93,0,1,0,3,1568433600,1568433600,1
Lenyngrad,0,1,0,1,1579755600,1579755600,1
miserlyape,0,1,0,3,1582002000,1582002000,1
lagattina,0,1,0,5,1590811200,1590811200,1
thegreatone998,0,1,0,11,1593662400,1593662400,1
Latricc,1,0,422,0,1599710400,1599710400,1
WellDressedLoser,0,1,0,6,1582434000,1582434000,1
bass7878,0,1,0,-7,1590897600,1590897600,1
Skakitty,0,1,0,1,1571889600,1571889600,1
Beatrice_Dragon,0,1,0,21,1611810000,1611810000,1
dyingforeverr,0,1,0,3,1575954000,1575954000,1
Gozillasbday,0,1,0,6,1608699600,1608699600,1
ophello,0,1,0,0,1612760400,1612760400,1
gretsall,0,1,0,4,1576472400,1576472400,1
bitchitits,0,1,0,1,1604466000,1604466000,1
CurveOfTheUniverse,0,1,0,2,1604116800,1604116800,1
LewdElfKatya,0,1,0,25,1587528000,1587528000,1
Marxist_Morgana,0,1,0,5,1604466000,1604466000,1
disktoaster,0,1,0,13,1603512000,1603512000,1
angryninja,0,1,0,4,1576558800,1576558800,1
Rs251,0,1,0,1,1607317200,1607317200,1
irritablemagpie,0,1,0,5,1606971600,1606971600,1
imperialpidgeon,0,1,0,2,1609390800,1609390800,1
czar_the_bizarre,0,1,0,39,1572148800,1572148800,1
chafos,0,1,0,21,1609304400,1609304400,1
embarrassmyself,0,1,0,2,1590724800,1590724800,1
pacingpilot,0,1,0,9,1592884800,1592884800,1
fmw1371,0,1,0,1,1603598400,1603598400,1
saeglopuralifi,0,1,0,3,1578027600,1578027600,1
KoopaKing16,0,1,0,8,1591243200,1591243200,1
kollontaine,0,1,0,1,1597464000,1597464000,1
panicinbabylon,0,1,0,1,1603512000,1603512000,1
bodom114,0,1,0,2,1605070800,1605070800,1
croppyboi,1,0,1,0,1588046400,1588046400,1
TeamCameron,0,1,0,1,1606626000,1606626000,1
PanTrimtab,0,1,0,4,1599624000,1599624000,1
big_ol_dad_dick,0,1,0,4,1598760000,1598760000,1
ultim88,0,1,0,12,1604030400,1604030400,1
kippysmith1231,0,1,0,10,1605762000,1605762000,1
hshdjfjdj,0,1,0,-1,1584244800,1584244800,1
TheGrandeLurker,0,1,0,2,1591156800,1591156800,1
dimperry,0,1,0,1,1603512000,1603512000,1
PhiloRex,0,1,0,1,1608786000,1608786000,1
BrainzKong,0,1,0,-3,1592971200,1592971200,1
Not_a-bot-i_swear,0,1,0,3,1604984400,1604984400,1
PBRmy,0,1,0,9,1598846400,1598846400,1
BluthiIndustries,0,1,0,136,1570420800,1570420800,1
2young2young,0,1,0,-1,1580274000,1580274000,1
_Kaib_,0,1,0,6,1591934400,1591934400,1
qwerty123---,0,1,0,1,1611982800,1611982800,1
qthequaint,0,1,0,35,1602043200,1602043200,1
fleshturnstoword,1,0,16,0,1581742800,1581742800,1
Eli_Fox,0,1,0,0,1598846400,1598846400,1
NateLeport,0,1,0,0,1571976000,1571976000,1
fingolfinz,0,1,0,1,1585454400,1585454400,1
doakickflop,0,1,0,1,1570680000,1570680000,1
ThusWankZarathustra,0,1,0,5,1609304400,1609304400,1
IranContraRedux,0,1,0,-10,1571025600,1571025600,1
roaringstar44,0,1,0,1,1600660800,1600660800,1
doorstopdave,0,1,0,1,1603512000,1603512000,1
Capital4145,0,1,0,1,1606626000,1606626000,1
batture,1,0,1892,0,1585195200,1585195200,1
ghostwizard82,1,0,566,0,1607749200,1607749200,1
Hillybunker,0,1,0,18,1553486400,1553486400,1
sthld86,0,1,0,-6,1606626000,1606626000,1
Appelknaller,0,1,0,15,1598673600,1598673600,1
dekachin5,0,1,0,1,1591243200,1591243200,1
IPeeSittingDown69,0,1,0,3,1603598400,1603598400,1
michellesgraphics,0,1,0,7,1604898000,1604898000,1
Elliot_Fox,0,1,0,1,1593057600,1593057600,1
tomb0ne,0,1,0,1,1599624000,1599624000,1
Cpt_squishy,1,0,51,0,1604984400,1604984400,1
TheJayde,0,1,0,1,1585454400,1585454400,1
Sp0nGeBobSquArEpAntZ,0,1,0,2,1559793600,1559793600,1
scottyjayyinDAhouse,0,1,0,1,1571889600,1571889600,1
CobraKraftSingles,0,1,0,3,1587182400,1587182400,1
litterpawz,1,0,10,0,1588996800,1588996800,1
Friendly_Syndicalist,0,1,0,9,1583899200,1583899200,1
Princess_Bunny1,0,1,0,-1,1589515200,1589515200,1
badillin,0,1,0,2,1590033600,1590033600,1
steve_was_here,0,1,0,1,1591329600,1591329600,1
coolluck33,0,1,0,2,1589860800,1589860800,1
FreidrichEngelss,0,1,0,7,1582088400,1582088400,1
sexydangernoodle,0,1,0,3,1608786000,1608786000,1
Udonnomi,0,1,0,91,1582261200,1582261200,1
Mickydsokay,0,1,0,1,1607922000,1607922000,1
ansteve1,0,1,0,24,1606539600,1606539600,1
Kenjammnogo,0,1,0,3,1590984000,1590984000,1
reyizreis,0,1,0,3,1597896000,1597896000,1
hikeandbike33,0,1,0,4,1608872400,1608872400,1
youcanbroom,0,1,0,9,1584763200,1584763200,1
mkmllr,0,1,0,3,1600315200,1600315200,1
alexandroid97,0,1,0,2,1578114000,1578114000,1
Benito_Juarez5,0,1,0,1,1577854800,1577854800,1
youdontknowme872,0,1,0,1,1596772800,1596772800,1
mambz12,0,1,0,-7,1602648000,1602648000,1
ChaseTheSavage64,0,1,0,1,1573621200,1573621200,1
Zharick_,0,1,0,19,1600228800,1600228800,1
wheatpuncher,0,1,0,7,1597118400,1597118400,1
dirrtydoogzz86,0,1,0,-2,1608267600,1608267600,1
Jeeves5196,0,1,0,3,1583812800,1583812800,1
Darkmortal10,0,1,0,2,1606626000,1606626000,1
Idan7856,0,1,0,-3,1608526800,1608526800,1
ThreatLvlMidnght,1,0,102,0,1565755200,1565755200,1
Ryanmarioco,0,1,0,-4,1590552000,1590552000,1
artsymineral,0,1,0,1,1603512000,1603512000,1
gtle2336,0,1,0,85,1596168000,1596168000,1
slitheringsavage,0,1,0,2,1608786000,1608786000,1
AnonUser1804,0,1,0,0,1589342400,1589342400,1
Kayliee73,0,1,0,-6,1588824000,1588824000,1
peanutbutterbriitlle,0,1,0,7,1567828800,1567828800,1
Saltylures2,0,1,0,16,1594008000,1594008000,1
one-big-bean,0,1,0,1,1606626000,1606626000,1
deathsyndrome,0,1,0,2,1566014400,1566014400,1
moonboy3000,0,1,0,1,1594872000,1594872000,1
The_Littlest_Teapot,0,1,0,1,1598760000,1598760000,1
genghis-san,0,1,0,25,1584244800,1584244800,1
Erikthonius,0,1,0,10,1526529600,1526529600,1
Alainx277,0,1,0,3,1607576400,1607576400,1
queeblo40,0,1,0,14,1593489600,1593489600,1
stillneet20,0,1,0,1,1601092800,1601092800,1
DynabladeWings,0,1,0,81,1606539600,1606539600,1
Mace109,0,1,0,3,1589860800,1589860800,1
ratskilledme,0,1,0,1,1592539200,1592539200,1
Titania_07012020,0,1,0,-30,1601870400,1601870400,1
RedHawwk,0,1,0,7,1572321600,1572321600,1
ConnorBigMuscles,0,1,0,2,1582088400,1582088400,1
Raidertck,0,1,0,6,1602475200,1602475200,1
livinglavidaloca69,0,1,0,2,1582088400,1582088400,1
RumDz7,0,1,0,2,1601265600,1601265600,1
Izzy5466,0,1,0,1,1598068800,1598068800,1
hasotothemaxo,0,1,0,-1,1568174400,1568174400,1
Chief_Scrub,0,1,0,1,1611982800,1611982800,1
petitelephanteau,0,1,0,19,1606280400,1606280400,1
VivaLaGuerraPopular_,0,1,0,2,1606539600,1606539600,1
KindheartednessOk684,1,0,913,0,1609304400,1609304400,1
Sciencetor2,0,1,0,-1,1598500800,1598500800,1
JamSanga3000,0,1,0,10,1599019200,1599019200,1
G_DuBs,0,1,0,1,1593921600,1593921600,1
Schmimps,0,1,0,9,1602734400,1602734400,1
jthawks,0,1,0,2,1607317200,1607317200,1
ComplicatedShoes1070,0,1,0,-8,1584072000,1584072000,1
BortonForger,0,1,0,15,1605934800,1605934800,1
Oogentog,0,1,0,3,1602129600,1602129600,1
adankname69420,0,1,0,1,1606626000,1606626000,1
Bizalich,0,1,0,7,1581310800,1581310800,1
falseinsight,0,1,0,11,1598155200,1598155200,1
Amortize_Me_Daddy,0,1,0,5,1605157200,1605157200,1
yeshahayeshahayes,0,1,0,2,1597118400,1597118400,1
BoiToyNamedTroy1,0,1,0,3,1593921600,1593921600,1
CosmicW00,0,1,0,1,1547355600,1547355600,1
dongormleone,0,1,0,5,1609390800,1609390800,1
Finly123,0,1,0,1,1576645200,1576645200,1
vanillavanity,0,1,0,2,1579755600,1579755600,1
jokersleuth,0,1,0,4,1612069200,1612069200,1
Adebisauce,0,1,0,-13,1568260800,1568260800,1
mptlpc,0,1,0,1,1570075200,1570075200,1
Connortime,0,1,0,-3,1601265600,1601265600,1
Jim_Crow_Joe,0,1,0,3,1598414400,1598414400,1
Neuromunger,0,1,0,1,1580792400,1580792400,1
CynecaFa775,0,1,0,11,1567310400,1567310400,1
Montiebon,0,1,0,7,1581051600,1581051600,1
NumericalSystem,0,1,0,2,1607749200,1607749200,1
Jumper5353,0,1,0,-2,1605243600,1605243600,1
Ithrasiel,0,1,0,1,1595304000,1595304000,1
Heavyphone,1,0,1,0,1588910400,1588910400,1
executordestroyer,0,1,0,1,1597464000,1597464000,1
Jacob----,0,1,0,0,1607490000,1607490000,1
Blasphemouse,0,1,0,3,1605934800,1605934800,1
drman64,0,1,0,0,1556596800,1556596800,1
mailmygovNNBot,0,1,0,1,1513486800,1513486800,1
frituurpan15,0,1,0,9,1581915600,1581915600,1
777Sir,0,1,0,1,1599796800,1599796800,1
SecretFeministWeapon,0,1,0,11,1577595600,1577595600,1
2thousand1hondacivic,0,1,0,1,1597809600,1597809600,1
Pineapplebro6,1,0,35,0,1601438400,1601438400,1
divine_spanner,0,1,0,1,1605243600,1605243600,1
Modern_Jacobin,0,1,0,6,1475121600,1475121600,1
makba,1,0,9,0,1580706000,1580706000,1
Spiderwebs666,0,1,0,1,1586145600,1586145600,1
backwoodsgeek,0,1,0,44,1596945600,1596945600,1
GoranSrna,0,1,0,2,1599537600,1599537600,1
reallyepicman,0,1,0,1,1583125200,1583125200,1
tinhtinh,0,1,0,1,1605070800,1605070800,1
cmonmanvs45,0,1,0,2,1597204800,1597204800,1
alemonbehindarock,0,1,0,1,1605416400,1605416400,1
AmorphousApathy,0,1,0,7,1605070800,1605070800,1
pestomime,0,1,0,3,1573016400,1573016400,1
SlashEDMProduction,0,1,0,-5,1545022800,1545022800,1
TRNielson,0,1,0,18,1580274000,1580274000,1
Morghenlynn,0,1,0,3,1604725200,1604725200,1
MrsButton,0,1,0,9,1602648000,1602648000,1
esoterrarium,1,0,0,0,1594008000,1594008000,1
FawkFather,0,1,0,-1,1598932800,1598932800,1
EndSlidingArea,0,1,0,6,1608440400,1608440400,1
beansinmydreams,0,1,0,1,1601697600,1601697600,1
IncognitoOne,0,1,0,20,1590120000,1590120000,1
candypoppler,0,1,0,2,1605243600,1605243600,1
Hutchcha,0,1,0,1,1580619600,1580619600,1
thebruh599,0,1,0,1,1608613200,1608613200,1
TheRealDeweyCox2000,0,1,0,-1,1588996800,1588996800,1
itsmattjamesbitch,0,1,0,1,1606885200,1606885200,1
nemoskull,0,1,0,9,1559707200,1559707200,1
FromRussiaWithDoubt,0,1,0,5,1603252800,1603252800,1
Leon_the_loathed,0,1,0,2,1575608400,1575608400,1
Mastafran,0,1,0,3,1606280400,1606280400,1
OkVoice254,0,1,0,3,1612069200,1612069200,1
stink_ditch,1,0,41,0,1585886400,1585886400,1
thenorthernscar,0,1,0,1,1589947200,1589947200,1
jimskog99,0,1,0,14,1609477200,1609477200,1
72073,0,1,0,4,1573016400,1573016400,1
Muffikins,0,1,0,3,1461384000,1461384000,1
BradGatov,0,1,0,16,1560139200,1560139200,1
FightMilk888,0,1,0,262,1582779600,1582779600,1
NewsworthyEvent,0,1,0,1,1577595600,1577595600,1
Unchosen_Heroes,0,1,0,10,1611896400,1611896400,1
chooseusernameeeeeee,0,1,0,1,1613970000,1613970000,1
Anon6376,0,1,0,1,1599537600,1599537600,1
avirambaby,1,0,9,0,1607490000,1607490000,1
TotesHuman,0,1,0,10,1430712000,1430712000,1
RelativeButterfly6,0,1,0,1,1590033600,1590033600,1
PleaseInputSkill,0,1,0,12,1604984400,1604984400,1
she-devi1,0,1,0,8,1606366800,1606366800,1
phallecbaldwinwins,0,1,0,2,1583643600,1583643600,1
jellyfishdenovo,0,1,0,7,1574312400,1574312400,1
cookiesareprettyyum,0,1,0,2,1539921600,1539921600,1
OMGimaDONKEY,0,1,0,3,1588737600,1588737600,1
Owlstorm,0,1,0,1,1599883200,1599883200,1
jakeydaddy,0,1,0,1,1607749200,1607749200,1
scarylions,0,1,0,1,1594180800,1594180800,1
Kopa23,0,1,0,3,1572580800,1572580800,1
Doodgye,1,0,16,0,1566360000,1566360000,1
Specialist_Fruit6600,0,1,0,1,1607662800,1607662800,1
khmln,0,1,0,1,1578978000,1578978000,1
BlueFaces-,0,1,0,14,1612155600,1612155600,1
Kirk_Kerman,0,1,0,2,1612155600,1612155600,1
Tunaman3434,0,1,0,12,1590552000,1590552000,1
cleepcleep,0,1,0,2,1575867600,1575867600,1
CannedTornado,0,1,0,5,1560571200,1560571200,1
BlenderGuy,0,1,0,1,1605589200,1605589200,1
atalikami,0,1,0,23,1585886400,1585886400,1
isosorry,0,1,0,8,1583211600,1583211600,1
RJ200016,0,1,0,2,1601352000,1601352000,1
cloakingdevice,0,1,0,3,1570766400,1570766400,1
teagoo42,0,1,0,4,1609131600,1609131600,1
bdog666,0,1,0,2,1552536000,1552536000,1
AlexandersWonder,0,1,0,14,1600574400,1600574400,1
gofyourselftoo,0,1,0,6,1578373200,1578373200,1
Gloryboy811,0,1,0,1,1603512000,1603512000,1
possumsushi,0,1,0,4,1583125200,1583125200,1
joseconsueko,0,1,0,2,1585454400,1585454400,1
lizmckinley,0,1,0,8,1576731600,1576731600,1
Jaxley78,0,1,0,1,1592193600,1592193600,1
12345pickle,0,1,0,1,1606626000,1606626000,1
Naoroji,0,1,0,5,1580446800,1580446800,1
G-1623,0,1,0,17,1580792400,1580792400,1
nite-n-day,0,1,0,17,1571544000,1571544000,1
Moaxxe,0,1,0,5,1582088400,1582088400,1
ILaughAtFunnyShit,0,1,0,22,1577941200,1577941200,1
monalisasnipples,0,1,0,15,1602820800,1602820800,1
mynamedenis,0,1,0,7,1594785600,1594785600,1
jodido999,0,1,0,2,1603598400,1603598400,1
Baron_Von_Dusseldork,0,1,0,4,1573707600,1573707600,1
CrystalSmurf88,0,1,0,1,1560657600,1560657600,1
fantasytensai,0,1,0,1,1562731200,1562731200,1
MooshkasOfCoraline,1,0,109,0,1605675600,1605675600,1
gabe100000,0,1,0,11,1599710400,1599710400,1
trexanill,1,0,127,0,1606971600,1606971600,1
danisahuman1,0,1,0,0,1584590400,1584590400,1
JButerscotch42,0,1,0,1,1634788800,1634788800,1
renato502,0,1,0,1,1607662800,1607662800,1
fxckhead3,0,1,0,1,1606798800,1606798800,1
XIII-I,0,1,0,48,1598760000,1598760000,1
localbruise,0,1,0,3,1579496400,1579496400,1
igot8001,0,1,0,2,1587441600,1587441600,1
PlataDePablo,0,1,0,3,1599105600,1599105600,1
TheLegendTwoSeven,0,1,0,1,1564545600,1564545600,1
adamndsmith,1,0,1630,0,1593748800,1593748800,1
AnarchyBreadBoy,0,1,0,7,1564459200,1564459200,1
cmontage,0,1,0,1,1586059200,1586059200,1
not-my-20th-account,0,1,0,1,1593316800,1593316800,1
Dog-of-Time,1,0,239,0,1552363200,1552363200,1
Ahmed2361997,0,1,0,0,1608526800,1608526800,1
LAGTadaka,0,1,0,2,1546405200,1546405200,1
FrogBefriender,0,1,0,13,1586750400,1586750400,1
nutterbutter1,0,1,0,4,1606021200,1606021200,1
ValkyrieWeather,0,1,0,1,1578200400,1578200400,1
gatinhadesunga,0,1,0,24,1592366400,1592366400,1
LAXnSASQUATCH,0,1,0,3,1589947200,1589947200,1
bassukurarinetto,0,1,0,18,1605934800,1605934800,1
bikeriderjon,0,1,0,1,1602648000,1602648000,1
rubdug,0,1,0,1,1556424000,1556424000,1
Roxiepluto,0,1,0,1,1597377600,1597377600,1
Mgaff21,1,0,9,0,1603857600,1603857600,1
squeezycakes19,0,1,0,9,1591934400,1591934400,1
the_red_light,0,1,0,3,1611982800,1611982800,1
SheepGoesBaaaa,0,1,0,2,1603598400,1603598400,1
Malojstoy,0,1,0,1,1607317200,1607317200,1
afrofrycook,0,1,0,-2,1571544000,1571544000,1
Kaka99999,1,0,9,0,1599710400,1599710400,1
Karashta,0,1,0,31,1597809600,1597809600,1
averybabery,0,1,0,29,1607144400,1607144400,1
MosquitoSpider,0,1,0,3,1595390400,1595390400,1
StonePlastic,1,0,5,0,1582866000,1582866000,1
bec_Cat,0,1,0,14,1589860800,1589860800,1
ricecripses,0,1,0,3,1582002000,1582002000,1
elizabro,0,1,0,2,1576731600,1576731600,1
Boopins05,0,1,0,3,1581138000,1581138000,1
japanther22,1,0,765,0,1559102400,1559102400,1
bfmason761,0,1,0,1,1600660800,1600660800,1
nadiayorc,0,1,0,0,1591243200,1591243200,1
I_3_3D_printers,0,1,0,5,1557115200,1557115200,1
nineva-v,0,1,0,3,1608872400,1608872400,1
45forprison,0,1,0,16,1580101200,1580101200,1
zarcherz,0,1,0,5,1601179200,1601179200,1
WarmHammsWonderland,0,1,0,48,1572235200,1572235200,1
librarymind6,0,1,0,1,1605675600,1605675600,1
swannygod,0,1,0,1,1570075200,1570075200,1
JackieRobotson,0,1,0,7,1550638800,1550638800,1
ThatBlackScienceKid,0,1,0,5,1602216000,1602216000,1
SL4V0J-Z1Z3K,0,1,0,-1,1560657600,1560657600,1
theonemangoonsquad,0,1,0,13,1603771200,1603771200,1
PurePandemonium,0,1,0,7,1608872400,1608872400,1
KeepLosinglibs,0,1,0,-1,1562731200,1562731200,1
p3t3rfyl3,1,0,60,0,1588737600,1588737600,1
FantasticSquirrel3,0,1,0,1,1591243200,1591243200,1
cenzala,0,1,0,15,1587268800,1587268800,1
chantellexoxoxo,0,1,0,11,1585886400,1585886400,1
Brunosanches1,0,1,0,9,1596254400,1596254400,1
phaute,0,1,0,1,1605070800,1605070800,1
whiteclawthreshermaw,0,1,0,1,1604379600,1604379600,1
Poon_Pirate,0,1,0,8,1583125200,1583125200,1
imagineworking,0,1,0,9,1566100800,1566100800,1
TraceOfHumanity,0,1,0,107,1583470800,1583470800,1
mm3331,0,1,0,5,1590033600,1590033600,1
brianvsshark,0,1,0,6,1546405200,1546405200,1
craniumrats,0,1,0,17,1569297600,1569297600,1
btroberts011,0,1,0,3,1609218000,1609218000,1
StealthyGyros,0,1,0,1,1609131600,1609131600,1
Ori_the_toaster,1,0,4,0,1608872400,1608872400,1
BrassMonkeyMike,0,1,0,1,1603512000,1603512000,1
Interaction-Born,1,0,5376,0,1600228800,1600228800,1
sjw7444,0,1,0,27,1572062400,1572062400,1
Anzenah,0,1,0,2,1586491200,1586491200,1
Lightblade4507,0,1,0,1,1612069200,1612069200,1
voltran1987,0,1,0,1,1602820800,1602820800,1
Subtropical_Blues,0,1,0,5,1573621200,1573621200,1
sadboyreyna,0,1,0,20,1601179200,1601179200,1
StubbornUnicorn95,0,1,0,1,1581138000,1581138000,1
kylez82,0,1,0,2,1591243200,1591243200,1
JedidiahSky,0,1,0,7,1608440400,1608440400,1
ttyy_yeetskeet,0,1,0,4,1608181200,1608181200,1
Alexstrazinc,0,1,0,3,1585454400,1585454400,1
wizardinspaceandtime,0,1,0,1,1572235200,1572235200,1
carolynto,0,1,0,4,1603512000,1603512000,1
uxzehjwiwxtrueit,0,1,0,5,1611982800,1611982800,1
TacoBelly311,0,1,0,5,1580706000,1580706000,1
victini0510,0,1,0,4,1607835600,1607835600,1
diegator,1,0,17,0,1599019200,1599019200,1
BlessYourFaces,0,1,0,1,1585454400,1585454400,1
letsgorbg,0,1,0,10,1607490000,1607490000,1
kda26,0,1,0,7,1575522000,1575522000,1
SStopProcrastinating,0,1,0,1,1603512000,1603512000,1
Princeofgats,0,1,0,1,1603425600,1603425600,1
AHCarbon,0,1,0,4,1598241600,1598241600,1
wraithdem0n,0,1,0,3,1584244800,1584244800,1
Deezboltz,0,1,0,2,1608267600,1608267600,1
Ghostindrawingroom,0,1,0,1,1603512000,1603512000,1
lolsuperfandehp,0,1,0,4,1593316800,1593316800,1
RavenCarci,0,1,0,38,1605589200,1605589200,1
Civ6Ever,0,1,0,1,1560657600,1560657600,1
digikun,0,1,0,1,1594008000,1594008000,1
FoctopusFire,0,1,0,22,1581051600,1581051600,1
Komfortable,0,1,0,7,1580619600,1580619600,1
jeferka,0,1,0,18,1597636800,1597636800,1
Smiran_Radev,0,1,0,1,1607230800,1607230800,1
connorjake123,0,1,0,3,1554264000,1554264000,1
katashtrophes,0,1,0,22,1602388800,1602388800,1
StaticUncertainty,0,1,0,45,1601179200,1601179200,1
faberge-egg7,0,1,0,3,1571198400,1571198400,1
TheGoodFortune,0,1,0,33,1597550400,1597550400,1
Morpheus61,0,1,0,2,1587960000,1587960000,1
sweetalypie,0,1,0,1,1606885200,1606885200,1
KenEarles3,0,1,0,5,1605589200,1605589200,1
Greendorg,0,1,0,1,1585627200,1585627200,1
ChineseKoiCarp,0,1,0,10,1605416400,1605416400,1
NotSoSlenderMan,0,1,0,3,1603512000,1603512000,1
myitredditacc,0,1,0,3,1603339200,1603339200,1
Beertarted,0,1,0,12,1592884800,1592884800,1
gperg,0,1,0,2,1602388800,1602388800,1
SuccessAndSerenity,0,1,0,13,1601179200,1601179200,1
OctaneOwl,0,1,0,1,1572930000,1572930000,1
UrNanFriendlyLady,0,1,0,1,1570852800,1570852800,1
ExplainedAway,0,1,0,5,1552194000,1552194000,1
Far-Following-8166,0,1,0,27,1606280400,1606280400,1
Cassandraplzkaythxx,0,1,0,3,1592625600,1592625600,1
BonfireXXX22,0,1,0,3,1601611200,1601611200,1
lucidneon,0,1,0,2,1569038400,1569038400,1
Transviolet,0,1,0,2,1606280400,1606280400,1
Jakethered_game,0,1,0,1,1606626000,1606626000,1
HorizonBeyond22,0,1,0,2,1607490000,1607490000,1
Wikiplay,0,1,0,22,1562212800,1562212800,1
jpegisthename,0,1,0,1,1560657600,1560657600,1
matsign,0,1,0,0,1587355200,1587355200,1
sokratesz,0,1,0,1,1581224400,1581224400,1
NewClayburn,0,1,0,1,1573794000,1573794000,1
Kevinisasimp69,0,1,0,1,1598760000,1598760000,1
theamnion,0,1,0,3,1606885200,1606885200,1
Panzerspartan,0,1,0,2,1600228800,1600228800,1
Scuttlenock,0,1,0,2,1581570000,1581570000,1
yrraljhun,0,1,0,2,1548046800,1548046800,1
x86ik,0,1,0,0,1585627200,1585627200,1
dildobagginsworth,0,1,0,7,1578114000,1578114000,1
Gottabeyou12,1,0,1,0,1539921600,1539921600,1
Hood0rnament,0,1,0,12,1592798400,1592798400,1
Thisisntjoe,0,1,0,21,1587960000,1587960000,1
landartheconqueror,0,1,0,2,1569124800,1569124800,1
Tricky-Battle1191,0,1,0,2,1612760400,1612760400,1
Swissarmy5,0,1,0,3,1611637200,1611637200,1
I_am_Fried,0,1,0,1,1584763200,1584763200,1
5pmFreeCrack,0,1,0,2,1606366800,1606366800,1
Clutsy_Naive,0,1,0,3,1607662800,1607662800,1
brownsugarlucy,0,1,0,8,1607835600,1607835600,1
Alextheseal_42,0,1,0,1,1603425600,1603425600,1
perpetuallyperfect,0,1,0,7,1595908800,1595908800,1
Kimiochi,0,1,0,8,1573966800,1573966800,1
paviator,0,1,0,1,1579064400,1579064400,1
lostshell,0,1,0,1,1591243200,1591243200,1
SaXyBeAcH,0,1,0,5,1602820800,1602820800,1
Tahedoz,0,1,0,1,1601352000,1601352000,1
HizDudenesss,0,1,0,1,1603512000,1603512000,1
sunshine-veins,0,1,0,33,1606194000,1606194000,1
ToHaveBeenConsidered,1,0,134,0,1606107600,1606107600,1
TheStatelyRaven,0,1,0,3,1583643600,1583643600,1
remnantechoes,0,1,0,1,1604379600,1604379600,1
dansedemorte,0,1,0,3,1609390800,1609390800,1
Tanakhan,0,1,0,6,1547269200,1547269200,1
Gen01_SIEBEN,0,1,0,6,1517115600,1517115600,1
DuePrize5,0,1,0,3,1606021200,1606021200,1
Messy-Recipe,0,1,0,41,1596859200,1596859200,1
Sinful_Whiskers,0,1,0,18,1600488000,1600488000,1
c11life,0,1,0,1,1588392000,1588392000,1
lileyelash,0,1,0,26,1570852800,1570852800,1
ISourceBondage,0,1,0,-1,1604898000,1604898000,1
THE_SPIKE69,0,1,0,1,1605934800,1605934800,1
nitsua_saxet,0,1,0,10,1611896400,1611896400,1
SPACEmanSPIFF77,0,1,0,1,1589860800,1589860800,1
Kyrkrim,0,1,0,1,1591243200,1591243200,1
Burger_k1ng,0,1,0,1,1598760000,1598760000,1
the_marsipan,0,1,0,3,1598932800,1598932800,1
prepareAnd_throwAway,0,1,0,2,1599796800,1599796800,1
Bunnyfartz,0,1,0,83,1601870400,1601870400,1
Fidel_Murphy,0,1,0,3,1592712000,1592712000,1
porscheninja,0,1,0,-40,1580533200,1580533200,1
flynndsey,0,1,0,61,1587614400,1587614400,1
GrammerCU,0,1,0,-9,1588996800,1588996800,1
Hijosdelhuracan,0,1,0,2,1600315200,1600315200,1
miketheplumber85,0,1,0,2,1607749200,1607749200,1
Nashtark,0,1,0,1,1598932800,1598932800,1
Samgasm,0,1,0,1,1578978000,1578978000,1
ellainix,0,1,0,36,1572235200,1572235200,1
whenthewindupbird,0,1,0,2,1603684800,1603684800,1
Patatemagique,0,1,0,1,1611982800,1611982800,1
LeatherProposal6,0,1,0,5,1603512000,1603512000,1
downvote_the_truth_,0,1,0,1,1608267600,1608267600,1
JoMiEd,0,1,0,71,1602993600,1602993600,1
daisybobaisy,0,1,0,2,1605589200,1605589200,1
fawada28,0,1,0,2,1604379600,1604379600,1
dieselrunner64,0,1,0,1,1611982800,1611982800,1
Pierre0livier,0,1,0,2,1577163600,1577163600,1
Drewzillawood,0,1,0,13,1577422800,1577422800,1
quitebereft,0,1,0,1,1606021200,1606021200,1
Murlca1776,0,1,0,1,1589688000,1589688000,1
Littleboyhugs,0,1,0,-8,1599796800,1599796800,1
Theons_sausage,0,1,0,1,1591243200,1591243200,1
bassisirrelevant,0,1,0,24,1601956800,1601956800,1
Friendly_Recompence,0,1,0,39,1597550400,1597550400,1
SirCabbage,0,1,0,10,1603512000,1603512000,1
PlzHlpPlzOhPlz,0,1,0,2,1607058000,1607058000,1
whitechristmas9,0,1,0,14,1571889600,1571889600,1
Sir_uranus,0,1,0,2,1587614400,1587614400,1
e99y0lk,0,1,0,300,1585108800,1585108800,1
Boy_wench,1,0,4670,0,1606798800,1606798800,1
abaker3392,0,1,0,-1,1585454400,1585454400,1
YogaFireYogaFlame,0,1,0,1,1603425600,1603425600,1
ecIce,0,1,0,1,1585454400,1585454400,1
Chesterbobby,0,1,0,0,1603512000,1603512000,1
raindog444,0,1,0,8,1579928400,1579928400,1
highmrk,0,1,0,1,1574312400,1574312400,1
JugularJoeKnows,0,1,0,3,1603512000,1603512000,1
balcon,0,1,0,1,1589860800,1589860800,1
mterry1,0,1,0,2,1602302400,1602302400,1
phelaz,0,1,0,5,1606539600,1606539600,1
IngSoc_Defector,0,1,0,6,1592712000,1592712000,1
shekelest,0,1,0,2,1560571200,1560571200,1
GerardBae,0,1,0,2,1569902400,1569902400,1
ayayay4444,0,1,0,2,1579928400,1579928400,1
flowah_powah,0,1,0,54,1588305600,1588305600,1
Turlo101,0,1,0,6,1594699200,1594699200,1
D4FF00,0,1,0,13,1593835200,1593835200,1
josh_fbi,0,1,0,7,1597809600,1597809600,1
thefullpython,0,1,0,3,1601265600,1601265600,1
inlibrary_legsnumb,0,1,0,3,1581224400,1581224400,1
ubercorey,0,1,0,1,1600660800,1600660800,1
lugnutfan,1,0,536,0,1567137600,1567137600,1
Jake_the_snake94,0,1,0,1,1611982800,1611982800,1
NBAZAN,0,1,0,6,1561003200,1561003200,1
dig_lazarus_dig48,0,1,0,22,1536897600,1536897600,1
nuclearmushrooms,0,1,0,18,1599969600,1599969600,1
HotPissamole,0,1,0,2,1598068800,1598068800,1
Havenos,0,1,0,15,1575608400,1575608400,1
YouJabroni44,0,1,0,2,1593662400,1593662400,1
m23b45,0,1,0,3,1591329600,1591329600,1
Mooned-by-Tamiyo,1,0,7,0,1599883200,1599883200,1
rolexova,0,1,0,1,1606021200,1606021200,1
CMFlunk,0,1,0,-11,1583125200,1583125200,1
phtevieboi,0,1,0,3,1605762000,1605762000,1
milky_bunns,0,1,0,18,1605330000,1605330000,1
codereign,0,1,0,1,1606021200,1606021200,1
temptemparkansas,0,1,0,13,1589428800,1589428800,1
collegedirtbag,0,1,0,2,1578978000,1578978000,1
TheMassesOpiate,0,1,0,6,1611810000,1611810000,1
FlowerNectar1,0,1,0,18,1598932800,1598932800,1
PreparationAshamed96,0,1,0,24,1605589200,1605589200,1
XminusOne,0,1,0,2,1596168000,1596168000,1
Moneybags99,0,1,0,11,1603684800,1603684800,1
kittley01,0,1,0,8,1598241600,1598241600,1
dimiria,0,1,0,1,1605330000,1605330000,1
GhostCorps973,0,1,0,3,1585454400,1585454400,1
Revolutionary-Ant926,0,1,0,3,1598760000,1598760000,1
MochaPaws,0,1,0,1,1565150400,1565150400,1
Whatishonor85,0,1,0,1,1605589200,1605589200,1
LeftistMeem,0,1,0,3,1585454400,1585454400,1
pro-jekt,0,1,0,50,1591243200,1591243200,1
Frozenar,0,1,0,1,1596340800,1596340800,1
Regret_a_garbo,0,1,0,1,1582693200,1582693200,1
FlowRanger,0,1,0,6,1601956800,1601956800,1
NoKluWhaTuDu,0,1,0,1,1606971600,1606971600,1
VladimirPutsItIn,1,0,18,0,1581829200,1581829200,1
KoolAid8668,0,1,0,1,1603512000,1603512000,1
sunshinetomato,0,1,0,3,1609736400,1609736400,1
ldnjbnk99,0,1,0,1,1576645200,1576645200,1
the_dayman,0,1,0,63,1595822400,1595822400,1
Scary-Dependent-3221,0,1,0,4,1612414800,1612414800,1
chazfinster_,0,1,0,11,1590033600,1590033600,1
wiggler303,0,1,0,5,1599451200,1599451200,1
psychicburrito,1,0,980,0,1569211200,1569211200,1
johnnywayne1,0,1,0,1,1582347600,1582347600,1
Industrialpainter89,0,1,0,13,1604552400,1604552400,1
IplumbusI,0,1,0,1,1591329600,1591329600,1
fuckwork9654,0,1,0,1,1571716800,1571716800,1
coyote1971,0,1,0,38,1607230800,1607230800,1
Crakla,0,1,0,13,1584244800,1584244800,1
Hpzrq92,0,1,0,5,1565409600,1565409600,1
supersynthi,0,1,0,2,1590033600,1590033600,1
TampaStu,0,1,0,2,1608872400,1608872400,1
Licensed_Ignorance,0,1,0,3,1607576400,1607576400,1
pierre45,1,0,3,0,1424149200,1424149200,1
socaldinglebag,0,1,0,2,1605330000,1605330000,1
leafstormz7,0,1,0,14,1598068800,1598068800,1
Tjstictches,0,1,0,9,1563249600,1563249600,1
lalaloui22,0,1,0,10,1572148800,1572148800,1
Kupferniet,0,1,0,-2,1589342400,1589342400,1
mindurpsqs,0,1,0,3,1572843600,1572843600,1
eevee135,0,1,0,6,1597118400,1597118400,1
zerebrum,0,1,0,1,1611896400,1611896400,1
MrBajjiBoy,0,1,0,2,1600401600,1600401600,1
the_roly,0,1,0,1,1599451200,1599451200,1
borbturbo,0,1,0,17,1607662800,1607662800,1
rcw01,0,1,0,1,1604898000,1604898000,1
Mr_Suzan,0,1,0,11,1588564800,1588564800,1
Jooylo,0,1,0,3,1591675200,1591675200,1
rexmus1,0,1,0,3,1598155200,1598155200,1
ScottyTitan,0,1,0,1,1608526800,1608526800,1
swampthingsonsteroid,0,1,0,8,1569211200,1569211200,1
xxdismalfirexx,0,1,0,110,1607835600,1607835600,1
DeaWho,0,1,0,1,1582779600,1582779600,1
jcoffey1992,1,0,0,0,1555905600,1555905600,1
hobeauwshotgun2,0,1,0,6,1562644800,1562644800,1
madnessdanz,0,1,0,17,1605070800,1605070800,1
shuritsen,0,1,0,2,1558670400,1558670400,1
DickBurns,0,1,0,17,1591156800,1591156800,1
Shaman_Ko,0,1,0,4,1603512000,1603512000,1
GexusTheAtlantean,0,1,0,9,1598328000,1598328000,1
Razakel,0,1,0,2,1602820800,1602820800,1
LingLingDesNibelung,0,1,0,1,1609390800,1609390800,1
FreshCleave,0,1,0,-2,1600574400,1600574400,1
Tseliteiv,0,1,0,2,1575867600,1575867600,1
JasperTheHuman,0,1,0,1,1606021200,1606021200,1
BoredOfReposts,0,1,0,1,1601870400,1601870400,1
wulfpaccxxiii,0,1,0,38,1570334400,1570334400,1
TacticalNurze,0,1,0,1,1608354000,1608354000,1
therickglenn,0,1,0,2,1596945600,1596945600,1
Seifer_Extreme,0,1,0,2,1596772800,1596772800,1
Bayerrc,0,1,0,2,1591243200,1591243200,1
Mr-5-5,0,1,0,2,1587268800,1587268800,1
FrankFurt16,0,1,0,3,1601611200,1601611200,1
IlREDACTEDlI,0,1,0,3,1604379600,1604379600,1
funhousearcade,0,1,0,-17,1549515600,1549515600,1
rabidjellybean,0,1,0,5,1603339200,1603339200,1
InsertCoinForCredit,0,1,0,-2,1589601600,1589601600,1
gerryberry12,0,1,0,1,1589947200,1589947200,1
LisaLisa_e,0,1,0,2,1599796800,1599796800,1
mobuy,0,1,0,2,1608526800,1608526800,1
papichoochoo,0,1,0,3,1611982800,1611982800,1
keyboredwarrior,0,1,0,1,1585454400,1585454400,1
blammotheclown,0,1,0,15,1566446400,1566446400,1
Iznal,0,1,0,5,1594612800,1594612800,1
transferingtoearth,0,1,0,7,1607576400,1607576400,1
Juergenator,0,1,0,3,1578373200,1578373200,1
indabayou,0,1,0,1,1608786000,1608786000,1
SnailyGarry,0,1,0,1,1611982800,1611982800,1
magneticopossum,0,1,0,8,1606885200,1606885200,1
skagman,0,1,0,0,1611982800,1611982800,1
PutridFoe65,0,1,0,3,1582779600,1582779600,1
matrixdutch,0,1,0,1,1442289600,1442289600,1
AnnaBiene,0,1,0,1,1605675600,1605675600,1
Nuinethir,0,1,0,2,1604725200,1604725200,1
incogburritos,0,1,0,67,1609131600,1609131600,1
erik9017,0,1,0,3,1606798800,1606798800,1
bobfacepoo,0,1,0,1,1583038800,1583038800,1
eatright909,0,1,0,2,1601092800,1601092800,1
that_one_ai_nerd,0,1,0,3,1573448400,1573448400,1
gbird8295,0,1,0,2,1599796800,1599796800,1
Demokrak,0,1,0,22,1583298000,1583298000,1
Paradox_Gods,1,0,5,0,1583470800,1583470800,1
phosTR,1,0,16,0,1579150800,1579150800,1
dew_licker,0,1,0,8,1592107200,1592107200,1
astrogeeknerd,0,1,0,1,1606626000,1606626000,1
qemqemqem,0,1,0,9,1559102400,1559102400,1
preguard,0,1,0,1,1606626000,1606626000,1
Fondle_My_Sweaters,0,1,0,2,1573621200,1573621200,1
trippy_grapes,0,1,0,25,1579928400,1579928400,1
amazingmaximo,0,1,0,1,1603425600,1603425600,1
That1GuyDerek,0,1,0,1,1608267600,1608267600,1
sayhay,0,1,0,12,1606280400,1606280400,1
throwaway13247568,0,1,0,-2,1602216000,1602216000,1
deathoflice,0,1,0,0,1593576000,1593576000,1
myusernamebarelyfits,0,1,0,1,1572148800,1572148800,1
MuellerisUnderMyBed,0,1,0,0,1603598400,1603598400,1
Sadinoel116,0,1,0,3,1599796800,1599796800,1
MapeyGirl,0,1,0,3,1594094400,1594094400,1
snarkdiva,0,1,0,2,1591243200,1591243200,1
CrazyIvanoveich,0,1,0,-1,1601352000,1601352000,1
CykoTom,0,1,0,6,1603598400,1603598400,1
Breakfast-of-titan,0,1,0,5,1606539600,1606539600,1
LB3PTMAN,0,1,0,1,1603512000,1603512000,1
wakamex,0,1,0,65,1550034000,1550034000,1
Aedelfrid,0,1,0,37,1599796800,1599796800,1
BenSaharEternal,0,1,0,1,1573966800,1573966800,1
Patient-Relation-553,0,1,0,6,1606626000,1606626000,1
r-sh,1,0,102,0,1557115200,1557115200,1
econ1mods1are1cucks,0,1,0,2,1573448400,1573448400,1
FlashCrashBash,0,1,0,4,1589947200,1589947200,1
rieuxdy,0,1,0,7,1597896000,1597896000,1
elusivestarlight,0,1,0,1,1603339200,1603339200,1
Mark13489,0,1,0,1,1597291200,1597291200,1
cardicow,0,1,0,1,1608786000,1608786000,1
AussieUpvotes,0,1,0,-4,1600660800,1600660800,1
awanderingi,0,1,0,6,1570248000,1570248000,1
blasted90,0,1,0,1,1596772800,1596772800,1
vinnvout,1,0,139,0,1575867600,1575867600,1
Deckhead13,0,1,0,1,1587700800,1587700800,1
epicscaley,0,1,0,1,1600142400,1600142400,1
Cyb3r_Genesis,0,1,0,87,1603080000,1603080000,1
JHarrisLB,0,1,0,2,1590120000,1590120000,1
quiver-me-timbers,0,1,0,2,1592798400,1592798400,1
runo9,0,1,0,3,1598500800,1598500800,1
ThomasJeffergun,0,1,0,1,1606885200,1606885200,1
Lemond678,0,1,0,29,1597982400,1597982400,1
scarab80,0,1,0,9,1602129600,1602129600,1
Amonraoul,0,1,0,3,1584763200,1584763200,1
galapagos1859,0,1,0,37,1602043200,1602043200,1
tM_5_7BszR,1,0,1,0,1455426000,1455426000,1
Ahrithul,0,1,0,-1,1589860800,1589860800,1
Actual-Gap-9800,0,1,0,9,1600401600,1600401600,1
Jaronaked,0,1,0,1,1588478400,1588478400,1
pope18,0,1,0,-8,1600833600,1600833600,1
Isitoolate51,0,1,0,3,1574830800,1574830800,1
majeufoe45,0,1,0,0,1600660800,1600660800,1
Aden_Sickle,0,1,0,-25,1559620800,1559620800,1
6395251,0,1,0,13,1562644800,1562644800,1
BatchThompson,0,1,0,-1,1582952400,1582952400,1
alphazeta2019,0,1,0,1,1580619600,1580619600,1
ryuuRyo,0,1,0,2,1608008400,1608008400,1
str8Astoner,0,1,0,2,1606539600,1606539600,1
Simmion,0,1,0,1,1605243600,1605243600,1
GeorgeBeGentle,0,1,0,0,1594267200,1594267200,1
anonymous_212,0,1,0,1,1603598400,1603598400,1
Yisrael_Pinto,0,1,0,0,1578114000,1578114000,1
LeSuperChon,0,1,0,2,1595131200,1595131200,1
vissersolomon,0,1,0,1,1601956800,1601956800,1
powersje1,0,1,0,1,1608699600,1608699600,1
devils-aggregate,0,1,0,10,1595649600,1595649600,1
coco-ono,0,1,0,1,1560225600,1560225600,1
PierrceHawkeye,0,1,0,3,1600920000,1600920000,1
sup_ty,0,1,0,1,1601179200,1601179200,1
Drag0nqueen,0,1,0,1,1591243200,1591243200,1
Dexilan,0,1,0,45,1607576400,1607576400,1
wafflesandgin,0,1,0,1,1572494400,1572494400,1
konjo1240,0,1,0,2,1585627200,1585627200,1
MassDebater44,0,1,0,63,1600488000,1600488000,1
JustThrowMeOutLater,0,1,0,2,1638766800,1638766800,1
fappyday,0,1,0,54,1603512000,1603512000,1
Bridget_Bishop,0,1,0,1,1601956800,1601956800,1
goranlepuz,0,1,0,2,1605589200,1605589200,1
KRelic,0,1,0,9,1605589200,1605589200,1
minininja_ow,0,1,0,0,1601352000,1601352000,1
colin_buffam,0,1,0,1,1609218000,1609218000,1
MyNaamIsIan,0,1,0,0,1606626000,1606626000,1
_green_theory_,0,1,0,-1,1589601600,1589601600,1
MyTinyVenus,0,1,0,3,1586836800,1586836800,1
KungThulhu,0,1,0,8,1612155600,1612155600,1
RedBat237,1,0,28,0,1546491600,1546491600,1
redditovar,0,1,0,6,1602820800,1602820800,1
Woten333,0,1,0,5,1592971200,1592971200,1
Fadelox,0,1,0,4,1581656400,1581656400,1
noodhoog,0,1,0,1,1560916800,1560916800,1
almighty_ruler,0,1,0,3,1609131600,1609131600,1
Deprestoned,0,1,0,3,1606366800,1606366800,1
Lyssa545,0,1,0,6,1612069200,1612069200,1
RoseTintMahWorld,0,1,0,2,1585627200,1585627200,1
tirednotsad,0,1,0,1,1594785600,1594785600,1
SniktG,0,1,0,7,1600833600,1600833600,1
Trouserchili82,0,1,0,-2,1585454400,1585454400,1
qtlizi,0,1,0,2,1575781200,1575781200,1
WheresWaldo6,0,1,0,7,1600833600,1600833600,1
roseofamber,0,1,0,2,1597032000,1597032000,1
gitjammin,0,1,0,2,1557460800,1557460800,1
itsmemariotime,0,1,0,10,1589947200,1589947200,1
rangotangodingo,0,1,0,1,1605330000,1605330000,1
Secret_agent_nope,0,1,0,1,1589860800,1589860800,1
CorvidDay,0,1,0,1,1604898000,1604898000,1
donnie_brasco,0,1,0,1,1604379600,1604379600,1
rojhin213,0,1,0,28,1601179200,1601179200,1
BoxOfRain_,0,1,0,2,1557547200,1557547200,1
HatchettheFly,0,1,0,2,1567915200,1567915200,1
Ryzasu,0,1,0,1,1569816000,1569816000,1
CompetitionProblem,0,1,0,3,1603512000,1603512000,1
thefaultinourseg,0,1,0,1,1578373200,1578373200,1
FullState,0,1,0,11,1595390400,1595390400,1
7leedim,0,1,0,6,1588219200,1588219200,1
veldalken_,0,1,0,8,1598328000,1598328000,1
Watashiwajoshua,0,1,0,1,1608786000,1608786000,1
TheGermanRaccoon,0,1,0,2,1605416400,1605416400,1
wolfketi,0,1,0,10,1572235200,1572235200,1
FuzzyCrocks,0,1,0,3,1591329600,1591329600,1
TerrisKagi,0,1,0,7,1603512000,1603512000,1
Ceenum,0,1,0,2,1554523200,1554523200,1
keykeypalmer,0,1,0,1,1618372800,1618372800,1
Pferdmagaepfel,0,1,0,1,1608699600,1608699600,1
peachstealingmonkeys,0,1,0,1,1603684800,1603684800,1
jamadhar,0,1,0,6,1612155600,1612155600,1
GaiasDotter,0,1,0,21,1606971600,1606971600,1
squngy,0,1,0,1,1604379600,1604379600,1
Admiral_dingy45,0,1,0,74,1591329600,1591329600,1
RamenJunkie,0,1,0,52,1598846400,1598846400,1
212134,0,1,0,19,1604116800,1604116800,1
Relapsq,0,1,0,1,1607662800,1607662800,1
jelly_bean_gangbang,0,1,0,27,1603512000,1603512000,1
chiefslw,0,1,0,7,1603512000,1603512000,1
ron_burgendy6969,0,1,0,-9,1550293200,1550293200,1
snowflakesandsakuras,1,0,215,0,1592798400,1592798400,1
andfor,0,1,0,1,1605589200,1605589200,1
raptoricon,0,1,0,2,1591156800,1591156800,1
smb_samba,0,1,0,1,1611982800,1611982800,1
woopstrafel,0,1,0,3,1602820800,1602820800,1
TheKittynator,0,1,0,2,1587182400,1587182400,1
cum_farter,0,1,0,1,1611982800,1611982800,1
SpyroTheLizardBoye,0,1,0,8,1603512000,1603512000,1
take_yo_vitamins,0,1,0,8,1612155600,1612155600,1
HiddenSage,0,1,0,2,1589860800,1589860800,1
Silverhood17,0,1,0,0,1608354000,1608354000,1
cynicalsonofabitch,0,1,0,5,1607144400,1607144400,1
shavedpineapples,0,1,0,1,1592712000,1592712000,1
kktc626,0,1,0,1,1599451200,1599451200,1
CulturalWindow,1,0,3,0,1605157200,1605157200,1
sweatyghost8,0,1,0,1,1608872400,1608872400,1
fucuasshole2,0,1,0,9,1585454400,1585454400,1
Brutusismyhomeboy,0,1,0,2,1599969600,1599969600,1
andseeingawwwNBC,0,1,0,-5,1561262400,1561262400,1
Low-Society,0,1,0,2,1592625600,1592625600,1
wubaluba_dubdub,0,1,0,1,1580360400,1580360400,1
yfraudd,0,1,0,13,1600228800,1600228800,1
chamacacabrona,0,1,0,33,1607662800,1607662800,1
paristexashilton,0,1,0,82,1580446800,1580446800,1
CdrNeonJoy,0,1,0,2,1601352000,1601352000,1
throwaway_overrated,0,1,0,0,1593230400,1593230400,1
epiwssa,0,1,0,3,1589860800,1589860800,1
xXMaGGoXx,1,0,6,0,1584936000,1584936000,1
nero147,0,1,0,2,1540872000,1540872000,1
Melbonie,0,1,0,343,1607403600,1607403600,1
porco_capitalisto,0,1,0,1,1607922000,1607922000,1
tokenanimal,0,1,0,2,1591243200,1591243200,1
spider_in_a_top_hat,0,1,0,2,1608440400,1608440400,1
Cullynoin,0,1,0,3,1598500800,1598500800,1
Extinctathon_,1,0,92,0,1601265600,1601265600,1
Im_iszen,0,1,0,1,1591329600,1591329600,1
jeepdave,0,1,0,1,1555905600,1555905600,1
MangoHombre,0,1,0,1,1579064400,1579064400,1
Skellyscribe,0,1,0,5,1593489600,1593489600,1
fishstickirl,0,1,0,2,1591848000,1591848000,1
CEOofAumShinrikyo,0,1,0,11,1579237200,1579237200,1
User1440,0,1,0,4,1539921600,1539921600,1
RageAgainstTheRobots,0,1,0,1,1572753600,1572753600,1
SunIsGay,0,1,0,10,1582261200,1582261200,1
Trees_for_Mees,0,1,0,5,1573621200,1573621200,1
97TillInfinity,0,1,0,3,1575954000,1575954000,1
BakaFame,0,1,0,2,1605589200,1605589200,1
81345deadlandlords,0,1,0,2,1588651200,1588651200,1
ElegantDegree,0,1,0,3,1604725200,1604725200,1
Crazyc011,0,1,0,2,1609304400,1609304400,1
YouNeverReadMe,0,1,0,151,1608181200,1608181200,1
METTATON6662,0,1,0,1,1608699600,1608699600,1
maxolotl_,1,0,224,0,1597464000,1597464000,1
adonzil,0,1,0,1,1604379600,1604379600,1
Ripnstein,0,1,0,8,1553832000,1553832000,1
nameless_solivagant,0,1,0,1,1603857600,1603857600,1
Yaygrrs,0,1,0,5,1562817600,1562817600,1
raison_de_eatre,0,1,0,9,1429848000,1429848000,1
shocktard,0,1,0,1,1606626000,1606626000,1
Whyarethedoorswooden,0,1,0,3,1589947200,1589947200,1
mep2367,0,1,0,11,1586664000,1586664000,1
wullymammith,0,1,0,6,1574226000,1574226000,1
photothegamer,0,1,0,2,1593662400,1593662400,1
MistahQueen,0,1,0,1,1585800000,1585800000,1
Arghs,0,1,0,3,1589515200,1589515200,1
dangler001,0,1,0,1,1584676800,1584676800,1
mexsystem28,0,1,0,4,1599105600,1599105600,1
Yeet256,0,1,0,7,1611810000,1611810000,1
FormaL69,0,1,0,12,1611982800,1611982800,1
Zmann966,1,0,28,0,1607749200,1607749200,1
tropicalunicorn,0,1,0,1,1545627600,1545627600,1
KevlarYarmulke,1,0,2392,0,1607749200,1607749200,1
EasterElk,0,1,0,-3,1598587200,1598587200,1
lucidity5,0,1,0,21,1590033600,1590033600,1
notcyberpope,0,1,0,1,1608267600,1608267600,1
DantesInferno91,0,1,0,-1,1607576400,1607576400,1
BoredMechanic,0,1,0,43,1597982400,1597982400,1
TheseNose3792,0,1,0,10,1599192000,1599192000,1
PansexualSatan,0,1,0,1,1575262800,1575262800,1
levyb02,0,1,0,1,1598932800,1598932800,1
fwiw22,0,1,0,2,1604030400,1604030400,1
Prepton,0,1,0,3,1573707600,1573707600,1
Ixziga,0,1,0,3,1570766400,1570766400,1
Lenzar86,0,1,0,2,1578200400,1578200400,1
Koof99,0,1,0,4,1573362000,1573362000,1
MC1133,0,1,0,1,1599192000,1599192000,1
Kietu,0,1,0,6,1589169600,1589169600,1
LeninsHammer,0,1,0,17,1579669200,1579669200,1
rooreeloo,0,1,0,3,1588132800,1588132800,1
FaRmErX2000,0,1,0,-25,1578286800,1578286800,1
YeahthisismyReddit,0,1,0,1,1608181200,1608181200,1
asgardian_superman,0,1,0,1,1597809600,1597809600,1
stargayzer,0,1,0,30,1599710400,1599710400,1
Beantownbrews,0,1,0,1,1606626000,1606626000,1
wecanbecowboys,0,1,0,25,1548651600,1548651600,1
McBaws21,0,1,0,1,1603857600,1603857600,1
LadyOrion2020,0,1,0,1,1591329600,1591329600,1
spleev,0,1,0,1,1597032000,1597032000,1
MrJake10,0,1,0,4,1605934800,1605934800,1
limppjuice,0,1,0,9,1565409600,1565409600,1
Red_Dogwood,0,1,0,13,1605330000,1605330000,1
Scruffyrivera,0,1,0,2,1614834000,1614834000,1
antifa_ceo,0,1,0,3,1594872000,1594872000,1
Neokon,0,1,0,42,1609131600,1609131600,1
TheMadnessWithinMe,0,1,0,3,1575867600,1575867600,1
CLBigGurl,0,1,0,7,1567310400,1567310400,1
Explosive_Diaeresis,0,1,0,10,1606539600,1606539600,1
wolverinehunter002,0,1,0,2,1561694400,1561694400,1
sadira246,0,1,0,2,1597118400,1597118400,1
hillshouldvewon94,0,1,0,0,1608094800,1608094800,1
w_a_g_unit,0,1,0,6,1547269200,1547269200,1
oroborometer,0,1,0,4,1611896400,1611896400,1
GoogleChromeKoran,0,1,0,1,1585195200,1585195200,1
CyinFromJohto,0,1,0,5,1584072000,1584072000,1
cocostotooo,0,1,0,2,1589774400,1589774400,1
1092384756,0,1,0,2,1596600000,1596600000,1
larsclaes,0,1,0,13,1599537600,1599537600,1
jackjayay,1,0,460,0,1602907200,1602907200,1
sketchburger,0,1,0,8,1563422400,1563422400,1
EnzymeX,0,1,0,12,1588046400,1588046400,1
MrBleak,0,1,0,1,1600574400,1600574400,1
someonenow1,0,1,0,1,1592452800,1592452800,1
blondeleather,0,1,0,21,1575003600,1575003600,1
Spread-Your-Wings,0,1,0,1,1602043200,1602043200,1
stillscottish1,0,1,0,15,1603512000,1603512000,1
OneandOnlyBeckster,0,1,0,1,1585540800,1585540800,1
i_canmakeamess,1,0,123,0,1605070800,1605070800,1
jawnlerdoe,0,1,0,1,1605070800,1605070800,1
blbrd30,0,1,0,3,1600488000,1600488000,1
bagelwithclocks,0,1,0,1,1603684800,1603684800,1
SanderGhar,0,1,0,-1,1603080000,1603080000,1
_Not_Bruce_Wayne_,0,1,0,3,1573102800,1573102800,1
pm_your_tity_please,0,1,0,2,1580878800,1580878800,1
Butter_fiend,1,0,53,0,1580101200,1580101200,1
AceGee,0,1,0,1,1605675600,1605675600,1
SkyKobb,0,1,0,1,1611982800,1611982800,1
roxypahoihoi,0,1,0,2,1617854400,1617854400,1
Comprehensive_Crow_3,0,1,0,4,1601784000,1601784000,1
beevyhoots,0,1,0,1,1607662800,1607662800,1
JoelMahon,0,1,0,1,1562040000,1562040000,1
danesh2003,0,1,0,1,1637298000,1637298000,1
TheGreenTactician,0,1,0,4,1545800400,1545800400,1
asim2991,0,1,0,-34,1592107200,1592107200,1
shfiven,0,1,0,-1,1603512000,1603512000,1
That_Dumb_Flower,0,1,0,1,1582261200,1582261200,1
mashedpotatoes2001,0,1,0,3,1606021200,1606021200,1
stipulus,0,1,0,5,1591243200,1591243200,1
realMrSparkle,0,1,0,6,1607749200,1607749200,1
thefockstopshere,0,1,0,6,1551762000,1551762000,1
meg4n,0,1,0,7,1587960000,1587960000,1
dodofishman,0,1,0,1,1570507200,1570507200,1
Savings-Revenue,0,1,0,1,1585454400,1585454400,1
RedMoon1507,1,0,12,0,1611810000,1611810000,1
nosingletree,0,1,0,-1,1593403200,1593403200,1
_buffster_,0,1,0,12,1592280000,1592280000,1
Negative_Plastic,0,1,0,1,1591329600,1591329600,1
LSDsavedmylife,0,1,0,2,1562299200,1562299200,1
Dumler,0,1,0,5,1596254400,1596254400,1
sebastianqu,0,1,0,16,1560916800,1560916800,1
magiche4d,0,1,0,2,1570161600,1570161600,1
pfSonata,0,1,0,-2,1591243200,1591243200,1
since4ever,0,1,0,22,1590984000,1590984000,1
IGbotter,0,1,0,1,1606626000,1606626000,1
OneTrueKram,0,1,0,1,1573621200,1573621200,1
VlV11,0,1,0,20,1577595600,1577595600,1
uminji,0,1,0,432,1587873600,1587873600,1
texlar,0,1,0,7,1585281600,1585281600,1
Mat_alThor,0,1,0,-1,1604379600,1604379600,1
watertessellation,0,1,0,7,1555819200,1555819200,1
bananainpyjama1,0,1,0,31,1565323200,1565323200,1
keysus_christ,0,1,0,1,1581656400,1581656400,1
mynameisvelocity,0,1,0,2,1589947200,1589947200,1
Pugtastic_smile,0,1,0,1,1605934800,1605934800,1
Zathoth,0,1,0,2,1548997200,1548997200,1
JimLucrative,0,1,0,8,1563422400,1563422400,1
fickenblasenspritzen,0,1,0,1,1573534800,1573534800,1
JaneyBurger,0,1,0,2,1612155600,1612155600,1
BuachEtiveMor,0,1,0,12,1574658000,1574658000,1
therailhead1974,0,1,0,2,1568952000,1568952000,1
nextgenammuntion,0,1,0,0,1611982800,1611982800,1
vikkipedia1988,1,0,477,0,1608094800,1608094800,1
Freon424,0,1,0,24,1609131600,1609131600,1
beachdemon14,0,1,0,1,1606626000,1606626000,1
capitalisttim88,0,1,0,0,1585454400,1585454400,1
DocGonzo71,0,1,0,9,1582693200,1582693200,1
RhettS,0,1,0,1,1539921600,1539921600,1
AModernDayMerlin,0,1,0,6,1564891200,1564891200,1
towije,0,1,0,8,1590120000,1590120000,1
demonitize_bot,0,1,0,1,1589256000,1589256000,1
yabadabadoit,0,1,0,17,1588046400,1588046400,1
ImTinyRick_gg,0,1,0,1,1603512000,1603512000,1
Norseman666,0,1,0,-1,1600747200,1600747200,1
furnoodle,0,1,0,19,1584331200,1584331200,1
Cliff_Clavin_Postman,0,1,0,44,1569211200,1569211200,1
belladonnamarchita,0,1,0,15,1587268800,1587268800,1
Cerebral_Savage,0,1,0,1,1612069200,1612069200,1
rjbradford33,0,1,0,6,1585627200,1585627200,1
comrade_isa,0,1,0,12,1585281600,1585281600,1
Delirium3192,0,1,0,1,1608613200,1608613200,1
scepteredhagiography,0,1,0,-1,1589256000,1589256000,1
basilkiller,0,1,0,1,1579150800,1579150800,1
WorldsWithin,0,1,0,54,1546318800,1546318800,1
Rezeox,0,1,0,1,1593576000,1593576000,1
regalbirdnerd,0,1,0,2,1605070800,1605070800,1
Montauksmom,0,1,0,6,1556251200,1556251200,1
ollypig1,0,1,0,6,1590638400,1590638400,1
Teutowolf,0,1,0,-1,1576040400,1576040400,1
r0s3___,1,0,3,0,1598155200,1598155200,1
NichtAddy,0,1,0,3,1603771200,1603771200,1
fellationelsen,0,1,0,10,1581570000,1581570000,1
catmeow2014,0,1,0,23,1612069200,1612069200,1
waigl,0,1,0,1,1562299200,1562299200,1
andymurray172,0,1,0,1,1584763200,1584763200,1
ok_to_sink,0,1,0,1,1550293200,1550293200,1
MonkNo595,0,1,0,12,1596340800,1596340800,1
hangingdenim,0,1,0,4,1599192000,1599192000,1
greggioia,0,1,0,12,1607403600,1607403600,1
NathTencent,0,1,0,4,1592280000,1592280000,1
--Gungnir--,0,1,0,1,1600660800,1600660800,1
philurbedwbees,0,1,0,11,1577854800,1577854800,1
MariaDBatchelor,0,1,0,6,1606194000,1606194000,1
quiet207,1,0,180,0,1588910400,1588910400,1
SeizedCheese,0,1,0,36,1604379600,1604379600,1
bumblebri93,0,1,0,2,1608526800,1608526800,1
shoobiedoobie,0,1,0,-3,1605589200,1605589200,1
vulturemittens,0,1,0,1,1552968000,1552968000,1
WhyIsMyBreadSoggy,0,1,0,3,1612155600,1612155600,1
judgebeholden,0,1,0,2,1531454400,1531454400,1
DAG123456,0,1,0,8,1579928400,1579928400,1
Garvin2,1,0,9,0,1561780800,1561780800,1
Synthoos,0,1,0,3,1558756800,1558756800,1
psychedelician,0,1,0,2,1595476800,1595476800,1
lunardonkey,0,1,0,4,1599192000,1599192000,1
zellfaze_new,0,1,0,18,1600228800,1600228800,1
benjohn87,0,1,0,3,1609304400,1609304400,1
AkexAlex,0,1,0,1,1611810000,1611810000,1
Tieerd,0,1,0,2,1589601600,1589601600,1
hahayourefat,0,1,0,-6,1601179200,1601179200,1
Desirai,0,1,0,1,1580014800,1580014800,1
Reverend_Schlachbals,0,1,0,3,1598414400,1598414400,1
occasionally_happy,0,1,0,16,1573794000,1573794000,1
ShimNikki,0,1,0,2,1578459600,1578459600,1
I-_T_-I,0,1,0,1,1601006400,1601006400,1
Science_1986,0,1,0,1,1603771200,1603771200,1
SaturnsEye,0,1,0,8,1585454400,1585454400,1
mirkywatters,0,1,0,1,1579410000,1579410000,1
LightTankTerror,0,1,0,18,1576904400,1576904400,1
autmned,0,1,0,3,1491710400,1491710400,1
killasin,0,1,0,3,1600660800,1600660800,1
SlipperyWetDogNose,0,1,0,1,1606885200,1606885200,1
TheDifferenceServer,0,1,0,1,1581483600,1581483600,1
AlbinoOrphans,0,1,0,4,1593835200,1593835200,1
softseraphic,0,1,0,8,1579755600,1579755600,1
pigtown-blues,0,1,0,47,1584763200,1584763200,1
neonowow,0,1,0,34,1599969600,1599969600,1
EthexC,0,1,0,12,1588478400,1588478400,1
FreeSoutherner,0,1,0,3,1600228800,1600228800,1
Supe12man,0,1,0,-1,1606626000,1606626000,1
Magmaticforce,0,1,0,15,1591588800,1591588800,1
notablossombombshell,0,1,0,3,1603339200,1603339200,1
skinny-fisted,0,1,0,1,1599969600,1599969600,1
DannyTaner,0,1,0,1,1608872400,1608872400,1
snakehisses,0,1,0,1,1606626000,1606626000,1
FeelsGouda,0,1,0,16,1605502800,1605502800,1
Augustinus77,0,1,0,1,1577163600,1577163600,1
n_pit,0,1,0,1,1565323200,1565323200,1
spergins,0,1,0,-4,1599883200,1599883200,1
SkeletonKeyX0X0,0,1,0,10,1579496400,1579496400,1
AngryUser34,0,1,0,2,1582002000,1582002000,1
Sporklessdinner,0,1,0,1,1606626000,1606626000,1
pbonesjones,0,1,0,1,1585454400,1585454400,1
devilsadidas,0,1,0,1,1589947200,1589947200,1
whopperwithchz,0,1,0,1,1572062400,1572062400,1
impossibletogetagf,0,1,0,1,1564718400,1564718400,1
fight-4-fries,0,1,0,3,1563249600,1563249600,1
Jessieoowwoo,1,0,21,0,1551848400,1551848400,1
mshep93,0,1,0,-10,1601438400,1601438400,1
Powwa9000,0,1,0,14,1592366400,1592366400,1
P33M,0,1,0,8,1557979200,1557979200,1
theacenoodles,0,1,0,6,1591156800,1591156800,1
ereader222,0,1,0,9,1600747200,1600747200,1
BOT_noot_noot,0,1,0,4,1605502800,1605502800,1
-TheFuckingAuthor-,1,0,3,0,1571371200,1571371200,1
starrrrrchild,0,1,0,3,1598673600,1598673600,1
curtdbz,0,1,0,9,1609045200,1609045200,1
solidsnakedummythicc,0,1,0,-1,1576386000,1576386000,1
DnDCrab,0,1,0,2,1589083200,1589083200,1
dysorientation,0,1,0,5,1571803200,1571803200,1
nicciana64472,1,0,0,0,1455339600,1455339600,1
Don-Blackman,0,1,0,1,1606539600,1606539600,1
bigeye_VI,0,1,0,5,1605157200,1605157200,1
sitnspin0,0,1,0,1,1606626000,1606626000,1
guiltycornet77,0,1,0,3,1580446800,1580446800,1
Snoo_2252,1,0,9,0,1595908800,1595908800,1
toonorth,0,1,0,1,1585454400,1585454400,1
Cosmodious,0,1,0,6,1598328000,1598328000,1
slynnry,0,1,0,5,1556424000,1556424000,1
twostep123,0,1,0,1,1608613200,1608613200,1
philosophist_,0,1,0,3,1552107600,1552107600,1
EzekialCat,0,1,0,2,1592798400,1592798400,1
sneakyclover,0,1,0,2,1577422800,1577422800,1
lumigan7,1,0,78,0,1578718800,1578718800,1
Instant_noodleless,0,1,0,1,1603512000,1603512000,1
memesalwaysdie,0,1,0,0,1591329600,1591329600,1
Atlas322,0,1,0,2,1579669200,1579669200,1
upemil,0,1,0,1,1602734400,1602734400,1
JPhase,1,0,459,0,1600228800,1600228800,1
NinjahBob,0,1,0,5,1571630400,1571630400,1
candysupreme,0,1,0,3,1579928400,1579928400,1
Seaunicron,0,1,0,1,1561780800,1561780800,1
SmeeGod,0,1,0,1,1603512000,1603512000,1
snowdogmom,0,1,0,2,1576731600,1576731600,1
fabrimancer,0,1,0,6,1604984400,1604984400,1
balad9,0,1,0,4,1607662800,1607662800,1
FreePatArthur,0,1,0,20,1594612800,1594612800,1
understandunderstand,0,1,0,2,1558152000,1558152000,1
greyviewing,0,1,0,1,1603512000,1603512000,1
OldManGing,0,1,0,3,1600574400,1600574400,1
ehmohteeoh,0,1,0,7,1593748800,1593748800,1
Jothegood,0,1,0,1,1609131600,1609131600,1
SaveMyElephants,0,1,0,1,1575262800,1575262800,1
stonks7903,0,1,0,17,1594008000,1594008000,1
Pie_Ro,0,1,0,-3,1551589200,1551589200,1
girlcalledkelly,0,1,0,13,1577163600,1577163600,1
FictionalOrange,0,1,0,2,1552968000,1552968000,1
Brf611,0,1,0,1,1607662800,1607662800,1
jephraim_tallow,0,1,0,2,1589688000,1589688000,1
coverletterheadstart,0,1,0,2,1606626000,1606626000,1
altuseracct2990,0,1,0,2,1590638400,1590638400,1
BrianSpilnerGallo12,0,1,0,1,1605589200,1605589200,1
borked3,1,0,27,0,1569902400,1569902400,1
Reconned,0,1,0,3,1600056000,1600056000,1
devil_in_drag,0,1,0,3,1602043200,1602043200,1
Morri67,0,1,0,3,1563249600,1563249600,1
1337Procrastinator,0,1,0,4,1585454400,1585454400,1
Beejsbj,0,1,0,2,1603857600,1603857600,1
marstersk,0,1,0,1,1572494400,1572494400,1
Facepalmed,0,1,0,-1,1573794000,1573794000,1
nothing_but_,0,1,0,3,1542171600,1542171600,1
screamingly,0,1,0,1,1573534800,1573534800,1
chaosoftime10,0,1,0,7,1584244800,1584244800,1
okaycpu,0,1,0,1,1583125200,1583125200,1
TreeFullOfFeathers,0,1,0,14,1601611200,1601611200,1
RamXid,0,1,0,30,1589601600,1589601600,1
bsg123123,0,1,0,7,1602907200,1602907200,1
disconcertinglymoist,0,1,0,5,1608354000,1608354000,1
WingsOfHeaven,0,1,0,3,1595563200,1595563200,1
queerly_radical,1,0,9,0,1607058000,1607058000,1
Ricky_Peanut,0,1,0,5,1573794000,1573794000,1
NEETHUGS,0,1,0,3,1580792400,1580792400,1
BlueOreos68,0,1,0,1,1603684800,1603684800,1
Demonyx12,0,1,0,1,1540353600,1540353600,1
Artistic_Narwhal_712,0,1,0,1,1599796800,1599796800,1
gaiaisgood,0,1,0,17,1555128000,1555128000,1
shawneestrings,0,1,0,5,1608181200,1608181200,1
Wicked_Googly,0,1,0,2,1605934800,1605934800,1
Chomper32,0,1,0,1,1600228800,1600228800,1
Aurelius_Titan,0,1,0,19,1604725200,1604725200,1
Cosmic_Kitsune,0,1,0,18,1604379600,1604379600,1
DisobedientGout,0,1,0,66,1569124800,1569124800,1
ceus10011,0,1,0,9,1581310800,1581310800,1
Mobile_Yellow,0,1,0,1,1637298000,1637298000,1
eitherorisgreat,0,1,0,2,1587614400,1587614400,1
niksa058,0,1,0,3,1579928400,1579928400,1
EaseleeiApproach,0,1,0,-1,1591329600,1591329600,1
Comfortable_Weird_83,0,1,0,2,1599883200,1599883200,1
Earthquake14,0,1,0,3,1573794000,1573794000,1
whiskeyspet,1,0,1,0,1541394000,1541394000,1
Marylucille,0,1,0,1,1588910400,1588910400,1
skarriss,0,1,0,-1,1607749200,1607749200,1
hajona,0,1,0,1,1605848400,1605848400,1
lilcyberyl,0,1,0,15,1579842000,1579842000,1
UnderpaidEngineer05,0,1,0,1,1609218000,1609218000,1
Zachariot88,0,1,0,2,1576731600,1576731600,1
limbo_ohno,0,1,0,2,1573016400,1573016400,1
Rhesusmonkeydave,0,1,0,1,1543208400,1543208400,1
TrashbagJoey,0,1,0,3,1605502800,1605502800,1
KungFu124,0,1,0,1,1606626000,1606626000,1
420CowboyTrashGoblin,0,1,0,1,1606021200,1606021200,1
Jam_Mann,0,1,0,18,1598155200,1598155200,1
hubblub,0,1,0,1,1598846400,1598846400,1
laszlo,0,1,0,2,1602216000,1602216000,1
moffl_joehy,0,1,0,4,1599192000,1599192000,1
eugene_stoner_,0,1,0,1,1607490000,1607490000,1
BikesBabiesBourbon,1,0,2,0,1601870400,1601870400,1
Wobbling,0,1,0,8,1589688000,1589688000,1
Rebirth98765,0,1,0,3,1594267200,1594267200,1
dabilahro,0,1,0,3,1604379600,1604379600,1
Great_Seaworthiness,0,1,0,2,1602993600,1602993600,1
ded_a_chek,0,1,0,10,1585454400,1585454400,1
Jkbucks,0,1,0,1,1598932800,1598932800,1
Magic_Sandwiches,0,1,0,1,1599624000,1599624000,1
Misenum,0,1,0,1,1606885200,1606885200,1
TrashMoonMoon,0,1,0,2,1581138000,1581138000,1
snekhoe,0,1,0,1,1598414400,1598414400,1
Due_Calligrapher8136,0,1,0,-1,1602216000,1602216000,1
Knightwing2525,0,1,0,1,1588651200,1588651200,1
siuinator,0,1,0,1,1600401600,1600401600,1
YayLewd,0,1,0,1,1578632400,1578632400,1
Cesurion,0,1,0,15,1596168000,1596168000,1
DiamondInTheSmooth,0,1,0,2,1597636800,1597636800,1
95blair,0,1,0,165,1602043200,1602043200,1
tengolibro,0,1,0,8,1562904000,1562904000,1
highoctane42093,0,1,0,1,1577854800,1577854800,1
echo_zoo,1,0,2680,0,1589256000,1589256000,1
DabStrong,0,1,0,4,1546405200,1546405200,1
lunahighwind,0,1,0,10,1585886400,1585886400,1
Hoo_Pharted,0,1,0,1,1591243200,1591243200,1
Ginnipe,0,1,0,2,1611982800,1611982800,1
relishingcarpenter,1,0,10,0,1559448000,1559448000,1
Boneroni,0,1,0,30,1574744400,1574744400,1
bebeyoda_staring,0,1,0,23,1587787200,1587787200,1
XlifelineBOX,0,1,0,5,1611982800,1611982800,1
KeithOlbrmnRapesKids,0,1,0,2,1635652800,1635652800,1
rkachowski,1,0,253,0,1606366800,1606366800,1
spiritedaway92,0,1,0,1,1606280400,1606280400,1
1fakeengineer,0,1,0,1,1589947200,1589947200,1
sayzi,0,1,0,2,1596945600,1596945600,1
redrose2017,0,1,0,7,1570939200,1570939200,1
stormchelle,0,1,0,2,1602820800,1602820800,1
JustADudeWhoThinks,0,1,0,13,1598932800,1598932800,1
BuriedButHedged11,0,1,0,5,1571371200,1571371200,1
ismystreetname,0,1,0,74,1603339200,1603339200,1
Allsiss,0,1,0,11,1584763200,1584763200,1
Dimter,0,1,0,0,1606107600,1606107600,1
Lazy_Maize_9552,0,1,0,1,1608008400,1608008400,1
10ebbor10,0,1,0,25,1575694800,1575694800,1
jmoyaknow,0,1,0,2,1574226000,1574226000,1
tpersona,0,1,0,1,1604638800,1604638800,1
whatwhat0808,0,1,0,18,1604293200,1604293200,1
0zzymandias_,1,0,162,0,1609045200,1609045200,1
wooglin1688,0,1,0,1,1611982800,1611982800,1
ChevalierdeSeingalt,1,0,3,0,1580187600,1580187600,1
bogenucleus,0,1,0,1,1576040400,1576040400,1
alt_egoi,0,1,0,3,1609218000,1609218000,1
thethrowawayable,0,1,0,2,1592712000,1592712000,1
MichelleStandsUp,0,1,0,1,1562126400,1562126400,1
FreezieKO,0,1,0,29,1598414400,1598414400,1
wantabe23,0,1,0,1,1608267600,1608267600,1
thepaleoboy,0,1,0,2,1578373200,1578373200,1
Pathfinder24,0,1,0,1,1576126800,1576126800,1
twilightprinc3ss,0,1,0,19,1576040400,1576040400,1
rothbard_anarchist,0,1,0,1,1571544000,1571544000,1
JiggyJ427,0,1,0,3,1569124800,1569124800,1
anontalk023,1,0,17,0,1563595200,1563595200,1
eight47pm,0,1,0,6,1608613200,1608613200,1
matcampa25,0,1,0,1,1589947200,1589947200,1
DJuskiwi,0,1,0,2,1591329600,1591329600,1
rmplstltskn_,0,1,0,1,1568520000,1568520000,1
Titiartichaud,0,1,0,3,1599883200,1599883200,1
meanls,0,1,0,5,1598241600,1598241600,1
she_may_be,0,1,0,1,1608613200,1608613200,1
I_Fight_Inferno,0,1,0,1,1603512000,1603512000,1
Sulluvun,0,1,0,10,1604379600,1604379600,1
onryo21,0,1,0,10,1605157200,1605157200,1
Malimalata,0,1,0,1,1605589200,1605589200,1
shadydaz9,0,1,0,17,1598068800,1598068800,1
REjectTheMemories,0,1,0,2,1582952400,1582952400,1
corpse_fucker_420,0,1,0,2,1602475200,1602475200,1
Csherman2,0,1,0,16,1609390800,1609390800,1
barsas161,1,0,757,0,1577422800,1577422800,1
keepthebear,0,1,0,2,1604898000,1604898000,1
DoodlesWeavers,0,1,0,-9,1563422400,1563422400,1
KeytKatysha,0,1,0,1,1606021200,1606021200,1
Robobeamer,0,1,0,6,1591243200,1591243200,1
CentrifugalFarts69,0,1,0,89,1597291200,1597291200,1
Dorodo4444,0,1,0,15,1601784000,1601784000,1
Fart_Barfington,0,1,0,1,1591329600,1591329600,1
Magenta_17,0,1,0,1,1611982800,1611982800,1
brooklynndg,0,1,0,12,1605848400,1605848400,1
GibbyGoesHard,0,1,0,39,1585281600,1585281600,1
facerollwiz,0,1,0,2,1601784000,1601784000,1
mellibird,0,1,0,5,1594180800,1594180800,1
bigbellyturtle,0,1,0,5,1603512000,1603512000,1
CritiqueMyAdvice,0,1,0,1,1584763200,1584763200,1
Vlyn,0,1,0,1,1608526800,1608526800,1
W0rsh3r,0,1,0,4,1554523200,1554523200,1
LostBackupFile,0,1,0,3,1585454400,1585454400,1
hotdogcaptain11,0,1,0,-4,1607662800,1607662800,1
inamestuff,1,0,12,0,1609390800,1609390800,1
tanksareforcowards,0,1,0,15,1555214400,1555214400,1
DolitehGreat,0,1,0,6,1583384400,1583384400,1
veronica2be,0,1,0,22,1569816000,1569816000,1
krispykola,0,1,0,15,1574658000,1574658000,1
Jkall13,0,1,0,7,1592107200,1592107200,1
farmer-boy-93,0,1,0,24,1593576000,1593576000,1
ndkaldjen,0,1,0,1,1635480000,1635480000,1
TheoreticalResult,0,1,0,1,1605589200,1605589200,1
MaxPower710,0,1,0,2,1604379600,1604379600,1
toomuchredditmaj,0,1,0,44,1596859200,1596859200,1
ozone63,0,1,0,0,1577422800,1577422800,1
acousticbruises,0,1,0,2,1605070800,1605070800,1
drakal30,0,1,0,-17,1601956800,1601956800,1
worldhype,0,1,0,1,1404878400,1404878400,1
JSpinnler,0,1,0,7,1554523200,1554523200,1
ina80,0,1,0,22,1578027600,1578027600,1
KinG-Mu,0,1,0,35,1607662800,1607662800,1
Droixhe,0,1,0,0,1608613200,1608613200,1
bboywhitey,0,1,0,2,1601179200,1601179200,1
trashboi814,0,1,0,14,1591416000,1591416000,1
hufflepuff-poet,0,1,0,2,1567569600,1567569600,1
Bjorkforkshorts,0,1,0,1,1604466000,1604466000,1
Homeless-Joe,0,1,0,1,1606280400,1606280400,1
dmelt01,0,1,0,2,1604811600,1604811600,1
happy_life_day,0,1,0,5,1587009600,1587009600,1
morris1022,0,1,0,0,1603252800,1603252800,1
BlueP0werRanger34,0,1,0,2,1604552400,1604552400,1
amorfotos,0,1,0,2,1604293200,1604293200,1
Cxefo,0,1,0,32,1594699200,1594699200,1
daymi,0,1,0,2,1553572800,1553572800,1
phantom_spaceman1138,0,1,0,6,1607922000,1607922000,1
xxxArchimedesxxx,0,1,0,1,1593576000,1593576000,1
andrejevas,0,1,0,29,1579237200,1579237200,1
Bermersher,0,1,0,3,1592280000,1592280000,1
stuffedanimalfap,0,1,0,2,1546405200,1546405200,1
123choji,0,1,0,1,1596600000,1596600000,1
_good_bot_,1,0,15,0,1581570000,1581570000,1
QuintessentialHalle,0,1,0,6,1564113600,1564113600,1
goaliedaddy,0,1,0,4,1591243200,1591243200,1
LucaYo,0,1,0,7,1608872400,1608872400,1
Gsygsygsy,0,1,0,5,1587528000,1587528000,1
vannahkadi,0,1,0,2,1574398800,1574398800,1
CaptainSothoth,0,1,0,4,1586577600,1586577600,1
VerofiablyInane1,0,1,0,3,1587873600,1587873600,1
softawre,0,1,0,3,1569211200,1569211200,1
TheBizzt,0,1,0,-2,1584504000,1584504000,1
bduddy,0,1,0,67,1573534800,1573534800,1
BlizzardLizard555,0,1,0,8,1607490000,1607490000,1
Merlbo,0,1,0,25,1582606800,1582606800,1
dannolin,0,1,0,1,1606021200,1606021200,1
Borris_Nobody,0,1,0,10,1583125200,1583125200,1
Late_Molasses,0,1,0,1,1584590400,1584590400,1
Keinichn,0,1,0,2,1603512000,1603512000,1
curlykalexx,0,1,0,2,1588996800,1588996800,1
Cautious_Cap,0,1,0,5,1597118400,1597118400,1
SissyInRed,0,1,0,24,1599451200,1599451200,1
evthrz,0,1,0,6,1593921600,1593921600,1
old_man_curmudgeon,0,1,0,1,1605502800,1605502800,1
casserolejoe,0,1,0,-4,1573621200,1573621200,1
i-love-myself-hard,1,0,13,0,1600142400,1600142400,1
mochicat91,0,1,0,4,1598414400,1598414400,1
Truly_Moist,0,1,0,2,1586577600,1586577600,1
N-K-91,0,1,0,2,1607835600,1607835600,1
evenlyroasted,0,1,0,7,1607403600,1607403600,1
9yroldupvotegiver,0,1,0,4,1598068800,1598068800,1
gofinditoutside,0,1,0,6,1587960000,1587960000,1
jesse9o3,0,1,0,8,1572062400,1572062400,1
bruh2077,1,0,12,0,1596081600,1596081600,1
rudamentK,0,1,0,8,1555214400,1555214400,1
Peen_Weinerstein,0,1,0,7,1569384000,1569384000,1
rararaknee,0,1,0,6,1583812800,1583812800,1
connessione,0,1,0,53,1608699600,1608699600,1
vinnymcapplesauce,0,1,0,0,1582088400,1582088400,1
deathsmokingmycigars,0,1,0,5,1608440400,1608440400,1
InvalidLength,1,0,14,0,1608354000,1608354000,1
hcraig38,0,1,0,2,1608354000,1608354000,1
PissMyPantalones,0,1,0,1,1607490000,1607490000,1
primetimenine,0,1,0,101,1604466000,1604466000,1
thebitlab,0,1,0,3,1608354000,1608354000,1
Jeniroo2,0,1,0,1,1600574400,1600574400,1
G-Bat,0,1,0,16,1612069200,1612069200,1
ChloroformScented,0,1,0,1,1634788800,1634788800,1
Mikatchoo,0,1,0,9,1606107600,1606107600,1
HotNubsOfSteel,0,1,0,-1,1588132800,1588132800,1
MrNeffery,0,1,0,3,1604552400,1604552400,1
Mr_Brunner,0,1,0,1,1608786000,1608786000,1
ChillyPickles,0,1,0,1,1581310800,1581310800,1
CPdragon,0,1,0,1,1553745600,1553745600,1
Micrococonut,0,1,0,1,1572148800,1572148800,1
Technetium_97,0,1,0,1,1591243200,1591243200,1
512emanresu,1,0,2352,0,1606885200,1606885200,1
AutumnBeckons,0,1,0,13,1591243200,1591243200,1
FlyingVhee,0,1,0,12,1590379200,1590379200,1
trihohair,0,1,0,52,1570593600,1570593600,1
scheherazade0xF,0,1,0,1,1585454400,1585454400,1
SneakyRussin13,0,1,0,1,1591329600,1591329600,1
hellololz1,0,1,0,3,1609477200,1609477200,1
AcringeWeido,0,1,0,1,1607922000,1607922000,1
-TheBeanQueen-,1,0,1277,0,1598414400,1598414400,1
Yellofishy,0,1,0,-15,1602043200,1602043200,1
jaynay1,0,1,0,42,1598846400,1598846400,1
HoodedKingdotcom,0,1,0,1,1606539600,1606539600,1
moogleslam,0,1,0,9,1603512000,1603512000,1
Sarcassimo,0,1,0,-1,1595217600,1595217600,1
Painfullakwardnesa,0,1,0,2,1606971600,1606971600,1
PM_ME_POTATO_PICS,0,1,0,5,1604811600,1604811600,1
Pakrat_Miz,0,1,0,1,1611896400,1611896400,1
kumquatparadise,0,1,0,1,1577854800,1577854800,1
hap_l_o,0,1,0,1,1598846400,1598846400,1
iluvstephenhawking,0,1,0,3,1589860800,1589860800,1
GlassPudding,0,1,0,3,1583899200,1583899200,1
odomandr,0,1,0,0,1585454400,1585454400,1
Nihilist_Servo,0,1,0,9,1581224400,1581224400,1
JadeStew,0,1,0,19,1554523200,1554523200,1
nervyrocks,0,1,0,54,1547528400,1547528400,1
Gometaa,0,1,0,2,1579582800,1579582800,1
WheatToastdream,1,0,37,0,1588564800,1588564800,1
Jac0b777,0,1,0,10,1552194000,1552194000,1
Antisocial_distance,0,1,0,1,1588996800,1588996800,1
HughDiePie,1,0,13,0,1606453200,1606453200,1
ach1lleast,0,1,0,2,1589947200,1589947200,1
DevilfishJack,0,1,0,3,1580274000,1580274000,1
zah4203,0,1,0,1,1605934800,1605934800,1
rml23,0,1,0,-5,1605502800,1605502800,1
Sunshine_Daylin,0,1,0,2,1602734400,1602734400,1
paradigmx,0,1,0,1,1573534800,1573534800,1
slithy_tove,0,1,0,1,1592884800,1592884800,1
rosencrantz_dies,0,1,0,9,1608786000,1608786000,1
DocRockhead,0,1,0,30,1603512000,1603512000,1
Tkx421,0,1,0,1,1578891600,1578891600,1
Lazy_Chemistry,0,1,0,2,1600056000,1600056000,1
lumberdrew,0,1,0,2,1597636800,1597636800,1
FormCompetitive6877,0,1,0,2,1606626000,1606626000,1
allonzeeLV,0,1,0,1,1610859600,1610859600,1
Coffeearing,0,1,0,6,1605070800,1605070800,1
MaxDemianCel,0,1,0,-3,1565496000,1565496000,1
not_sleep_4ever,0,1,0,111,1598328000,1598328000,1
robotteeth,0,1,0,15,1580101200,1580101200,1
faustxo,0,1,0,2,1612155600,1612155600,1
reerathered1,0,1,0,1,1596513600,1596513600,1
GanonSmokesDope,0,1,0,-8,1607576400,1607576400,1
ahotassmess25,0,1,0,1,1582866000,1582866000,1
blendertom,0,1,0,5,1590379200,1590379200,1
Vantaredd,0,1,0,2,1594785600,1594785600,1
AvailableProfile,0,1,0,2,1601179200,1601179200,1
Hulaoxiansheng,0,1,0,0,1562558400,1562558400,1
MyDogsNameIsBadger,0,1,0,1,1573534800,1573534800,1
ImCommieJesus,0,1,0,14,1566446400,1566446400,1
freddielovesdelilah,0,1,0,7,1602734400,1602734400,1
Xegeth,0,1,0,-14,1599537600,1599537600,1
SparkedWolf,0,1,0,26,1598846400,1598846400,1
TMJ_Jack,0,1,0,3,1603598400,1603598400,1
portrayedaswhat,0,1,0,2,1571976000,1571976000,1
themarsrover,0,1,0,12,1607576400,1607576400,1
dat_philtrum,0,1,0,2,1554696000,1554696000,1
dagal846,0,1,0,1,1603512000,1603512000,1
shaan_hussain,0,1,0,1,1580619600,1580619600,1
brianSIRENZ,0,1,0,-4,1606539600,1606539600,1
beepboop33,0,1,0,6,1582002000,1582002000,1
despacitogamer123,0,1,0,1,1575435600,1575435600,1
SramSeniorEDHificer,1,0,14,0,1606626000,1606626000,1
CentipedeSenpai,0,1,0,8,1568260800,1568260800,1
MercenaryCow,0,1,0,3,1585454400,1585454400,1
throwaway3418241,0,1,0,4,1589774400,1589774400,1
kassiopaia,0,1,0,7,1603598400,1603598400,1
bomboclawt75,0,1,0,2,1590638400,1590638400,1
IQVX,0,1,0,1,1556856000,1556856000,1
Enderchangling,0,1,0,76,1606453200,1606453200,1
harry000,0,1,0,1,1606626000,1606626000,1
SantanaSongwithoutB,0,1,0,1,1614920400,1614920400,1
tikaf,0,1,0,3,1600574400,1600574400,1
FutureMarkus,0,1,0,2,1603598400,1603598400,1
imboredsoisignedup,1,0,4,0,1471579200,1471579200,1
Snoo_Cookie,0,1,0,-3,1602129600,1602129600,1
YebureYatog,0,1,0,2,1605934800,1605934800,1
fatbastick,0,1,0,1,1589860800,1589860800,1
Envexacution,0,1,0,-9,1575176400,1575176400,1
seannytoobad,0,1,0,2,1605675600,1605675600,1
Ivondras,0,1,0,3,1578027600,1578027600,1
Darkparktarmparm,0,1,0,1,1561003200,1561003200,1
NIhIlIstIc-1,0,1,0,3,1557892800,1557892800,1
Smallz1014,0,1,0,1,1603512000,1603512000,1
Landxr33,0,1,0,-6,1572753600,1572753600,1
revolutionarykittens,0,1,0,1,1606712400,1606712400,1
pancake_sweater,0,1,0,2,1563940800,1563940800,1
motivated-robot,0,1,0,-13,1586577600,1586577600,1
Pickle-Wife,0,1,0,7,1608699600,1608699600,1
kleptophobiac,0,1,0,12,1578891600,1578891600,1
ThatSorcerer,0,1,0,2,1578546000,1578546000,1
Raaayjx,0,1,0,1,1580446800,1580446800,1
WaRlorder72,0,1,0,1,1582779600,1582779600,1
r1a2c3h4,1,0,18,0,1598155200,1598155200,1
throwaway19283726171,0,1,0,4,1598414400,1598414400,1
sgtlonewolf,0,1,0,-2,1585454400,1585454400,1
whatsthebfor,0,1,0,3,1607576400,1607576400,1
skinnylung,0,1,0,1,1597982400,1597982400,1
nyoomkaty,0,1,0,3,1606971600,1606971600,1
NeverThrowawayAcid,0,1,0,1,1604898000,1604898000,1
Jerryickson,0,1,0,1,1609304400,1609304400,1
MarylandKrab,0,1,0,1,1591243200,1591243200,1
MoreEliteThanYou,0,1,0,5,1581570000,1581570000,1
shangrila500,0,1,0,3,1580360400,1580360400,1
Leftleaninghaggis,0,1,0,14,1607749200,1607749200,1
Raf_Camora,0,1,0,-1,1611896400,1611896400,1
carlsaganblessyou,0,1,0,0,1590206400,1590206400,1
biz812,0,1,0,6,1605502800,1605502800,1
tavorflavor,0,1,0,1,1602993600,1602993600,1
somern65,0,1,0,117,1572930000,1572930000,1
Kalebtbacon,0,1,0,9,1609477200,1609477200,1
whatusernamex,0,1,0,67,1571889600,1571889600,1
LaserTurboShark69,0,1,0,1,1602907200,1602907200,1
rtp91,0,1,0,1,1588219200,1588219200,1
Porkaholicthroway,0,1,0,5,1608613200,1608613200,1
Psistriker94,0,1,0,-1,1599019200,1599019200,1
Greenbean618,0,1,0,28,1572148800,1572148800,1
lobsterdadddy,0,1,0,3,1593921600,1593921600,1
magicalmorganx,0,1,0,2,1582520400,1582520400,1
EmeraldAtoma,0,1,0,7,1570507200,1570507200,1
csapperstein,0,1,0,15,1561521600,1561521600,1
rrattlesnake,0,1,0,20,1608526800,1608526800,1
Commonmispelingbot,0,1,0,1,1572753600,1572753600,1
Buffalo_Taquito17,0,1,0,2,1594958400,1594958400,1
SidB111,0,1,0,1,1601006400,1601006400,1
Optimal_Copy_1242,1,0,8,0,1607662800,1607662800,1
OrangeFreakingJoe,0,1,0,9,1589428800,1589428800,1
AmosJoseph,0,1,0,1,1606280400,1606280400,1
Spockticus,0,1,0,1,1603771200,1603771200,1
SnooAdvice7448,0,1,0,1,1600833600,1600833600,1
Theappunderground,0,1,0,-8,1595131200,1595131200,1
Mojachee,0,1,0,2,1582347600,1582347600,1
PerfectParfait5,0,1,0,1,1570248000,1570248000,1
dryrubs,0,1,0,9,1558238400,1558238400,1
xXGoobyXx,0,1,0,-2,1608267600,1608267600,1
buffalowselfesteem,1,0,4,0,1606366800,1606366800,1
WeAllJusSomeEggFr,0,1,0,1,1605157200,1605157200,1
splenicartery,0,1,0,1,1601006400,1601006400,1
SomeJadedGuy,0,1,0,1,1585454400,1585454400,1
nomnom6969,0,1,0,1,1583899200,1583899200,1
honeycomb095,0,1,0,3,1606798800,1606798800,1
SLG_Didact,0,1,0,2,1604379600,1604379600,1
rollerska8er,0,1,0,10,1593748800,1593748800,1
TranarchoCom,0,1,0,1,1594440000,1594440000,1
pete306,0,1,0,2,1594872000,1594872000,1
patrick_bw,0,1,0,18,1591588800,1591588800,1
loliduhh,0,1,0,2,1579410000,1579410000,1
ronvass,0,1,0,1,1600833600,1600833600,1
george_amberson19,0,1,0,8,1598155200,1598155200,1
Eagle_707,0,1,0,1,1593835200,1593835200,1
vbails,0,1,0,1,1602043200,1602043200,1
Sicpsym_tr-c0usnzz,0,1,0,1,1579323600,1579323600,1
Franksredsilverado,0,1,0,1,1603512000,1603512000,1
ItsEazyImBackNow,0,1,0,6,1585454400,1585454400,1
skinybot1224,0,1,0,2,1607230800,1607230800,1
themanwithbigbrain,0,1,0,-10,1563336000,1563336000,1
chazmaster44,0,1,0,41,1607230800,1607230800,1
coolsexguy,0,1,0,3,1600747200,1600747200,1
OMGITSJAD,0,1,0,2,1587528000,1587528000,1
FlauertyMombasa,0,1,0,3,1581224400,1581224400,1
biobooster40k,0,1,0,6,1585454400,1585454400,1
lurker_registered,0,1,0,7,1604293200,1604293200,1
havegottobejoking,0,1,0,1,1572580800,1572580800,1
Nosbod_,0,1,0,2,1594612800,1594612800,1
TheRockinkitty,0,1,0,16,1604030400,1604030400,1
TheJrr,0,1,0,9,1592625600,1592625600,1
planborcord,0,1,0,7,1611810000,1611810000,1
Deranth,0,1,0,4,1584763200,1584763200,1
AjantsAgony,0,1,0,90,1576299600,1576299600,1
RastaPastah,0,1,0,1,1568952000,1568952000,1
samueltunechi,0,1,0,-5,1571976000,1571976000,1
Kepan999,0,1,0,3,1566187200,1566187200,1
annooonnnn,0,1,0,2,1609045200,1609045200,1
ColonelJayce,0,1,0,34,1604898000,1604898000,1
ADeviousFella,0,1,0,6,1572408000,1572408000,1
threequarterminus,0,1,0,8,1553400000,1553400000,1
mvsr990,0,1,0,4,1590120000,1590120000,1
nostealmyhoodie,0,1,0,1,1576558800,1576558800,1
Support_Sweaty,0,1,0,-3,1608699600,1608699600,1
jona612,0,1,0,8,1575003600,1575003600,1
coozin,0,1,0,2,1577422800,1577422800,1
deletable666,0,1,0,1,1600660800,1600660800,1
KennyKentagious,0,1,0,8,1578286800,1578286800,1
periodicchemistrypun,0,1,0,1,1573534800,1573534800,1
Lucker_Kid,0,1,0,1,1603598400,1603598400,1
Dizzy-Speaker,0,1,0,7,1603598400,1603598400,1
bassabr,0,1,0,2,1564372800,1564372800,1
argh7259,0,1,0,4,1584676800,1584676800,1
spider2k,0,1,0,1,1608872400,1608872400,1
sigriv,0,1,0,1,1532923200,1532923200,1
mombawamba,1,0,68,0,1605416400,1605416400,1
LigerXT5,0,1,0,3,1605934800,1605934800,1
LovelyKakapo,0,1,0,6,1608872400,1608872400,1
Dormideous,0,1,0,3,1606798800,1606798800,1
Skybo007,0,1,0,1,1588132800,1588132800,1
HyperFoxx,1,0,172,0,1597896000,1597896000,1
JimmyPage108,0,1,0,15,1606626000,1606626000,1
Hermanissoxxx,0,1,0,1,1557547200,1557547200,1
vegozmia,0,1,0,108,1587182400,1587182400,1
depthnoir,0,1,0,17,1599105600,1599105600,1
JessieBash,0,1,0,-4,1585540800,1585540800,1
52fighters,0,1,0,3,1606539600,1606539600,1
mint_jewel_lips,0,1,0,3,1611896400,1611896400,1
zildawolf,0,1,0,1,1580706000,1580706000,1
TheSmokeyPounder,0,1,0,1,1588392000,1588392000,1
jonnykickstomp,0,1,0,10,1606626000,1606626000,1
dr69ons6mur6i,0,1,0,2,1596600000,1596600000,1
DEFCOR434,0,1,0,-3,1605934800,1605934800,1
Atbd23,0,1,0,18,1562472000,1562472000,1
tampers_w_evidence,0,1,0,15,1551589200,1551589200,1
Cupkek,0,1,0,117,1562990400,1562990400,1
LizvEross,0,1,0,1,1589947200,1589947200,1
IntellectualRetard_,0,1,0,1,1578978000,1578978000,1
ElPedroChico,0,1,0,1,1595131200,1595131200,1
Forward-Egg9123,1,0,51,0,1606539600,1606539600,1
tr1pp1nballs,0,1,0,10,1608526800,1608526800,1
brockwilmert,0,1,0,14,1573794000,1573794000,1
krimin_killr21,0,1,0,15,1579237200,1579237200,1
Treegan10,0,1,0,2,1603512000,1603512000,1
Spookyboi608,0,1,0,2,1610514000,1610514000,1
OldBridge5,0,1,0,1,1590033600,1590033600,1
Roshamboagogo,0,1,0,1,1592971200,1592971200,1
C_Nova,0,1,0,1,1573534800,1573534800,1
thrwouawwei,0,1,0,2,1560312000,1560312000,1
thatguygxx,0,1,0,5,1606626000,1606626000,1
EthanWChen,0,1,0,1,1602043200,1602043200,1
InterestingFeedback,0,1,0,8,1575262800,1575262800,1
_bigfootsdick,0,1,0,3,1607490000,1607490000,1
Representative_Ad246,1,0,1,0,1599537600,1599537600,1
SuperSaiyanSandwich,0,1,0,4,1585540800,1585540800,1
johnnywithawhy,0,1,0,4,1583125200,1583125200,1
uga2atl,1,0,21,0,1607144400,1607144400,1
Ed_Vilon,0,1,0,4,1579669200,1579669200,1
aquaticmoon,0,1,0,22,1585972800,1585972800,1
Cortheya,0,1,0,8,1551070800,1551070800,1
KillerofBadThings,0,1,0,7,1582952400,1582952400,1
Elven_Rhiza,0,1,0,3,1606539600,1606539600,1
Queenmarshmellow,0,1,0,-10,1567828800,1567828800,1
Ketanin,0,1,0,8,1577509200,1577509200,1
Sky_Hawk105,0,1,0,11,1541826000,1541826000,1
acidvomit,0,1,0,-2,1596254400,1596254400,1
CloudFTL,0,1,0,1,1600833600,1600833600,1
MattR59,0,1,0,11,1572494400,1572494400,1
nosrednaeoj,1,0,7,0,1606712400,1606712400,1
sickestinvertebrate,0,1,0,1,1606453200,1606453200,1
a-rock-fact,0,1,0,2,1607922000,1607922000,1
thebardjaskier,0,1,0,2,1584676800,1584676800,1
atsuko_24,0,1,0,49,1606885200,1606885200,1
tobster1113,0,1,0,24,1571716800,1571716800,1
1960sCampVillain,0,1,0,5,1602993600,1602993600,1
BruhruckObummer,0,1,0,4,1591588800,1591588800,1
humanbeing2016,1,0,108,0,1607662800,1607662800,1
KAS30,0,1,0,4,1573362000,1573362000,1
baile508,0,1,0,0,1608786000,1608786000,1
Redpill1981,0,1,0,0,1594958400,1594958400,1
queenlatifaisagod,1,0,96,0,1578978000,1578978000,1
whichMD,0,1,0,1,1603684800,1603684800,1
anotherfailedspinoff,0,1,0,16,1570161600,1570161600,1
Katholikos,0,1,0,20,1595995200,1595995200,1
CountBlah_Blah,0,1,0,7,1574485200,1574485200,1
AShaughRighting,0,1,0,2,1597377600,1597377600,1
hipsterstalker,0,1,0,1,1574226000,1574226000,1
CallMeDrewvy,0,1,0,1,1582779600,1582779600,1
CDewfus,0,1,0,1,1585454400,1585454400,1
elm-noob,0,1,0,1,1605589200,1605589200,1
Mrhurtmachine,0,1,0,2,1585108800,1585108800,1
roadkill1428,0,1,0,1,1606885200,1606885200,1
saahed69,0,1,0,2,1609218000,1609218000,1
MacGrimey,0,1,0,3,1604379600,1604379600,1
TallFee0,0,1,0,1,1600574400,1600574400,1
spring_while_I_fall,0,1,0,1,1605157200,1605157200,1
Kurva-Lazanja,0,1,0,1,1573362000,1573362000,1
malewifemichaelmyers,0,1,0,13,1611982800,1611982800,1
hotairballonfreak,0,1,0,3,1612069200,1612069200,1
Ricardoprex,0,1,0,1,1603598400,1603598400,1
Krowsfeet,0,1,0,2,1607662800,1607662800,1
cynicaljerkahole,0,1,0,11,1584763200,1584763200,1
IlinPT,0,1,0,2,1588392000,1588392000,1
Inertiatic-Wrist,0,1,0,1,1608872400,1608872400,1
ssccoottttyy,0,1,0,12,1578805200,1578805200,1
getyourzirc0n,0,1,0,3,1603512000,1603512000,1
jason94762,0,1,0,16,1575349200,1575349200,1
chillidog02,1,0,23,0,1560398400,1560398400,1
slydexic,0,1,0,2,1598673600,1598673600,1
thecommunistserver,1,0,1,0,1547874000,1547874000,1
Some-Length8383,0,1,0,1,1608699600,1608699600,1
the-next-stage,0,1,0,4,1547355600,1547355600,1
Betty2theWhite,0,1,0,2,1601697600,1601697600,1
something_random_927,0,1,0,2,1592452800,1592452800,1
WelcomeToTheBough,0,1,0,2,1568347200,1568347200,1
UnDeadPresident,0,1,0,43,1580360400,1580360400,1
vgamer0,0,1,0,5,1601870400,1601870400,1
nthcxd,0,1,0,14,1570075200,1570075200,1
MsMungo,0,1,0,0,1595908800,1595908800,1
SourceAlert,0,1,0,1,1607835600,1607835600,1
Theodore__Kerabatsos,0,1,0,1,1589774400,1589774400,1
yaKaytuxa,0,1,0,0,1606366800,1606366800,1
Sm1lestheBear,0,1,0,1,1574053200,1574053200,1
Sir_Vexer,0,1,0,2,1599624000,1599624000,1
threefrogs,0,1,0,17,1560571200,1560571200,1
TheWillingWell13,0,1,0,9,1599019200,1599019200,1
xosfear,0,1,0,22,1548565200,1548565200,1
RodLawyer,0,1,0,1,1553832000,1553832000,1
Glockmaster666,0,1,0,-3,1606539600,1606539600,1
NKVD_openup,0,1,0,10,1578286800,1578286800,1
Jmsaint,0,1,0,6,1585022400,1585022400,1
CharlieAndArtemis,0,1,0,7,1562212800,1562212800,1
BlahYourHamster,0,1,0,59,1595563200,1595563200,1
Biuku,0,1,0,-1,1587614400,1587614400,1
Flurbb,0,1,0,5,1600228800,1600228800,1
xBirdisword,0,1,0,17,1611982800,1611982800,1
gallardo2012xd,0,1,0,3,1587182400,1587182400,1
GarlicKitty,0,1,0,2,1600833600,1600833600,1
ROClNANTE,0,1,0,2,1600315200,1600315200,1
ragvamuffin,0,1,0,2,1553227200,1553227200,1
BumOnALog,0,1,0,3,1576040400,1576040400,1
ISieferVII,0,1,0,16,1603512000,1603512000,1
llandar,0,1,0,3,1605934800,1605934800,1
applebees_microwave,0,1,0,3,1605243600,1605243600,1
yarnwhore,0,1,0,8,1589169600,1589169600,1
wolfman12793,0,1,0,5,1601956800,1601956800,1
CashOgre,0,1,0,8,1585454400,1585454400,1
sdqcmkgevgbbypcsro,0,1,0,-23,1607835600,1607835600,1
hundreddollabillaz,1,0,25,0,1588132800,1588132800,1
Chadamir_Putin,0,1,0,9,1599451200,1599451200,1
Critical_Hamster_89,0,1,0,3,1602388800,1602388800,1
I_have_a_helmet,0,1,0,1,1606626000,1606626000,1
RU_dumbORdumbr,0,1,0,1,1593576000,1593576000,1
Indiancockburn,0,1,0,2,1604293200,1604293200,1
Knives4Bullets,0,1,0,3,1562299200,1562299200,1
Noughmad,0,1,0,5,1575262800,1575262800,1
backawhile92,0,1,0,9,1575608400,1575608400,1
Allison-Hehe,0,1,0,12,1580187600,1580187600,1
Triviajunkie95,0,1,0,3,1566446400,1566446400,1
binipped,0,1,0,-1,1598760000,1598760000,1
throwaway42,0,1,0,1,1584676800,1584676800,1
ResidentSleeperCell,0,1,0,7,1608094800,1608094800,1
ize_yo,0,1,0,14,1599019200,1599019200,1
iiCabin,0,1,0,2,1594699200,1594699200,1
Whiplash86420,0,1,0,9,1545022800,1545022800,1
Ker-aooc,0,1,0,2,1611982800,1611982800,1
feralfred,0,1,0,9,1605157200,1605157200,1
taoistidiot,0,1,0,2,1604811600,1604811600,1
xbromide,0,1,0,73,1597809600,1597809600,1
sssasenhora,1,0,18,0,1604293200,1604293200,1
OmegaInLA,0,1,0,30,1566619200,1566619200,1
CrazyCaper,0,1,0,1,1604379600,1604379600,1
poon15,0,1,0,15,1592193600,1592193600,1
bambiibear,1,0,0,0,1607576400,1607576400,1
Plankzt,0,1,0,-4,1576731600,1576731600,1
ice_king_and_gunter,0,1,0,5,1590638400,1590638400,1
pembull,0,1,0,39,1606453200,1606453200,1
fucking_unicorn,0,1,0,3,1606021200,1606021200,1
neceone1sister,0,1,0,1,1600833600,1600833600,1
austinmiles,0,1,0,2,1606021200,1606021200,1
choncionline,1,0,64,0,1608267600,1608267600,1
BurningDeltaIV,0,1,0,0,1582779600,1582779600,1
flamenski,0,1,0,27,1582434000,1582434000,1
TerantQ,0,1,0,80,1589342400,1589342400,1
Lancimus,0,1,0,1,1581570000,1581570000,1
Mockbubbles2628,0,1,0,3,1572148800,1572148800,1
FitMongoose9,0,1,0,6,1602734400,1602734400,1
taylorpagemusic,0,1,0,4,1598846400,1598846400,1
Papa_Furanku,0,1,0,6,1585454400,1585454400,1
sticky_banana,1,0,40,0,1539921600,1539921600,1
InfectiousYouth,0,1,0,3,1589860800,1589860800,1
IsItTooLateForReddit,0,1,0,1,1606021200,1606021200,1
Professor-B83,0,1,0,2,1582174800,1582174800,1
impishonetwo3,1,0,6,0,1605416400,1605416400,1
FrankieBoopa,0,1,0,1,1598068800,1598068800,1
Abductmedaddy,0,1,0,3,1596945600,1596945600,1
silkymilkk,0,1,0,2,1599624000,1599624000,1
BedHeadBread,0,1,0,4,1594872000,1594872000,1
CreamOnMyNipples,0,1,0,-1,1599969600,1599969600,1
Cumlord4444,0,1,0,2,1602216000,1602216000,1
teaaaelliott,0,1,0,23,1600228800,1600228800,1
Aqua_Virus,0,1,0,8,1570507200,1570507200,1
dingdongcuntslayer,0,1,0,1,1588910400,1588910400,1
Liquorace,0,1,0,1,1605502800,1605502800,1
JonathanCrane2,0,1,0,39,1592193600,1592193600,1
ohhaberathee,0,1,0,3,1581483600,1581483600,1
Curious_A_Crane,0,1,0,25,1602993600,1602993600,1
TheGuyWhoReallyCares,1,0,92,0,1606798800,1606798800,1
jklharris,0,1,0,1,1612069200,1612069200,1
Kind_Principle_3647,0,1,0,1,1599969600,1599969600,1
AZStarkiller,0,1,0,-3,1575781200,1575781200,1
Eagle_Vision_13,0,1,0,3,1576904400,1576904400,1
SpartanLazarPipBoy3k,0,1,0,2,1596427200,1596427200,1
SuddenlyGeccos,0,1,0,1,1607576400,1607576400,1
jaywilliamstheman,0,1,0,39,1585281600,1585281600,1
GreasyPeter,0,1,0,3,1575522000,1575522000,1
MaslowsNeedsLol,1,0,48,0,1602216000,1602216000,1
Szelenas,0,1,0,8,1587700800,1587700800,1
Hippopotamus-Hump-Ya,0,1,0,3,1598673600,1598673600,1
llame_llama,0,1,0,-6,1553486400,1553486400,1
gynoplasty,0,1,0,39,1582434000,1582434000,1
soniky1,0,1,0,1,1608526800,1608526800,1
tmo_slc,0,1,0,2,1584331200,1584331200,1
Laearo,0,1,0,4,1611896400,1611896400,1
Odbdb,0,1,0,1,1592107200,1592107200,1
OstapBenderBey,0,1,0,3,1543467600,1543467600,1
BigBoy1102,0,1,0,1,1584763200,1584763200,1
gogoman2012,0,1,0,1,1608872400,1608872400,1
killdare,0,1,0,3,1602129600,1602129600,1
chester_copperpot7,0,1,0,5,1585454400,1585454400,1
Tark001,0,1,0,-6,1608354000,1608354000,1
ThreadRetributionist,0,1,0,53,1587268800,1587268800,1
WaterOnMe,0,1,0,6,1603425600,1603425600,1
SilverRock75,0,1,0,6,1599796800,1599796800,1
Fiveseconds5,0,1,0,-5,1590984000,1590984000,1
Anax-Junius,1,0,4,0,1608094800,1608094800,1
CyberD7,0,1,0,-12,1578286800,1578286800,1
soyouwannadance,0,1,0,3,1586404800,1586404800,1
ninurta_ningirsu,0,1,0,1,1608872400,1608872400,1
Khandro_T,0,1,0,1,1572062400,1572062400,1
Requiredmetrics,0,1,0,9,1570075200,1570075200,1
GoldenSpamfish,0,1,0,10,1589256000,1589256000,1
boatyfloat,0,1,0,4,1579150800,1579150800,1
MultiStratz,0,1,0,7,1583643600,1583643600,1
DietyChief,0,1,0,5,1572843600,1572843600,1
visualsurface,0,1,0,6,1608526800,1608526800,1
th3l3rk3r,0,1,0,2,1603512000,1603512000,1
Sopocolas,0,1,0,102,1601265600,1601265600,1
schwarzekatze999,0,1,0,3,1594008000,1594008000,1
Orion14159,0,1,0,8,1611810000,1611810000,1
orion4888,0,1,0,117,1608613200,1608613200,1
sexygreencardigan,0,1,0,14,1572494400,1572494400,1
aioy,0,1,0,5,1556164800,1556164800,1
activitylogger,0,1,0,1,1609304400,1609304400,1
escapemanuele,0,1,0,2,1592107200,1592107200,1
blacklodging,0,1,0,10,1597032000,1597032000,1
BadbadwickedZoot,0,1,0,2,1604552400,1604552400,1
LongdyckJohnson,0,1,0,1,1587614400,1587614400,1
thekingwoz,0,1,0,0,1601352000,1601352000,1
ExpensivePatience5,0,1,0,2,1603598400,1603598400,1
KnowledgeIsDangerous,0,1,0,6,1602734400,1602734400,1
fox131313,0,1,0,4,1556424000,1556424000,1
Cypher26,0,1,0,3,1590120000,1590120000,1
69InBinaryWasTaken,0,1,0,46,1587614400,1587614400,1
dyertewrewrew,0,1,0,-4,1607144400,1607144400,1
RearWheelDriveCult,0,1,0,124,1600920000,1600920000,1
throw951away,0,1,0,1,1571457600,1571457600,1
Pizza_Ninja,0,1,0,2,1570161600,1570161600,1
PaintedPearTickler,0,1,0,1,1598760000,1598760000,1
uhtredofbeb,0,1,0,2,1582779600,1582779600,1
MedianWhiteMale,0,1,0,3,1588564800,1588564800,1
The_darter,0,1,0,2,1600488000,1600488000,1
elrudu,0,1,0,4,1605070800,1605070800,1
jetjetjupt,1,0,209,0,1600228800,1600228800,1
AllThatCreepeth,0,1,0,10,1547010000,1547010000,1
ItCertainlyChecksOut,0,1,0,6,1557547200,1557547200,1
djab1,0,1,0,0,1555905600,1555905600,1
Andysmith_is,0,1,0,16,1573016400,1573016400,1
ColonelHans,0,1,0,1,1608958800,1608958800,1
okherrgoesnothing,0,1,0,3,1601092800,1601092800,1
genericlatino,0,1,0,4,1564545600,1564545600,1
Gangreless,0,1,0,463,1606021200,1606021200,1
An_Innocent_Childs,0,1,0,-9,1608699600,1608699600,1
drldxn,0,1,0,22,1576558800,1576558800,1
this_is_so_wasteful,0,1,0,7,1606971600,1606971600,1
JagKissarIDuschen,0,1,0,4,1582779600,1582779600,1
Voslancid777,0,1,0,1,1582261200,1582261200,1
okaytheng,0,1,0,2,1564718400,1564718400,1
tmwildlife,1,0,5176,0,1596168000,1596168000,1
Xurkitree1,0,1,0,1,1606366800,1606366800,1
Matthew_Lake,0,1,0,1,1571803200,1571803200,1
Annchan4,0,1,0,4,1603080000,1603080000,1
amyra2005,0,1,0,1,1585454400,1585454400,1
curiousTings,0,1,0,1,1593921600,1593921600,1
caloocana,0,1,0,1,1601352000,1601352000,1
coltrainjones,0,1,0,10,1546750800,1546750800,1
Shiny_Rage,1,0,90,0,1564804800,1564804800,1
Arfman2,0,1,0,5,1604116800,1604116800,1
the_man2012,0,1,0,1,1603512000,1603512000,1
jackstrawnyc,0,1,0,1,1607144400,1607144400,1
thatoneguysi,0,1,0,1,1572843600,1572843600,1
juse-pedru,0,1,0,3,1580619600,1580619600,1
Frank_McGracie,0,1,0,10,1605157200,1605157200,1
Hatgameguy,0,1,0,7,1603425600,1603425600,1
ChronosCast,0,1,0,2,1577854800,1577854800,1
VesemirsPotionsNLean,0,1,0,2,1579755600,1579755600,1
SayYesToEverythingHm,0,1,0,1,1572062400,1572062400,1
Tim_the_terrible,0,1,0,1,1609390800,1609390800,1
evokerhythm,0,1,0,4,1584417600,1584417600,1
cjmayo44,0,1,0,2,1597291200,1597291200,1
lil_pfft,0,1,0,22,1606280400,1606280400,1
natteulven,0,1,0,6,1587873600,1587873600,1
things_will_calm_up,0,1,0,3,1567828800,1567828800,1
pierknows,0,1,0,1,1577854800,1577854800,1
KarmicComic12334,0,1,0,2,1598932800,1598932800,1
Cricket_Chassis,0,1,0,5,1573189200,1573189200,1
titans661,0,1,0,2,1583812800,1583812800,1
macrotransactions,0,1,0,-2,1603512000,1603512000,1
onethecamden,0,1,0,2,1553918400,1553918400,1
TooManyWaifu,0,1,0,6,1571284800,1571284800,1
AncientIllustrator4,0,1,0,0,1620446400,1620446400,1
Lepty,0,1,0,0,1608699600,1608699600,1
mgenkin,0,1,0,2,1635220800,1635220800,1
Teaspoooons,0,1,0,11,1598673600,1598673600,1
ManaHasu,0,1,0,4,1552536000,1552536000,1
AlienatedOphelia,0,1,0,1,1465012800,1465012800,1
ceebee6,0,1,0,6,1584676800,1584676800,1
Spartacus891,0,1,0,15,1593144000,1593144000,1
FurryFrog199,0,1,0,-2,1606539600,1606539600,1
AdeptnessTime,1,0,2,0,1601524800,1601524800,1
fuckalljobs,0,1,0,5,1562040000,1562040000,1
InMyRestlessDreams23,1,0,174,0,1579582800,1579582800,1
rSkorpio,0,1,0,-1,1578373200,1578373200,1
maddsturbation,0,1,0,12,1593662400,1593662400,1
malakistiri,0,1,0,1,1607230800,1607230800,1
JayKaBe,0,1,0,-1,1608526800,1608526800,1
Coffee__2__Code,0,1,0,1,1599192000,1599192000,1
icyjiubnext,0,1,0,29,1601438400,1601438400,1
mostlybadopinions,0,1,0,5,1608786000,1608786000,1
razlethe,0,1,0,2,1587614400,1587614400,1
coffeensnake,0,1,0,3,1612069200,1612069200,1
peijots,0,1,0,33,1579150800,1579150800,1
StripClubDemiGod,0,1,0,2,1557028800,1557028800,1
BoredMan29,0,1,0,43,1589860800,1589860800,1
Yes-more-of-that,0,1,0,1,1606971600,1606971600,1
fucklefuckle782,0,1,0,2,1592452800,1592452800,1
iansmart8,1,0,13,0,1606021200,1606021200,1
SenatorRobPortman,0,1,0,1,1605589200,1605589200,1
MatiasPalacios,0,1,0,1,1611982800,1611982800,1
BushDidN0thingWr0ng,0,1,0,8,1594353600,1594353600,1
badbrainradio,0,1,0,11,1601265600,1601265600,1
Zart01,0,1,0,1,1608699600,1608699600,1
kuribbi,0,1,0,2,1567137600,1567137600,1
Only_Being_Frank,0,1,0,-12,1589860800,1589860800,1
Knowledge_gaps,0,1,0,2,1601352000,1601352000,1
BillDino,0,1,0,10,1571544000,1571544000,1
Gswizzle67,0,1,0,3,1585022400,1585022400,1
mahogafrick,0,1,0,6,1601265600,1601265600,1
jfcmfer,0,1,0,20,1586923200,1586923200,1
taxhelpmethrowaway,1,0,0,0,1562385600,1562385600,1
Progressiveandfiscal,0,1,0,1,1605934800,1605934800,1
RupertxPupkin,0,1,0,5,1598500800,1598500800,1
cinderblock0,0,1,0,2,1612069200,1612069200,1
yummyyummypancakes,0,1,0,8,1584849600,1584849600,1
everyoneiknowistrash,0,1,0,44,1598673600,1598673600,1
Gumcow,0,1,0,-18,1594440000,1594440000,1
sfwestbank,0,1,0,2,1603771200,1603771200,1
empathetic_caterwaul,0,1,0,38,1597464000,1597464000,1
wallonthefloor,0,1,0,1,1612242000,1612242000,1
joe180uk,0,1,0,4,1607749200,1607749200,1
RocketSilence,0,1,0,63,1602907200,1602907200,1
proletarianviolence,0,1,0,3,1573621200,1573621200,1
EwItsForgotten,0,1,0,-19,1589947200,1589947200,1
IrrelevantLurking,0,1,0,1,1575003600,1575003600,1
Meulinia,0,1,0,6,1598500800,1598500800,1
kingokarp,0,1,0,58,1599624000,1599624000,1
mycatsnameislarry,0,1,0,2,1605934800,1605934800,1
theycallmeponcho,0,1,0,22,1598760000,1598760000,1
smegma_toast,0,1,0,13,1590379200,1590379200,1
cassie_hill,0,1,0,2,1601352000,1601352000,1
BeastMesquite,0,1,0,4,1558497600,1558497600,1
UhmNotMe,0,1,0,4,1574312400,1574312400,1
Weird__Weirdo,0,1,0,28,1597636800,1597636800,1
HereToFuckYouOff,0,1,0,4,1595217600,1595217600,1
thekiasmus,0,1,0,1,1606798800,1606798800,1
JaviG,0,1,0,12,1587960000,1587960000,1
tempaccount920123,0,1,0,1,1606021200,1606021200,1
redknight942,0,1,0,1,1605243600,1605243600,1
schneiderchris,0,1,0,1,1606626000,1606626000,1
Alfal97,1,0,0,0,1564545600,1564545600,1
Savethesinner,0,1,0,2,1582088400,1582088400,1
tamingthemind,0,1,0,16,1598328000,1598328000,1
gopir,0,1,0,7,1595908800,1595908800,1
killmeplsbbyxx,1,0,1914,0,1574139600,1574139600,1
LZ_Flying,0,1,0,8,1599019200,1599019200,1
ToKeepAndToHoldForev,0,1,0,1,1594353600,1594353600,1
vodkafrap,1,0,213,0,1606366800,1606366800,1
-MrLizard-,0,1,0,15,1605502800,1605502800,1
bigmansteve61516,0,1,0,380,1594440000,1594440000,1
Super_Vegeta,0,1,0,1,1600660800,1600660800,1
Painkiller967,0,1,0,1,1607403600,1607403600,1
n1c0_ds,0,1,0,18,1591329600,1591329600,1
Knukun,0,1,0,4,1578286800,1578286800,1
JaqueeVee,0,1,0,34,1586923200,1586923200,1
LegariousIII,0,1,0,1,1586318400,1586318400,1
jpguerra2019,0,1,0,1,1602734400,1602734400,1
CommanderSa1amander,0,1,0,-3,1599969600,1599969600,1
mexicanred1,0,1,0,1,1585454400,1585454400,1
deadtorrent,0,1,0,9,1583643600,1583643600,1
Tea_Cake_Puppy,0,1,0,4,1588996800,1588996800,1
Talkat,0,1,0,-4,1572062400,1572062400,1
RedditDictatorship,0,1,0,9,1608181200,1608181200,1
Fawn_Chicken,0,1,0,4,1602388800,1602388800,1
PressureWelder,0,1,0,2,1603512000,1603512000,1
BoydJones,1,0,2,0,1575262800,1575262800,1
EyeBleachConnoisseur,0,1,0,16,1574312400,1574312400,1
wwwdiggdotcom,0,1,0,4,1602561600,1602561600,1
trollmum,0,1,0,18,1591934400,1591934400,1
spawndoctor,0,1,0,1,1591243200,1591243200,1
Nomn,0,1,0,26,1576731600,1576731600,1
shocklax,0,1,0,2,1576990800,1576990800,1
bowtieboys,0,1,0,2,1583643600,1583643600,1
NegativeSpeech,0,1,0,5,1574744400,1574744400,1
bazamataz84,0,1,0,1,1606712400,1606712400,1
annaprad7,0,1,0,18,1579582800,1579582800,1
Turnip_Stonk,0,1,0,20,1593835200,1593835200,1
misticfed,0,1,0,1,1587614400,1587614400,1
skwerel,0,1,0,-3,1545022800,1545022800,1
GibbledKibble,0,1,0,3,1592884800,1592884800,1
FridaKahlosEyebrows,0,1,0,1,1595304000,1595304000,1
IHateHappyPeople,1,0,182,0,1604898000,1604898000,1
Reux,0,1,0,2,1607662800,1607662800,1
sloughlin99,0,1,0,1,1609390800,1609390800,1
Mancobbler,0,1,0,2,1601352000,1601352000,1
BigDave29,0,1,0,2,1600747200,1600747200,1
primrosecoffee,0,1,0,3,1602993600,1602993600,1
Bubbly_Manufacturer9,0,1,0,1,1600401600,1600401600,1
TheSoloWay,0,1,0,4,1603684800,1603684800,1
rolyataylor2,0,1,0,1,1589947200,1589947200,1
draziwizard,0,1,0,8,1579582800,1579582800,1
LeoMarius,0,1,0,13,1559016000,1559016000,1
RickySnow420,0,1,0,2,1578373200,1578373200,1
382563fme,0,1,0,2,1571976000,1571976000,1
notZ987,0,1,0,9,1583125200,1583125200,1
badatnamingaccount,0,1,0,13,1612155600,1612155600,1
unicorndroppingz,1,0,57,0,1611982800,1611982800,1
Getoffmylawn82,0,1,0,20,1581397200,1581397200,1
-PleaseDontNoticeMe-,0,1,0,1,1585195200,1585195200,1
Geoff_Mantelpiece,0,1,0,54,1607922000,1607922000,1
EverydayHalloween,0,1,0,1,1568606400,1568606400,1
majxover,0,1,0,4,1573534800,1573534800,1
MajorParts,0,1,0,2,1564804800,1564804800,1
Entreprehoosier,0,1,0,2,1559361600,1559361600,1
adityarao310,1,0,10,0,1574830800,1574830800,1
witqueen,0,1,0,1,1603512000,1603512000,1
ConfusedBisexual1992,0,1,0,2,1602388800,1602388800,1
Deranged_Cyborg,0,1,0,14,1584763200,1584763200,1
CoolyDudeyJr,0,1,0,-2,1605502800,1605502800,1
Docktor_V,0,1,0,9,1571371200,1571371200,1
Hippopotamidaes,0,1,0,1,1600574400,1600574400,1
Squid_Brains,0,1,0,10,1588564800,1588564800,1
tucya,0,1,0,1,1600833600,1600833600,1
ratheadx,0,1,0,2,1611982800,1611982800,1
asyl831,0,1,0,43,1575522000,1575522000,1
tedshreddon,0,1,0,9,1567656000,1567656000,1
godkarp,1,0,53,0,1595736000,1595736000,1
grandcarry,0,1,0,9,1599624000,1599624000,1
Mr_Thingy,0,1,0,1,1598673600,1598673600,1
tossThisoneOut42020,1,0,11,0,1584072000,1584072000,1
exp_cj,0,1,0,1,1599624000,1599624000,1
spicedbec,0,1,0,7,1571371200,1571371200,1
butareyoumoist,0,1,0,10,1603512000,1603512000,1
Papa_Dragon582,0,1,0,1,1607662800,1607662800,1
dasumld,1,0,30,0,1582434000,1582434000,1
lamustard,0,1,0,1,1600056000,1600056000,1
ku3ah,0,1,0,-5,1582779600,1582779600,1
Trashman2500,0,1,0,1,1600747200,1600747200,1
unnatrual,0,1,0,3,1603512000,1603512000,1
NightSky222,0,1,0,3,1567137600,1567137600,1
Betterthanbeer,0,1,0,30,1581656400,1581656400,1
Decap_,0,1,0,1,1587614400,1587614400,1
Schmliza,0,1,0,12,1606885200,1606885200,1
D3ZURAH,0,1,0,7,1577854800,1577854800,1
bluehorserunning,0,1,0,0,1584504000,1584504000,1
steamedartichoke,0,1,0,1,1602302400,1602302400,1
MANDOG813,0,1,0,3,1606021200,1606021200,1
berxorz,0,1,0,91,1605934800,1605934800,1
fundriedtomatoes,0,1,0,1,1603252800,1603252800,1
BellleChloe,0,1,0,3,1599451200,1599451200,1
jojuinc90,0,1,0,18,1592193600,1592193600,1
slutDwight,0,1,0,0,1571889600,1571889600,1
eyal0,0,1,0,-2,1606626000,1606626000,1
MadWhiskeyGrin,0,1,0,8,1584763200,1584763200,1
zeusicles,0,1,0,6,1606971600,1606971600,1
SammyC25268,0,1,0,1,1612069200,1612069200,1
bubblecoffee,0,1,0,5,1602302400,1602302400,1
ben_10_,0,1,0,1,1593230400,1593230400,1
lgb_br,0,1,0,5,1586836800,1586836800,1
kyrayuknowho,0,1,0,18,1592020800,1592020800,1
Paterno_Ster,0,1,0,2,1607144400,1607144400,1
MDKG-1974,0,1,0,1,1606366800,1606366800,1
Quints8419,0,1,0,1,1606021200,1606021200,1
Dave-4544,0,1,0,1,1590206400,1590206400,1
v_a_n_d_e_l_a_y,0,1,0,1,1604466000,1604466000,1
feisty_weatherman,0,1,0,5,1608958800,1608958800,1
DrGutz,0,1,0,1,1609131600,1609131600,1
kyltorr47,0,1,0,6,1591329600,1591329600,1
ActionJacx,0,1,0,3,1579064400,1579064400,1
Innocuous1997,0,1,0,6,1590811200,1590811200,1
zukaarin,0,1,0,1,1577682000,1577682000,1
eudemonist,0,1,0,1,1603598400,1603598400,1
Tanner0773,1,0,14,0,1604379600,1604379600,1
FrenchPetrushka,0,1,0,1,1603512000,1603512000,1
gokul_hugh,0,1,0,-3,1593057600,1593057600,1
lynnyfox,0,1,0,3,1606971600,1606971600,1
anownedguy,0,1,0,5,1597982400,1597982400,1
delphinawrites,0,1,0,1,1601611200,1601611200,1
Tris_t,0,1,0,2,1603684800,1603684800,1
Job-lair,0,1,0,1,1612155600,1612155600,1
Actually_a_Patrick,0,1,0,3,1605589200,1605589200,1
Anonymos_Rex,0,1,0,1,1605934800,1605934800,1
Skelator555,0,1,0,1,1584763200,1584763200,1
ryancaa,0,1,0,2,1603080000,1603080000,1
alwaysbeenawkward,0,1,0,2,1611637200,1611637200,1
HumanSeeing,0,1,0,25,1607230800,1607230800,1
ParticularMidnight5,0,1,0,2,1553745600,1553745600,1
PerpetuallyInert,0,1,0,15,1567569600,1567569600,1
thegodsoul,0,1,0,1,1576126800,1576126800,1
nfpy,0,1,0,3,1580619600,1580619600,1
awalakaiehu,0,1,0,25,1593057600,1593057600,1
DeceitfulLittleB,0,1,0,1,1600660800,1600660800,1
Zap12344,0,1,0,5,1510549200,1510549200,1
franciscrot,1,0,2,0,1599019200,1599019200,1
DrStrangemann,0,1,0,2,1608354000,1608354000,1
JostaDragon,1,0,52,0,1593403200,1593403200,1
hour_back,0,1,0,45,1600833600,1600833600,1
berggr,0,1,0,5,1600142400,1600142400,1
anxiousMortal,0,1,0,6,1593921600,1593921600,1
Megmca,0,1,0,2,1605589200,1605589200,1
Medical_Officer,0,1,0,3,1578978000,1578978000,1
thepancakeking,0,1,0,11,1577509200,1577509200,1
diverareyouok,0,1,0,4,1603598400,1603598400,1
M3rcyM4in,0,1,0,9,1580792400,1580792400,1
tomatoslashfiction,0,1,0,1,1594785600,1594785600,1
vidar2020,0,1,0,7,1605243600,1605243600,1
ionlyhavetwolegs,0,1,0,10,1584763200,1584763200,1
sonder22,0,1,0,15,1551502800,1551502800,1
Dreadfire_RD,0,1,0,2,1604466000,1604466000,1
snowbunnie678,0,1,0,4,1584936000,1584936000,1
Jo356,0,1,0,7,1606885200,1606885200,1
yoddilayhewho,0,1,0,5,1602043200,1602043200,1
DrBLEH,0,1,0,2,1602129600,1602129600,1
commfi,0,1,0,1,1580014800,1580014800,1
McAnalSandwich,0,1,0,6,1575954000,1575954000,1
betterbarsthanthis,1,0,21,0,1602302400,1602302400,1
-RomeoZulu-,0,1,0,4,1583899200,1583899200,1
chunklight,0,1,0,1,1609563600,1609563600,1
ninfan200,0,1,0,1,1605157200,1605157200,1
PBB0RN,0,1,0,1,1609304400,1609304400,1
CompetitiveMachine94,0,1,0,-7,1606453200,1606453200,1
IrregularSizeRudy,0,1,0,3,1603771200,1603771200,1
RI-Monkey,0,1,0,0,1603684800,1603684800,1
infernobird94,0,1,0,9,1585195200,1585195200,1
viral-architect,0,1,0,2,1584417600,1584417600,1
kerfufflecrunch,0,1,0,1,1587268800,1587268800,1
js30a,0,1,0,2,1567137600,1567137600,1
Randyand67,0,1,0,6,1583643600,1583643600,1
realish7,0,1,0,1,1591329600,1591329600,1
Fraiserlendrum,0,1,0,2,1589947200,1589947200,1
Ido_nothing,1,0,99,0,1558929600,1558929600,1
vanzh,0,1,0,-1,1601179200,1601179200,1
Quipster99,0,1,0,1,1481864400,1481864400,1
Turguryurrrn,0,1,0,1,1603512000,1603512000,1
You_Know_Whatitis,0,1,0,1,1585454400,1585454400,1
PovertyNomad,0,1,0,2,1602907200,1602907200,1
minilog,1,0,11,0,1585108800,1585108800,1
Zer0g2,0,1,0,1,1575608400,1575608400,1
ThotmeOfAtlantis,0,1,0,7,1588651200,1588651200,1
greeblegrop,0,1,0,1,1582693200,1582693200,1
Fjelsted,0,1,0,3,1589601600,1589601600,1
aaaaaaaaimnotanormie,0,1,0,0,1608699600,1608699600,1
MrPootisBrights,0,1,0,2,1611810000,1611810000,1
ShadowTerrors,0,1,0,1,1635220800,1635220800,1
Wattybangbang,1,0,0,0,1546405200,1546405200,1
demolitionsquid,0,1,0,3,1569988800,1569988800,1
SeeTheBold,0,1,0,15,1557201600,1557201600,1
BaldKnobber123,0,1,0,918,1603512000,1603512000,1
allfoodmatters,0,1,0,3,1608786000,1608786000,1
junibeans21,0,1,0,1,1600574400,1600574400,1
ScientistSanTa,0,1,0,1,1611982800,1611982800,1
kona_worldwaker,0,1,0,1,1604552400,1604552400,1
franzzegerman,0,1,0,1,1601352000,1601352000,1
fannyanuanu,0,1,0,3,1595563200,1595563200,1
FunkySauron,0,1,0,1,1595649600,1595649600,1
dethbisnuusnuu,0,1,0,5,1606798800,1606798800,1
pbwa1983,0,1,0,1,1611982800,1611982800,1
Agent-c1983,0,1,0,1,1573966800,1573966800,1
CaptainMemeO,0,1,0,8,1603425600,1603425600,1
gracethespacequeen,0,1,0,5,1595044800,1595044800,1
somewhr4mbombay,0,1,0,1,1565841600,1565841600,1
BenTrawets,0,1,0,2,1602129600,1602129600,1
loudfloralpattern,0,1,0,22,1599364800,1599364800,1
septicboy,0,1,0,1,1603512000,1603512000,1
gameanytime,0,1,0,9,1581915600,1581915600,1
lancetay,0,1,0,25,1608786000,1608786000,1
WaggyTails,0,1,0,3,1589169600,1589169600,1
lindtdelli,0,1,0,1,1580965200,1580965200,1
Explosivo666,0,1,0,1,1636606800,1636606800,1
ivansh_92,0,1,0,2,1598846400,1598846400,1
LifeOfMaddox,0,1,0,7,1600228800,1600228800,1
axiologus,0,1,0,29,1559793600,1559793600,1
myfamilyknowsmyname,0,1,0,2,1587009600,1587009600,1
Unrelenting_Force,0,1,0,41,1585800000,1585800000,1
statistress,0,1,0,19,1602734400,1602734400,1
HermesTristmegistus,0,1,0,5,1541304000,1541304000,1
squeakypop6,0,1,0,2,1603080000,1603080000,1
SnortXSnarl,0,1,0,1,1585454400,1585454400,1
jonolupo,0,1,0,1,1600660800,1600660800,1
Sarahsota,0,1,0,13,1603252800,1603252800,1
FetaMight,0,1,0,5,1595908800,1595908800,1
Ireallydontknowbuddy,0,1,0,2,1608526800,1608526800,1
FrancisReed,0,1,0,-9,1595217600,1595217600,1
buggarboo,0,1,0,1,1600920000,1600920000,1
SciMiles,0,1,0,7,1597204800,1597204800,1
StalwartLancer,0,1,0,1,1608699600,1608699600,1
Capernici,0,1,0,19,1566446400,1566446400,1
ZTB,0,1,0,82,1572062400,1572062400,1
Trekkimon,0,1,0,1,1572930000,1572930000,1
Johnbongjovi420,0,1,0,1,1587009600,1587009600,1
_Tenderlion,0,1,0,2,1596340800,1596340800,1
HoodratTinkerbell,0,1,0,1,1573102800,1573102800,1
Loaki8,0,1,0,1,1608267600,1608267600,1
podopteryx,0,1,0,11,1573621200,1573621200,1
DraxShadow23,0,1,0,27,1588824000,1588824000,1
stolencatkarma,0,1,0,1,1589515200,1589515200,1
Montayre,0,1,0,0,1594267200,1594267200,1
Ha-haTits,0,1,0,0,1585454400,1585454400,1
Arkansas_confucius,0,1,0,7,1603512000,1603512000,1
PandaPolishesPotatos,0,1,0,2,1585454400,1585454400,1
kamipsycho,0,1,0,-6,1606626000,1606626000,1
riccardostecca,0,1,0,1,1594008000,1594008000,1
Mabronamo,0,1,0,1,1601265600,1601265600,1
saturnellipse,0,1,0,7,1600401600,1600401600,1
ABardInTheHand,0,1,0,8,1611982800,1611982800,1
CosmoZombie,0,1,0,15,1569211200,1569211200,1
electropoptart,0,1,0,30,1579669200,1579669200,1
jasdonle,0,1,0,1,1605502800,1605502800,1
Angelripper,0,1,0,16,1584244800,1584244800,1
linc007,0,1,0,1,1606626000,1606626000,1
KingPointless,0,1,0,4,1598673600,1598673600,1
amehzinghdnimgs,0,1,0,1,1606626000,1606626000,1
NuggetsPhD,0,1,0,20,1596772800,1596772800,1
stalking_me_softly,0,1,0,1,1589947200,1589947200,1
herrodumpring,1,0,19,0,1575867600,1575867600,1
4ce_Redditor,0,1,0,0,1608613200,1608613200,1
breadgurrl,1,0,11,0,1592107200,1592107200,1
slip-shot,0,1,0,1,1605157200,1605157200,1
tremontguy,0,1,0,3,1591329600,1591329600,1
serg407,1,0,13,0,1609131600,1609131600,1
_nothingtohide_,1,0,72,0,1594440000,1594440000,1
oasis948151,0,1,0,19,1609131600,1609131600,1
Runeowl73,0,1,0,4,1566878400,1566878400,1
GreyLoad,0,1,0,3,1577336400,1577336400,1
Beanman001,0,1,0,5,1597636800,1597636800,1
JadedImagination4292,0,1,0,7,1609304400,1609304400,1
hylian_timelord,0,1,0,4,1602129600,1602129600,1
suspiriaeam,0,1,0,10,1580706000,1580706000,1
Rei-o-Sunshine,0,1,0,2,1608699600,1608699600,1
Serious_stuff_,0,1,0,5,1611637200,1611637200,1
ScatAway0,1,0,17,0,1573880400,1573880400,1
oliknox,0,1,0,1,1589342400,1589342400,1
spectacularkay,1,0,12,0,1592971200,1592971200,1
DrManHappenin,0,1,0,6,1575435600,1575435600,1
sanjuniperose,0,1,0,6,1605243600,1605243600,1
throwaway3434678,0,1,0,2,1553832000,1553832000,1
bugandbear22,0,1,0,57,1579928400,1579928400,1
saltydangerous,0,1,0,0,1605416400,1605416400,1
RWARRRRRR,0,1,0,5,1605589200,1605589200,1
Lukerspook,0,1,0,3,1576213200,1576213200,1
StratuhG,0,1,0,11,1608440400,1608440400,1
American_DOOMER,0,1,0,5,1604116800,1604116800,1
glasshe4d,0,1,0,8,1609304400,1609304400,1
nacosomtu,0,1,0,1,1606626000,1606626000,1
Penny0207,0,1,0,6,1603512000,1603512000,1
deadm1c3,0,1,0,1,1591243200,1591243200,1
neeshgufnk,0,1,0,3,1572235200,1572235200,1
Ectara,0,1,0,2,1541131200,1541131200,1
Daimoth,0,1,0,2,1606021200,1606021200,1
tushbewithyou,0,1,0,1,1609304400,1609304400,1
UnironicallyDabbing,0,1,0,1,1608786000,1608786000,1
beaducaf,0,1,0,0,1606885200,1606885200,1
Rudyrobbob,0,1,0,1,1591329600,1591329600,1
JMFe95,1,0,51,0,1574312400,1574312400,1
cdjcon,0,1,0,2,1591243200,1591243200,1
mjoewright,0,1,0,-2,1585454400,1585454400,1
DJCubs,1,0,6,0,1561348800,1561348800,1
Marthmellow44,0,1,0,4,1592798400,1592798400,1
rageisrelentless,0,1,0,6,1603080000,1603080000,1
DReicht,0,1,0,3,1423198800,1423198800,1
mudburn,0,1,0,1,1612069200,1612069200,1
brorabailey,0,1,0,2,1583298000,1583298000,1
Bugslayer03,0,1,0,1,1585454400,1585454400,1
LostFsh24,0,1,0,2,1606885200,1606885200,1
mykleins,0,1,0,6,1602993600,1602993600,1
alloyant,0,1,0,6,1572062400,1572062400,1
DarkWorld25,0,1,0,71,1598328000,1598328000,1
johnnyhavok2,0,1,0,2,1590206400,1590206400,1
lokie65,0,1,0,24,1605589200,1605589200,1
marianoth,1,0,39,0,1552536000,1552536000,1
HumanLard,0,1,0,1,1608872400,1608872400,1
PMMeYourBootyPics,0,1,0,10,1607144400,1607144400,1
Mauri_ce,0,1,0,20,1571630400,1571630400,1
wrknprogress2020,0,1,0,1,1602907200,1602907200,1
pandaSmore,0,1,0,1,1592366400,1592366400,1
malisc140,0,1,0,10,1601611200,1601611200,1
sociallygraceless,0,1,0,3,1577336400,1577336400,1
3_first_names,0,1,0,1,1594958400,1594958400,1
Apptubrutae,0,1,0,1,1584244800,1584244800,1
Budget_Tackle,0,1,0,3,1594872000,1594872000,1
Fight_me_honkey,0,1,0,17,1587009600,1587009600,1
Accipiter_,0,1,0,2,1606539600,1606539600,1
Deusex-Machina,0,1,0,6,1575349200,1575349200,1
joyhole122,0,1,0,3,1584331200,1584331200,1
beemccouch,0,1,0,1,1607922000,1607922000,1
Oilrigrandy,0,1,0,8,1561521600,1561521600,1
logic6711,0,1,0,1,1603684800,1603684800,1
Alillate,0,1,0,1,1594440000,1594440000,1
rasputin1,0,1,0,1,1605243600,1605243600,1
SnooBooks1843,0,1,0,14,1601870400,1601870400,1
josh_the_misanthrope,0,1,0,21,1597723200,1597723200,1
BorkBuzz,0,1,0,3,1605848400,1605848400,1
ReedorReed,0,1,0,1,1603425600,1603425600,1
randyterrence,0,1,0,4,1573707600,1573707600,1
Scew,0,1,0,1,1541044800,1541044800,1
skwerldom,0,1,0,2,1603598400,1603598400,1
enameless,0,1,0,1,1603512000,1603512000,1
87527,0,1,0,2,1590984000,1590984000,1
SalvadorMolly,0,1,0,3,1565409600,1565409600,1
Dontrumpme,0,1,0,1,1584763200,1584763200,1
SnooTangerines9465,0,1,0,0,1596600000,1596600000,1
xxXXcaramelXXxx,0,1,0,1,1609304400,1609304400,1
polfev,0,1,0,1,1609304400,1609304400,1
whenuknow,0,1,0,0,1602475200,1602475200,1
bub465,0,1,0,26,1574658000,1574658000,1
joefelice1,0,1,0,-24,1601784000,1601784000,1
USSRwasbad,0,1,0,2,1585454400,1585454400,1
Byeah24,0,1,0,-4,1612069200,1612069200,1
ItsChris8776,0,1,0,2,1603512000,1603512000,1
TaskManager1000,0,1,0,1,1603684800,1603684800,1
Balkina_Crops,1,0,0,0,1591675200,1591675200,1
itsallcorn,0,1,0,1,1601092800,1601092800,1
ZacksOOMagain,0,1,0,1,1603598400,1603598400,1
Jesus_Would_Do,0,1,0,2,1584244800,1584244800,1
sue_yoo,0,1,0,-3,1606539600,1606539600,1
spudspud06,0,1,0,4,1600488000,1600488000,1
cimayn,0,1,0,27,1570334400,1570334400,1
Schooney123,0,1,0,4,1572408000,1572408000,1
swaroope,0,1,0,14,1594094400,1594094400,1
indominuspattern,0,1,0,2,1605589200,1605589200,1
medicalhershey,0,1,0,8,1591416000,1591416000,1
woahlads,0,1,0,116,1608181200,1608181200,1
IM2Q2BSTR8,0,1,0,3,1581310800,1581310800,1
syracTheEnforcer,0,1,0,2,1594008000,1594008000,1
marina7890,0,1,0,2,1604466000,1604466000,1
80poundnuts,0,1,0,1,1601179200,1601179200,1
yeahfucku,0,1,0,-5,1586664000,1586664000,1
fishthethird,0,1,0,38,1575781200,1575781200,1
TanTanMan,0,1,0,-1,1591243200,1591243200,1
raudssus,0,1,0,1,1609390800,1609390800,1
Niagr,0,1,0,4,1607230800,1607230800,1
PostingMountainOC,0,1,0,-1,1606626000,1606626000,1
BalletPrincess18,0,1,0,1,1602648000,1602648000,1
kbpancakes,0,1,0,3,1607403600,1607403600,1
SensiblySizedDildo,0,1,0,9,1605589200,1605589200,1
Agent0451,0,1,0,2,1617940800,1617940800,1
landisthemandis,0,1,0,3,1588132800,1588132800,1
Caravaggio_,0,1,0,11,1599019200,1599019200,1
JoelBlackout,1,0,86,0,1611982800,1611982800,1
CaliKaTastrophy,0,1,0,-6,1577595600,1577595600,1
ahabes78,0,1,0,2,1607490000,1607490000,1
planefindermt,0,1,0,1,1580274000,1580274000,1
FollowingMyOwnPath,0,1,0,2,1563336000,1563336000,1
Myusernameiscooler,0,1,0,3,1601006400,1601006400,1
TsunamifoxyDCfan,0,1,0,1,1594094400,1594094400,1
Avolation742,0,1,0,26,1565496000,1565496000,1
therobotfromrocky4,0,1,0,3,1567656000,1567656000,1
Watchman74,0,1,0,1,1585195200,1585195200,1
R3dNova,0,1,0,7,1600747200,1600747200,1
depressedsalami,0,1,0,1,1585454400,1585454400,1
ArnieLarg,1,0,61,0,1583985600,1583985600,1
42Petrichor,0,1,0,13,1584676800,1584676800,1
OpheliaXo,1,0,11,0,1601438400,1601438400,1
bdhdjbsbdbdhhd,0,1,0,1,1606626000,1606626000,1
joeboe567,0,1,0,16,1592366400,1592366400,1
LastCommunication3,0,1,0,2,1609304400,1609304400,1
Cat3TRD,0,1,0,2,1582952400,1582952400,1
ThePlayfulApe,0,1,0,2,1602216000,1602216000,1
barbellsandcats,0,1,0,-15,1609304400,1609304400,1
HyperbolicPedant71,0,1,0,4,1604203200,1604203200,1
shinhoto,0,1,0,1,1606626000,1606626000,1
RayZorbach,0,1,0,1,1599451200,1599451200,1
NewPointOfView,0,1,0,2,1589860800,1589860800,1
frankorion,0,1,0,2,1579755600,1579755600,1
Tookie_Knows,0,1,0,1,1603512000,1603512000,1
McEzz,0,1,0,12,1571976000,1571976000,1
deltagirl14,0,1,0,-1,1573448400,1573448400,1
beefy_muffinss,0,1,0,1,1608440400,1608440400,1
nightcrawler995,0,1,0,-4,1600920000,1600920000,1
sedition666,0,1,0,2,1599624000,1599624000,1
brewmastermonk,0,1,0,21,1535169600,1535169600,1
Zodaix,0,1,0,-11,1569729600,1569729600,1
SamW2469,0,1,0,0,1581310800,1581310800,1
Zacharacamyison,0,1,0,14,1595563200,1595563200,1
brojito1,0,1,0,3,1602734400,1602734400,1
Jinxy_Minx,0,1,0,1,1602734400,1602734400,1
Whocket_Pale,0,1,0,7,1600142400,1600142400,1
DependentBumblebee5,0,1,0,1,1611810000,1611810000,1
IQof24,0,1,0,4,1581915600,1581915600,1
EricSonOfEricEricson,0,1,0,9,1574830800,1574830800,1
the_dadsonvacation,1,0,10,0,1583211600,1583211600,1
tenderfather,0,1,0,2,1592020800,1592020800,1
nedylan,0,1,0,5,1605502800,1605502800,1
DoMeTo-orwhatever,1,0,134,0,1599019200,1599019200,1
Dopegnsnfkn,0,1,0,1,1609650000,1609650000,1
bripatrick,0,1,0,6,1580274000,1580274000,1
DeadPrateRoberts,1,0,3,0,1608786000,1608786000,1
herrsmith,0,1,0,5,1604898000,1604898000,1
pepemary,1,0,0,0,1554350400,1554350400,1
SexyCrimes,0,1,0,2,1574658000,1574658000,1
jessicabheart26,0,1,0,1,1603166400,1603166400,1
Ghettohippo,0,1,0,1,1609390800,1609390800,1
ItalianAutonomism,1,0,1,0,1602475200,1602475200,1
Palehorses420,1,0,83,0,1538712000,1538712000,1
Sebastiano_DiRavello,0,1,0,2,1605589200,1605589200,1
bellestarxo,0,1,0,1,1609477200,1609477200,1
Faulty_Pants,0,1,0,49,1579928400,1579928400,1
northernutlenning,0,1,0,7,1570507200,1570507200,1
Dfu-destruct1,1,0,0,0,1595476800,1595476800,1
Mescallan,0,1,0,18,1598760000,1598760000,1
whatsthisevenfor,0,1,0,4,1598673600,1598673600,1
yeah_right_rhonda,0,1,0,1,1564891200,1564891200,1
UltraMountain25,0,1,0,0,1576558800,1576558800,1
scuzzmonkey69,0,1,0,0,1580446800,1580446800,1
Rileyrod,0,1,0,15,1568520000,1568520000,1
Outlaw5055,0,1,0,108,1606626000,1606626000,1
teeleer,0,1,0,1,1605070800,1605070800,1
merpymoop,0,1,0,41,1609304400,1609304400,1
davidbd7,0,1,0,1,1615611600,1615611600,1
Runswithchickens,0,1,0,2,1582002000,1582002000,1
EffortAutomatic,0,1,0,1,1605589200,1605589200,1
anestetika,0,1,0,15,1601265600,1601265600,1
Xxyz260,0,1,0,17,1604898000,1604898000,1
TheVirtuousJ,1,0,28,0,1592193600,1592193600,1
digital_end,0,1,0,13,1585022400,1585022400,1
CurtTAustin,0,1,0,12,1594526400,1594526400,1
refrayn,0,1,0,13,1607230800,1607230800,1
Ironical_Swells,1,0,44,0,1559707200,1559707200,1
nicholassifa,0,1,0,32,1606626000,1606626000,1
graavyrobber,0,1,0,7,1572148800,1572148800,1
EMPeace,0,1,0,17,1558670400,1558670400,1
t0bynet,0,1,0,1,1605070800,1605070800,1
Shuttheflufffup,0,1,0,1,1640926800,1640926800,1
r0binh00dthrowaway,1,0,36,0,1601179200,1601179200,1
LaughDamnIt,0,1,0,2,1582779600,1582779600,1
Saphi93,0,1,0,20,1606885200,1606885200,1
jimjamriff,0,1,0,9,1585454400,1585454400,1
R3t1r3m3nt,0,1,0,5,1608181200,1608181200,1
BetterThanICould,0,1,0,47,1601179200,1601179200,1
MisforMandolin,0,1,0,-12,1598673600,1598673600,1
osomysterioso,0,1,0,3,1593835200,1593835200,1
gillbeats,0,1,0,-6,1561867200,1561867200,1
chase42O,0,1,0,1,1579669200,1579669200,1
siaarzh,0,1,0,1,1560139200,1560139200,1
mobiusandfinn,0,1,0,1,1583384400,1583384400,1
Dydono_,0,1,0,2,1608786000,1608786000,1
onlyinforamin,0,1,0,4,1603512000,1603512000,1
tr33rt,0,1,0,2,1605070800,1605070800,1
Collins_Michael,0,1,0,5,1560484800,1560484800,1
ThatCrazyCanuck37,0,1,0,59,1606194000,1606194000,1
TurielD,0,1,0,14,1605502800,1605502800,1
NoirRenie,1,0,20,0,1568779200,1568779200,1
Trueiceking,0,1,0,1,1585454400,1585454400,1
therestruth,0,1,0,3,1608872400,1608872400,1
toyototoya,0,1,0,-3,1578373200,1578373200,1
nick5th,0,1,0,0,1585454400,1585454400,1
Pr3ttynp3tty,1,0,37,0,1604030400,1604030400,1
Tyronto,0,1,0,8,1603512000,1603512000,1
ChubbyLilPanda,0,1,0,1,1605243600,1605243600,1
lusciouslucius,0,1,0,3,1603598400,1603598400,1
MrRainbowManMan,0,1,0,4,1603684800,1603684800,1
optimixta5,0,1,0,-4,1589601600,1589601600,1
tiddysprinkles69,0,1,0,1,1605502800,1605502800,1
revinjan28,0,1,0,1,1581829200,1581829200,1
kiddenz,0,1,0,2,1581742800,1581742800,1
Mongo_Fifty,0,1,0,2,1608786000,1608786000,1
stormofbabes,0,1,0,1,1605848400,1605848400,1
WeebyGang,0,1,0,2,1597118400,1597118400,1
Estartes2,0,1,0,33,1608181200,1608181200,1
Jebist,0,1,0,16,1586404800,1586404800,1
Mezzoforte90,0,1,0,1,1611723600,1611723600,1
RandonEnglishMun,0,1,0,1,1638162000,1638162000,1
verybad-notgood,0,1,0,1,1570161600,1570161600,1
thebigshipper,0,1,0,1,1595822400,1595822400,1
lycheebobatea,0,1,0,1,1608526800,1608526800,1
lucasbronden101,0,1,0,1,1600660800,1600660800,1
Drewmainia,0,1,0,50,1606626000,1606626000,1
Lerios404,0,1,0,32,1583812800,1583812800,1
thematrixs,0,1,0,3,1572321600,1572321600,1
Banana_mechanic,0,1,0,2,1584936000,1584936000,1
xsnowpeltx,0,1,0,14,1572667200,1572667200,1
BlondieBerry,0,1,0,1,1584158400,1584158400,1
DukeOfJukes,0,1,0,1,1608267600,1608267600,1
paintballboi07,0,1,0,9,1606626000,1606626000,1
Bhima,0,1,0,29,1566187200,1566187200,1
myfatmonkey,0,1,0,1,1606885200,1606885200,1
xionura,0,1,0,1,1592452800,1592452800,1
Ta-bar-nack,0,1,0,1,1612069200,1612069200,1
MoonMonkeyKing,0,1,0,2,1563422400,1563422400,1
ProfessorMoriarty163,0,1,0,26,1573621200,1573621200,1
WeedIronMoneyNTheUSA,0,1,0,5,1572494400,1572494400,1
DrumsnGames,0,1,0,8,1593748800,1593748800,1
997Mbor,0,1,0,4,1576904400,1576904400,1
Haramu,0,1,0,7,1561867200,1561867200,1
nsa_k,0,1,0,2,1597377600,1597377600,1
MoofieMofo,0,1,0,8,1552276800,1552276800,1
FlyNap,0,1,0,1,1571630400,1571630400,1
lilbowardwoward,0,1,0,1,1601524800,1601524800,1
Sensitive_One_,1,0,24,0,1608786000,1608786000,1
SirJudithCollins,1,0,25,0,1605157200,1605157200,1
Aclassydame,0,1,0,7,1596772800,1596772800,1
PM_ME_CLEAN_CODE,1,0,1234,0,1597291200,1597291200,1
anhtm,0,1,0,45,1603425600,1603425600,1
Pretend-Pain,0,1,0,1,1589947200,1589947200,1
sortahuman123,0,1,0,3,1612155600,1612155600,1
Idjosko84,1,0,1,0,1587268800,1587268800,1
islesforthecup,1,0,10,0,1608181200,1608181200,1
DudeHopesHesThinking,0,1,0,1,1606021200,1606021200,1
TreeDollarFiddyCent,0,1,0,38,1589515200,1589515200,1
circaatomicage,0,1,0,2,1564113600,1564113600,1
ProfaJuchito,0,1,0,43,1593057600,1593057600,1
Collinsiq,0,1,0,6,1601179200,1601179200,1
LonelyGranberia,0,1,0,-5,1564027200,1564027200,1
wahlberger,0,1,0,1,1573534800,1573534800,1
bigblitzx,0,1,0,26,1601956800,1601956800,1
Superslowmojoe,0,1,0,1,1572494400,1572494400,1
nophonevalet,0,1,0,1,1605589200,1605589200,1
snapsnazzy,0,1,0,11,1598155200,1598155200,1
Nightfinder786,0,1,0,3,1601524800,1601524800,1
wayfaring_mind,0,1,0,1,1576299600,1576299600,1
DowntoMarsGirl6196,0,1,0,11,1602388800,1602388800,1
fuckwit-mcbumcrumble,0,1,0,120,1564459200,1564459200,1
Gorl08,0,1,0,2,1560830400,1560830400,1
_acw,0,1,0,4,1587700800,1587700800,1
BrokenMeatRobot,0,1,0,5,1573621200,1573621200,1
jikklefik,0,1,0,1,1606626000,1606626000,1
BlackysStars,1,0,4475,0,1593403200,1593403200,1
OWENISAGANGSTER,0,1,0,1,1571630400,1571630400,1
goldentrips,0,1,0,47,1600747200,1600747200,1
mohelgamal,0,1,0,1,1606626000,1606626000,1
haileyps,0,1,0,3,1609390800,1609390800,1
ragepudding,0,1,0,2,1598846400,1598846400,1
SpeedysComing,0,1,0,9,1606626000,1606626000,1
kn4zuz,0,1,0,16,1611896400,1611896400,1
KinkyChickGamer,0,1,0,48,1598587200,1598587200,1
Zeedee,0,1,0,13,1564632000,1564632000,1
LubieDobreJedzenie,0,1,0,2,1603512000,1603512000,1
flauderer,1,0,298,0,1608440400,1608440400,1
Strategian,0,1,0,11,1594612800,1594612800,1
BossManIL,0,1,0,1,1607662800,1607662800,1
BrooklynSmash,0,1,0,1,1608613200,1608613200,1
raidragun,0,1,0,3,1605934800,1605934800,1
PaulmonandArtfunkel,0,1,0,3,1480914000,1480914000,1
maxstandard,0,1,0,10,1608440400,1608440400,1
literallymetaphoric,0,1,0,87,1583038800,1583038800,1
forestrox,0,1,0,3,1604898000,1604898000,1
HelpMeDownFromHere,0,1,0,7,1599796800,1599796800,1
Expandexplorelive,0,1,0,2,1580533200,1580533200,1
Bbaccivorous,0,1,0,32,1611723600,1611723600,1
rainbowseeker,0,1,0,5,1571544000,1571544000,1
MrDagoth,0,1,0,1,1621828800,1621828800,1
Emachinebot,0,1,0,1,1589947200,1589947200,1
Eran8433,0,1,0,-16,1599537600,1599537600,1
ChemETypeBeat,0,1,0,90,1602475200,1602475200,1
viniciusah,0,1,0,1,1601956800,1601956800,1
777XSuperHornet,0,1,0,4,1594440000,1594440000,1
s1ght3k,1,0,40,0,1607576400,1607576400,1
Todded,0,1,0,2,1483765200,1483765200,1
Ubernerd_Lucas,0,1,0,59,1580274000,1580274000,1
TWD41,1,0,9,0,1569297600,1569297600,1
pm_your_perky_tittys,0,1,0,27,1579669200,1579669200,1
girl_who_loves_girls,0,1,0,5,1595390400,1595390400,1
InternetTight,0,1,0,1,1608699600,1608699600,1
1_048596,0,1,0,3,1589256000,1589256000,1
jeredendonnar,0,1,0,1,1598760000,1598760000,1
SmearItIn,0,1,0,1,1590292800,1590292800,1
NSACIARAPEVICTIM,0,1,0,5,1606280400,1606280400,1
allrollingwolf,0,1,0,2,1604898000,1604898000,1
Eileen_Palglace,0,1,0,1,1579064400,1579064400,1
Sergeant--Tibbs,0,1,0,154,1603512000,1603512000,1
eduardocereto,0,1,0,12,1573102800,1573102800,1
Shia_LaBeowulf,0,1,0,3,1579928400,1579928400,1
usernameerror--,0,1,0,4,1608786000,1608786000,1
SevFTW,0,1,0,8,1597291200,1597291200,1
lowth01,0,1,0,1,1602648000,1602648000,1
growlmreh,0,1,0,3,1608267600,1608267600,1
elleinadekal,0,1,0,2,1606280400,1606280400,1
Franckenberry,0,1,0,25,1606021200,1606021200,1
jametron2014,0,1,0,6,1591675200,1591675200,1
JohnJaysOnMyFeet,0,1,0,7,1607922000,1607922000,1
sputzie88,0,1,0,16,1601265600,1601265600,1
CameoLover88,0,1,0,-1,1603425600,1603425600,1
maldroits,0,1,0,3,1602129600,1602129600,1
Fahku,0,1,0,-2,1598500800,1598500800,1
Monkofbrailletext,0,1,0,4,1608094800,1608094800,1
MyLittleRapidash,0,1,0,2,1600574400,1600574400,1
egrom,0,1,0,3,1598241600,1598241600,1
Jaxhuskeh,0,1,0,2,1579755600,1579755600,1
Billypillgrim,0,1,0,1,1607922000,1607922000,1
sk8rgrrl69,0,1,0,3,1603512000,1603512000,1
JusticeGuard78,0,1,0,56,1579323600,1579323600,1
Yougottabestopit,0,1,0,1,1560744000,1560744000,1
AnotherMadHatter,0,1,0,22,1605675600,1605675600,1
Awesomekirk86,0,1,0,2,1594785600,1594785600,1
WeatherwaxDaughter,0,1,0,2,1603512000,1603512000,1
sassypants29,0,1,0,10,1605589200,1605589200,1
DGOrion64,0,1,0,1,1592798400,1592798400,1
slackingpharmadrone,0,1,0,4,1587528000,1587528000,1
xCuriousReaderX,0,1,0,2,1609390800,1609390800,1
sonicoduh1125,0,1,0,3,1570593600,1570593600,1
vonnyvonnyvonny,0,1,0,0,1599019200,1599019200,1
WoolIsForWolves,0,1,0,7,1597723200,1597723200,1
spiruhristodulo,0,1,0,93,1598068800,1598068800,1
Wootbeers,0,1,0,0,1601265600,1601265600,1
Laetoy,0,1,0,1,1602129600,1602129600,1
Texan1978,0,1,0,2,1580446800,1580446800,1
SaulGoodBroo,0,1,0,1,1611550800,1611550800,1
Skullfurious,0,1,0,2,1585368000,1585368000,1
lubricatedwatermelon,0,1,0,11,1601092800,1601092800,1
Liensis09,0,1,0,-13,1585108800,1585108800,1
BalalaikaClawJob,0,1,0,29,1586491200,1586491200,1
SchwanzusCity,0,1,0,1,1620273600,1620273600,1
lawbotamized,0,1,0,11,1592798400,1592798400,1
Farentight,0,1,0,1,1565668800,1565668800,1
pointy_object,0,1,0,3,1596859200,1596859200,1
RiceKrispyKush,0,1,0,3,1545109200,1545109200,1
KingOfDatShit,1,0,12,0,1592884800,1592884800,1
AlphaScarr,0,1,0,6,1586577600,1586577600,1
Nick__________,0,1,0,0,1608699600,1608699600,1
lonerstoic,1,0,6,0,1581397200,1581397200,1
americabest123456789,0,1,0,2,1603598400,1603598400,1
DrinkNattysDoFattys,0,1,0,-12,1588996800,1588996800,1
ThrowRAaway_,0,1,0,7,1592193600,1592193600,1
Dizzy_Data_,0,1,0,1,1600833600,1600833600,1
MFD123,1,0,119,0,1574053200,1574053200,1
Qthuhu,0,1,0,2,1585540800,1585540800,1
benyeti1,0,1,0,23,1611810000,1611810000,1
NeoBokononist,0,1,0,3,1557288000,1557288000,1
lessonslearnedaboutr,0,1,0,1,1607835600,1607835600,1
nomadnoir,0,1,0,6,1567915200,1567915200,1
denizgult,0,1,0,4,1582779600,1582779600,1
Scrambled_59,0,1,0,1,1606626000,1606626000,1
RangaNesquik,0,1,0,2,1608699600,1608699600,1
mrlayabout,0,1,0,1,1604030400,1604030400,1
PM_ME_YOUR_BODY69,0,1,0,-4,1554955200,1554955200,1
wrp1,0,1,0,1,1608267600,1608267600,1
Nuke_Waste,0,1,0,18,1590120000,1590120000,1
SprezzaturaVigilante,0,1,0,1,1599451200,1599451200,1
AnarchoKiernan,0,1,0,3,1558152000,1558152000,1
AMuderFlippinCracker,0,1,0,1,1565323200,1565323200,1
iUsedtoHadHerpes,0,1,0,10,1612069200,1612069200,1
ObviouslyGenius,0,1,0,3,1569124800,1569124800,1
xyzjoysibar,0,1,0,1,1619323200,1619323200,1
Reggie_Reggietime,0,1,0,1,1571630400,1571630400,1
detuned--radio,0,1,0,1,1601956800,1601956800,1
teuast,0,1,0,16,1579928400,1579928400,1
Eliza1312,0,1,0,1,1608354000,1608354000,1
oneshotz,0,1,0,2,1578027600,1578027600,1
lordagr,0,1,0,4,1603166400,1603166400,1
royaIs,0,1,0,1,1603512000,1603512000,1
Far-Wear,0,1,0,2,1608526800,1608526800,1
GuantanaMo,0,1,0,16,1606712400,1606712400,1
greetz_dk,0,1,0,19,1608872400,1608872400,1
wbmw3w,0,1,0,31,1584417600,1584417600,1
weirdhorsiegirrl,0,1,0,20,1584590400,1584590400,1
simplyrelaxing,0,1,0,2,1606280400,1606280400,1
theboxfriend,0,1,0,2,1584590400,1584590400,1
lornetka,0,1,0,13,1606021200,1606021200,1
DaveJo127,0,1,0,1,1572930000,1572930000,1
3thaddict,0,1,0,8,1560571200,1560571200,1
CTSmith26,0,1,0,3,1603512000,1603512000,1
JohnMaddn,1,0,15,0,1593489600,1593489600,1
DCadvisor,0,1,0,1,1557979200,1557979200,1
fre_rn,0,1,0,1,1602993600,1602993600,1
elchapothe3rd,0,1,0,6,1574830800,1574830800,1
Monolith01,0,1,0,1,1560830400,1560830400,1
el1o,0,1,0,8,1605762000,1605762000,1
WorriedJob2809,0,1,0,-1,1598673600,1598673600,1
Sta723,0,1,0,11,1593921600,1593921600,1
morningtide,0,1,0,5,1581829200,1581829200,1
Adrienskis,0,1,0,5,1576299600,1576299600,1
DefaultText,0,1,0,26,1591329600,1591329600,1
Darth_Yarras,0,1,0,1,1607662800,1607662800,1
beardedbroco,0,1,0,7,1607835600,1607835600,1
seretoniini,0,1,0,1,1603684800,1603684800,1
PoliticalThrwawy1776,0,1,0,12,1568347200,1568347200,1
impressablenomad38,0,1,0,4,1604898000,1604898000,1
covalent_blond,0,1,0,8,1585800000,1585800000,1
reallytrulymadly,0,1,0,1,1600660800,1600660800,1
Amekyras,0,1,0,7,1564459200,1564459200,1
Darkside0483,0,1,0,2,1584504000,1584504000,1
Prxject_Ghoul,0,1,0,8,1591934400,1591934400,1
tangotrigger,0,1,0,2,1584331200,1584331200,1
Overall-Bad-1233,0,1,0,1,1599019200,1599019200,1
chuchuramen,0,1,0,164,1608613200,1608613200,1
Sith_Spawn,0,1,0,3,1570680000,1570680000,1
ColeFlaat,1,0,224,0,1596686400,1596686400,1
sheepinb,0,1,0,1,1600920000,1600920000,1
KnockKnockChicken,0,1,0,15,1604379600,1604379600,1
BudIsWiser,0,1,0,3,1564459200,1564459200,1
spankythemonk,0,1,0,1,1598760000,1598760000,1
MorpheusOnAcid,0,1,0,1,1602561600,1602561600,1
nickasf_,0,1,0,3,1602907200,1602907200,1
sleepysterling,0,1,0,4,1599105600,1599105600,1
Hrmpfreally,0,1,0,1,1608267600,1608267600,1
Beretman93,0,1,0,2,1597809600,1597809600,1
UR_NEIGHBOR_STACY,0,1,0,17,1608699600,1608699600,1
Carnivus,0,1,0,-10,1550898000,1550898000,1
tbjlurk,0,1,0,24,1593921600,1593921600,1
dangheck,0,1,0,1,1598932800,1598932800,1
WackAmNotBlack,0,1,0,16,1605762000,1605762000,1
VenalParadigmShift,0,1,0,1,1612069200,1612069200,1
beavertownneckoil,0,1,0,1,1605502800,1605502800,1
choirboy17,0,1,0,3,1606539600,1606539600,1
antnydi,0,1,0,18,1595044800,1595044800,1
El_Zea,1,0,57,0,1608008400,1608008400,1
kosure,0,1,0,6,1491537600,1491537600,1
BlacknWhiteMoose,0,1,0,1,1580533200,1580533200,1
XxX_datboi69_XxX,0,1,0,4,1576386000,1576386000,1
Exile714,0,1,0,1,1585454400,1585454400,1
MRicho,0,1,0,1,1605502800,1605502800,1
massiveZO,0,1,0,-13,1606626000,1606626000,1
CrackPipeQueen,0,1,0,7,1574658000,1574658000,1
yanis222003,0,1,0,5,1561780800,1561780800,1
BirdMask1347,0,1,0,7,1582866000,1582866000,1
LouisTheLuis,0,1,0,6,1607662800,1607662800,1
TheWire90,0,1,0,2,1601352000,1601352000,1
Subjunctive__Bot,0,1,0,2,1515474000,1515474000,1
sonellia,0,1,0,7,1603512000,1603512000,1
Zombieaterr,0,1,0,3,1611810000,1611810000,1
DragonSpiceChai,0,1,0,11,1606626000,1606626000,1
Misadventrous,0,1,0,3,1576040400,1576040400,1
OtherKrab,0,1,0,4,1605330000,1605330000,1
RJayX15,0,1,0,4,1609390800,1609390800,1
lippincottpop,0,1,0,2,1581051600,1581051600,1
Do_I_have_to_move,0,1,0,6,1540008000,1540008000,1
SpiderInTheFire,0,1,0,1,1576213200,1576213200,1
ididntleaveonpurpose,0,1,0,1,1608267600,1608267600,1
Frankengamer,0,1,0,1,1565755200,1565755200,1
JudgeHoltman,0,1,0,1,1591243200,1591243200,1
TyFn_islove,0,1,0,4,1582779600,1582779600,1
1414141414,0,1,0,16,1593144000,1593144000,1
AnacostiaSheriff,0,1,0,7,1566532800,1566532800,1
Vallinin,0,1,0,0,1606626000,1606626000,1
Oxxide,0,1,0,15,1609477200,1609477200,1
blantickal,0,1,0,4,1585886400,1585886400,1
SIAMESEDICK,0,1,0,48,1581138000,1581138000,1
dankdank420240,0,1,0,2,1583384400,1583384400,1
Dilpickle6194,0,1,0,10,1577854800,1577854800,1
elhank,0,1,0,2,1600228800,1600228800,1
levacjeep,0,1,0,3,1608526800,1608526800,1
King_Quantar,0,1,0,5,1611896400,1611896400,1
dancingdavid1991,0,1,0,2,1550984400,1550984400,1
Sophie74656,0,1,0,1,1603512000,1603512000,1
IanCal,0,1,0,1,1605589200,1605589200,1
IamThe101,0,1,0,1,1592107200,1592107200,1
alone-on-earth,1,0,0,0,1597464000,1597464000,1
bwinsy,0,1,0,2,1594440000,1594440000,1
atwistedlamb,0,1,0,1,1606885200,1606885200,1
orzellan,1,0,5,0,1528862400,1528862400,1
PhillMahooters,0,1,0,2,1603425600,1603425600,1
NateZeroh,0,1,0,1,1594008000,1594008000,1
PM_ME_UR_DECOLLETAGE,0,1,0,29,1584676800,1584676800,1
MPAA752,0,1,0,1,1578114000,1578114000,1
rocket717_,0,1,0,0,1589947200,1589947200,1
ngc6027,0,1,0,3,1587182400,1587182400,1
Low_Grade_Humility,0,1,0,0,1596254400,1596254400,1
dueprover,1,0,1,0,1456549200,1456549200,1
earmuffal,0,1,0,1,1595649600,1595649600,1
TaraMarseglia,0,1,0,1,1599537600,1599537600,1
planetspode,0,1,0,5,1602734400,1602734400,1
AmnesiacGuy,0,1,0,1,1586664000,1586664000,1
stoirtap,0,1,0,1,1582866000,1582866000,1
treebend,0,1,0,1,1609131600,1609131600,1
yc102,0,1,0,2,1592712000,1592712000,1
maxwellshmaxwell,0,1,0,0,1598760000,1598760000,1
Fluxbux2,0,1,0,3,1576990800,1576990800,1
jakus00,0,1,0,8,1575608400,1575608400,1
Chadzilla22,0,1,0,1,1585454400,1585454400,1
Business-Welder,0,1,0,8,1585627200,1585627200,1
subchop710,0,1,0,0,1577336400,1577336400,1
nullenatr,0,1,0,1,1608958800,1608958800,1
dangernoodle01,0,1,0,3,1569384000,1569384000,1
Apothnesko,0,1,0,5,1589256000,1589256000,1
Apocketfulofwhimsy,0,1,0,1,1603512000,1603512000,1
fishlope-,0,1,0,7,1589947200,1589947200,1
RexUmbra,0,1,0,6,1608267600,1608267600,1
dragon34,0,1,0,2,1589947200,1589947200,1
firstworldandarchist,0,1,0,10,1469851200,1469851200,1
SantabuthesStalin,0,1,0,35,1594699200,1594699200,1
justinvan82,0,1,0,2,1576558800,1576558800,1
SIM0NEY,0,1,0,2,1603512000,1603512000,1
egomosnonservo,0,1,0,6,1473912000,1473912000,1
wonderfulworldofweed,0,1,0,7,1581829200,1581829200,1
Razorwire_Dave,0,1,0,0,1606798800,1606798800,1
DeliciousMagician,0,1,0,1,1597809600,1597809600,1
luckysilverdragon,0,1,0,5,1603598400,1603598400,1
rainbowrooooad,0,1,0,47,1554868800,1554868800,1
pmmethempuns,0,1,0,3,1598846400,1598846400,1
tragicdiffidence12,0,1,0,1,1591329600,1591329600,1
User65397468953,0,1,0,1,1585454400,1585454400,1
strobing1,0,1,0,1,1593662400,1593662400,1
throwawaythefeeIs,0,1,0,7,1591329600,1591329600,1
XarrenJhuud,0,1,0,2,1599883200,1599883200,1
Mongoose1970,0,1,0,-22,1585540800,1585540800,1
thisuserna,0,1,0,1,1603512000,1603512000,1
Lucyloves,0,1,0,1,1603512000,1603512000,1
Juststumblinaround,0,1,0,-1,1606626000,1606626000,1
ThatOneNecro,0,1,0,1,1579755600,1579755600,1
Defiantcaveman,0,1,0,3,1608526800,1608526800,1
ACTION_FEMALE,0,1,0,2,1558497600,1558497600,1
DickBentley,0,1,0,2,1572235200,1572235200,1
lars7083,0,1,0,3,1586750400,1586750400,1
thecoobman5,0,1,0,-4,1598155200,1598155200,1
AlcoholicR0bot,0,1,0,1,1591588800,1591588800,1
MoBee30,0,1,0,7,1579064400,1579064400,1
redditformyphone25,0,1,0,2,1587096000,1587096000,1
The_Master_Debator,0,1,0,2,1586923200,1586923200,1
tiredoldfella,0,1,0,12,1600142400,1600142400,1
Matiel94,0,1,0,2,1608526800,1608526800,1
thinkfast522,0,1,0,1,1596600000,1596600000,1
msolorio79,0,1,0,1,1608872400,1608872400,1
obsidian_lance,0,1,0,67,1606885200,1606885200,1
jem5x5,0,1,0,9,1591588800,1591588800,1
MusicEd921,0,1,0,2,1587441600,1587441600,1
mybarbeeworld,0,1,0,22,1587009600,1587009600,1
ComfortableScreen,0,1,0,23,1571803200,1571803200,1
Vast-Owl-Who,0,1,0,3,1603512000,1603512000,1
happynargul,0,1,0,10,1603252800,1603252800,1
ChomskyCokeKitchen,0,1,0,1,1606626000,1606626000,1
LibretarianYoshi,0,1,0,0,1608440400,1608440400,1
nbPhosphophyllite,0,1,0,1,1608354000,1608354000,1
Jake5647382910,0,1,0,2,1604030400,1604030400,1
Puzzled_Personality1,0,1,0,5,1599105600,1599105600,1
bug_bite,0,1,0,8,1605157200,1605157200,1
RosebudsDad,0,1,0,4,1560657600,1560657600,1
Jellyfish2_0,0,1,0,1,1609390800,1609390800,1
Cannacology,0,1,0,1,1604030400,1604030400,1
-seriously-101,0,1,0,1,1572408000,1572408000,1
Showerthawts,0,1,0,2,1600574400,1600574400,1
Fancy-Bear1776,0,1,0,2,1590292800,1590292800,1
OrderedRestoration,0,1,0,3,1577941200,1577941200,1
matraji,1,0,7,0,1599278400,1599278400,1
MarcellusxWallace,0,1,0,75,1604030400,1604030400,1
Mil3s101,0,1,0,3,1603598400,1603598400,1
yaldie,0,1,0,2,1608440400,1608440400,1
PhookSkywalker,0,1,0,0,1612069200,1612069200,1
HebrewJohnson,0,1,0,3,1600574400,1600574400,1
whammysammy101,0,1,0,1,1603512000,1603512000,1
eidjcn10,0,1,0,15,1580274000,1580274000,1
isthisreallyitfuck,0,1,0,1,1609304400,1609304400,1
nappy_zap,0,1,0,2,1608526800,1608526800,1
thegolfpilot,0,1,0,3,1603598400,1603598400,1
kvass11,0,1,0,3,1587355200,1587355200,1
caas1,1,0,20,0,1556769600,1556769600,1
chaoCheesePie,0,1,0,5,1585022400,1585022400,1
train_spotting,0,1,0,1,1598673600,1598673600,1
AiriaTasui,0,1,0,5,1606712400,1606712400,1
DcHeroMartian,0,1,0,13,1592884800,1592884800,1
lavishsuperscript,0,1,0,2,1601179200,1601179200,1
CarryMeBack2Virginia,0,1,0,0,1570766400,1570766400,1
ooyahooyah,0,1,0,1,1603684800,1603684800,1
Sanator27,0,1,0,27,1557201600,1557201600,1
seansurvives,0,1,0,1,1597550400,1597550400,1
Juschillin888,0,1,0,1,1581224400,1581224400,1
lazylaser97,0,1,0,1,1606885200,1606885200,1
CrimsonPirate6,0,1,0,3,1587960000,1587960000,1
I-am-very-bored,0,1,0,3,1608872400,1608872400,1
andywarholocaust,0,1,0,4,1611982800,1611982800,1
vizion_r3hab,0,1,0,1,1600660800,1600660800,1
antihackerbg,0,1,0,1,1599278400,1599278400,1
benjamminam,0,1,0,1,1593921600,1593921600,1
mikeisanon154,0,1,0,2,1603425600,1603425600,1
AnotherJohnJimenez,0,1,0,1,1612155600,1612155600,1
BearfangTheGamer,0,1,0,7,1604898000,1604898000,1
Dammination_11,0,1,0,2,1581224400,1581224400,1
problematikUAV,0,1,0,1,1576904400,1576904400,1
Rygar82,0,1,0,6,1589947200,1589947200,1
keyboardqueen90,0,1,0,2,1574398800,1574398800,1
lulalilikabaloo,1,0,519,0,1590897600,1590897600,1
dolisve,1,0,112,0,1606366800,1606366800,1
Quirky_Flight,0,1,0,0,1584763200,1584763200,1
xxGioDudexx,0,1,0,1,1606280400,1606280400,1
cabbage16,0,1,0,5,1601956800,1601956800,1
ThroughlyDruxy,0,1,0,-2,1565150400,1565150400,1
Stauner-mcgregor,0,1,0,15,1611810000,1611810000,1
PsychMasterDrippin,0,1,0,2,1599451200,1599451200,1
hankypinky,0,1,0,1,1589860800,1589860800,1
FeedMeMore22778534,0,1,0,0,1590638400,1590638400,1
SirTickleTots,0,1,0,1,1585454400,1585454400,1
Sileniced,0,1,0,22,1562299200,1562299200,1
International_Slice1,0,1,0,15,1593057600,1593057600,1
WorkCult,1,0,19,0,1568606400,1568606400,1
louieDlemon,0,1,0,1,1606712400,1606712400,1
Bartleby_TheScrivene,0,1,0,6,1577422800,1577422800,1
Torven,0,1,0,15,1569988800,1569988800,1
KillFascEatOli,0,1,0,8,1586750400,1586750400,1
stryker161,0,1,0,1,1565841600,1565841600,1
stoneyyay,0,1,0,18,1611810000,1611810000,1
Moist_Ham,0,1,0,28,1584936000,1584936000,1
Savage_Mick,0,1,0,1,1589083200,1589083200,1
Brass14,0,1,0,82,1577854800,1577854800,1
HappyAppleDance,0,1,0,12,1573707600,1573707600,1
The_Tell_Tale_Heart,0,1,0,95,1590120000,1590120000,1
Positive_Novel1402,0,1,0,1,1606280400,1606280400,1
Chakrakan,0,1,0,3,1605934800,1605934800,1
spei180,0,1,0,-1,1573534800,1573534800,1
sschroeder82,0,1,0,3,1599278400,1599278400,1
Itz_Rocket-18,0,1,0,2,1606626000,1606626000,1
msveedubbin,0,1,0,3,1596340800,1596340800,1
Tsanes_Karmau,0,1,0,1,1575781200,1575781200,1
AlmightyDildo,0,1,0,120,1605589200,1605589200,1
Spicy_Ejaculate,0,1,0,10,1605070800,1605070800,1
Randdos,1,0,1,0,1598932800,1598932800,1
thelittlemeremaid,0,1,0,2,1595649600,1595649600,1
LilithontheEdge,0,1,0,2,1607058000,1607058000,1
zzztobee,0,1,0,2,1607403600,1607403600,1
radjadsad,0,1,0,3,1599796800,1599796800,1
Cuntalicous,0,1,0,15,1606712400,1606712400,1
younessssx,0,1,0,15,1562817600,1562817600,1
onemetaboi,0,1,0,1,1598846400,1598846400,1
CiXeL,0,1,0,13,1586404800,1586404800,1
Somerandomdude97655,0,1,0,14,1573966800,1573966800,1
confused-as-heck,1,0,93,0,1572148800,1572148800,1
voluptuous--,0,1,0,1,1600660800,1600660800,1
oindividuo,0,1,0,1,1565755200,1565755200,1
MrBeekers,0,1,0,10,1609218000,1609218000,1
Kysche14,0,1,0,3,1560916800,1560916800,1
Buckyhead,0,1,0,4,1578546000,1578546000,1
MercenaryOfOZ,0,1,0,26,1580965200,1580965200,1
NoKitsu,0,1,0,10,1575176400,1575176400,1
ldsdmtgod,0,1,0,5,1611982800,1611982800,1
Box_O_Donguses,0,1,0,8,1606194000,1606194000,1
lifedesignleaders,0,1,0,1,1602648000,1602648000,1
testreker,0,1,0,1,1605589200,1605589200,1
YoItsMeAmerica,0,1,0,0,1584072000,1584072000,1
DredNau9ht,0,1,0,2,1597982400,1597982400,1
RayLove660022,0,1,0,2,1612155600,1612155600,1
howdypardner007,0,1,0,1,1599624000,1599624000,1
ChinExpander420,0,1,0,1,1569643200,1569643200,1
shawnecy,0,1,0,68,1588392000,1588392000,1
thenathurat,1,0,29,0,1562644800,1562644800,1
v0xb0x_,0,1,0,-6,1612069200,1612069200,1
Connie2k17,0,1,0,2,1573534800,1573534800,1
KansanLesbian,0,1,0,2,1603166400,1603166400,1
Cats4life666,0,1,0,0,1573448400,1573448400,1
ThorinFrostclaw,0,1,0,1,1572494400,1572494400,1
dangerusty,0,1,0,3,1581915600,1581915600,1
TS-028,0,1,0,4,1584158400,1584158400,1
ic3m4n10,0,1,0,2,1584417600,1584417600,1
animesthetics,0,1,0,2,1597982400,1597982400,1
2yoil,0,1,0,14,1602043200,1602043200,1
mfiskars,0,1,0,2,1607058000,1607058000,1
heavyweightchamp001,0,1,0,-40,1598328000,1598328000,1
faithren,0,1,0,4,1603944000,1603944000,1
Few_Opportunity5852,0,1,0,3,1603512000,1603512000,1
amanofewords,0,1,0,5,1612069200,1612069200,1
diazbrothersbong,0,1,0,3,1584849600,1584849600,1
tanuki_goten,0,1,0,39,1592107200,1592107200,1
SciFiPaine0,0,1,0,13,1563508800,1563508800,1
sneakos2,0,1,0,1,1598760000,1598760000,1
smellofwarmsummerair,0,1,0,1,1591329600,1591329600,1
puppiesandmoney,0,1,0,9,1567569600,1567569600,1
feartheocelot,0,1,0,7,1585108800,1585108800,1
PhilosopherDave,0,1,0,1,1591243200,1591243200,1
turtleycoolthrowaway,0,1,0,2,1599537600,1599537600,1
sukkotfretensis,0,1,0,1,1572062400,1572062400,1
pistoncivic,0,1,0,3,1598587200,1598587200,1
vape4jesus247,0,1,0,13,1597118400,1597118400,1
magically_inclined,0,1,0,-2,1608526800,1608526800,1
bullyhunter57,0,1,0,6,1612069200,1612069200,1
awkwalkard,0,1,0,13,1569124800,1569124800,1
ConfidentLecture0,1,0,11,0,1590552000,1590552000,1
TJNUMBER9,0,1,0,2,1602388800,1602388800,1
GloriousHypnotart,0,1,0,3,1605589200,1605589200,1
OuchLOLcom,0,1,0,0,1604379600,1604379600,1
Future_Zer0,0,1,0,11,1607317200,1607317200,1
Al-Fayyad,0,1,0,32,1597809600,1597809600,1
robertbieber,0,1,0,5,1584244800,1584244800,1
bicycle_mice,0,1,0,3,1601870400,1601870400,1
WizardryAwaits,0,1,0,191,1588564800,1588564800,1
fapestniegd,0,1,0,5,1568088000,1568088000,1
butterflysheath,0,1,0,5,1601784000,1601784000,1
pissonyorug,0,1,0,2,1589515200,1589515200,1
RightsideDownDaniel,0,1,0,1,1598155200,1598155200,1
PresidentCam2,1,0,88,0,1581915600,1581915600,1
cellobotomy,0,1,0,24,1583470800,1583470800,1
Magnus250,0,1,0,1,1606626000,1606626000,1
hey_guys12345,0,1,0,21,1607576400,1607576400,1
2ndChanceAtLife,0,1,0,2,1585627200,1585627200,1
lucidcharm,0,1,0,19,1573362000,1573362000,1
RobinsonHuso12,0,1,0,1,1608354000,1608354000,1
thailandblack,0,1,0,1,1578373200,1578373200,1
Pinhead_Larry224,0,1,0,1,1609390800,1609390800,1
DJ-Smash,0,1,0,1,1596340800,1596340800,1
roguegambit83,0,1,0,1,1597377600,1597377600,1
Red_Rabbit_Run,1,0,5,0,1584590400,1584590400,1
ETRfreeTS,0,1,0,229,1595476800,1595476800,1
Rlherron,0,1,0,12,1571544000,1571544000,1
laoluei,0,1,0,17,1611896400,1611896400,1
ultraviolentfuture,0,1,0,1,1584244800,1584244800,1
Sauron0212,0,1,0,4,1603252800,1603252800,1
L1onCub5,0,1,0,3,1570248000,1570248000,1
hermionesmurf,0,1,0,5,1588651200,1588651200,1
RikkySpanish82,0,1,0,2,1589774400,1589774400,1
Saiyaman,0,1,0,2,1596340800,1596340800,1
Villhermus,0,1,0,28,1603425600,1603425600,1
DavidDormvik,0,1,0,2,1557892800,1557892800,1
SpeedyAshMain,0,1,0,0,1612155600,1612155600,1
vanillaholler,0,1,0,10,1563854400,1563854400,1
sammypants123,0,1,0,37,1584590400,1584590400,1
glowinginthedarks,0,1,0,2,1605070800,1605070800,1
amiokrightnow,0,1,0,7,1599537600,1599537600,1
Sohte3,0,1,0,45,1607835600,1607835600,1
Weegie321,0,1,0,1,1599192000,1599192000,1
Tspacecake,0,1,0,1,1635739200,1635739200,1
int-enzo,0,1,0,31,1587787200,1587787200,1
teszes,0,1,0,7,1598414400,1598414400,1
KINGTEHUTI,0,1,0,1,1417496400,1417496400,1
szymonhimself,0,1,0,35,1592280000,1592280000,1
wyom1ng,0,1,0,56,1588132800,1588132800,1
FinanceMark,0,1,0,1,1599537600,1599537600,1
CaligulaNeptuneBane,0,1,0,2,1591329600,1591329600,1
Common_Appearance,0,1,0,1,1589947200,1589947200,1
JephaHowler,0,1,0,4,1587182400,1587182400,1
Jessticle_,0,1,0,0,1608526800,1608526800,1
deptii,1,0,28,0,1605848400,1605848400,1
NothingButTheTruthy,0,1,0,1,1564891200,1564891200,1
W_OMEGALUL_W,0,1,0,77,1587614400,1587614400,1
PM_ME_UR_XTRA_NIPS,0,1,0,1,1588219200,1588219200,1
OxKLove,0,1,0,5,1598760000,1598760000,1
stephencarlstrom,1,0,23,0,1575003600,1575003600,1
ArcticTern4theWorse,0,1,0,6,1596081600,1596081600,1
crepesandcarnival,0,1,0,4,1603684800,1603684800,1
OG-Believe-Me,0,1,0,1,1604811600,1604811600,1
Home--Builder,0,1,0,1,1606626000,1606626000,1
KibitoKai,0,1,0,4,1547528400,1547528400,1
minibuns0404,0,1,0,2,1585454400,1585454400,1
gmc93l2,0,1,0,2,1605675600,1605675600,1
The_wanderer420,0,1,0,4,1607749200,1607749200,1
BananaFishSauce,0,1,0,1,1582779600,1582779600,1
Steadfast_Truth,0,1,0,2,1606539600,1606539600,1
SlimmG8r,0,1,0,7,1608613200,1608613200,1
mspotatohead22,0,1,0,2,1594094400,1594094400,1
tsicsafitna,0,1,0,3,1596772800,1596772800,1
iforgotmylogon,0,1,0,1,1593403200,1593403200,1
Victoria_The_White,0,1,0,-6,1606539600,1606539600,1
BBM_Dreamer,0,1,0,1,1607922000,1607922000,1
AyNevada,1,0,16,0,1596340800,1596340800,1
Jalor218,0,1,0,16,1589947200,1589947200,1
amrakkarma,0,1,0,14,1597550400,1597550400,1
Console_Pheasant,0,1,0,19,1597118400,1597118400,1
mugbee0,0,1,0,1,1598068800,1598068800,1
Crystal_Pesci,0,1,0,1,1547182800,1547182800,1
Loopchute,0,1,0,1,1591243200,1591243200,1
Chocolatedippedbacon,0,1,0,22,1559707200,1559707200,1
Krazinsky,0,1,0,32,1572667200,1572667200,1
pinko-perchik,0,1,0,10,1605243600,1605243600,1
fearhs,0,1,0,1,1602388800,1602388800,1
noyourmomfat,0,1,0,3,1591156800,1591156800,1
AnnalenaErb,0,1,0,1,1568260800,1568260800,1
bot4bot,0,1,0,1,1585368000,1585368000,1
Finn_Dalire,0,1,0,5,1573621200,1573621200,1
Marokiii,0,1,0,22,1597550400,1597550400,1
Wolliemon,1,0,39,0,1589947200,1589947200,1
ollieread,0,1,0,5,1585886400,1585886400,1
ectish,0,1,0,1,1603598400,1603598400,1
MissWall-E,0,1,0,-3,1602907200,1602907200,1
Murky_Visual4972,1,0,18,0,1611723600,1611723600,1
TowelRackInDenial,0,1,0,2,1599969600,1599969600,1
dirtysofttaco,0,1,0,0,1584331200,1584331200,1
hbaz101,0,1,0,1,1606280400,1606280400,1
eats_butter,0,1,0,41,1600401600,1600401600,1
HWDB99,0,1,0,164,1607144400,1607144400,1
sfpoet,0,1,0,8,1598155200,1598155200,1
PayRespects-Bot,0,1,0,7,1598414400,1598414400,1
IRULETHISREDDIT,0,1,0,0,1585454400,1585454400,1
Shanks_Yagami,0,1,0,1,1609736400,1609736400,1
2020___2020,0,1,0,2,1606280400,1606280400,1
mukuro,0,1,0,10,1524196800,1524196800,1
ranifer,0,1,0,1,1570420800,1570420800,1
Anubis-Hound,0,1,0,70,1597291200,1597291200,1
Gul_Ducatti,0,1,0,9,1606453200,1606453200,1
solaza,0,1,0,3,1582779600,1582779600,1
Mergus84,0,1,0,86,1598846400,1598846400,1
fullautophx,0,1,0,3,1606971600,1606971600,1
Rockaustin,0,1,0,3,1436932800,1436932800,1
i_hope_youre_ok,1,0,14,0,1583125200,1583125200,1
hueckstaedt,0,1,0,-4,1608786000,1608786000,1
SmolBeers,0,1,0,6,1600660800,1600660800,1
monks3090,0,1,0,9,1597032000,1597032000,1
sweetdrippins,0,1,0,4,1584763200,1584763200,1
Tara_is_a_Potato,0,1,0,3,1597982400,1597982400,1
tldr553,0,1,0,-15,1600315200,1600315200,1
MrMangoKitten,0,1,0,2,1597118400,1597118400,1
TiredMemeReference,0,1,0,2,1603598400,1603598400,1
MCHammons15,0,1,0,17,1608267600,1608267600,1
WakeNikis,0,1,0,3,1578891600,1578891600,1
chinchila5,0,1,0,4,1603425600,1603425600,1
Tronkfool,0,1,0,2,1604552400,1604552400,1
austadamola,0,1,0,1,1604466000,1604466000,1
petelka,0,1,0,82,1611982800,1611982800,1
bumford11,0,1,0,5,1577077200,1577077200,1
This--Ali2,0,1,0,3,1572062400,1572062400,1
newaccountwhomstdis,0,1,0,7,1605848400,1605848400,1
whynottakeadab,0,1,0,1,1592280000,1592280000,1
oneday111,0,1,0,11,1560744000,1560744000,1
TerrariaEnthusiast99,0,1,0,1,1597291200,1597291200,1
cheifgarrity,0,1,0,-1,1600747200,1600747200,1
Projectrage,0,1,0,2,1579064400,1579064400,1
nomoredream_,1,0,35,0,1607144400,1607144400,1
candyspicefire,0,1,0,5,1611810000,1611810000,1
earljones710,0,1,0,1,1596772800,1596772800,1
bsdetox,0,1,0,12,1539921600,1539921600,1
The-blackSP4RROW,0,1,0,5,1606539600,1606539600,1
yrhendystu,0,1,0,3,1606021200,1606021200,1
ooooouuuo,0,1,0,4,1603512000,1603512000,1
Timber3,0,1,0,2,1603512000,1603512000,1
kumba24,0,1,0,2,1609218000,1609218000,1
unwarypigeon846,0,1,0,1,1585972800,1585972800,1
Individual-Cupcake,0,1,0,32,1608786000,1608786000,1
miniskit,0,1,0,46,1604984400,1604984400,1
RiotMoose,0,1,0,19,1593835200,1593835200,1
jumbletron01,0,1,0,1,1603512000,1603512000,1
SirDumpel,0,1,0,7,1605848400,1605848400,1
Freebandz1,0,1,0,-8,1575435600,1575435600,1
Elladel,0,1,0,28,1573534800,1573534800,1
olmagpie,0,1,0,4,1608786000,1608786000,1
RLtradefiend,0,1,0,1,1596600000,1596600000,1
GrimAllen,0,1,0,2,1588132800,1588132800,1
stoodonaduck,0,1,0,21,1603512000,1603512000,1
CombodianBreastMilk,0,1,0,2,1606366800,1606366800,1
ExceptionalWeirdo,0,1,0,-56,1597636800,1597636800,1
Peachycat16,0,1,0,3,1604811600,1604811600,1
sodoff_Bauldrick,0,1,0,1,1605070800,1605070800,1
zoltar-wisdom,0,1,0,2,1612242000,1612242000,1
TheReal_UFO,0,1,0,2,1585195200,1585195200,1
WashingtonIrving2719,0,1,0,1,1611982800,1611982800,1
grey_danke,1,0,1,0,1599278400,1599278400,1
Suicidalsocialistcat,0,1,0,40,1565582400,1565582400,1
TorqueyJ,0,1,0,0,1585454400,1585454400,1
BigBoiz74,0,1,0,3,1578978000,1578978000,1
cantgrowaneckbeard,0,1,0,12,1583643600,1583643600,1
F9574,0,1,0,12,1575867600,1575867600,1
aniar00,0,1,0,2,1581224400,1581224400,1
funaway727,0,1,0,0,1605589200,1605589200,1
RuralKT,0,1,0,1,1577854800,1577854800,1
itsfairadvantage,0,1,0,3,1611810000,1611810000,1
Pandaz1z,0,1,0,1,1597118400,1597118400,1
djmedicalman,0,1,0,30,1608699600,1608699600,1
vandealex1,0,1,0,2,1599278400,1599278400,1
Evaughn5,0,1,0,5,1606021200,1606021200,1
justinATL,0,1,0,10,1579496400,1579496400,1
Image_of_glass_man,0,1,0,10,1573794000,1573794000,1
skubaloob,0,1,0,2,1592366400,1592366400,1
whostole,0,1,0,2,1574139600,1574139600,1
lilBalzac,0,1,0,4,1592971200,1592971200,1
DoReid0,0,1,0,1,1606539600,1606539600,1
Hari484,0,1,0,6,1600660800,1600660800,1
atomic_pie,0,1,0,1,1592280000,1592280000,1
PastaBolognese,0,1,0,1,1604379600,1604379600,1
TheKingOfTCGames,0,1,0,-24,1561521600,1561521600,1
tk421storm,0,1,0,5,1606885200,1606885200,1
anarcho_something,0,1,0,31,1553832000,1553832000,1
Lifes4livin88,0,1,0,-2,1564804800,1564804800,1
Safy_burger21,0,1,0,1,1604030400,1604030400,1
Ask_Who_Owes_Me_Gold,0,1,0,1,1603598400,1603598400,1
Gopher_Trace,0,1,0,5,1591675200,1591675200,1
Monsi_ggnore,0,1,0,1,1597118400,1597118400,1
equestrian123123,0,1,0,8,1574830800,1574830800,1
HariTerra,0,1,0,3,1599278400,1599278400,1
davidlol1,0,1,0,2,1603598400,1603598400,1
urbandeadthrowaway2,0,1,0,8,1595563200,1595563200,1
DiNiCoBr,0,1,0,1,1587441600,1587441600,1
ProfessorSpike,0,1,0,11,1576386000,1576386000,1
op3l,0,1,0,1,1591329600,1591329600,1
Jskidmore1217,0,1,0,0,1577682000,1577682000,1
muramasa_x6,0,1,0,70,1578027600,1578027600,1
DarkAngel9999,0,1,0,2,1598241600,1598241600,1
JeezusMurphy,0,1,0,1,1611982800,1611982800,1
anarchrism,0,1,0,1,1600920000,1600920000,1
Buffinator360,0,1,0,31,1585454400,1585454400,1
Cookbookboopbook,0,1,0,0,1585454400,1585454400,1
kanonco,0,1,0,3,1601352000,1601352000,1
Anbcdeptraivkl,0,1,0,45,1584676800,1584676800,1
cutebutwillfight,0,1,0,52,1571544000,1571544000,1
WillingnessJealous81,0,1,0,-2,1607576400,1607576400,1
aza-rnglab,0,1,0,66,1597982400,1597982400,1
Stealth-B12,0,1,0,7,1585800000,1585800000,1
Galle_,0,1,0,6,1612069200,1612069200,1
notsohipsterithink,0,1,0,1,1606626000,1606626000,1
ronp88,0,1,0,1,1585454400,1585454400,1
tattletittle333,1,0,27,0,1608267600,1608267600,1
Aldrahill,0,1,0,19,1598760000,1598760000,1
TheRobotsHaveCome,0,1,0,2,1569211200,1569211200,1
Graptoveria,0,1,0,22,1595563200,1595563200,1
onedollarwilliam,0,1,0,1,1601006400,1601006400,1
12ed13lood1,0,1,0,10,1575003600,1575003600,1
tangeledyarn,1,0,14,0,1611896400,1611896400,1
Phishtravaganza,0,1,0,19,1596254400,1596254400,1
Lunarmouse,0,1,0,5,1598846400,1598846400,1
FortniteIsCancerBot,0,1,0,2,1555905600,1555905600,1
SkyPlays,0,1,0,9,1591243200,1591243200,1
cfloweristradional,0,1,0,2,1607490000,1607490000,1
beingblonde900,0,1,0,35,1568520000,1568520000,1
jNSKkK,0,1,0,1,1570939200,1570939200,1
Bajileh,0,1,0,1,1607403600,1607403600,1
Fergye-Ward,0,1,0,1,1581915600,1581915600,1
3and2,0,1,0,44,1583470800,1583470800,1
start_bruh,0,1,0,1,1593403200,1593403200,1
MetalSeaWeed,0,1,0,2,1602907200,1602907200,1
x131e,0,1,0,1,1608872400,1608872400,1
Caishen_IC3,0,1,0,1,1596427200,1596427200,1
Neon_Hippy,0,1,0,14,1576126800,1576126800,1
theLostGuide,0,1,0,1,1602043200,1602043200,1
Pyratelife4me,0,1,0,1,1609390800,1609390800,1
voidspaceistrippy,0,1,0,3,1609304400,1609304400,1
forty_percent_done,0,1,0,18,1605070800,1605070800,1
Popular_Prescription,0,1,0,2,1603598400,1603598400,1
ovrclocked,0,1,0,2,1607576400,1607576400,1
eschus2,0,1,0,-1,1598760000,1598760000,1
Revolution1917,0,1,0,1,1593748800,1593748800,1
thekhannahkeht,0,1,0,5,1605762000,1605762000,1
capt_poopsy_daizy,0,1,0,1,1575608400,1575608400,1
Truyth,0,1,0,10,1554264000,1554264000,1
BetterTheory,0,1,0,1,1570248000,1570248000,1
DeadlyTissues,0,1,0,1,1554350400,1554350400,1
IMissGW,0,1,0,7,1600228800,1600228800,1
sy403,0,1,0,3,1606280400,1606280400,1
mykul,0,1,0,4,1576040400,1576040400,1
hansn,0,1,0,20,1578891600,1578891600,1
6hai,0,1,0,0,1603080000,1603080000,1
CanadianLink,1,0,2,0,1580792400,1580792400,1
advice50,0,1,0,30,1593662400,1593662400,1
Globalpigeon,0,1,0,3,1574830800,1574830800,1
LupoSolitarioOoOo,0,1,0,7,1595822400,1595822400,1
HornetBoring,0,1,0,2,1603598400,1603598400,1
amitygoodtogo,0,1,0,2,1575694800,1575694800,1
darDARWINwin,1,0,23,0,1608354000,1608354000,1
GetsBetterAfterAFew,0,1,0,25,1603512000,1603512000,1
TheFio,0,1,0,15,1560398400,1560398400,1
JBabymax,0,1,0,24,1606280400,1606280400,1
altuniverseself,0,1,0,0,1586664000,1586664000,1
terrifiedofgolfcarts,0,1,0,1,1593662400,1593662400,1
Donotbanmebeeotch,0,1,0,4,1588996800,1588996800,1
Touch_the_Cow,0,1,0,-19,1577336400,1577336400,1
tommybass,0,1,0,11,1578114000,1578114000,1
MultiverseTraveller,0,1,0,-11,1608267600,1608267600,1
mieeekeee,0,1,0,1,1606021200,1606021200,1
bubbly_cakes,0,1,0,21,1609477200,1609477200,1
DA-CHEESEMONGER,0,1,0,2,1583557200,1583557200,1
MilesyART,0,1,0,1,1582779600,1582779600,1
danamo219,0,1,0,9,1608181200,1608181200,1
meggielim,0,1,0,3,1609304400,1609304400,1
popdisaster00,0,1,0,4,1603598400,1603598400,1
Ickplant,0,1,0,6,1553832000,1553832000,1
exoenigma,0,1,0,11,1557288000,1557288000,1
AnImEiSfOrLoOsErS,0,1,0,5,1589947200,1589947200,1
rbcyalater,0,1,0,1,1600574400,1600574400,1
SuperDeuxd,0,1,0,3,1582779600,1582779600,1
ActivatingEMP,0,1,0,1,1580101200,1580101200,1
sailing808,0,1,0,2,1601870400,1601870400,1
smellmymustard,0,1,0,4,1600574400,1600574400,1
beefstroganoffowitz,0,1,0,0,1602129600,1602129600,1
Serven_118,0,1,0,20,1593748800,1593748800,1
MtBakerScum,0,1,0,10,1571976000,1571976000,1
theguywiththeyeballs,0,1,0,1,1589601600,1589601600,1
jaxob420,0,1,0,2,1608008400,1608008400,1
DottieAB,1,0,142,0,1602561600,1602561600,1
l4n0,0,1,0,2,1605848400,1605848400,1
KunulingusKhan,0,1,0,16,1605330000,1605330000,1
QuantumCalc,0,1,0,1,1607403600,1607403600,1
nothing2Cinthewoods,0,1,0,6,1612069200,1612069200,1
Spacemuffler,0,1,0,2,1608181200,1608181200,1
SpiderQueen72,0,1,0,16,1599019200,1599019200,1
JoeMarron,0,1,0,6,1597377600,1597377600,1
84yodamudshark,0,1,0,1,1636693200,1636693200,1
iwishihadntdoneit,0,1,0,22,1596686400,1596686400,1
Macross_,0,1,0,122,1589601600,1589601600,1
gigglefarting,0,1,0,2,1600315200,1600315200,1
jazzforpants,0,1,0,-8,1605589200,1605589200,1
afishda,0,1,0,1,1605589200,1605589200,1
TheGhettoSmokerLady,0,1,0,1,1607662800,1607662800,1
Tro_Ahwai5,0,1,0,4,1572235200,1572235200,1
TechnoPagan87109,0,1,0,2,1594526400,1594526400,1
Quiet_Student,0,1,0,44,1574485200,1574485200,1
Cool_Bowties,0,1,0,2,1612069200,1612069200,1
Amirkedar,0,1,0,2,1596600000,1596600000,1
albinoman38,0,1,0,24,1574398800,1574398800,1
SolidArk,0,1,0,1,1607749200,1607749200,1
Rev_Cleophus_James,0,1,0,8,1598673600,1598673600,1
Eis_Konig,0,1,0,12,1592193600,1592193600,1
wbbarth,0,1,0,3,1575694800,1575694800,1
TopKulak,0,1,0,7,1599969600,1599969600,1
Cuilen,0,1,0,4,1596340800,1596340800,1
FreeShmokeee,0,1,0,-5,1583643600,1583643600,1
Stoppablemurph,0,1,0,3,1591329600,1591329600,1
ProfessionalEvaLover,0,1,0,20,1587873600,1587873600,1
Glittering_Show_3414,1,0,0,0,1608267600,1608267600,1
SoFastMuchFurious,0,1,0,2,1635220800,1635220800,1
AndersonFormiga,0,1,0,2,1597896000,1597896000,1
Nocommentt1000,0,1,0,2,1590120000,1590120000,1
xxtoto,0,1,0,4,1555041600,1555041600,1
FlamesRiseHigher,0,1,0,3,1599105600,1599105600,1
benutzranke,0,1,0,2,1599710400,1599710400,1
idontsleepsowell,0,1,0,5,1607835600,1607835600,1
mormon_bible,0,1,0,17,1603598400,1603598400,1
rockwashear,0,1,0,1,1599883200,1599883200,1
TripleTapDev,0,1,0,1,1603080000,1603080000,1
Zimgruk,0,1,0,13,1598932800,1598932800,1
West_U2L8,0,1,0,1,1589860800,1589860800,1
BadBunnyFooFoo,0,1,0,2,1602561600,1602561600,1
Vlastalica01,0,1,0,42,1608699600,1608699600,1
BlackShadowv,0,1,0,5,1567569600,1567569600,1
Deadhead7889,0,1,0,9,1603512000,1603512000,1
lunaelilium,0,1,0,1,1608267600,1608267600,1
Itzfitz84,0,1,0,1,1603944000,1603944000,1
Gazer_Beam2020,0,1,0,1,1589083200,1589083200,1
Jaggerman82,0,1,0,2,1591243200,1591243200,1
theory-creator,0,1,0,2,1603425600,1603425600,1
manguito86,0,1,0,0,1588564800,1588564800,1
DoctorPantsMD,0,1,0,4,1599278400,1599278400,1
Stockholmbarber,0,1,0,1,1605934800,1605934800,1
Qa-ravi,0,1,0,1,1582779600,1582779600,1
dirtyVeganCommy,0,1,0,17,1564113600,1564113600,1
TrappedThinker,0,1,0,1,1593662400,1593662400,1
GloopBeep,0,1,0,46,1597636800,1597636800,1
BabaYagaaa,0,1,0,6,1587873600,1587873600,1
SpaceForceTrooper,0,1,0,4,1586232000,1586232000,1
bdld39,0,1,0,5,1603598400,1603598400,1
LittleLight85,0,1,0,6,1585454400,1585454400,1
superzooploop,1,0,516,0,1586318400,1586318400,1
MidNerd,0,1,0,2,1553400000,1553400000,1
thefrydaddy,0,1,0,49,1599969600,1599969600,1
Legitimate_Purple_17,1,0,5,0,1604203200,1604203200,1
anonlala101,0,1,0,3,1595736000,1595736000,1
radtrashboi,0,1,0,10,1588910400,1588910400,1
Piploow,0,1,0,1,1605416400,1605416400,1
itrTie,0,1,0,1,1601179200,1601179200,1
tummytickles23,1,0,9,0,1580706000,1580706000,1
TizzioCaio,0,1,0,21,1598760000,1598760000,1
JimmyxxBrewha,0,1,0,228,1606971600,1606971600,1
AllOfMyVotes,0,1,0,13,1580014800,1580014800,1
hendawg86,0,1,0,3,1605502800,1605502800,1
Wizard_Enthusiast,0,1,0,1,1603512000,1603512000,1
HistoricalDentist736,0,1,0,1,1601006400,1601006400,1
Lyude,0,1,0,10,1593748800,1593748800,1
steezyweezey,0,1,0,1,1606626000,1606626000,1
The_Guy_820,0,1,0,1,1593057600,1593057600,1
popyacollar4,0,1,0,1,1605070800,1605070800,1
sccavanaugh,0,1,0,1,1643173200,1643173200,1
giganticsquid,0,1,0,2,1596513600,1596513600,1
JustinkLindsay,0,1,0,2,1586750400,1586750400,1
Klowned,0,1,0,6,1580274000,1580274000,1
Raxxye,0,1,0,1,1611810000,1611810000,1
DaCheesiestEchidna,0,1,0,12,1574658000,1574658000,1
kinyon,0,1,0,3,1608181200,1608181200,1
anoako,0,1,0,32,1599105600,1599105600,1
flickledort,0,1,0,9,1598241600,1598241600,1
PuttingInTheEffort,0,1,0,1,1585454400,1585454400,1
NewVoice2040,0,1,0,1,1591329600,1591329600,1
dcmldcml,0,1,0,78,1569902400,1569902400,1
Captain_Grammaticus,0,1,0,16,1590465600,1590465600,1
andyboy98,0,1,0,13,1514091600,1514091600,1
CloakedInOak,0,1,0,5,1581829200,1581829200,1
OzziePawzy69,0,1,0,7,1577941200,1577941200,1
ergHelium,0,1,0,15,1570507200,1570507200,1
B___E,0,1,0,9,1576558800,1576558800,1
QueenOfQuok,0,1,0,1,1611982800,1611982800,1
adick_did,0,1,0,1,1601179200,1601179200,1
bardelocio,0,1,0,4,1582693200,1582693200,1
InappropriatelySaid,0,1,0,-1,1580101200,1580101200,1
TinyMoose4,0,1,0,9,1603684800,1603684800,1
felinocumpleanos,0,1,0,8,1594872000,1594872000,1
Blue-Steele,0,1,0,-6,1565064000,1565064000,1
_Chi-Guy_,0,1,0,1,1598587200,1598587200,1
PC__LOAD__LETTER,0,1,0,2,1531108800,1531108800,1
bbyxnat,0,1,0,17,1579410000,1579410000,1
iloveblazepizza,0,1,0,1,1584590400,1584590400,1
deepstate_fangirl,0,1,0,1,1608613200,1608613200,1
emptychild1684,0,1,0,2,1590552000,1590552000,1
Hells_Fargo,0,1,0,5,1595995200,1595995200,1
hal68k,0,1,0,6,1563422400,1563422400,1
missingmytowel,0,1,0,1,1606626000,1606626000,1
rando-sam,0,1,0,17,1585281600,1585281600,1
thecandyfairy,0,1,0,69,1578114000,1578114000,1
bobcollege,0,1,0,0,1605589200,1605589200,1
CashingOutInShinjuku,0,1,0,4,1599883200,1599883200,1
PowderWitch90,0,1,0,8,1573362000,1573362000,1
rachsant,0,1,0,48,1549515600,1549515600,1
jwhguitar,0,1,0,4,1599710400,1599710400,1
WeAreButStardust,0,1,0,8,1608958800,1608958800,1
Hallucinates_Bacon,0,1,0,14,1568347200,1568347200,1
poply,1,0,70,0,1582002000,1582002000,1
PomegranatePancakes,0,1,0,3,1563940800,1563940800,1
Schaden336,0,1,0,5,1602561600,1602561600,1
SamSlate,0,1,0,1,1607490000,1607490000,1
ushimi,1,0,45,0,1592971200,1592971200,1
VikingLordOfSpam,1,0,28,0,1603771200,1603771200,1
Unfriendly_NPC,0,1,0,64,1592452800,1592452800,1
Deliousa,0,1,0,3,1606798800,1606798800,1
pkelliher98,0,1,0,15,1597291200,1597291200,1
existential_plant,0,1,0,2,1574658000,1574658000,1
hawklost,0,1,0,1,1604466000,1604466000,1
VegetableSmoker,1,0,129,0,1606712400,1606712400,1
cdandajacket,0,1,0,21,1574571600,1574571600,1
ShowMe_River,0,1,0,-7,1601870400,1601870400,1
kne0n,0,1,0,1,1608267600,1608267600,1
y_4KLs_27,1,0,1,0,1455685200,1455685200,1
nesuno,0,1,0,8,1612155600,1612155600,1
Aapas,0,1,0,1,1601870400,1601870400,1
meow1204,0,1,0,2,1602388800,1602388800,1
theskymoves,0,1,0,-6,1595390400,1595390400,1
Chemoralora,0,1,0,3,1598587200,1598587200,1
Upper-Song1924,0,1,0,1,1607662800,1607662800,1
XxenaTroi,0,1,0,1,1612069200,1612069200,1
suavecool21692169,0,1,0,1,1608872400,1608872400,1
crimsonultra,0,1,0,18,1591243200,1591243200,1
everythingbutblues,0,1,0,198,1591848000,1591848000,1
HalfFullPessimist,0,1,0,1,1589860800,1589860800,1
crusoepat,0,1,0,18,1607835600,1607835600,1
JellybeanEyes,0,1,0,1,1604030400,1604030400,1
PENIS-MAN545,0,1,0,1,1607058000,1607058000,1
Kozkoz828,0,1,0,5,1603684800,1603684800,1
GrouchySkipDriverMB,0,1,0,4,1577682000,1577682000,1
blitz672,0,1,0,1,1589860800,1589860800,1
BilythePuppet,0,1,0,0,1605934800,1605934800,1
portobello_mushroom,0,1,0,7,1597636800,1597636800,1
dripfeed_addict,0,1,0,5,1581915600,1581915600,1
BrinkBreaker,0,1,0,107,1603512000,1603512000,1
Epicgamer33,0,1,0,20,1592366400,1592366400,1
9145operate,0,1,0,1,1608267600,1608267600,1
rockybagboa,0,1,0,2,1573880400,1573880400,1
_Coolton_,0,1,0,4,1591156800,1591156800,1
m23574,0,1,0,1,1588824000,1588824000,1
fermafone,0,1,0,2,1600660800,1600660800,1
kody_420,0,1,0,-14,1568692800,1568692800,1
naturallyiced,0,1,0,5,1608786000,1608786000,1
DA_princesss,0,1,0,16,1582434000,1582434000,1
Zolku,0,1,0,1,1580619600,1580619600,1
NotoneFuwagi,0,1,0,0,1591329600,1591329600,1
vomitousleech,0,1,0,3,1598673600,1598673600,1
flakysoul,0,1,0,200,1608786000,1608786000,1
Upstairs_Jump,1,0,9,0,1531713600,1531713600,1
popswag,0,1,0,4,1573966800,1573966800,1
icamefordeath,0,1,0,5,1592625600,1592625600,1
downvotedyeet,0,1,0,1,1572235200,1572235200,1
Raise_the_Truth,0,1,0,10,1593921600,1593921600,1
Somanypaswords4,0,1,0,5,1590638400,1590638400,1
StrangeMeeps,0,1,0,3,1598155200,1598155200,1
Xfolo,0,1,0,60,1596600000,1596600000,1
hyakkymaru,1,0,83,0,1581051600,1581051600,1
1sharp1flat,0,1,0,1,1608958800,1608958800,1
dmonman,0,1,0,0,1600660800,1600660800,1
oodats,0,1,0,4,1600660800,1600660800,1
Dpira_Ugotts,0,1,0,12,1565668800,1565668800,1
ProfessorSunglasses,0,1,0,1,1604638800,1604638800,1
Feinyan,0,1,0,2,1609304400,1609304400,1
CainNoAbel,0,1,0,3,1550379600,1550379600,1
kalyco,0,1,0,2,1534478400,1534478400,1
Fun-atParties,0,1,0,6,1569556800,1569556800,1
heysansfans,0,1,0,8,1597118400,1597118400,1
Dop3ryENT,1,0,2,0,1542517200,1542517200,1
mambotot,0,1,0,7,1557288000,1557288000,1
Alicendre,0,1,0,4,1555905600,1555905600,1
Hopper23,0,1,0,1,1583470800,1583470800,1
East902,0,1,0,1,1571716800,1571716800,1
mintaka5,0,1,0,4,1604293200,1604293200,1
Axsaul,0,1,0,1,1604293200,1604293200,1
Nemisii,0,1,0,24,1574139600,1574139600,1
DosMangos,0,1,0,12,1581397200,1581397200,1
Saint-Judas,0,1,0,2,1597896000,1597896000,1
Poobutt42069,0,1,0,-11,1607922000,1607922000,1
smashkeys,0,1,0,2,1596168000,1596168000,1
gelidus22,0,1,0,1,1580965200,1580965200,1
Kimkari,0,1,0,2,1578459600,1578459600,1
DistortedDisorder,1,0,42,0,1591588800,1591588800,1
Hampton64,0,1,0,4,1573102800,1573102800,1
zephyris12,0,1,0,5,1587182400,1587182400,1
mleclerc182,0,1,0,53,1575435600,1575435600,1
NvidiaforMen,0,1,0,1,1585454400,1585454400,1
themage1028,0,1,0,5,1561694400,1561694400,1
EnhancedIntrospector,0,1,0,27,1580101200,1580101200,1
TrailCamOrgy,0,1,0,1,1634702400,1634702400,1
KetchupIsDisgusting,0,1,0,0,1593230400,1593230400,1
Shark_Test,0,1,0,5,1591848000,1591848000,1
wafflehousewhore,0,1,0,3,1566360000,1566360000,1
Little_Donkey29,0,1,0,3,1583726400,1583726400,1
leopetri,0,1,0,9,1582002000,1582002000,1
asdfghjkml,0,1,0,5,1582779600,1582779600,1
a_glass_soul,1,0,165,0,1567569600,1567569600,1
Trez720,0,1,0,1,1611982800,1611982800,1
TehGamist,0,1,0,1,1578373200,1578373200,1
donnavan,0,1,0,1,1571889600,1571889600,1
Asphalt_Is_Stronk,0,1,0,3,1590206400,1590206400,1
TRNSilent,0,1,0,5,1572062400,1572062400,1
shayaaa,0,1,0,2,1599019200,1599019200,1
jen_esaisquoi,0,1,0,12,1609390800,1609390800,1
hebrewcoffee11,0,1,0,-3,1576213200,1576213200,1
VaultBreaker_,0,1,0,1,1590984000,1590984000,1
lack0fvirtue,0,1,0,43,1606194000,1606194000,1
Trawetser,0,1,0,3,1601611200,1601611200,1
sionnach,0,1,0,1,1573966800,1573966800,1
MedianJ03,0,1,0,1,1606021200,1606021200,1
ExWebics,0,1,0,1,1589947200,1589947200,1
TTRPG_Fiend,0,1,0,6,1609218000,1609218000,1
OldSpicedRum,0,1,0,2,1603512000,1603512000,1
MonteSS_454,0,1,0,7,1612069200,1612069200,1
Philodendron-Dad,0,1,0,3,1578114000,1578114000,1
IFunnysDead,0,1,0,1,1607058000,1607058000,1
alanishere111,0,1,0,1,1547528400,1547528400,1
webtheg,0,1,0,3,1573275600,1573275600,1
CanadianDragonGuy,0,1,0,1,1575954000,1575954000,1
conejaverde,0,1,0,1,1461643200,1461643200,1
Jaskier_The_Bard85,0,1,0,10,1583557200,1583557200,1
euphorichords,0,1,0,8,1594872000,1594872000,1
onhereimJim,0,1,0,1,1603512000,1603512000,1
Bimbey,1,0,8,0,1591416000,1591416000,1
Constantine-Decrypt,0,1,0,2,1582174800,1582174800,1
Cjc0074,0,1,0,1,1607662800,1607662800,1
ToolanWheeler,0,1,0,0,1608699600,1608699600,1
smoking-tiger,0,1,0,1,1608699600,1608699600,1
FluffyTippy,0,1,0,4,1593748800,1593748800,1
letsnotmeeteachother,0,1,0,1,1591329600,1591329600,1
x0xk,0,1,0,2,1593748800,1593748800,1
ornithobiography,0,1,0,2,1589947200,1589947200,1
Beavertales,0,1,0,1,1585454400,1585454400,1
jerricka,0,1,0,1,1601352000,1601352000,1
Indicawise,0,1,0,4,1590120000,1590120000,1
madcunt2250,0,1,0,6,1598068800,1598068800,1
xmromi,0,1,0,-17,1595563200,1595563200,1
Dayvihd,0,1,0,3,1596772800,1596772800,1
moonbriar,0,1,0,3,1603512000,1603512000,1
Bentnoz,0,1,0,-17,1575262800,1575262800,1
proteinrichpiano,0,1,0,1,1598760000,1598760000,1
stickayrickay,0,1,0,1,1585454400,1585454400,1
Taps698,0,1,0,2,1605589200,1605589200,1
sp1neless,0,1,0,261,1573966800,1573966800,1
Hoobkaaway,0,1,0,1,1605589200,1605589200,1
ReturnOfSalty,0,1,0,2,1589860800,1589860800,1
jemmyleggs,0,1,0,0,1581224400,1581224400,1
merlinsbeers,0,1,0,1,1591329600,1591329600,1
Confident_Interest,0,1,0,1,1590033600,1590033600,1
Mytriptorussia2018,1,0,0,0,1599278400,1599278400,1
House_of_ill_fame,0,1,0,15,1569124800,1569124800,1
CpnChase10,0,1,0,2,1576213200,1576213200,1
KNBeaArthur,0,1,0,44,1605330000,1605330000,1
Cut_Off_One_Head,0,1,0,23,1595649600,1595649600,1
newuser797,0,1,0,3,1596859200,1596859200,1
bugginout23,0,1,0,2,1563595200,1563595200,1
waffles_like_an_iron,0,1,0,12,1593057600,1593057600,1
SonGoku915,0,1,0,-3,1606539600,1606539600,1
JerkyWaffle,0,1,0,2,1588219200,1588219200,1
Diagon_Phoenix,1,0,20,0,1598760000,1598760000,1
SeraphsEnvy,0,1,0,-1,1576645200,1576645200,1
iatesugarray,0,1,0,2,1607058000,1607058000,1
Trainer45y,0,1,0,1,1605589200,1605589200,1
LoudMusic,0,1,0,5,1575867600,1575867600,1
Growanon,0,1,0,12,1592884800,1592884800,1
InsignificantThing,0,1,0,2,1580101200,1580101200,1
ScienceNeverLies,0,1,0,2,1603425600,1603425600,1
0vermountain,0,1,0,8,1611723600,1611723600,1
Howllikeawolf,0,1,0,3,1599019200,1599019200,1
IAintNoCowgirl,0,1,0,10,1582693200,1582693200,1
gayboyroy,0,1,0,2,1586836800,1586836800,1
fritolaids,0,1,0,0,1585454400,1585454400,1
VA2AallDay,0,1,0,1,1594267200,1594267200,1
bishop14,0,1,0,2,1601265600,1601265600,1
Jon4DayWeekUS,0,1,0,2,1568865600,1568865600,1
nutria_twiga,0,1,0,2,1582866000,1582866000,1
ShavenSkavenSavings,0,1,0,1,1577250000,1577250000,1
Warp15,0,1,0,14,1599883200,1599883200,1
TheColorblindSnail,0,1,0,-6,1607835600,1607835600,1
idonotknowwhototrust,0,1,0,96,1603512000,1603512000,1
llch3esemanll,0,1,0,1,1612069200,1612069200,1
TreyChips,0,1,0,4,1597636800,1597636800,1
Phuxus,0,1,0,0,1602993600,1602993600,1
staydizzycauseilike,0,1,0,24,1611896400,1611896400,1
EelRoll,1,0,742,0,1595995200,1595995200,1
kedoclem,0,1,0,1,1597204800,1597204800,1
TooLazyForName,0,1,0,3,1585454400,1585454400,1
ankerous,0,1,0,1,1599883200,1599883200,1
whosyadadday,0,1,0,7,1587355200,1587355200,1
RedsEats123,0,1,0,4,1552795200,1552795200,1
Gabe-57,1,0,2,0,1606712400,1606712400,1
PainfulSincere,0,1,0,2,1576472400,1576472400,1
kacknase,0,1,0,5,1571803200,1571803200,1
Travellinoz,0,1,0,1,1606626000,1606626000,1
jake354k12,0,1,0,2,1562040000,1562040000,1
SpiceForce1,0,1,0,3,1607576400,1607576400,1
Xanza,0,1,0,2,1601870400,1601870400,1
fatphotog,0,1,0,1,1579323600,1579323600,1
El_mochilero,0,1,0,1,1634788800,1634788800,1
DrBootyButtcheekz,0,1,0,1,1608526800,1608526800,1
GroovingPict,0,1,0,1,1609390800,1609390800,1
ferret_dude_13,0,1,0,1,1612414800,1612414800,1
Lopsided_Guide,0,1,0,8,1564027200,1564027200,1
CappyRicks,0,1,0,12,1598068800,1598068800,1
dejadorie,0,1,0,25,1602734400,1602734400,1
breadboy666,0,1,0,8,1577336400,1577336400,1
FloatingRevolver,0,1,0,-1,1600660800,1600660800,1
MisterRobotoe,0,1,0,1,1608872400,1608872400,1
ShadowSlayer74,0,1,0,6,1585454400,1585454400,1
Alexander_Baidtach,0,1,0,11,1592366400,1592366400,1
AndrysThorngage,0,1,0,1,1603598400,1603598400,1
CommanderKS,0,1,0,8,1597982400,1597982400,1
Givingtree310,0,1,0,2,1596340800,1596340800,1
respectfulrebel,0,1,0,1,1592366400,1592366400,1
JFizDaWiz,0,1,0,4,1591156800,1591156800,1
plasticTron,0,1,0,3,1589169600,1589169600,1
vampy_kitten666,0,1,0,7,1580014800,1580014800,1
Anarcho-Liberal,0,1,0,2,1604725200,1604725200,1
Keller42,0,1,0,1,1612155600,1612155600,1
alvvaysthere,0,1,0,7,1607058000,1607058000,1
USA2SCOT,0,1,0,2,1560916800,1560916800,1
fecaleruptions,0,1,0,6,1602734400,1602734400,1
FartRat420,0,1,0,2,1602907200,1602907200,1
doctormadra,0,1,0,1,1608699600,1608699600,1
mikenice1,0,1,0,23,1574658000,1574658000,1
chankaran,0,1,0,5,1606021200,1606021200,1
I_amnotanonion,0,1,0,18,1602043200,1602043200,1
potsandpans,0,1,0,2,1572667200,1572667200,1
Confused-Baboon,0,1,0,74,1586059200,1586059200,1
Oozerman,0,1,0,-9,1596686400,1596686400,1
imhere4science,0,1,0,8,1609131600,1609131600,1
BUFBills_AfricasTeam,0,1,0,5,1603512000,1603512000,1
DatDude343,0,1,0,1,1578373200,1578373200,1
baharnarf,1,0,62,0,1580619600,1580619600,1
jhyanasnirvana,0,1,0,3,1594958400,1594958400,1
lostheev,0,1,0,22,1600315200,1600315200,1
hereforyebeer,0,1,0,4,1574658000,1574658000,1
a_n_d_r_e_w,0,1,0,3,1546405200,1546405200,1
dontcareitsonlyreddi,0,1,0,5,1612242000,1612242000,1
mickeyaaaa,0,1,0,3,1596859200,1596859200,1
BeardsAndDragons,0,1,0,26,1589860800,1589860800,1
Eyehopeuchoke,0,1,0,298,1573966800,1573966800,1
Trippyvizionz,0,1,0,3,1573534800,1573534800,1
severus-antinous,0,1,0,0,1573102800,1573102800,1
HorizonHyperSword,0,1,0,13,1573102800,1573102800,1
TurbulentHovercraft0,0,1,0,2,1603598400,1603598400,1
elsavonschrader,0,1,0,43,1592971200,1592971200,1
HighlanderL1,0,1,0,10,1598155200,1598155200,1
Baywatch_123,0,1,0,4,1584504000,1584504000,1
R_Ukraine,1,0,62,0,1584590400,1584590400,1
sirfhartsalot,1,0,3,0,1608008400,1608008400,1
AgentFreckles,0,1,0,3,1440388800,1440388800,1
editedxi,0,1,0,1,1602648000,1602648000,1
cazwell220,0,1,0,52,1598068800,1598068800,1
Diablo_swing,0,1,0,42,1594872000,1594872000,1
StupidFuckingDick,0,1,0,23,1591675200,1591675200,1
spinyfever,0,1,0,3,1611982800,1611982800,1
wiseoldllamaman2,0,1,0,1,1610082000,1610082000,1
FlyBoyG,0,1,0,2,1585108800,1585108800,1
IchabodKane,0,1,0,22,1599105600,1599105600,1
MilitaryDogs,0,1,0,1,1606885200,1606885200,1
dong_lover,0,1,0,1,1583211600,1583211600,1
KhanFu,0,1,0,2,1594612800,1594612800,1
motoo344,0,1,0,1,1603512000,1603512000,1
mnewman19,0,1,0,8,1573534800,1573534800,1
IAmMoosekiller,0,1,0,4,1608526800,1608526800,1
WalterHenderson,0,1,0,38,1565496000,1565496000,1
kolotoure4,0,1,0,3,1605934800,1605934800,1
businesshelps,1,0,1,0,1516683600,1516683600,1
pomodoro64,0,1,0,3,1572753600,1572753600,1
killerb412,0,1,0,23,1607403600,1607403600,1
emil-anon,0,1,0,1,1577077200,1577077200,1
Both-Condition-6394,0,1,0,1,1600056000,1600056000,1
Throwaway204842848,1,0,3,0,1608699600,1608699600,1
Silent_Palpatine,0,1,0,22,1576990800,1576990800,1
MrKent,0,1,0,3,1569988800,1569988800,1
melonshunter,0,1,0,26,1574658000,1574658000,1
CoffieCayke,0,1,0,1,1604379600,1604379600,1
sexy_bethany,0,1,0,4,1583899200,1583899200,1
pawdlawk,0,1,0,3,1553918400,1553918400,1
h0ser,0,1,0,3,1599019200,1599019200,1
kingkumquat,0,1,0,1,1578978000,1578978000,1
opossum-my-possum,0,1,0,2,1587355200,1587355200,1
2001stargate,0,1,0,1,1608699600,1608699600,1
Cheeseheadman,0,1,0,34,1583557200,1583557200,1
OoMythoO,0,1,0,1,1601352000,1601352000,1
TheFoxRiverFugitive,0,1,0,8,1609304400,1609304400,1
GuidedArk,0,1,0,30,1600056000,1600056000,1
SpaceMarine_CR,0,1,0,1,1605070800,1605070800,1
mrdavidrt,0,1,0,1,1578891600,1578891600,1
gloriusking,0,1,0,4,1575435600,1575435600,1
negativethinking66,0,1,0,23,1554868800,1554868800,1
cantgrowcorn,0,1,0,1,1603512000,1603512000,1
escriba_n1,0,1,0,1,1563854400,1563854400,1
11-22-1963,0,1,0,44,1561694400,1561694400,1
jay_diggity_dog,0,1,0,3,1582606800,1582606800,1
niteFlight,0,1,0,3,1534478400,1534478400,1
A_Sad_Scientist_,0,1,0,1,1610427600,1610427600,1
Musky_X,0,1,0,11,1577163600,1577163600,1
patchworkfungi,0,1,0,2,1591761600,1591761600,1
budlightbody,0,1,0,1,1606021200,1606021200,1
ProfessorWednesday,0,1,0,3,1575262800,1575262800,1
marigoldfrank,0,1,0,23,1591329600,1591329600,1
momiji-leafs,1,0,1,0,1602043200,1602043200,1
notcherrie,0,1,0,2,1598760000,1598760000,1
Macho_Viejo,0,1,0,62,1577768400,1577768400,1
Neon_Camouflage,0,1,0,10,1608181200,1608181200,1
Fliere_Fluiter,0,1,0,6,1595217600,1595217600,1
n1chtj4n,0,1,0,3,1579064400,1579064400,1
Skullfoe,0,1,0,13,1563940800,1563940800,1
Zakael7,0,1,0,5,1583384400,1583384400,1
iceman22frost,0,1,0,1,1557288000,1557288000,1
Celulite2000,0,1,0,3,1582866000,1582866000,1
Kehpyi,0,1,0,33,1604379600,1604379600,1
magisternemo,0,1,0,1,1609477200,1609477200,1
JackThomasYost,0,1,0,1,1584158400,1584158400,1
GrzegorzusLudi,0,1,0,2,1606885200,1606885200,1
caplel19,0,1,0,7,1607749200,1607749200,1
Cardiganlamp,0,1,0,2,1603684800,1603684800,1
R_F_Omega,0,1,0,6,1611810000,1611810000,1
caspaz,0,1,0,5,1607144400,1607144400,1
aBeeSeeOneTwoThree,0,1,0,-2,1573362000,1573362000,1
TravelSizedBlonde,0,1,0,1,1574398800,1574398800,1
mrkramer1990,0,1,0,28,1565150400,1565150400,1
Various-Commission-5,0,1,0,1,1606798800,1606798800,1
Im_A_Decoy,0,1,0,2,1567569600,1567569600,1
CuttlefishKing,0,1,0,7,1579064400,1579064400,1
Icarusisminenow,0,1,0,4,1573448400,1573448400,1
Tomoudon,1,0,10,0,1601524800,1601524800,1
BanquetDinner,0,1,0,3,1603512000,1603512000,1
JohnGilbonny,0,1,0,1,1611810000,1611810000,1
sparklyslothsnail,1,0,40,0,1594008000,1594008000,1
JokarAkaFatum,0,1,0,1,1601870400,1601870400,1
demonsauce666,0,1,0,5,1582779600,1582779600,1
Generic_name_no1,0,1,0,1,1611982800,1611982800,1
pookage,0,1,0,24,1606626000,1606626000,1
NaCo2y,0,1,0,-1,1606626000,1606626000,1
Skvora,0,1,0,-4,1608786000,1608786000,1
merkopolo,1,0,1,0,1574658000,1574658000,1
salmon-of-the-sky,0,1,0,1,1573621200,1573621200,1
ProudPlatinean,0,1,0,5,1607576400,1607576400,1
IvanOmeara,0,1,0,29,1578718800,1578718800,1
sjmulkerin,0,1,0,7,1585195200,1585195200,1
valentincsgo,0,1,0,2,1561348800,1561348800,1
Mitra_Divinorum,0,1,0,3,1603339200,1603339200,1
SafeSalad,0,1,0,2,1593662400,1593662400,1
RaidRover,0,1,0,5,1602475200,1602475200,1
mayneffs,0,1,0,1,1603512000,1603512000,1
NokturnaN7,0,1,0,29,1582606800,1582606800,1
Lynxbro,0,1,0,6,1564459200,1564459200,1
Alex_Porter_Bridges,0,1,0,2,1577854800,1577854800,1
RPBSVC,0,1,0,2,1559275200,1559275200,1
shaggy99,0,1,0,1,1598414400,1598414400,1
timemachinedreamin,0,1,0,17,1581742800,1581742800,1
PillowsSleepTonight,0,1,0,11,1582693200,1582693200,1
sapphicromantic,0,1,0,71,1594785600,1594785600,1
bellyofpug,0,1,0,-5,1602734400,1602734400,1
NoodlesMCGees,0,1,0,16,1600228800,1600228800,1
Rosenblattca,0,1,0,5,1602820800,1602820800,1
luminodaemon,0,1,0,4,1575435600,1575435600,1
AllEyezOnMe1256,0,1,0,1,1585454400,1585454400,1
warmrhombus,1,0,6,0,1571371200,1571371200,1
NameOf_A_Guy,1,0,0,0,1577336400,1577336400,1
Draulik,0,1,0,8,1599105600,1599105600,1
Spitzly,0,1,0,-5,1556078400,1556078400,1
Stormpax,0,1,0,45,1607576400,1607576400,1
tftDatElfs,0,1,0,1,1600488000,1600488000,1
ProfessorBongwater,0,1,0,2,1596254400,1596254400,1
Accomplished-Fruit33,0,1,0,-12,1598673600,1598673600,1
Lucky-leader,0,1,0,6,1605502800,1605502800,1
dvvvvvvvvvvd,0,1,0,3,1612069200,1612069200,1
8eightball8,0,1,0,18,1608181200,1608181200,1
flamegrove,0,1,0,7,1604984400,1604984400,1
Ninjavitis_,0,1,0,0,1571544000,1571544000,1
haveaplan602,0,1,0,3,1604379600,1604379600,1
Svalor007,0,1,0,1,1585454400,1585454400,1
thapinksock,0,1,0,1,1588392000,1588392000,1
it_always_rains_22,0,1,0,2,1598846400,1598846400,1
t3m3r1t4,0,1,0,1,1567828800,1567828800,1
Thefocker,0,1,0,6,1603512000,1603512000,1
jeanbaptistegrenouil,1,0,49,0,1605416400,1605416400,1
iwasbannedfromapoc,0,1,0,-34,1569384000,1569384000,1
pilclo,0,1,0,8,1609390800,1609390800,1
Bobby-Vinson,0,1,0,1,1595217600,1595217600,1
Sissinou,0,1,0,0,1606971600,1606971600,1
cowhill,0,1,0,1,1591329600,1591329600,1
onlythebulls13,0,1,0,1,1573275600,1573275600,1
Seydaigato,0,1,0,4,1563940800,1563940800,1
LindseyIsBored,0,1,0,4,1603512000,1603512000,1
Drowning_in_Plastic,0,1,0,1,1608526800,1608526800,1
Stalinwolf,0,1,0,1,1608872400,1608872400,1
hi_welcome2chilis,0,1,0,0,1576818000,1576818000,1
lady__jane,0,1,0,70,1578891600,1578891600,1
Amazed_Alloy,0,1,0,1,1585454400,1585454400,1
blakejeiler,0,1,0,3,1594612800,1594612800,1
easy_e628,0,1,0,1,1606626000,1606626000,1
Safebrowse,0,1,0,3,1583899200,1583899200,1
Demabolik,0,1,0,9,1572235200,1572235200,1
ItsOnlyDrugsM8,0,1,0,1,1611982800,1611982800,1
youth-is-fleeting,0,1,0,1,1584158400,1584158400,1
Covid19KilledEpstein,0,1,0,6,1612155600,1612155600,1
ACaffeinatedWandress,0,1,0,1,1584244800,1584244800,1
BlueberryNagel,0,1,0,3,1605502800,1605502800,1
Sloanosaurus-Nick,0,1,0,26,1551848400,1551848400,1
favoritesmacdui,0,1,0,3,1557028800,1557028800,1
The_Groovy_Boomstick,0,1,0,16,1601352000,1601352000,1
toberlone87,0,1,0,8,1603512000,1603512000,1
mariaozawa2,0,1,0,13,1575176400,1575176400,1
Trailer_Park_Jihad,0,1,0,4,1605934800,1605934800,1
Eledridan,0,1,0,4,1606626000,1606626000,1
Hubertoi,0,1,0,1,1604466000,1604466000,1
Yoshimitsu-MKII,0,1,0,-9,1582606800,1582606800,1
M_D_N,0,1,0,35,1600056000,1600056000,1
pufcj,0,1,0,2,1571544000,1571544000,1
UnimportantAltNOlook,0,1,0,54,1571112000,1571112000,1
Mogisbro,0,1,0,41,1578891600,1578891600,1
IngoTheGreat,0,1,0,1,1603771200,1603771200,1
bfmason76,0,1,0,1,1603598400,1603598400,1
Shisa2020,0,1,0,10,1606712400,1606712400,1
real6ofClubs,0,1,0,6,1597982400,1597982400,1
bobthebuilder090909,0,1,0,11,1583726400,1583726400,1
Letumstrike,0,1,0,9,1607662800,1607662800,1
Grey___Goo_MH,0,1,0,3,1603512000,1603512000,1
GulfChippy,0,1,0,4,1560657600,1560657600,1
HeroboT,0,1,0,2,1576558800,1576558800,1
remote_production,0,1,0,5,1608699600,1608699600,1
chialio,0,1,0,6,1554350400,1554350400,1
WhatinTardnation,0,1,0,36,1604030400,1604030400,1
Capable_Inspector,0,1,0,2,1584763200,1584763200,1
lizaislame,1,0,347,0,1606712400,1606712400,1
AntiHyperbolic,0,1,0,12,1578891600,1578891600,1
crazzedcat,0,1,0,5,1575349200,1575349200,1
13thstepinc,0,1,0,-4,1606539600,1606539600,1
Ardenovic,1,0,22,0,1570766400,1570766400,1
goedegeit,0,1,0,1,1598846400,1598846400,1
420Jonz,0,1,0,2,1589083200,1589083200,1
Superman0379,1,0,1,0,1579669200,1579669200,1
TSJR_,0,1,0,2,1578891600,1578891600,1
laybach,0,1,0,5,1607144400,1607144400,1
cchu1,0,1,0,14,1562385600,1562385600,1
Taylor_Shwifty,1,0,82,0,1599624000,1599624000,1
HoneyCrispWarrior,0,1,0,2,1572843600,1572843600,1
illegitimate_Raccoon,0,1,0,1,1607922000,1607922000,1
fuoicu812,0,1,0,1,1603512000,1603512000,1
animethrowaway4404,0,1,0,1,1578373200,1578373200,1
Luge1112,0,1,0,1,1608267600,1608267600,1
robertbongwater,0,1,0,2,1581915600,1581915600,1
jrgman42,0,1,0,10,1611896400,1611896400,1
RustyGuns,0,1,0,3,1584072000,1584072000,1
Zech08,0,1,0,45,1600660800,1600660800,1
rosco611,1,0,9,0,1570852800,1570852800,1
baconsane,0,1,0,6,1599969600,1599969600,1
rogersp188,0,1,0,3,1603512000,1603512000,1
JohnnyWobble,0,1,0,0,1605243600,1605243600,1
RideAWhiteSwan,0,1,0,6,1572148800,1572148800,1
archSkeptic,0,1,0,1,1593921600,1593921600,1
ChipMendelson,0,1,0,-4,1585454400,1585454400,1
ShinyUnicornKitten,0,1,0,3,1570075200,1570075200,1
whatthecrudd,0,1,0,3,1572321600,1572321600,1
Yung_Rocks,0,1,0,2,1592020800,1592020800,1
love_drives_out_fear,0,1,0,0,1583298000,1583298000,1
Narethii,0,1,0,1,1612069200,1612069200,1
feraxerom,0,1,0,3,1577336400,1577336400,1
I-choose-love,0,1,0,9,1608699600,1608699600,1
Gkkiux,0,1,0,17,1605070800,1605070800,1
cptsquirts,0,1,0,18,1604293200,1604293200,1
ayram3824,0,1,0,1,1568001600,1568001600,1
137Fine,0,1,0,11,1580619600,1580619600,1
LtLysergio,0,1,0,14,1602043200,1602043200,1
alquemir,0,1,0,11,1606971600,1606971600,1
Interngalactic5555,0,1,0,5,1606712400,1606712400,1
Conman93,0,1,0,2,1596427200,1596427200,1
enadelb,0,1,0,2,1556596800,1556596800,1
ThurnisHaleyh,0,1,0,0,1596081600,1596081600,1
mt379,0,1,0,8,1602907200,1602907200,1
Guagliodorione,0,1,0,13,1598587200,1598587200,1
iXanderr,0,1,0,1,1585454400,1585454400,1
Yashida14,0,1,0,-17,1607317200,1607317200,1
Chet_Ripley01,0,1,0,24,1611810000,1611810000,1
HeyYoLessonHereBey,0,1,0,1,1604116800,1604116800,1
tuthuu,0,1,0,10,1576386000,1576386000,1
Pie737,0,1,0,2,1603598400,1603598400,1
blazera,0,1,0,1,1612069200,1612069200,1
PrincessToadTool,0,1,0,8,1611723600,1611723600,1
tempted_temptress,0,1,0,1,1612155600,1612155600,1
TarvisioMLN,0,1,0,1,1607835600,1607835600,1
Sethodine,0,1,0,1,1555300800,1555300800,1
no_average_joe22,0,1,0,1,1587528000,1587528000,1
stopmutations,0,1,0,2,1590120000,1590120000,1
dickweed62,0,1,0,-8,1573534800,1573534800,1
Cavalier878,0,1,0,1,1608267600,1608267600,1
OmZk_bot,0,1,0,3,1563249600,1563249600,1
fingerthato,0,1,0,1,1570420800,1570420800,1
The_Wild_Slor,0,1,0,1,1576645200,1576645200,1
petedob21,0,1,0,6,1576645200,1576645200,1
scvlliver,0,1,0,9,1602129600,1602129600,1
That-Sandy-Arab,0,1,0,-6,1574658000,1574658000,1
ReadTheHandbook,0,1,0,19,1579410000,1579410000,1
LessPoetry,0,1,0,1,1602216000,1602216000,1
justamanlet,0,1,0,1,1603512000,1603512000,1
Sulissthea,0,1,0,5,1567569600,1567569600,1
Ze0123,0,1,0,5,1557892800,1557892800,1
phatpedro21,0,1,0,8,1608094800,1608094800,1
DiegoBrando1234,0,1,0,5,1588305600,1588305600,1
crmsnbleyd,0,1,0,7,1590120000,1590120000,1
Ari_Rahikkala,0,1,0,1,1561780800,1561780800,1
AlzateFilms,0,1,0,0,1599278400,1599278400,1
PoeBronn,0,1,0,39,1585886400,1585886400,1
CommunityStripper,0,1,0,13,1543381200,1543381200,1
tr4pstigma,0,1,0,1,1603339200,1603339200,1
MenstruatingMuffin,0,1,0,1,1603512000,1603512000,1
human_bean17,0,1,0,4,1606453200,1606453200,1
championsofnothing,0,1,0,22,1600747200,1600747200,1
wyatt_riot_69,1,0,78,0,1581656400,1581656400,1
Scottyboy30,0,1,0,0,1599537600,1599537600,1
DearCress9,0,1,0,2,1589947200,1589947200,1
sgst,0,1,0,12,1573102800,1573102800,1
wifebeatsme,0,1,0,2,1603598400,1603598400,1
Thesadzombie,0,1,0,2,1579150800,1579150800,1
Toastytuesdee,0,1,0,0,1581310800,1581310800,1
Adept-News,1,0,55,0,1588564800,1588564800,1
inbedwithabook,0,1,0,4,1584504000,1584504000,1
Demknowsbetter,0,1,0,1,1611982800,1611982800,1
RandyDingusKing,0,1,0,2,1608267600,1608267600,1
Garpfruit,0,1,0,4,1570680000,1570680000,1
skollieboer,0,1,0,2,1605416400,1605416400,1
Pumpkin_Eater9000,0,1,0,9,1544763600,1544763600,1
atticus713,0,1,0,2,1579237200,1579237200,1
jaupkef,0,1,0,19,1591588800,1591588800,1
HarvestProject,0,1,0,1,1579410000,1579410000,1
Psychoborg,0,1,0,15,1597032000,1597032000,1
Corroded_Filter,0,1,0,1,1602043200,1602043200,1
CatatonicFruitCup,0,1,0,2,1580274000,1580274000,1
truck149,0,1,0,65,1584763200,1584763200,1
PM_ME_UR_BUMZ,0,1,0,16,1581829200,1581829200,1
kat123411,0,1,0,7,1585886400,1585886400,1
MyAssCheeks,0,1,0,1,1606539600,1606539600,1
yoltbg,1,0,4,0,1574485200,1574485200,1
smellybluerash,0,1,0,19,1608181200,1608181200,1
VictoriaBitterPerfum,0,1,0,1,1598760000,1598760000,1
raakonfrenzi,0,1,0,29,1576472400,1576472400,1
PushAny,0,1,0,4,1608008400,1608008400,1
chbjupiter,0,1,0,-13,1592366400,1592366400,1
daughterofpotter,1,0,63,0,1593230400,1593230400,1
astrologicrat,0,1,0,96,1609304400,1609304400,1
noodleslirp,0,1,0,3,1599796800,1599796800,1
derpherp128,0,1,0,17,1594440000,1594440000,1
Dingo_NZ,0,1,0,-33,1598587200,1598587200,1
thatfloorguy,0,1,0,89,1560398400,1560398400,1
N0XDND,0,1,0,55,1598068800,1598068800,1
cullenlawton_11,0,1,0,3,1578891600,1578891600,1
djaeke,0,1,0,78,1578373200,1578373200,1
jewishman7780,0,1,0,-6,1573534800,1573534800,1
Whtwb11,0,1,0,1,1594267200,1594267200,1
sammyslug13,1,0,2,0,1557288000,1557288000,1
realedazed,0,1,0,3,1599796800,1599796800,1
imapoisson,0,1,0,2,1563854400,1563854400,1
fucker69879,0,1,0,1,1605070800,1605070800,1
WYKON,0,1,0,3,1579669200,1579669200,1
kickstand,0,1,0,2,1593748800,1593748800,1
nonamenomore,0,1,0,2,1602907200,1602907200,1
69_BABATUNDE_,1,0,1,0,1611810000,1611810000,1
Cazumarzu,0,1,0,1,1599278400,1599278400,1
parallel_synapse,0,1,0,1,1560744000,1560744000,1
Lyricalyrics,0,1,0,0,1592366400,1592366400,1
progressives4win,0,1,0,1,1607230800,1607230800,1
RageMonster---,0,1,0,5,1578718800,1578718800,1
Kinners_Dinners,0,1,0,1,1603598400,1603598400,1
Trainwrecktom38,0,1,0,1,1607835600,1607835600,1
clockwork_proxy,0,1,0,2,1624248000,1624248000,1
gooeyShroom,0,1,0,13,1592280000,1592280000,1
pegleg_1979,0,1,0,-1,1598846400,1598846400,1
Sealkyuubinaruto,0,1,0,7,1598846400,1598846400,1
scratchresistor,0,1,0,6,1600056000,1600056000,1
Rawhide_Steaksauce,0,1,0,1,1583985600,1583985600,1
TheRealPifftastic,1,0,6226,0,1602475200,1602475200,1
arolust,0,1,0,2,1487480400,1487480400,1
cPikah,1,0,65,0,1596945600,1596945600,1
maximusheals,0,1,0,2,1557806400,1557806400,1
HeroicBarret,0,1,0,1,1607403600,1607403600,1
DurinsFolk,0,1,0,43,1595044800,1595044800,1
Goldroger9,0,1,0,3,1596340800,1596340800,1
ChemicalShard,0,1,0,35,1593576000,1593576000,1
75_mg_75,0,1,0,44,1608872400,1608872400,1
guillaume21,0,1,0,1,1591848000,1591848000,1
AlwaysTiredOftenSad,0,1,0,20,1545627600,1545627600,1
justcasualdeath,0,1,0,9,1607144400,1607144400,1
PrioritySilent,0,1,0,1,1603512000,1603512000,1
SpicyL3mons,0,1,0,8,1603252800,1603252800,1
DoubtlessCar0,0,1,0,1,1618977600,1618977600,1
Mountsaintmichel,0,1,0,-7,1608526800,1608526800,1
sonic1749,0,1,0,1,1603512000,1603512000,1
FjoddeJimmy,0,1,0,4,1602820800,1602820800,1
mitchelconnell,0,1,0,1,1608613200,1608613200,1
canadianseaman,0,1,0,8,1594008000,1594008000,1
funkalunatic,1,0,26,0,1546923600,1546923600,1
spaxcow,0,1,0,1,1612328400,1612328400,1
jjarvissses,0,1,0,0,1608267600,1608267600,1
joebayfocus,0,1,0,2,1580274000,1580274000,1
howaan,0,1,0,-5,1604293200,1604293200,1
MemorableYetUnique,0,1,0,5,1587614400,1587614400,1
AMZHR,1,0,4,0,1586491200,1586491200,1
HydrooTheUnappealing,0,1,0,2,1580360400,1580360400,1
lunchvic,0,1,0,2,1588564800,1588564800,1
mikejones99501,0,1,0,2,1592107200,1592107200,1
ElvenUnicorn,0,1,0,1,1608267600,1608267600,1
commiefilth69,1,0,2,0,1550466000,1550466000,1
Kazimierz__,0,1,0,2,1612069200,1612069200,1
missfriedcalamari,0,1,0,7,1550638800,1550638800,1
IngoDearS,1,0,181,0,1576645200,1576645200,1
InLampsWeTrust,1,0,126,0,1600747200,1600747200,1
lucy-boopsy,1,0,400,0,1599537600,1599537600,1
pvnkrockjesvs,1,0,255,0,1607490000,1607490000,1
Zippyss92,0,1,0,3,1602302400,1602302400,1
HoeLeeFak,0,1,0,-1,1598760000,1598760000,1
airbornejoel,0,1,0,5,1600660800,1600660800,1
ashensolitude,0,1,0,4,1603080000,1603080000,1
screech_owl_kachina,0,1,0,6,1586836800,1586836800,1
kidgorgeous62,0,1,0,6,1588478400,1588478400,1
psyblade613,0,1,0,1,1608267600,1608267600,1
somuchdanger,1,0,64,0,1606366800,1606366800,1
fluffymuff6,0,1,0,0,1576645200,1576645200,1
pavlo_escobrah,0,1,0,2,1606021200,1606021200,1
Corynne1274,0,1,0,2,1604116800,1604116800,1
Keichavik,0,1,0,2,1591243200,1591243200,1
autumnwalk,0,1,0,5,1569556800,1569556800,1
fuuckimlate,0,1,0,1,1605934800,1605934800,1
rapter200,0,1,0,1,1603339200,1603339200,1
Vagitron9000,0,1,0,5,1595044800,1595044800,1
gorgorita32,0,1,0,6,1567656000,1567656000,1
americanaregay,1,0,1,0,1588824000,1588824000,1
Ringolian16,0,1,0,1,1599105600,1599105600,1
_GLL,0,1,0,1,1608699600,1608699600,1
DiverseNerd,0,1,0,7,1573362000,1573362000,1
Dyscordio,0,1,0,1,1572408000,1572408000,1
Cotereaux,0,1,0,2,1601611200,1601611200,1
mellowmike84,0,1,0,0,1605589200,1605589200,1
Garnardo,1,0,83,0,1582347600,1582347600,1
JennaMarblesFanClub,0,1,0,1,1614402000,1614402000,1
katmulan3216,0,1,0,1,1605934800,1605934800,1
Maxg2909,0,1,0,1,1603512000,1603512000,1
Lessiarty,0,1,0,14,1612069200,1612069200,1
monicamarie798,0,1,0,1,1563595200,1563595200,1
Nicobade,0,1,0,2,1555300800,1555300800,1
tasteee_kake,0,1,0,3,1590638400,1590638400,1
ankhang93,0,1,0,1,1609304400,1609304400,1
Sloppyjonutz,0,1,0,0,1589601600,1589601600,1
Ok-Baseball8629,1,0,508,0,1598932800,1598932800,1
BladeTam,0,1,0,28,1587614400,1587614400,1
lisbethborden,1,0,389,0,1611896400,1611896400,1
ThatYellowElephant,0,1,0,0,1590897600,1590897600,1
mintylizard,0,1,0,5,1563336000,1563336000,1
MzTwatRocket,0,1,0,1,1609736400,1609736400,1
corncorncorn9,0,1,0,3,1590033600,1590033600,1
WhiteMedican,0,1,0,1,1606280400,1606280400,1
Fryed_Squid,0,1,0,44,1588219200,1588219200,1
midnight_x_toker,0,1,0,1,1585108800,1585108800,1
pierdolenierobie,0,1,0,1,1608267600,1608267600,1
MissFrybread,0,1,0,3,1576818000,1576818000,1
Cheafy,0,1,0,-11,1584158400,1584158400,1
nightskate,0,1,0,1,1568347200,1568347200,1
coolestzark,0,1,0,4,1604293200,1604293200,1
jason_noir,0,1,0,1,1596254400,1596254400,1
FearlessIntention,0,1,0,6,1608181200,1608181200,1
OK_Mason_721,0,1,0,2,1604811600,1604811600,1
zielawolfsong,0,1,0,5,1605934800,1605934800,1
saiga_antelope,0,1,0,0,1598760000,1598760000,1
MadPinoRage,0,1,0,3,1598673600,1598673600,1
acloudintrousers,0,1,0,0,1520744400,1520744400,1
UltraMegaBlaster,0,1,0,7,1607922000,1607922000,1
fucksnitchesbitches,0,1,0,1,1600660800,1600660800,1
galiopower,0,1,0,1,1583726400,1583726400,1
Strange_Airships,0,1,0,4,1592712000,1592712000,1
imbakinacake,0,1,0,1,1601352000,1601352000,1
phillygebile,0,1,0,18,1558238400,1558238400,1
thebigyeet420,0,1,0,15,1604552400,1604552400,1
jutruth,0,1,0,24,1601438400,1601438400,1
huntynomics,0,1,0,23,1602648000,1602648000,1
AceMoriarty,0,1,0,2,1608958800,1608958800,1
obuto4,1,0,39,0,1576990800,1576990800,1
babyd42,0,1,0,1,1552276800,1552276800,1
MasterGrid,0,1,0,-6,1597377600,1597377600,1
Skateblades,0,1,0,1,1606021200,1606021200,1
SuccMyHorseCock,0,1,0,1,1603684800,1603684800,1
TutOrHere,0,1,0,1,1605589200,1605589200,1
ChickolasCage,0,1,0,2,1603684800,1603684800,1
Humphking,0,1,0,18,1605762000,1605762000,1
thomhaverphord,0,1,0,4,1563249600,1563249600,1
mindbleach,0,1,0,6,1551070800,1551070800,1
Smoothie928,0,1,0,2,1572408000,1572408000,1
thelynch07,0,1,0,1,1608872400,1608872400,1
yungyienie,0,1,0,19,1579755600,1579755600,1
pgriss,0,1,0,2,1573534800,1573534800,1
matt05891,0,1,0,1,1599969600,1599969600,1
kmavapc,0,1,0,7,1608786000,1608786000,1
Gatfro30,0,1,0,1,1589947200,1589947200,1
kingtheo007,0,1,0,2,1608613200,1608613200,1
Hammerdin10,0,1,0,3,1606712400,1606712400,1
xallaboutx,0,1,0,7,1583726400,1583726400,1
libtard_idiot,0,1,0,11,1593144000,1593144000,1
neat-NEAT,0,1,0,2,1576904400,1576904400,1
bt812,0,1,0,0,1611982800,1611982800,1
father2shanes,0,1,0,1,1606626000,1606626000,1
mj_bee,0,1,0,43,1576645200,1576645200,1
claytonjaym,0,1,0,1,1597291200,1597291200,1
heymanmaniac,0,1,0,1,1605502800,1605502800,1
HartNature,0,1,0,4,1564804800,1564804800,1
angryvitsch,0,1,0,1,1605243600,1605243600,1
SH4TPOSTER,0,1,0,-13,1602734400,1602734400,1
Khulod,0,1,0,3,1589947200,1589947200,1
joni0helper,0,1,0,9,1580187600,1580187600,1
Euphoric_Bus,0,1,0,6,1590033600,1590033600,1
StuffWotIDid,0,1,0,2,1584763200,1584763200,1
chewssoap,1,0,7,0,1590811200,1590811200,1
TDhotpants,0,1,0,13,1606021200,1606021200,1
Whitefang-450,0,1,0,8,1598846400,1598846400,1
Broly2022,0,1,0,1,1603512000,1603512000,1
mychalkendricks53,0,1,0,2,1580014800,1580014800,1
carlwinslow408,0,1,0,1,1573275600,1573275600,1
wellpaidscientist,0,1,0,1,1611982800,1611982800,1
oE_72eB__3,1,0,1,0,1455685200,1455685200,1
votedog,0,1,0,6,1608267600,1608267600,1
Neither-Sprinkles,0,1,0,1,1606626000,1606626000,1
Byaaah,0,1,0,14,1579755600,1579755600,1
grumpybambi,0,1,0,52,1603425600,1603425600,1
Shock3r69,0,1,0,5,1574658000,1574658000,1
heckinboot,0,1,0,1,1594180800,1594180800,1
AltruisticPerversion,0,1,0,4,1580101200,1580101200,1
GOD_KING_YUGI,0,1,0,37,1586404800,1586404800,1
postparoxysmally,0,1,0,14,1561780800,1561780800,1
TunaFlapSlap,0,1,0,1,1591243200,1591243200,1
EccentricFox,0,1,0,5,1591243200,1591243200,1
48shadesofgrey,0,1,0,1,1593662400,1593662400,1
Privateer2368,0,1,0,1,1598846400,1598846400,1
Tanzious03,0,1,0,4,1605934800,1605934800,1
RedPlaidO,0,1,0,112,1605934800,1605934800,1
Tylermcd93,0,1,0,1,1560916800,1560916800,1
StrangeYam5,0,1,0,5,1604379600,1604379600,1
wishtomakegains,0,1,0,1,1568088000,1568088000,1
RTKMessy,0,1,0,1,1598760000,1598760000,1
beso1,0,1,0,1,1597291200,1597291200,1
Skygazer24,0,1,0,12,1593489600,1593489600,1
sluttypolitician,0,1,0,61,1573448400,1573448400,1
kyousanjouri,0,1,0,2,1606021200,1606021200,1
psicokroket,0,1,0,2,1608526800,1608526800,1
leon203,0,1,0,2,1575349200,1575349200,1
TheLesserWombat,0,1,0,6,1605243600,1605243600,1
A_Achilles,0,1,0,1,1606626000,1606626000,1
Feta__Cheese,0,1,0,1,1603166400,1603166400,1
eeelaw,1,0,8,0,1583726400,1583726400,1
brokedumbcunt,0,1,0,5,1573189200,1573189200,1
bcbrown19,0,1,0,6,1598760000,1598760000,1
shy247,0,1,0,21,1608526800,1608526800,1
Fugeh,0,1,0,5,1606194000,1606194000,1
ihateaccountnames24,0,1,0,27,1586404800,1586404800,1
Fiosaiche3-14,0,1,0,2,1594267200,1594267200,1
d6410,0,1,0,1,1603512000,1603512000,1
billyfreddy,0,1,0,2,1579410000,1579410000,1
Whiskey_rabbit2390,0,1,0,6,1602388800,1602388800,1
sawdos,0,1,0,1,1606626000,1606626000,1
15infantryparatroop,0,1,0,2,1602475200,1602475200,1
Hairy_Ambassador1586,0,1,0,1,1605934800,1605934800,1
FatChopSticks,0,1,0,1,1583470800,1583470800,1
nunezger,0,1,0,5,1572408000,1572408000,1
OkWellFuck,0,1,0,7,1551589200,1551589200,1
thatbraziliantho,0,1,0,0,1597896000,1597896000,1
queenruth,0,1,0,19,1592884800,1592884800,1
ragrok,0,1,0,1,1608872400,1608872400,1
mynumberistwentynine,0,1,0,4,1568347200,1568347200,1
FullTimeWorkIsCancer,0,1,0,6,1596168000,1596168000,1
Jas032,0,1,0,10,1577422800,1577422800,1
bloodfaerie,0,1,0,2,1512882000,1512882000,1
iR3vives,0,1,0,8,1604466000,1604466000,1
MihirP2299,0,1,0,7,1565755200,1565755200,1
steve-koda,0,1,0,32,1603598400,1603598400,1
anonymous385726495,0,1,0,1,1600056000,1600056000,1
hogwashnola,0,1,0,12,1606280400,1606280400,1
LukeTriton,0,1,0,8,1605934800,1605934800,1
klappertand,0,1,0,38,1598673600,1598673600,1
pickledtoesies,0,1,0,1,1603771200,1603771200,1
airblast42,0,1,0,6,1577941200,1577941200,1
HelalViagra,0,1,0,2,1593403200,1593403200,1
Aromatic-Ball,0,1,0,5,1587873600,1587873600,1
jknight68,0,1,0,38,1581742800,1581742800,1
acav802,1,0,18,0,1600315200,1600315200,1
AM_I_A_PERVERT,0,1,0,6,1608354000,1608354000,1
balsimcripply,0,1,0,1,1606971600,1606971600,1
RufflyHufflyPride,0,1,0,2,1608440400,1608440400,1
DafyddBreen,0,1,0,1,1579496400,1579496400,1
Send_ur_private_pics,0,1,0,66,1605589200,1605589200,1
PeterMus,0,1,0,1,1595217600,1595217600,1
slashinhobo1,0,1,0,1,1604030400,1604030400,1
Pig_of_HRE,0,1,0,3,1598587200,1598587200,1
SushiPants85,0,1,0,1,1591243200,1591243200,1
cynicalveggie,0,1,0,1,1599796800,1599796800,1
Mikielle,0,1,0,1,1603512000,1603512000,1
spAceArtiste,0,1,0,2,1608440400,1608440400,1
Dopenastywhale,0,1,0,27,1591934400,1591934400,1
WillCode4Cats,0,1,0,1,1568347200,1568347200,1
Oceanic85,0,1,0,1,1569384000,1569384000,1
SeanyLord222,0,1,0,1,1601438400,1601438400,1
fstarnes9,0,1,0,6,1578114000,1578114000,1
V0idgazer,0,1,0,1,1591329600,1591329600,1
obnoxiousstalkerfan,0,1,0,1,1606021200,1606021200,1
himbosupreme,0,1,0,14,1604466000,1604466000,1
Bigbewmistaken,1,0,0,0,1595908800,1595908800,1
lygus007,0,1,0,1,1598760000,1598760000,1
fake_sagan,0,1,0,5,1602648000,1602648000,1
AnonymousUser132,0,1,0,1,1600574400,1600574400,1
Naarfus,0,1,0,1,1572580800,1572580800,1
ironmanmatch,0,1,0,13,1582606800,1582606800,1
latinabunnyxo,0,1,0,3,1586664000,1586664000,1
nosg0,0,1,0,1,1590984000,1590984000,1
Anonymous_Stork,0,1,0,1,1603512000,1603512000,1
feelyourlines,0,1,0,29,1576040400,1576040400,1
JazzyJames33,0,1,0,0,1590465600,1590465600,1
dannylopuz,0,1,0,6,1603857600,1603857600,1
Panama-R3d,0,1,0,-2,1582779600,1582779600,1
Ophelia_Grey,0,1,0,53,1597636800,1597636800,1
torio333,0,1,0,2,1601870400,1601870400,1
Valkenhyne,0,1,0,3,1606712400,1606712400,1
h-hux,0,1,0,5,1592452800,1592452800,1
GOATflayer666,0,1,0,26,1547874000,1547874000,1
xxdibxx,0,1,0,0,1586145600,1586145600,1
6e6f6e2d62696e617279,0,1,0,7,1467691200,1467691200,1
RedPillAddict92,0,1,0,2,1586059200,1586059200,1
rottweilered,0,1,0,1,1600660800,1600660800,1
mdmalenin,0,1,0,4,1607490000,1607490000,1
RGBetrix,0,1,0,111,1607835600,1607835600,1
idiotinpowerarmor,0,1,0,210,1604293200,1604293200,1
HerpDerpCrabMan,0,1,0,44,1602216000,1602216000,1
brizey0,0,1,0,1,1603339200,1603339200,1
MobileMessage,0,1,0,21,1602907200,1602907200,1
abhorsen-clariel,0,1,0,2,1548651600,1548651600,1
GTFOONME,0,1,0,2,1605070800,1605070800,1
tomdobb,0,1,0,7,1513832400,1513832400,1
Zacmondejar,0,1,0,1,1578805200,1578805200,1
rando_97,0,1,0,9,1579410000,1579410000,1
JayBeeJB89,0,1,0,9,1607835600,1607835600,1
love_please,0,1,0,7,1568433600,1568433600,1
Hypergnostic,0,1,0,6,1545886800,1545886800,1
grig109,0,1,0,-2,1595563200,1595563200,1
xemirex,0,1,0,3,1603252800,1603252800,1
SueedBeyg,0,1,0,3,1599105600,1599105600,1
TheLastDragon2,0,1,0,1,1606885200,1606885200,1
anybodywantakiwi,0,1,0,2,1601524800,1601524800,1
TryAOLFree,0,1,0,2,1555732800,1555732800,1
FirestormCold,0,1,0,2,1608699600,1608699600,1
King2DThrone,1,0,125,0,1607576400,1607576400,1
WeAreThePast,0,1,0,1,1582174800,1582174800,1
SpliTTMark,0,1,0,3,1603512000,1603512000,1
helloimback991,1,0,10,0,1563076800,1563076800,1
PyriteLad92,0,1,0,1,1592193600,1592193600,1
lxu7,0,1,0,4,1601092800,1601092800,1
-MythicKnight-,0,1,0,4,1602907200,1602907200,1
Kquiarsh,0,1,0,64,1606712400,1606712400,1
_The_Huntsman_,0,1,0,1,1590379200,1590379200,1
SalazarsHands,0,1,0,1,1598760000,1598760000,1
machinedlens,0,1,0,4,1588046400,1588046400,1
VoltJumperCables,0,1,0,24,1590465600,1590465600,1
BassPro_Millionaire,0,1,0,-5,1550552400,1550552400,1
Kajninja13,0,1,0,0,1585454400,1585454400,1
Doubleplus_Ultra,0,1,0,133,1604725200,1604725200,1
cylelo,0,1,0,4,1572321600,1572321600,1
Initial-Duck,0,1,0,1,1581397200,1581397200,1
theroboredneck,0,1,0,2,1600488000,1600488000,1
Tetra_D_Toxin,0,1,0,1,1611982800,1611982800,1
DumpsterLegs,0,1,0,1,1602734400,1602734400,1
Bweng1s,0,1,0,1,1598673600,1598673600,1
battybatt,0,1,0,1,1604379600,1604379600,1
santiathedisco,0,1,0,7,1603252800,1603252800,1
Qix213,0,1,0,6,1609390800,1609390800,1
NudeCeleryMan,0,1,0,1,1603512000,1603512000,1
kaluxs,0,1,0,1,1572930000,1572930000,1
aikoaiko,0,1,0,5,1599019200,1599019200,1
Palindromeboy,0,1,0,1,1602216000,1602216000,1
blackaudis8,0,1,0,217,1607317200,1607317200,1
jimbob320,0,1,0,3,1590379200,1590379200,1
takool,0,1,0,1,1606626000,1606626000,1
6times666,0,1,0,2,1606366800,1606366800,1
Conmanthegreat,0,1,0,11,1580706000,1580706000,1
CDeloresBl,0,1,0,5,1569988800,1569988800,1
Raenman,0,1,0,0,1580619600,1580619600,1
billiamwerk,0,1,0,1,1599364800,1599364800,1
Superhighme420,0,1,0,1,1608267600,1608267600,1
Issa0721,0,1,0,1,1580619600,1580619600,1
MvmgUQBd,0,1,0,1,1566964800,1566964800,1
poodlescaboodles,0,1,0,14,1584763200,1584763200,1
leftyluciii,0,1,0,0,1601956800,1601956800,1
Iam_nameless,0,1,0,1,1589688000,1589688000,1
gimmesummuneh,0,1,0,1,1600660800,1600660800,1
Steelracer,0,1,0,10,1591243200,1591243200,1
JamesVeras,0,1,0,1,1567396800,1567396800,1
Unhelpfulhamster,0,1,0,1,1549515600,1549515600,1
BurningScion,1,0,436,0,1572408000,1572408000,1
TheWiseTortuga,0,1,0,1,1562904000,1562904000,1
sneeria,0,1,0,3,1579669200,1579669200,1
justokre,0,1,0,1,1595304000,1595304000,1
atomfenrir,0,1,0,3,1608872400,1608872400,1
astrogemini,0,1,0,36,1584244800,1584244800,1
FrigoCoder,0,1,0,15,1592280000,1592280000,1
Sovietkitten,0,1,0,3,1589428800,1589428800,1
CatFanTheMan,0,1,0,1,1585368000,1585368000,1
MurderSpoon1132,0,1,0,2,1607058000,1607058000,1
caligulaismad,0,1,0,1,1606626000,1606626000,1
PinbaIl,0,1,0,1,1590552000,1590552000,1
420incognito,0,1,0,1,1593316800,1593316800,1
ScarletWonders,1,0,26,0,1576731600,1576731600,1
Comprehensive_Bat_74,0,1,0,1,1599796800,1599796800,1
sarakeera,0,1,0,12,1576990800,1576990800,1
meat_eating_midwife,0,1,0,3,1555992000,1555992000,1
hsurjo,0,1,0,1,1602302400,1602302400,1
ken28e,0,1,0,1,1577336400,1577336400,1
psychosikh,0,1,0,7,1599451200,1599451200,1
FreshStink,0,1,0,9,1605502800,1605502800,1
Spaminator2000,1,0,155,0,1586750400,1586750400,1
sixfootpartysub,0,1,0,13,1605502800,1605502800,1
a_dry_banana,0,1,0,1,1571544000,1571544000,1
smellthecolor9,0,1,0,1,1570248000,1570248000,1
dirtfather,0,1,0,8,1578632400,1578632400,1
StrangeBirdFlying,0,1,0,20,1561780800,1561780800,1
theelanad1,0,1,0,5,1548046800,1548046800,1
ErianTomor,0,1,0,165,1602043200,1602043200,1
StLaura,0,1,0,8,1606885200,1606885200,1
dfrxnlimited,1,0,92,0,1602475200,1602475200,1
Whitmans,0,1,0,2,1608094800,1608094800,1
llgirl99,0,1,0,3,1607662800,1607662800,1
kysmith1306,0,1,0,1,1591329600,1591329600,1
TEOLAYKI,0,1,0,-4,1553140800,1553140800,1
Skydog87,0,1,0,7,1604898000,1604898000,1
rblur0001,0,1,0,18,1605416400,1605416400,1
luckybrat,0,1,0,1,1599019200,1599019200,1
eon0,0,1,0,5,1561348800,1561348800,1
MistukoSan,0,1,0,1,1608613200,1608613200,1
The_Moorish_Guard,0,1,0,4,1609045200,1609045200,1
nosleepincrooklyn,0,1,0,1,1608526800,1608526800,1
Crankywhentiredd,0,1,0,5,1603425600,1603425600,1
sexykropotkin4u2nv,0,1,0,23,1594180800,1594180800,1
MrScaryEgg,0,1,0,20,1589860800,1589860800,1
SatanKardashian,0,1,0,1,1589515200,1589515200,1
Bojacketamine,0,1,0,3,1608872400,1608872400,1
Artistic-Question,0,1,0,1,1593230400,1593230400,1
Background_Bit_3505,0,1,0,-3,1607403600,1607403600,1
TrustMeItsNormal,0,1,0,4,1576299600,1576299600,1
jebroni583,0,1,0,5,1601956800,1601956800,1
Q_van_der_Stuff,1,0,7,0,1606626000,1606626000,1
NotAWasteOfMyTime,0,1,0,2,1393304400,1393304400,1
crj3012,0,1,0,1,1568865600,1568865600,1
EndOfQualm,0,1,0,-3,1557633600,1557633600,1
msynowicz,0,1,0,18,1597204800,1597204800,1
punchingnazis247,1,0,1,0,1550552400,1550552400,1
brianbezn,0,1,0,3,1593835200,1593835200,1
PlayerNate,0,1,0,1,1605848400,1605848400,1
alchowhore,0,1,0,2,1608267600,1608267600,1
lefty-loosy,0,1,0,5,1568952000,1568952000,1
Awesomeguy5507,0,1,0,1,1605675600,1605675600,1
SirDigbyCeasar,0,1,0,294,1582002000,1582002000,1
froggythefrankman,0,1,0,1,1593921600,1593921600,1
kieronj6241,0,1,0,13,1600056000,1600056000,1
NouberNou,0,1,0,3,1603512000,1603512000,1
HorseLikeAPissRace,1,0,211,0,1608872400,1608872400,1
sticksnstonesluv,0,1,0,6,1580878800,1580878800,1
Facehammer,0,1,0,10,1572843600,1572843600,1
SweetEmmalineBaDaBa,0,1,0,3,1598155200,1598155200,1
engineerinasweater,0,1,0,4,1583470800,1583470800,1
ddsoyka,0,1,0,3,1596254400,1596254400,1
hinowisaybye,0,1,0,4,1579755600,1579755600,1
IVotedDonaldTrump,1,0,0,0,1606366800,1606366800,1
panic_always,0,1,0,7,1591243200,1591243200,1
gaylot_trant,0,1,0,6,1609390800,1609390800,1
Katow-joismycousin,0,1,0,2,1582520400,1582520400,1
Deathbysnusnubooboo,0,1,0,35,1611896400,1611896400,1
hurrem-hutan,0,1,0,2,1599796800,1599796800,1
Arkhonist,0,1,0,7,1573448400,1573448400,1
piedrift,0,1,0,11,1605589200,1605589200,1
Frousteleous,0,1,0,8,1572235200,1572235200,1
angry_italian,0,1,0,-9,1612069200,1612069200,1
dropyopanties,0,1,0,1,1612155600,1612155600,1
Tell_me__,0,1,0,3,1596254400,1596254400,1
kirbbabble,0,1,0,10,1602216000,1602216000,1
_____---_-_-_-,0,1,0,5,1603512000,1603512000,1
WW4veteran,0,1,0,1,1566619200,1566619200,1
Dystopiq,0,1,0,1,1600833600,1600833600,1
Fake_Math,0,1,0,2,1608526800,1608526800,1
notyouraveragefag,0,1,0,-1,1611982800,1611982800,1
PringlesDuckFace,0,1,0,2,1570680000,1570680000,1
LeftTurn836,0,1,0,2,1599624000,1599624000,1
RestingBitchPhase,0,1,0,2,1566792000,1566792000,1
BigsmileAsHappy222,0,1,0,1,1563508800,1563508800,1
_skeglingur_,0,1,0,3,1602475200,1602475200,1
McCarty898,0,1,0,1,1589947200,1589947200,1
VersaceSamurai,0,1,0,2,1608267600,1608267600,1
fauxfidelity,0,1,0,6,1602129600,1602129600,1
ThrowAway12344444445,0,1,0,1,1598846400,1598846400,1
imenotu,0,1,0,5,1601956800,1601956800,1
ashtrominer,0,1,0,6,1602043200,1602043200,1
draxmax,0,1,0,30,1593057600,1593057600,1
MethamphetamineMan,0,1,0,-9,1573016400,1573016400,1
uncannedasparagus,0,1,0,38,1579928400,1579928400,1
vom513,0,1,0,6,1577941200,1577941200,1
remc0,0,1,0,2,1606626000,1606626000,1
inception2010,0,1,0,4,1595217600,1595217600,1
CousinVladimir,0,1,0,40,1567137600,1567137600,1
SimpleGazelle,0,1,0,1,1634875200,1634875200,1
omegachild,0,1,0,1,1569816000,1569816000,1
picklesncrackers,1,0,8,0,1578459600,1578459600,1
candouss,0,1,0,1,1606885200,1606885200,1
Caterpillar_Budget,0,1,0,5,1595822400,1595822400,1
risheeb1002,0,1,0,1,1575262800,1575262800,1
RetartidMunkee,1,0,8,0,1597464000,1597464000,1
MixxMaster,0,1,0,3,1606280400,1606280400,1
Snarklord,0,1,0,15,1572235200,1572235200,1
phasexero,0,1,0,1,1605589200,1605589200,1
thegreatestajax,0,1,0,1,1611982800,1611982800,1
midgelmo,0,1,0,3,1606798800,1606798800,1
Dontneedweed,0,1,0,6,1599451200,1599451200,1
illuyanka,0,1,0,37,1577854800,1577854800,1
PumpkinGrinder,0,1,0,1,1576645200,1576645200,1
Comando173023,0,1,0,1,1605589200,1605589200,1
Poppin_Fresh_Bro,0,1,0,1,1605589200,1605589200,1
Tholor463,0,1,0,1,1597982400,1597982400,1
Eeeeels,0,1,0,1,1566878400,1566878400,1
Zxifer,0,1,0,27,1560398400,1560398400,1
Mike_Not_Michael,0,1,0,1,1605589200,1605589200,1
blazerback13,0,1,0,12,1604552400,1604552400,1
Complete_Fix2563,0,1,0,1,1609045200,1609045200,1
karatekidhunter,0,1,0,2,1597118400,1597118400,1
Scipio11,0,1,0,104,1575349200,1575349200,1
Shakespeare314,0,1,0,9,1583298000,1583298000,1
Turd32,0,1,0,1,1550552400,1550552400,1
shad-ie,0,1,0,22,1576126800,1576126800,1
pokemonandpot,0,1,0,4,1601870400,1601870400,1
Hevymettle,0,1,0,1,1606626000,1606626000,1
earthwormjim91,0,1,0,3,1598068800,1598068800,1
Cyanofrost,0,1,0,3,1591243200,1591243200,1
davep123456789,0,1,0,10,1580533200,1580533200,1
senavi,0,1,0,3,1605589200,1605589200,1
canvaswolf,0,1,0,17,1576299600,1576299600,1
jagerade,1,0,49,0,1569470400,1569470400,1
counterweightkid,0,1,0,1,1603512000,1603512000,1
Astaroth_lives,0,1,0,1,1598068800,1598068800,1
raindyrps,0,1,0,25,1602475200,1602475200,1
perthguppy,0,1,0,1,1605589200,1605589200,1
orient-tec,1,0,0,0,1547269200,1547269200,1
historicartist,0,1,0,25,1572321600,1572321600,1
Stuffenfluff,0,1,0,5,1608613200,1608613200,1
BeckahTee,0,1,0,7,1599710400,1599710400,1
plantanosuprnova,0,1,0,2,1585454400,1585454400,1
TOWF-52200,0,1,0,3,1593835200,1593835200,1
powerporker69,0,1,0,2,1608267600,1608267600,1
DWMoose83,0,1,0,3,1603512000,1603512000,1
BlagulonDelta,0,1,0,30,1607922000,1607922000,1
ScreamingTablecloth,0,1,0,5,1598414400,1598414400,1
PhthaloVonLangborste,0,1,0,4,1604725200,1604725200,1
BroccRL,0,1,0,23,1609304400,1609304400,1
p0t0o0o0o0o,0,1,0,1,1608526800,1608526800,1
Kaiqer,0,1,0,1,1612069200,1612069200,1
LABBreton,0,1,0,1,1598328000,1598328000,1
Brandon0032,0,1,0,4,1603252800,1603252800,1
yaoi_love_yaoi_life,0,1,0,2,1608008400,1608008400,1
Uncle_Cobes,0,1,0,1,1609218000,1609218000,1
Claim_Serious,0,1,0,4,1606539600,1606539600,1
moonwasted,0,1,0,5,1603944000,1603944000,1
vonmolotov,0,1,0,0,1611637200,1611637200,1
TortiousTroll,0,1,0,9,1571803200,1571803200,1
spermface,0,1,0,1,1602993600,1602993600,1
ILieAboutBiology,0,1,0,5,1600833600,1600833600,1
Isawa_Chuckles,0,1,0,1,1593748800,1593748800,1
Raizelmaxx,0,1,0,1,1575349200,1575349200,1
IntrovertSociallyAnx,1,0,39,0,1588996800,1588996800,1
JawShoeWaah,0,1,0,1,1605589200,1605589200,1
cloudy_raccoon,0,1,0,3,1608008400,1608008400,1
cyllibi,0,1,0,-1,1564027200,1564027200,1
PrettyFlyForAHifi,0,1,0,1,1539835200,1539835200,1
clexkate,0,1,0,3,1586318400,1586318400,1
darkroomknight,0,1,0,1,1606021200,1606021200,1
thecooliestone,0,1,0,3,1603512000,1603512000,1
TheMusesMagic,0,1,0,30,1576645200,1576645200,1
lonelylonersolo,0,1,0,5,1600660800,1600660800,1
iacubus3,0,1,0,3,1563508800,1563508800,1
aventador_7,1,0,90,0,1603771200,1603771200,1
thirdcoastskibum,1,0,13,0,1564286400,1564286400,1
Teddyglogan,0,1,0,3,1604116800,1604116800,1
pmn310,0,1,0,2,1563940800,1563940800,1
thebeandogg,0,1,0,1,1606453200,1606453200,1
Shadlezz07,0,1,0,2,1602129600,1602129600,1
butterbewbs,0,1,0,8,1607403600,1607403600,1
CrimsonSpoon,0,1,0,5,1576126800,1576126800,1
theRealAverageHuman,0,1,0,1,1606539600,1606539600,1
radredinbed,0,1,0,16,1556683200,1556683200,1
GodWantedUsToBeLit,0,1,0,-4,1598760000,1598760000,1
Gathdar21,0,1,0,1,1599796800,1599796800,1
Strech_Marks,0,1,0,1,1605589200,1605589200,1
firemyth,0,1,0,5,1603512000,1603512000,1
gmroybal,0,1,0,1,1609390800,1609390800,1
icantthinks,0,1,0,-2,1579669200,1579669200,1
laydown_staydown,0,1,0,11,1588996800,1588996800,1
BaffledBazaar,0,1,0,1,1598673600,1598673600,1
Dednotslippin,0,1,0,28,1595131200,1595131200,1
peteteat,0,1,0,3,1581915600,1581915600,1
spookykreep,0,1,0,1,1595995200,1595995200,1
worldrallyblue,0,1,0,2,1600833600,1600833600,1
Abatteredcrate,0,1,0,4,1581310800,1581310800,1
No-Breakfast-8422,0,1,0,1,1614661200,1614661200,1
BabybearPrincess,0,1,0,1,1581570000,1581570000,1
magfrank112,0,1,0,13,1563768000,1563768000,1
Ok_Forever8375,0,1,0,3,1611982800,1611982800,1
Me_and_myCorncob,0,1,0,2,1589860800,1589860800,1
2210-2211,0,1,0,3,1598500800,1598500800,1
Geiser147,0,1,0,1,1602216000,1602216000,1
UnknownAbstractOne,0,1,0,1,1609218000,1609218000,1
HereToBeProductive,0,1,0,1,1573534800,1573534800,1
SonofaNeitzscheman,0,1,0,3,1608181200,1608181200,1
Kzzzzzzzzttt,0,1,0,3,1601092800,1601092800,1
Zyra00,0,1,0,5,1611896400,1611896400,1
Samdoggy360,0,1,0,-10,1606539600,1606539600,1
Kristoffer__1,0,1,0,2,1573534800,1573534800,1
RightHearted,0,1,0,42,1596600000,1596600000,1
Coitus_King,0,1,0,1,1583726400,1583726400,1
73810,0,1,0,3,1607835600,1607835600,1
martinw89,0,1,0,1,1594699200,1594699200,1
astro_scientician,0,1,0,1,1611810000,1611810000,1
MercilessReality,0,1,0,1,1604466000,1604466000,1
idgaFUKgandalf,0,1,0,10,1608526800,1608526800,1
Yosefpoysun,0,1,0,3,1608267600,1608267600,1
Magnolia_Wellness,0,1,0,2,1608181200,1608181200,1
derpado514,0,1,0,13,1603684800,1603684800,1
neetscrewup,0,1,0,7,1565409600,1565409600,1
Ghostofthelion,0,1,0,0,1590120000,1590120000,1
TheBlueberryPirate,0,1,0,31,1585454400,1585454400,1
terseword,0,1,0,6,1579496400,1579496400,1
NoLimitsNegus,0,1,0,2,1599278400,1599278400,1
j-man1992,0,1,0,-1,1588392000,1588392000,1
takemeback10years,0,1,0,2,1600228800,1600228800,1
joronimo99,0,1,0,1,1591329600,1591329600,1
_johndoes,0,1,0,15,1598760000,1598760000,1
nofaprecommender,0,1,0,6,1600488000,1600488000,1
The_Taller_Jesus,0,1,0,14,1609131600,1609131600,1
Tazzeh,0,1,0,2,1582520400,1582520400,1
pm_me_photo-copiers,0,1,0,2,1602648000,1602648000,1
lemonadebiscuit,0,1,0,18,1606712400,1606712400,1
Butwinsky,0,1,0,9,1605589200,1605589200,1
gougie2,0,1,0,16,1605675600,1605675600,1
horsey_cabbage,0,1,0,-1,1608526800,1608526800,1
HumptyDumptyDoodle,0,1,0,9,1598414400,1598414400,1
Xola_RS,0,1,0,1,1601352000,1601352000,1
Jealous-Paramedic,0,1,0,1,1576990800,1576990800,1
Heckin_doin_a_reddit,1,0,26,0,1599019200,1599019200,1
plottingvengeance,0,1,0,2,1592020800,1592020800,1
ElBigBrown,0,1,0,1,1599019200,1599019200,1
combustibleduckling,0,1,0,15,1608008400,1608008400,1
blogfairy,1,0,159,0,1608354000,1608354000,1
thehaitian1234,1,0,1,0,1586491200,1586491200,1
capslocke48,0,1,0,4,1560398400,1560398400,1
Randomly_Passing_By,0,1,0,18,1598414400,1598414400,1
The-Cynical-One,0,1,0,10,1571112000,1571112000,1
themonsterinquestion,0,1,0,38,1572494400,1572494400,1
Anarchissed,0,1,0,24,1598587200,1598587200,1
NewtTheProl,0,1,0,55,1567224000,1567224000,1
NightWeaver64,0,1,0,11,1572667200,1572667200,1
tyrannosauruscassie,0,1,0,2,1598932800,1598932800,1
CrazyCoKids,0,1,0,2,1577336400,1577336400,1
irespectnoneofyou,0,1,0,10,1601265600,1601265600,1
Reaganson,0,1,0,-1,1609304400,1609304400,1
Fenla,0,1,0,1,1606885200,1606885200,1
Ihfsa,0,1,0,5,1602820800,1602820800,1
vasia891,0,1,0,15,1589515200,1589515200,1
LoadandGlow,0,1,0,1,1568260800,1568260800,1
Cold-Coyote-8088,0,1,0,1,1600833600,1600833600,1
Threggar,0,1,0,5,1572235200,1572235200,1
mocaaaaaaaa,0,1,0,2,1601352000,1601352000,1
Bixotron,0,1,0,1,1591329600,1591329600,1
johntheduncan,1,0,7,0,1608699600,1608699600,1
Solipsisticurge,0,1,0,1,1570766400,1570766400,1
minahmyu,0,1,0,1,1603512000,1603512000,1
srybuddygottathrow,0,1,0,2,1608354000,1608354000,1
rainymorningblue,0,1,0,71,1597464000,1597464000,1
I-need-no-username,0,1,0,7,1574485200,1574485200,1
Z0rya,0,1,0,1,1591243200,1591243200,1
bl00ster,0,1,0,8,1550293200,1550293200,1
ExileEden,0,1,0,1,1606626000,1606626000,1
memeflood9999,0,1,0,1,1601352000,1601352000,1
Shinikage1,0,1,0,7,1607662800,1607662800,1
Latapoxy,0,1,0,13,1561089600,1561089600,1
PostBender,0,1,0,1,1605070800,1605070800,1
ornithoid,0,1,0,37,1612155600,1612155600,1
inhelldorado,0,1,0,0,1604811600,1604811600,1
thatJainaGirl,0,1,0,4,1609304400,1609304400,1
No_time_yo,0,1,0,155,1598155200,1598155200,1
Think_Void,0,1,0,21,1572667200,1572667200,1
frootloopzs,0,1,0,1,1564804800,1564804800,1
gabenator123,0,1,0,4,1568952000,1568952000,1
RevolXpsych,0,1,0,6,1583298000,1583298000,1
GnyrTheWanderer,1,0,26,0,1587960000,1587960000,1
SwaggyAdult,0,1,0,54,1598846400,1598846400,1
mchlpl1,0,1,0,10,1600920000,1600920000,1
brainrad,0,1,0,3,1577509200,1577509200,1
AlaskanTrash,0,1,0,28,1587355200,1587355200,1
MarchesaCasati,0,1,0,5,1589860800,1589860800,1
thisbabedoestoomuch,0,1,0,7,1587182400,1587182400,1
Mazon_Del,0,1,0,4,1603512000,1603512000,1
slugsies,0,1,0,2,1578459600,1578459600,1
mith_king456,0,1,0,1,1603684800,1603684800,1
Accurate_Username,0,1,0,10,1569297600,1569297600,1
Hershey2424,0,1,0,1,1579150800,1579150800,1
kaleighb1988,0,1,0,-5,1600142400,1600142400,1
hahahsjdhdh,0,1,0,3,1602216000,1602216000,1
jaykun123,0,1,0,25,1604030400,1604030400,1
WhyAreYouAllHere,0,1,0,87,1553486400,1553486400,1
jimisol,0,1,0,79,1606194000,1606194000,1
DavidArchibald34,0,1,0,31,1604984400,1604984400,1
Dacno,0,1,0,1,1611982800,1611982800,1
j_Rockk,0,1,0,1,1585540800,1585540800,1
nuclearcowgirl,0,1,0,1,1609218000,1609218000,1
Poam_Chomsky,0,1,0,8,1606366800,1606366800,1
jayen,0,1,0,9,1575867600,1575867600,1
Fresh-Meme-Merchant,0,1,0,-3,1576645200,1576645200,1
TurtleBurgle,0,1,0,3,1585454400,1585454400,1
ForRedditFun,0,1,0,3,1572753600,1572753600,1
faenairth,0,1,0,8,1611982800,1611982800,1
fermenttodothat,0,1,0,1,1602648000,1602648000,1
rh2006fan,0,1,0,8,1538280000,1538280000,1
Barrietta,0,1,0,2,1600660800,1600660800,1
awalme,1,0,68,0,1517634000,1517634000,1
RevvyJ,0,1,0,6,1603512000,1603512000,1
uncommonpanda,0,1,0,16,1584244800,1584244800,1
dadvenom,0,1,0,1,1600574400,1600574400,1
taysway1989,0,1,0,1,1610773200,1610773200,1
spoken_g,1,0,8,0,1599796800,1599796800,1
nihilist_funky_kong,0,1,0,9,1599278400,1599278400,1
enjuus,0,1,0,30,1608267600,1608267600,1
Alex_Jones_ASMR,0,1,0,27,1583470800,1583470800,1
Nottooshabbi,0,1,0,4,1606712400,1606712400,1
cowardice_,0,1,0,20,1575262800,1575262800,1
sweater_,0,1,0,1,1554696000,1554696000,1
Junior_Effective4759,1,0,1,0,1609218000,1609218000,1
Khesh,0,1,0,3,1582520400,1582520400,1
I_Came_For_Cats,0,1,0,7,1600315200,1600315200,1
StillWatersR_D,0,1,0,16,1592193600,1592193600,1
JuriJurka,0,1,0,3,1608440400,1608440400,1
MickHD,0,1,0,1,1608872400,1608872400,1
SydneyCartonLived,0,1,0,1,1608872400,1608872400,1
toytun11,0,1,0,1,1574744400,1574744400,1
anon-190895,0,1,0,1,1580187600,1580187600,1
mooooooosee,0,1,0,40,1569556800,1569556800,1
slator_hardin,0,1,0,4,1596254400,1596254400,1
ibsk8n,0,1,0,38,1583643600,1583643600,1
gingerbutnotaweasley,0,1,0,4,1575003600,1575003600,1
Dietcokeisgod,0,1,0,5,1598846400,1598846400,1
cycophuk,0,1,0,7,1576990800,1576990800,1
overpaidconsultant,0,1,0,10,1581915600,1581915600,1
GeneralHoneywine,0,1,0,22,1599364800,1599364800,1
imnotme247,0,1,0,2,1596772800,1596772800,1
SniffCheck,0,1,0,3,1603598400,1603598400,1
marma182,0,1,0,6,1586664000,1586664000,1
Life1sGoode,0,1,0,1,1603512000,1603512000,1
TroisEtDouze,1,0,48,0,1606971600,1606971600,1
meh2280,0,1,0,2,1608008400,1608008400,1
prettyboiheron,1,0,22,0,1608699600,1608699600,1
longpreamble,0,1,0,4,1566964800,1566964800,1
TheFireThisTime,1,0,1,0,1599278400,1599278400,1
23Heart23,0,1,0,1,1608613200,1608613200,1
HailBuckSeitan,0,1,0,3,1577941200,1577941200,1
RcNorth,0,1,0,12,1560657600,1560657600,1
mutamalium,0,1,0,7,1594353600,1594353600,1
Zhuinden,0,1,0,2,1592712000,1592712000,1
denvercavins,1,0,0,0,1606539600,1606539600,1
Guy_On_R_Collapse,0,1,0,3,1604116800,1604116800,1
TheNincro,0,1,0,1,1556596800,1556596800,1
jatoospry,0,1,0,0,1603080000,1603080000,1
SpecificEnergy,0,1,0,4,1560312000,1560312000,1
drag0naut26,0,1,0,5,1553140800,1553140800,1
11Letters1Name,0,1,0,0,1600142400,1600142400,1
Zboubkiller,0,1,0,1,1593921600,1593921600,1
FusiformFiddle,0,1,0,28,1592884800,1592884800,1
MarvelMan4IronMan,0,1,0,3,1603512000,1603512000,1
Starfox-sf,0,1,0,12,1612069200,1612069200,1
10_4rubberducky,0,1,0,20,1580619600,1580619600,1
zebal,1,0,11,0,1572930000,1572930000,1
PortAlexander,0,1,0,11,1578805200,1578805200,1
Denkiri_the_Catalyst,0,1,0,15,1584763200,1584763200,1
sweetstack13,0,1,0,1,1585108800,1585108800,1
DreamWeaver0,0,1,0,6,1561780800,1561780800,1
Fit_Range4001,0,1,0,1,1610773200,1610773200,1
EbriusSage,0,1,0,1,1596254400,1596254400,1
D20babin,0,1,0,40,1582002000,1582002000,1
oozyb52,0,1,0,1,1588910400,1588910400,1
shyguy247x,0,1,0,1,1589860800,1589860800,1
Dalickbread,0,1,0,1,1600228800,1600228800,1
miaou_dubois,0,1,0,4,1612155600,1612155600,1
aireads,0,1,0,9,1567656000,1567656000,1
UtePass,0,1,0,4,1578459600,1578459600,1
cherrycoloured,0,1,0,2,1591761600,1591761600,1
EuroPolice,0,1,0,58,1594699200,1594699200,1
DalinarxBlackthorn,0,1,0,274,1605589200,1605589200,1
cinderellus,0,1,0,83,1590897600,1590897600,1
inkuspinkus,0,1,0,6,1565755200,1565755200,1
Boi77727,0,1,0,-3,1589860800,1589860800,1
carlislecarl,0,1,0,4,1600833600,1600833600,1
dragunityag,0,1,0,2,1603512000,1603512000,1
AttackinTheCops,0,1,0,3,1537848000,1537848000,1
Bengerm77,0,1,0,1,1608872400,1608872400,1
pypfm,0,1,0,1,1603512000,1603512000,1
projectplat22,0,1,0,2,1560657600,1560657600,1
Kaitou21,0,1,0,1,1597118400,1597118400,1
funziesize,0,1,0,0,1603512000,1603512000,1
Nightcrawler618,0,1,0,3,1580014800,1580014800,1
creepkingdeath,0,1,0,-9,1572667200,1572667200,1
caseyweederman,0,1,0,-11,1570507200,1570507200,1
Redbaron1981,0,1,0,2,1603512000,1603512000,1
altairian,0,1,0,5,1585454400,1585454400,1
algaegreen27,0,1,0,11,1599710400,1599710400,1
brusher89,0,1,0,31,1602043200,1602043200,1
Lickalottapuss69,0,1,0,5,1585540800,1585540800,1
Several-Judgment,0,1,0,298,1592366400,1592366400,1
Farqualpatine,0,1,0,3,1605675600,1605675600,1
VibeBOT,0,1,0,1,1603512000,1603512000,1
accountnumber3,0,1,0,8,1599969600,1599969600,1
pndas,0,1,0,9,1572408000,1572408000,1
alwaller1,0,1,0,13,1588737600,1588737600,1
py_girl,0,1,0,0,1574139600,1574139600,1
Spritam,0,1,0,1,1597118400,1597118400,1
simmerbrently,0,1,0,2,1602907200,1602907200,1
nanomvrk9,0,1,0,25,1581656400,1581656400,1
UristMcDoesmath,0,1,0,1,1606280400,1606280400,1
tacomctacoson,0,1,0,5,1606021200,1606021200,1
lawlesspanda,0,1,0,4,1575954000,1575954000,1
Chelstopes,0,1,0,1,1578891600,1578891600,1
isupportrugbyhookers,0,1,0,7,1603080000,1603080000,1
Mr_Mankind_,0,1,0,3,1599451200,1599451200,1
CallMeBigPapaya,0,1,0,8,1576645200,1576645200,1
FinnishFriday,0,1,0,2,1582779600,1582779600,1
lordofboards,0,1,0,1,1513832400,1513832400,1
mchlmrqs,0,1,0,6,1564891200,1564891200,1
pbmcc88,0,1,0,3,1603598400,1603598400,1
Charbarzz,0,1,0,2,1567569600,1567569600,1
rikashiku,0,1,0,5,1603598400,1603598400,1
Stickysmoke,0,1,0,1,1603512000,1603512000,1
CitizenCue,0,1,0,3,1611982800,1611982800,1
Ginjedai,0,1,0,1,1610514000,1610514000,1
zabka14,0,1,0,1,1584590400,1584590400,1
StumblyRhubarb,0,1,0,15,1584936000,1584936000,1
marlboroprincess,0,1,0,12,1567569600,1567569600,1
icemann0,0,1,0,3,1580274000,1580274000,1
lets_eat_therich,1,0,99,0,1574398800,1574398800,1
HighDensityPolyEther,0,1,0,3,1571025600,1571025600,1
uqioretghasfdgh,0,1,0,2,1603771200,1603771200,1
spapper46853157,0,1,0,1,1592798400,1592798400,1
turbodindon1,0,1,0,1,1608872400,1608872400,1
43rd_username,0,1,0,1,1608526800,1608526800,1
JustMySecondAccount8,0,1,0,3,1591156800,1591156800,1
Key_Stress,0,1,0,19,1595217600,1595217600,1
GuiltyAffect,0,1,0,2,1575176400,1575176400,1
ingrid_bubble,0,1,0,1,1600747200,1600747200,1
imnotfeelingcreative,0,1,0,3,1611982800,1611982800,1
1994-11,0,1,0,7,1580187600,1580187600,1
Krugenn,0,1,0,1,1606539600,1606539600,1
sttevenindavalley,0,1,0,-1,1584244800,1584244800,1
flamingoplayer,0,1,0,1,1559016000,1559016000,1
simp3s,0,1,0,1,1634616000,1634616000,1
Vague_Man,0,1,0,1,1597464000,1597464000,1
Whizara,0,1,0,90,1600488000,1600488000,1
floofboops,0,1,0,3,1596772800,1596772800,1
Riverkid2257,0,1,0,85,1568952000,1568952000,1
MundaneArt6,0,1,0,2,1605762000,1605762000,1
Atrimon7,0,1,0,63,1609131600,1609131600,1
pr0nking98,0,1,0,1,1583985600,1583985600,1
twinkingoth,0,1,0,6,1609390800,1609390800,1
SecludedSandwich,0,1,0,2,1589169600,1589169600,1
miuuuuuuuuu,0,1,0,1,1611810000,1611810000,1
rjsaihtam,0,1,0,12,1588910400,1588910400,1
whitepawbunny,0,1,0,15,1574658000,1574658000,1
dude-j,0,1,0,0,1611982800,1611982800,1
DigBikDaddy,0,1,0,3,1607144400,1607144400,1
rr777,0,1,0,1,1585454400,1585454400,1
RigidSphincter,0,1,0,1,1589515200,1589515200,1
true4blue,0,1,0,3,1599019200,1599019200,1
Kdrizzle0326,0,1,0,9,1600142400,1600142400,1
Mateo-Castro,0,1,0,3,1578978000,1578978000,1
nutellawafffle,0,1,0,1,1597118400,1597118400,1
crucibelle,0,1,0,13,1554523200,1554523200,1
RubbInns,0,1,0,10,1585454400,1585454400,1
y4f4yc728,0,1,0,7,1572408000,1572408000,1
epic-stuff161,0,1,0,1,1593316800,1593316800,1
pokopkpk,1,0,35,0,1578978000,1578978000,1
ShoutingCongressTart,0,1,0,3,1576472400,1576472400,1
ahorsenamedwhimsical,0,1,0,111,1581397200,1581397200,1
gusbusdonecus,1,0,19,0,1585540800,1585540800,1
JoeTheKodiakCuddler,0,1,0,2,1608526800,1608526800,1
justagenericname1,0,1,0,7,1607922000,1607922000,1
tellybum90,0,1,0,-3,1603512000,1603512000,1
stoneduranus,0,1,0,1,1608181200,1608181200,1
unholymoses,0,1,0,5,1569816000,1569816000,1
fineanodyning,0,1,0,8,1592971200,1592971200,1
Hathalud,0,1,0,51,1599883200,1599883200,1
magmamyr,0,1,0,20,1603425600,1603425600,1
dickeykevin,0,1,0,21,1573966800,1573966800,1
PandorasBoxingGlove,0,1,0,20,1559275200,1559275200,1
l0rd6th,0,1,0,4,1601611200,1601611200,1
begonephantasms,0,1,0,11,1599364800,1599364800,1
Born-Bar,0,1,0,1,1589860800,1589860800,1
Throweayyy,0,1,0,48,1611810000,1611810000,1
SquallyFungus0,0,1,0,1,1577941200,1577941200,1
Piperismydog,0,1,0,1,1585454400,1585454400,1
stayfuingy,0,1,0,-3,1603080000,1603080000,1
nphased,0,1,0,21,1591243200,1591243200,1
MonkeyManCity,0,1,0,2,1608613200,1608613200,1
IAmTheBasicModel,0,1,0,3,1609304400,1609304400,1
TurnPunchKick,0,1,0,-1,1584244800,1584244800,1
gettinalittlecozy,0,1,0,0,1557547200,1557547200,1
ECG163,0,1,0,17,1589515200,1589515200,1
Arrowstar,0,1,0,2,1606798800,1606798800,1
spacebotanyx,0,1,0,1,1604203200,1604203200,1
gicupfunny,0,1,0,-1,1606021200,1606021200,1
tiflis,0,1,0,2,1596513600,1596513600,1
flosiraptor,1,0,739,0,1600833600,1600833600,1
0xc0ba17,0,1,0,1,1598846400,1598846400,1
Rafaeliki,0,1,0,2,1605934800,1605934800,1
Bobsledtohell,0,1,0,15,1573966800,1573966800,1
DarkeningHumour,0,1,0,1,1605157200,1605157200,1
dread_neck,0,1,0,3,1604030400,1604030400,1
bradtwo,0,1,0,2,1585454400,1585454400,1
guavagoodness,0,1,0,4,1591761600,1591761600,1
shitducks,0,1,0,1,1554350400,1554350400,1
bananahammerredoux,0,1,0,2,1605762000,1605762000,1
Darius_Kel,0,1,0,1,1577422800,1577422800,1
SufferinTree,0,1,0,45,1604466000,1604466000,1
duburitto,0,1,0,1,1592798400,1592798400,1
ColtxKiLA,0,1,0,26,1583038800,1583038800,1
victimofimperialism,0,1,0,1,1609218000,1609218000,1
Merlin22,0,1,0,1,1576645200,1576645200,1
Wamb0wneD,0,1,0,1,1606626000,1606626000,1
jeropian-fly,0,1,0,0,1577422800,1577422800,1
Lil-Roku,0,1,0,108,1564632000,1564632000,1
mybedisblue,1,0,21,0,1556856000,1556856000,1
trolololoz,0,1,0,0,1604379600,1604379600,1
w8watm8,0,1,0,3,1601611200,1601611200,1
Fluffedbread,0,1,0,35,1604466000,1604466000,1
Pregnantandroid,0,1,0,2,1601265600,1601265600,1
Antonomon,0,1,0,4,1553140800,1553140800,1
myripyro,0,1,0,24,1600228800,1600228800,1
CHBCKyle,0,1,0,14,1581915600,1581915600,1
snoboy8999,0,1,0,1,1613106000,1613106000,1
tytds,0,1,0,1,1608786000,1608786000,1
csrak,0,1,0,3,1612069200,1612069200,1
Mr__Jeff,0,1,0,3,1608613200,1608613200,1
Skates2077,0,1,0,1,1600747200,1600747200,1
hoppynhappy,0,1,0,3,1591329600,1591329600,1
BrokenGuitar30,0,1,0,1,1603512000,1603512000,1
colonii,0,1,0,2,1584849600,1584849600,1
THUMB5UP,0,1,0,1,1593921600,1593921600,1
bowtothehypnotoad,0,1,0,6,1597896000,1597896000,1
MrSplattacus,0,1,0,1,1587355200,1587355200,1
ilovepennepasta,0,1,0,1,1602216000,1602216000,1
LOSTgenetics,0,1,0,1,1579410000,1579410000,1
Oromis107,0,1,0,107,1596600000,1596600000,1
AgentOrange256,0,1,0,-5,1587182400,1587182400,1
FACEMELTER720,0,1,0,8,1611896400,1611896400,1
Sarqaah,0,1,0,24,1590033600,1590033600,1
NoremacKnom,1,0,73,0,1597636800,1597636800,1
Nolan4sheriff,0,1,0,1,1606712400,1606712400,1
Lazysaurus,1,0,6,0,1605762000,1605762000,1
gracewitch,0,1,0,5,1582779600,1582779600,1
Swampy_Smegma,0,1,0,2,1597032000,1597032000,1
Phrare,0,1,0,6,1561694400,1561694400,1
hubbabubbaliciouss,0,1,0,1,1608267600,1608267600,1
Teatoly,1,0,27,0,1605157200,1605157200,1
MassiveFloppyDong,0,1,0,8,1577941200,1577941200,1
Turbulent-Cake,0,1,0,-14,1584072000,1584072000,1
qx87,0,1,0,2,1590379200,1590379200,1
i8bonelesschicken,0,1,0,5,1608872400,1608872400,1
SpiderJerusalem42,0,1,0,1,1636520400,1636520400,1
Hickey_Maury,0,1,0,2,1608267600,1608267600,1
who_are_we_922,0,1,0,1,1608526800,1608526800,1
Master_Bateman69,0,1,0,2,1588392000,1588392000,1
Keepcreepcreepin,0,1,0,1,1604379600,1604379600,1
Vir_Liber,0,1,0,66,1595390400,1595390400,1
Bowling_Trophies,1,0,430,0,1599364800,1599364800,1
prul,0,1,0,17,1582261200,1582261200,1
FrostyDetails,0,1,0,7,1600056000,1600056000,1
AcidReignz_,0,1,0,4,1585886400,1585886400,1
slantedsc,0,1,0,13,1557979200,1557979200,1
Airfoiled,0,1,0,3,1608526800,1608526800,1
ungratefulsamurai,0,1,0,3,1593576000,1593576000,1
LibertyCityKid,0,1,0,29,1576386000,1576386000,1
Jordan2650,1,0,30,0,1590465600,1590465600,1
timely_ripcurrent,0,1,0,3,1601265600,1601265600,1
TvamandAham,0,1,0,1,1598760000,1598760000,1
Lolrip425,0,1,0,-1,1601092800,1601092800,1
Nicepire,0,1,0,1,1558929600,1558929600,1
WeldinMike27,0,1,0,6,1597550400,1597550400,1
someguy5003,0,1,0,5,1587873600,1587873600,1
Saltyfembot,0,1,0,2,1608699600,1608699600,1
UnknownParentage,0,1,0,2,1570248000,1570248000,1
TaylorTip17,0,1,0,1,1601352000,1601352000,1
Moongoat,0,1,0,1,1481259600,1481259600,1
Gelderland33,1,0,8,0,1605589200,1605589200,1
ForestOfMirrors,0,1,0,2,1608094800,1608094800,1
dykmoby,0,1,0,48,1588392000,1588392000,1
smimatt,1,0,33,0,1564027200,1564027200,1
coolreader18,0,1,0,1,1585886400,1585886400,1
Ask_Djhinn,0,1,0,9,1570248000,1570248000,1
LetitsNow003,0,1,0,16,1608440400,1608440400,1
summer_the_husky,0,1,0,1,1540008000,1540008000,1
IdahoLibbie,0,1,0,-5,1602820800,1602820800,1
WomanNotAGirl,0,1,0,0,1600228800,1600228800,1
daddyfailure,0,1,0,8,1595044800,1595044800,1
chinglofordion,0,1,0,1,1608267600,1608267600,1
Milo359,0,1,0,1,1613365200,1613365200,1
edc0,0,1,0,11,1542776400,1542776400,1
Freidhelm,0,1,0,4,1605589200,1605589200,1
thatonedude1604,0,1,0,1,1621310400,1621310400,1
TaciturnDurm,0,1,0,24,1579150800,1579150800,1
TheTestPilot,0,1,0,2,1576213200,1576213200,1
nobody12345671,0,1,0,1,1594267200,1594267200,1
cannaceo,0,1,0,0,1589947200,1589947200,1
Dudeman1919,0,1,0,0,1597723200,1597723200,1
hackmiko,0,1,0,18,1583985600,1583985600,1
TheZoloftMaster,0,1,0,1,1594785600,1594785600,1
biggiefalls86,0,1,0,1,1572235200,1572235200,1
AHH_im_on_fire,0,1,0,1,1624852800,1624852800,1
kajarago,0,1,0,0,1557633600,1557633600,1
dirtyterps,0,1,0,5,1607662800,1607662800,1
backlikeclap,0,1,0,24,1585454400,1585454400,1
pkfxn,0,1,0,12,1572753600,1572753600,1
demon0192,0,1,0,-138,1601179200,1601179200,1
GoSquanchYoSelf,0,1,0,6,1608699600,1608699600,1
Arin33912,0,1,0,1,1609563600,1609563600,1
Emeraldminer299,0,1,0,1,1607576400,1607576400,1
Hypez69,0,1,0,11,1555732800,1555732800,1
Dpower244,0,1,0,1,1603684800,1603684800,1
Squeezylemons7,1,0,139,0,1590033600,1590033600,1
InfiniteSink,0,1,0,15,1587268800,1587268800,1
Uranium_Chuff_Links,0,1,0,3,1606021200,1606021200,1
anfornum,0,1,0,0,1583038800,1583038800,1
yetiking96,1,0,16,0,1574830800,1574830800,1
wotanii,0,1,0,5,1474171200,1474171200,1
vonnegutfan2,0,1,0,1,1603598400,1603598400,1
iwjahshehbs,0,1,0,1,1597809600,1597809600,1
brianTC,0,1,0,2,1585368000,1585368000,1
niaiserie,0,1,0,1,1593576000,1593576000,1
Anal_Assassination,0,1,0,0,1608267600,1608267600,1
TxBeerWorldwide,0,1,0,3,1604898000,1604898000,1
chinchillas4fire,0,1,0,6,1609390800,1609390800,1
TheAwkwardOne-_-,0,1,0,11,1609304400,1609304400,1
JBCoverArt,0,1,0,2,1600920000,1600920000,1
fatalfuuu,0,1,0,2,1578805200,1578805200,1
brothermuffin,0,1,0,1,1603512000,1603512000,1
weaverco,0,1,0,1,1612069200,1612069200,1
ikeaj123,0,1,0,9,1576213200,1576213200,1
Ghostlybather,0,1,0,6,1569988800,1569988800,1
noelsmidgeon,0,1,0,3,1603512000,1603512000,1
regoosed,0,1,0,2,1601956800,1601956800,1
sewkzz,0,1,0,31,1601179200,1601179200,1
IndigoImperatrix,0,1,0,2,1592625600,1592625600,1
brundlfly,0,1,0,2,1603512000,1603512000,1
CRLTSUX,0,1,0,123,1607749200,1607749200,1
RockKillsKid,0,1,0,1,1573362000,1573362000,1
ChadDAIncel,0,1,0,5,1606712400,1606712400,1
Karlovious,0,1,0,11,1567569600,1567569600,1
WrongCorridor,0,1,0,2,1590465600,1590465600,1
Downfallmatrix,0,1,0,11,1608699600,1608699600,1
mordacthedenier,0,1,0,2,1603252800,1603252800,1
MrGoldenPeen,0,1,0,18,1605243600,1605243600,1
Stupid_question_bot,0,1,0,1,1573621200,1573621200,1
fat_schlonker,0,1,0,40,1583125200,1583125200,1
adoreandu,0,1,0,3,1575867600,1575867600,1
theoriginalmypooper,0,1,0,4,1568606400,1568606400,1
simorely,0,1,0,1,1606971600,1606971600,1
XCurlyXO,0,1,0,7,1602907200,1602907200,1
gouellette,0,1,0,1,1574053200,1574053200,1
Saera-chan,0,1,0,16,1589688000,1589688000,1
HealthyQuit4758,0,1,0,2,1612155600,1612155600,1
tolandruth,0,1,0,8,1585022400,1585022400,1
fairliem,0,1,0,39,1606539600,1606539600,1
phx1rgg,0,1,0,1,1608613200,1608613200,1
catharsis69,0,1,0,11,1588478400,1588478400,1
Raymuuze,0,1,0,1,1611982800,1611982800,1
thetimehathcome,0,1,0,-1,1571371200,1571371200,1
SoKarma19,0,1,0,3,1581915600,1581915600,1
murse_joe,0,1,0,3,1596945600,1596945600,1
Knockemm,0,1,0,14,1608872400,1608872400,1
rholygreens,0,1,0,4,1591243200,1591243200,1
RichardSphincter,0,1,0,3,1595304000,1595304000,1
NatashkaX,0,1,0,4,1548046800,1548046800,1
AjaxOrion,0,1,0,2,1603598400,1603598400,1
Radioheadfanatic,0,1,0,5,1611810000,1611810000,1
momal4,0,1,0,9,1592366400,1592366400,1
That1Guy718,0,1,0,5,1578632400,1578632400,1
StanleySalad,0,1,0,48,1577941200,1577941200,1
FUCKFASCISTSCUM,0,1,0,14,1571371200,1571371200,1
DatCarpet,0,1,0,2,1588651200,1588651200,1
The__Plumber,0,1,0,1,1608267600,1608267600,1
Fieshface,0,1,0,2,1606021200,1606021200,1
iheartnargles,0,1,0,1,1608699600,1608699600,1
bigAlittleACAB,0,1,0,7,1583211600,1583211600,1
mannotgoodatanything,0,1,0,1,1563508800,1563508800,1
nuromie,0,1,0,1,1603512000,1603512000,1
digodk,0,1,0,1,1593835200,1593835200,1
czvck,0,1,0,13,1596600000,1596600000,1
TheTrashBoat06,0,1,0,4,1597377600,1597377600,1
Hell-on-wheels,0,1,0,4,1583557200,1583557200,1
riraq25,0,1,0,122,1604379600,1604379600,1
alpinecoast,0,1,0,12,1583211600,1583211600,1
aimxwrite,0,1,0,7,1592280000,1592280000,1
Bunny36,0,1,0,31,1582606800,1582606800,1
NormanQuacks345,0,1,0,2,1586836800,1586836800,1
eatMYcookieCRUMBS,0,1,0,2,1581224400,1581224400,1
Lucas_F_A,0,1,0,1,1589688000,1589688000,1
Volcanic-Penguin,0,1,0,18,1606885200,1606885200,1
Ramzy213,0,1,0,1,1603512000,1603512000,1
Fedna0,0,1,0,45,1570507200,1570507200,1
whoisedward,0,1,0,13,1575349200,1575349200,1
kisscumbag,0,1,0,1,1585108800,1585108800,1
maellie27,0,1,0,9,1578373200,1578373200,1
juberish,0,1,0,-16,1601179200,1601179200,1
DoodleGaming,0,1,0,-1,1590120000,1590120000,1
n8ivco1,0,1,0,2,1597636800,1597636800,1
Thanthela,0,1,0,3,1600142400,1600142400,1
Obtuse_Inquisitive,0,1,0,1,1604379600,1604379600,1
thevitamincj,0,1,0,7,1609131600,1609131600,1
iceyone444,0,1,0,3,1571889600,1571889600,1
Ok_Designer_Things,0,1,0,6,1603512000,1603512000,1
Dr_StrangeLovePHD,0,1,0,21,1607230800,1607230800,1
Nitrome1000,0,1,0,1,1589860800,1589860800,1
ressunkiee,1,0,25,0,1528862400,1528862400,1
47-Rambaldi,0,1,0,7,1602388800,1602388800,1
kdemetrovits,0,1,0,5,1576472400,1576472400,1
courier1b,1,0,23,0,1607403600,1607403600,1
Ott621,0,1,0,1,1590206400,1590206400,1
micropup,0,1,0,-15,1559620800,1559620800,1
Moravia300,0,1,0,1,1606453200,1606453200,1
ThankGodForSagan,0,1,0,7,1605934800,1605934800,1
steppo9472,0,1,0,-1,1605502800,1605502800,1
JustAPoorBoy42,0,1,0,10,1573534800,1573534800,1
AnnabelsKeeper,0,1,0,5,1577854800,1577854800,1
Elife55,0,1,0,15,1604466000,1604466000,1
pharoahmunch,0,1,0,17,1603684800,1603684800,1
xaminedlyfe,0,1,0,3,1586664000,1586664000,1
EternalNY1,0,1,0,21,1581224400,1581224400,1
Blargle33,0,1,0,7,1594440000,1594440000,1
emilyjgirler,0,1,0,13,1603684800,1603684800,1
wifichick,0,1,0,6,1597291200,1597291200,1
YborBum,0,1,0,7,1590465600,1590465600,1
jetgirl80444,0,1,0,2,1553832000,1553832000,1
Breaktest,0,1,0,2,1570939200,1570939200,1
kmbnw,0,1,0,2,1597032000,1597032000,1
johnny-sutts,0,1,0,6,1593230400,1593230400,1
JupitersKoK,0,1,0,30,1596427200,1596427200,1
Adidas_track_suit,0,1,0,2,1556424000,1556424000,1
Smyds,0,1,0,1,1526616000,1526616000,1
Pantelima,0,1,0,1,1603512000,1603512000,1
Omega2k3,0,1,0,2,1567656000,1567656000,1
cyberst0rm,0,1,0,-16,1601611200,1601611200,1
TehAwkwardOne,0,1,0,3,1592539200,1592539200,1
bibird66,0,1,0,10,1560571200,1560571200,1
Xenogenes,0,1,0,1,1585454400,1585454400,1
LeroytheOtter,0,1,0,23,1571371200,1571371200,1
ZehKapitan,0,1,0,5,1538452800,1538452800,1
PhorcedAynalPhist,0,1,0,1,1607662800,1607662800,1
RR_1246,0,1,0,4,1570593600,1570593600,1
PrincepsMagnus,0,1,0,37,1585108800,1585108800,1
cheese_n_crack,0,1,0,2,1586404800,1586404800,1
FIREDINKER,0,1,0,1,1579064400,1579064400,1
BranwenJojo,0,1,0,8,1599624000,1599624000,1
goodsnpr,0,1,0,9,1608958800,1608958800,1
Lord_Petyr_PoppyCock,0,1,0,11,1600574400,1600574400,1
Stepheedoos,0,1,0,1,1606021200,1606021200,1
violentcurves,0,1,0,3,1552708800,1552708800,1
stumblingblock1914,0,1,0,180,1600228800,1600228800,1
Business-Car-3667,0,1,0,4,1607835600,1607835600,1
sucobe,0,1,0,0,1589860800,1589860800,1
BigbysOtherHand,0,1,0,31,1607835600,1607835600,1
korasi_khan,0,1,0,198,1602907200,1602907200,1
AnthonyParchman,0,1,0,3,1577854800,1577854800,1
Bagtoss,0,1,0,1,1608613200,1608613200,1
TransThrowaway232,0,1,0,3,1599796800,1599796800,1
wutanc,0,1,0,8,1580101200,1580101200,1
Crystalgirl121,1,0,4,0,1607576400,1607576400,1
qualino,0,1,0,2,1573102800,1573102800,1
Hallozy,0,1,0,-4,1602388800,1602388800,1
Nhenghali,0,1,0,1,1600833600,1600833600,1
vatikmi,1,0,1,0,1456635600,1456635600,1
_Sum141,0,1,0,1,1604116800,1604116800,1
ruke25,0,1,0,3,1588737600,1588737600,1
AbsolXGuardian,0,1,0,12,1606453200,1606453200,1
The_Mighty_Nezha,0,1,0,255,1571630400,1571630400,1
memelord69420lmao,0,1,0,1,1606626000,1606626000,1
kapayo,1,0,53,0,1604984400,1604984400,1
bluebird_heart,0,1,0,6,1572667200,1572667200,1
Much_Doge_Much_Wow,0,1,0,58,1589860800,1589860800,1
poly_meh,0,1,0,-5,1584504000,1584504000,1
Duffalpha,0,1,0,37,1605502800,1605502800,1
Shadowchani,0,1,0,12,1608094800,1608094800,1
dedarou96,0,1,0,11,1597377600,1597377600,1
sleepycarbon,0,1,0,6,1588046400,1588046400,1
laDurchblick,0,1,0,9,1607576400,1607576400,1
tenspeed2,0,1,0,1,1588305600,1588305600,1
bobosuda,0,1,0,2,1591243200,1591243200,1
Zaratustash,0,1,0,1,1577077200,1577077200,1
ecozay,0,1,0,203,1601438400,1601438400,1
pasmonteiro,1,0,0,0,1607144400,1607144400,1
sh1nycat,0,1,0,1,1603512000,1603512000,1
hugmeimbored,0,1,0,3,1593057600,1593057600,1
JV13FRight,0,1,0,1,1582952400,1582952400,1
Cypher1993,0,1,0,-1,1591329600,1591329600,1
zezrapod,0,1,0,4,1582779600,1582779600,1
MrCrispPacket,0,1,0,29,1608613200,1608613200,1
AtheistCell,0,1,0,1,1606626000,1606626000,1
Prtedting,0,1,0,1,1578459600,1578459600,1
Aktionjackson,0,1,0,1,1642741200,1642741200,1
ablacnk,0,1,0,1,1591329600,1591329600,1
TiRow77,0,1,0,0,1600142400,1600142400,1
EJArt,0,1,0,33,1602561600,1602561600,1
Showerbeerguy13,0,1,0,6,1598414400,1598414400,1
Emperor_of_Cats,0,1,0,2,1591243200,1591243200,1
ihateworkingandlife,1,0,68,0,1581742800,1581742800,1
jeebus224,0,1,0,-3,1574312400,1574312400,1
PressxStart,0,1,0,11,1587355200,1587355200,1
exciter,0,1,0,1,1596340800,1596340800,1
TheNamelessOnes,0,1,0,1,1584417600,1584417600,1
Killa--,0,1,0,2,1603512000,1603512000,1
camest,0,1,0,9,1607317200,1607317200,1
shayndco,0,1,0,1,1611896400,1611896400,1
LegionPsycher,0,1,0,2,1594699200,1594699200,1
DrJohnHix,0,1,0,1,1598932800,1598932800,1
captain_borgue,0,1,0,6,1603598400,1603598400,1
daderpracer21,0,1,0,1,1539921600,1539921600,1
thisis2stressful4me,0,1,0,189,1606971600,1606971600,1
BobSaiyaman,0,1,0,2,1605330000,1605330000,1
ZookTheMagnificent,0,1,0,14,1584763200,1584763200,1
J18_,0,1,0,2,1602561600,1602561600,1
Lightbulbbrightbulb,0,1,0,6,1599278400,1599278400,1
DaSandGuy,0,1,0,2,1606712400,1606712400,1
bobbobbob123321123,0,1,0,2,1585368000,1585368000,1
C0r4a,0,1,0,14,1597118400,1597118400,1
00MrNiceGuy00,0,1,0,2,1603598400,1603598400,1
Melancholy-Monster,0,1,0,6,1607490000,1607490000,1
ZachGrandichIsGay,0,1,0,2,1603080000,1603080000,1
SophisticatedCelery,0,1,0,1,1603512000,1603512000,1
FuriousTalons,0,1,0,22,1607317200,1607317200,1
Wtfisthatt,0,1,0,146,1608440400,1608440400,1
Specter313,0,1,0,2,1577509200,1577509200,1
billthekobold,0,1,0,2,1575176400,1575176400,1
Infamous-Helicopter7,0,1,0,-4,1606107600,1606107600,1
Oil_Ocean,0,1,0,3,1599019200,1599019200,1
areyoufknserious,0,1,0,16,1572062400,1572062400,1
Gnash323,0,1,0,2,1593662400,1593662400,1
DadCough,0,1,0,1,1600660800,1600660800,1
darkerpoole,0,1,0,1,1597896000,1597896000,1
palindrome4lyfe,1,0,7,0,1606107600,1606107600,1
hstabley,0,1,0,1,1605157200,1605157200,1
Eeeenriqueeee,0,1,0,1,1590984000,1590984000,1
horn-kneeee,0,1,0,6,1596686400,1596686400,1
joe_beardon,0,1,0,7,1588910400,1588910400,1
NoScrying,0,1,0,13,1580619600,1580619600,1
schultzie2240,0,1,0,1,1637125200,1637125200,1
Anarcho_Eggie,0,1,0,1,1604379600,1604379600,1
Ston_35,0,1,0,1,1606626000,1606626000,1
RobbexRobbex,0,1,0,1,1585454400,1585454400,1
academicbagel,0,1,0,1,1606539600,1606539600,1
tenzo13,0,1,0,1,1602302400,1602302400,1
Princy04,0,1,0,6,1605934800,1605934800,1
LordPHI18,1,0,19,0,1605243600,1605243600,1
schmidtily,0,1,0,17,1605502800,1605502800,1
Destronoma,0,1,0,-3,1539921600,1539921600,1
MF-Doom_1,0,1,0,2,1611896400,1611896400,1
spirited_skeptic,1,0,44,0,1599192000,1599192000,1
givepositivity,0,1,0,7,1567569600,1567569600,1
das_neue_fleisch,0,1,0,2,1600574400,1600574400,1
vehicularimpediment,0,1,0,2,1576731600,1576731600,1
Red_Degenerate,0,1,0,29,1573016400,1573016400,1
I_think_charitably,0,1,0,4,1603598400,1603598400,1
Double-Exchange,0,1,0,2,1598932800,1598932800,1
Sure-Highway-6998,0,1,0,141,1612155600,1612155600,1
200_percent,0,1,0,2,1597032000,1597032000,1
yungprettyricky,0,1,0,3,1598587200,1598587200,1
Aquill98,0,1,0,1,1595476800,1595476800,1
TheRealTgc,0,1,0,5,1559880000,1559880000,1
Galumsor,0,1,0,9,1596600000,1596600000,1
lovelyafterthoughts,0,1,0,14,1576386000,1576386000,1
Clunkbot,0,1,0,5,1579928400,1579928400,1
Greggsnbacon23,0,1,0,28,1605589200,1605589200,1
CashStash48,0,1,0,1,1581483600,1581483600,1
usamajr9,1,0,10,0,1605502800,1605502800,1
jasper_bittergrab,1,0,367,0,1593057600,1593057600,1
moreplastic,0,1,0,1,1600660800,1600660800,1
Branstone22,0,1,0,1,1594785600,1594785600,1
Dash_O_Cunt,0,1,0,39,1580706000,1580706000,1
tajnywspolpracownik,0,1,0,1,1634443200,1634443200,1
FlaccidDictator,0,1,0,3,1585195200,1585195200,1
choose_sleep,0,1,0,22,1562126400,1562126400,1
scumbag760,0,1,0,1,1585454400,1585454400,1
indicanna,0,1,0,2,1608094800,1608094800,1
PinkPropaganda,0,1,0,1,1607749200,1607749200,1
arrowmissedtheapple,0,1,0,1,1591329600,1591329600,1
Smart_Resist615,0,1,0,2,1598068800,1598068800,1
Flashmode1,0,1,0,3,1570593600,1570593600,1
trapqueen412,0,1,0,1,1598846400,1598846400,1
The-MT-Sant,1,0,2235,0,1603425600,1603425600,1
nyar26,0,1,0,1,1606712400,1606712400,1
Exystenc,1,0,0,0,1589256000,1589256000,1
Super-Addition-141,0,1,0,5,1603512000,1603512000,1
BrokenMind5,0,1,0,1,1611982800,1611982800,1
Technical-Midnight-2,0,1,0,2,1606280400,1606280400,1
5starkarma,0,1,0,1,1577336400,1577336400,1
the_shrimp_boi,0,1,0,36,1603166400,1603166400,1
i_spilled_it,0,1,0,1,1603512000,1603512000,1
BJules319,0,1,0,1,1604293200,1604293200,1
ToothyBjComic,1,0,126,0,1599537600,1599537600,1
UselessYuki,0,1,0,4,1567483200,1567483200,1
HiLaryHH,0,1,0,-7,1576558800,1576558800,1
altoid_lover,0,1,0,7,1568779200,1568779200,1
Aanairai,0,1,0,2,1590206400,1590206400,1
Ummdustry,0,1,0,1,1572843600,1572843600,1
gamer690000,0,1,0,1,1606626000,1606626000,1
jimbabwae2,0,1,0,34,1606539600,1606539600,1
smoothiegangsta,0,1,0,11,1580706000,1580706000,1
plantmum99,0,1,0,1,1603512000,1603512000,1
Nobody285,0,1,0,13,1601611200,1601611200,1
DogeSoup,0,1,0,1,1573534800,1573534800,1
proonjooce,0,1,0,7,1600228800,1600228800,1
djspacepope,0,1,0,14,1585627200,1585627200,1
idkjustletmeondamnit,0,1,0,-4,1591156800,1591156800,1
CoughlinClover,0,1,0,3,1574485200,1574485200,1
yosoybasura200,1,0,49,0,1581483600,1581483600,1
DellR610,0,1,0,-11,1559620800,1559620800,1
Linseed1984,0,1,0,21,1605157200,1605157200,1
BarfHurricane,1,0,29,0,1605762000,1605762000,1
SnowmanPickins,0,1,0,1,1583726400,1583726400,1
Osuxid,0,1,0,27,1559793600,1559793600,1
Brockkilledspeedy,0,1,0,-5,1560657600,1560657600,1
Inuitinnuendo,0,1,0,-1,1545109200,1545109200,1
blackpink777,0,1,0,2,1591329600,1591329600,1
Ddddoooogggg,0,1,0,2,1603512000,1603512000,1
youfailedthiscity,0,1,0,1,1583557200,1583557200,1
moonside64,0,1,0,1,1601870400,1601870400,1
kambo2k19,0,1,0,1,1579064400,1579064400,1
eggalan,0,1,0,5,1611896400,1611896400,1
Tanzious02,0,1,0,1,1601870400,1601870400,1
Serrahfina,0,1,0,17,1608786000,1608786000,1
Hurtem,0,1,0,25,1607922000,1607922000,1
OrangeJIM123,0,1,0,1,1600833600,1600833600,1
paleopia,0,1,0,1,1603512000,1603512000,1
Yungissh,0,1,0,1,1608699600,1608699600,1
DoctorOsmium,0,1,0,1,1610859600,1610859600,1
AFuddyDuddy,0,1,0,49,1580274000,1580274000,1
Ayoeh,0,1,0,4,1583384400,1583384400,1
nangelina,1,0,287,0,1566360000,1566360000,1
Cran4c,0,1,0,1,1607835600,1607835600,1
zy469xw23,0,1,0,1,1582347600,1582347600,1
mrsfigg17,0,1,0,5,1565323200,1565323200,1
catmandoom84,0,1,0,2,1602820800,1602820800,1
decepsis_overmark,0,1,0,9,1606626000,1606626000,1
The_Fool_Of_Owari,0,1,0,1,1585454400,1585454400,1
ZoruuWolfy,0,1,0,42,1569297600,1569297600,1
cujo,0,1,0,2,1585281600,1585281600,1
lodobol,0,1,0,2,1600228800,1600228800,1
sizzmatic21,0,1,0,1,1554696000,1554696000,1
Unnormally2,0,1,0,0,1591243200,1591243200,1
zosce,0,1,0,18,1561521600,1561521600,1
clinkyscales,0,1,0,1,1604466000,1604466000,1
zedudedaniel,0,1,0,42,1579842000,1579842000,1
Thaaaaaaa,0,1,0,20,1592539200,1592539200,1
SnootHead,0,1,0,1,1552968000,1552968000,1
ejbrut,0,1,0,2,1582779600,1582779600,1
Salt-Refrigerator-75,0,1,0,1,1604638800,1604638800,1
Saiomi,0,1,0,1,1603598400,1603598400,1
aikifuku,0,1,0,3,1612069200,1612069200,1
mayasmomma,0,1,0,1,1581051600,1581051600,1
A_medium_sized_rock,0,1,0,43,1601870400,1601870400,1
stanleytuccimane,0,1,0,10,1608181200,1608181200,1
mcstafford,0,1,0,2,1602302400,1602302400,1
pil0tinthesky,0,1,0,1,1589083200,1589083200,1
shivi1321,0,1,0,2,1609477200,1609477200,1
benm0112358,0,1,0,1,1605589200,1605589200,1
mwheele86,0,1,0,5,1561780800,1561780800,1
sunfloweronmars,0,1,0,19,1600228800,1600228800,1
Gimme_Garlic_Bread,0,1,0,2,1571112000,1571112000,1
aujoi,0,1,0,1,1596772800,1596772800,1
Bannedfromreddit66,1,0,1,0,1609390800,1609390800,1
turnchri,0,1,0,3,1588996800,1588996800,1
liptongtea,0,1,0,2,1603512000,1603512000,1
Iloveforkknife,0,1,0,2,1599192000,1599192000,1
bandfag,0,1,0,1,1587873600,1587873600,1
Vormav,0,1,0,2,1426910400,1426910400,1
CumSicarioDisputabo,0,1,0,6,1611896400,1611896400,1
KKvanMalmsteen,0,1,0,42,1597809600,1597809600,1
itovuo,0,1,0,1,1611896400,1611896400,1
selm267,0,1,0,9,1611810000,1611810000,1
crayfl,0,1,0,3,1597464000,1597464000,1
itsdietz,0,1,0,1,1584158400,1584158400,1
aavant-gardee,0,1,0,9,1599969600,1599969600,1
Zoopydoop_,0,1,0,1,1611982800,1611982800,1
innocentdemand,0,1,0,2,1603252800,1603252800,1
Geetsly,0,1,0,2,1566446400,1566446400,1
Amateurlapse,1,0,698,0,1603512000,1603512000,1
Elegant-Rectum,0,1,0,1,1572235200,1572235200,1
Substantial-Sun7508,0,1,0,1,1635134400,1635134400,1
spacemanaut,0,1,0,2,1572580800,1572580800,1
nodepostgres,0,1,0,1,1582261200,1582261200,1
Wizardwheel,0,1,0,3,1608008400,1608008400,1
I-Cant-Argue,1,0,1,0,1583470800,1583470800,1
Ronaldatov27,0,1,0,1,1609477200,1609477200,1
the_roguetrader,0,1,0,2,1607403600,1607403600,1
needy_asshole,0,1,0,84,1590638400,1590638400,1
BeamServer,0,1,0,0,1601870400,1601870400,1
Somekindacrazy,0,1,0,-4,1578978000,1578978000,1
OhHolyBenetar,1,0,18,0,1585972800,1585972800,1
thej00ninja,0,1,0,7,1591243200,1591243200,1
pugba,0,1,0,1,1550293200,1550293200,1
wavyboykyle,1,0,16,0,1569470400,1569470400,1
MyOpinionion,0,1,0,1,1560571200,1560571200,1
Debonaire,0,1,0,6,1573621200,1573621200,1
indestructible_deng,0,1,0,-3,1548997200,1548997200,1
pratyekabuddha4,0,1,0,3,1566705600,1566705600,1
NEOX036,0,1,0,1,1636171200,1636171200,1
idreamofketo,0,1,0,2,1576818000,1576818000,1
TheNineSixOne,0,1,0,2,1612328400,1612328400,1
CodeKraken,0,1,0,25,1574485200,1574485200,1
WhAtEvErYoUmEaN101,0,1,0,7,1608958800,1608958800,1
sasuke2490,0,1,0,1,1594353600,1594353600,1
Lesson333,0,1,0,0,1601524800,1601524800,1
musicluvr989,0,1,0,3,1604379600,1604379600,1
noonday8,0,1,0,2,1585627200,1585627200,1
JacquesLeTrou,0,1,0,2,1592884800,1592884800,1
Febreze02,0,1,0,1,1599192000,1599192000,1
subduedReality,0,1,0,1,1594180800,1594180800,1
GuruofGurus,0,1,0,1,1567569600,1567569600,1
functi0nal,0,1,0,8,1574658000,1574658000,1
interlopenz,0,1,0,1,1564804800,1564804800,1
discospek,0,1,0,1,1592798400,1592798400,1
GreenDinosaur,0,1,0,6,1579496400,1579496400,1
AutumnRain789,0,1,0,2,1589688000,1589688000,1
Danny-Fr,0,1,0,23,1598846400,1598846400,1
Lexex192,0,1,0,1,1577422800,1577422800,1
SoliderpyFromGreece,0,1,0,1,1589688000,1589688000,1
Chad_Pringle,0,1,0,3,1612069200,1612069200,1
Pryzbo,0,1,0,2,1554782400,1554782400,1
bottyliscious,0,1,0,6,1547010000,1547010000,1
fuck2o19,0,1,0,3,1601352000,1601352000,1
bambishmambi,0,1,0,46,1608181200,1608181200,1
iaintdanny,0,1,0,1,1603512000,1603512000,1
here_he_comes_,1,0,451,0,1575867600,1575867600,1
cadams7407,0,1,0,-4,1582779600,1582779600,1
NoxiousStimuli,0,1,0,65,1581915600,1581915600,1
one_1_quickquestion,0,1,0,3,1602907200,1602907200,1
tastyf,0,1,0,1,1576645200,1576645200,1
Fergus95,0,1,0,1,1605502800,1605502800,1
BattShadows,0,1,0,7,1561780800,1561780800,1
HakanJ,0,1,0,4,1606453200,1606453200,1
12lemontrees,0,1,0,9,1606712400,1606712400,1
MightySweep,0,1,0,533,1604811600,1604811600,1
supervermont,0,1,0,2,1594267200,1594267200,1
Seaglasshorsiedoo,0,1,0,73,1602648000,1602648000,1
peribeth,0,1,0,20,1595390400,1595390400,1
0themosswitch0,0,1,0,1,1564459200,1564459200,1
ecst3r,0,1,0,1,1562904000,1562904000,1
Allos_Trent,0,1,0,3,1592712000,1592712000,1
buckthorne_seagrass,0,1,0,12,1567569600,1567569600,1
KanyeWorshipper2,0,1,0,1,1617854400,1617854400,1
BigBoobsMacGee,0,1,0,1,1573448400,1573448400,1
Hwatwasthat,0,1,0,1,1585454400,1585454400,1
luluwinsteadd13,0,1,0,2,1601265600,1601265600,1
jkwah,0,1,0,58,1597982400,1597982400,1
chabanny,0,1,0,2,1608872400,1608872400,1
inEthos,1,0,0,0,1581656400,1581656400,1
themaskednipple,0,1,0,1,1606885200,1606885200,1
Willzohh,0,1,0,1,1608526800,1608526800,1
seiftnewbie,0,1,0,1,1600574400,1600574400,1
MattPilkerson,0,1,0,1,1572843600,1572843600,1
Wahngott,0,1,0,1,1607662800,1607662800,1
PM_YOUR_CUTE_BHOLE,0,1,0,1,1577336400,1577336400,1
faux_maux_,0,1,0,3,1607403600,1607403600,1
DrunkyMcDrunk-Drunk,0,1,0,1,1475035200,1475035200,1
WannaSeeTrustIssues,0,1,0,1,1573362000,1573362000,1
UnnoticedPet,0,1,0,10,1572321600,1572321600,1
Striking-Ad-2222,0,1,0,1,1608094800,1608094800,1
_SandScar_,0,1,0,4,1594440000,1594440000,1
fishus,0,1,0,1,1592625600,1592625600,1
Jmb3930,0,1,0,1,1571716800,1571716800,1
NotEnoughGuitars,0,1,0,2,1604725200,1604725200,1
countnoxxferatu,0,1,0,17,1597723200,1597723200,1
Piqued_a_Pack,0,1,0,2,1585627200,1585627200,1
Boardsportz,1,0,0,0,1585972800,1585972800,1
reality_czech,0,1,0,16,1556942400,1556942400,1
RoastKrill,0,1,0,36,1588996800,1588996800,1
L0EZ0E,0,1,0,8,1600315200,1600315200,1
joeislandstranded,0,1,0,2,1603598400,1603598400,1
IgnorantAndApathetic,0,1,0,1,1545109200,1545109200,1
ThePertinentParty,0,1,0,2,1611810000,1611810000,1
JaH247,0,1,0,1,1562299200,1562299200,1
nazuuka,0,1,0,1,1602734400,1602734400,1
The-Senate-Palpy,0,1,0,1,1586836800,1586836800,1
mandar26,0,1,0,8,1557720000,1557720000,1
Tlr321,0,1,0,3,1569124800,1569124800,1
GalacticTurmoil,0,1,0,4,1608613200,1608613200,1
Libralily,1,0,17,0,1441857600,1441857600,1
HydroRaptorz,0,1,0,1,1574139600,1574139600,1
ForeignResult,0,1,0,4,1590206400,1590206400,1
YodaGayming,0,1,0,8,1607230800,1607230800,1
akost18,0,1,0,2,1581397200,1581397200,1
thegirIhasnoname,1,0,1464,0,1595736000,1595736000,1
pugsaremydrugs,0,1,0,5,1551330000,1551330000,1
beefdx,0,1,0,2,1608267600,1608267600,1
sandygooner42069,0,1,0,1,1607317200,1607317200,1
boonkles,0,1,0,-5,1571112000,1571112000,1
thefreshestofstarts,0,1,0,1,1585454400,1585454400,1
aozorapedal,0,1,0,-10,1601784000,1601784000,1
Iuliatenea,0,1,0,8,1595217600,1595217600,1
Fresque,0,1,0,1,1599451200,1599451200,1
AeroPressobsessedguy,0,1,0,-19,1598673600,1598673600,1
apetoo,0,1,0,2,1551330000,1551330000,1
blejusca,0,1,0,1,1611982800,1611982800,1
cynnicole,0,1,0,5,1587268800,1587268800,1
jesushowardchrist,0,1,0,2,1606453200,1606453200,1
No_Signal,0,1,0,11,1605502800,1605502800,1
toronto_programmer,0,1,0,1,1608699600,1608699600,1
popeyemati,0,1,0,2,1598500800,1598500800,1
sadandunderpaid,0,1,0,2,1585627200,1585627200,1
SpeedOfMoose,0,1,0,1,1605589200,1605589200,1
knd775,0,1,0,1,1585195200,1585195200,1
papapena_,0,1,0,6,1604552400,1604552400,1
kenfro87,0,1,0,-1,1602820800,1602820800,1
dirttrack6531,0,1,0,-3,1607576400,1607576400,1
Chillllz,0,1,0,10,1575176400,1575176400,1
i_have_cheese,0,1,0,6,1584244800,1584244800,1
ChairmanNoodle,0,1,0,1,1608872400,1608872400,1
Eb10064,0,1,0,7,1575608400,1575608400,1
pamcake1220,0,1,0,2,1551157200,1551157200,1
Hideout_Economist,0,1,0,2,1606626000,1606626000,1
an_ennui,0,1,0,9,1609045200,1609045200,1
amandatheperson,0,1,0,1,1591502400,1591502400,1
ProphecyofCasandra,0,1,0,2,1549256400,1549256400,1
zerowasteminimalist,0,1,0,8,1603425600,1603425600,1
Arrays-Start-at-1,0,1,0,16,1601179200,1601179200,1
55985,0,1,0,2,1538193600,1538193600,1
xpawntakesqueenx,0,1,0,3,1605934800,1605934800,1
FrankTheMagicPotato,0,1,0,4,1596772800,1596772800,1
Sensitive-Banana-761,0,1,0,31,1612155600,1612155600,1
LampshadeThis,0,1,0,5,1600315200,1600315200,1
HundredsOfBees,1,0,29,0,1560225600,1560225600,1
smashburgerofficial,0,1,0,9,1605762000,1605762000,1
D3T3KT,0,1,0,1,1608699600,1608699600,1
HumansKillEverything,0,1,0,3,1596772800,1596772800,1
blootannery,0,1,0,20,1597809600,1597809600,1
Saphirweretigrx,0,1,0,3,1599105600,1599105600,1
smellingcrackers,0,1,0,5,1590638400,1590638400,1
vaimes-r,0,1,0,1,1559102400,1559102400,1
self_interst,0,1,0,1,1601697600,1601697600,1
rxo__,0,1,0,11,1609218000,1609218000,1
Freechoco,0,1,0,0,1569643200,1569643200,1
CogitoErgoScum,0,1,0,1,1606626000,1606626000,1
buttsecksregulator,0,1,0,4,1599537600,1599537600,1
fooku_fookme,1,0,133,0,1584331200,1584331200,1
_DarthBob_,0,1,0,2,1604984400,1604984400,1
Enough_Instance,1,0,33,0,1572843600,1572843600,1
LtGnu,0,1,0,2,1557547200,1557547200,1
OrElse_Ellipsis,0,1,0,1,1565928000,1565928000,1
UsernameIn3and20,0,1,0,4,1606626000,1606626000,1
hussain10089,0,1,0,1,1600920000,1600920000,1
Blackie810,0,1,0,4,1571976000,1571976000,1
the_chanboy,0,1,0,1,1608267600,1608267600,1
ajyssa,0,1,0,126,1595304000,1595304000,1
ScruffsMcGuff,0,1,0,12,1591243200,1591243200,1
c117s,0,1,0,3,1589860800,1589860800,1
The-Divine-Invasion,0,1,0,14,1599537600,1599537600,1
AllisonIsReal,0,1,0,1,1612242000,1612242000,1
ColourOfCanada,1,0,131,0,1590206400,1590206400,1
DysfunctionalUnivers,0,1,0,2,1602820800,1602820800,1
SiberianToaster,0,1,0,52,1591502400,1591502400,1
mickermiker,0,1,0,3,1580706000,1580706000,1
Vintage_Lobster,0,1,0,1,1605070800,1605070800,1
BotWillber,1,0,2,0,1575090000,1575090000,1
DundleDwarf,0,1,0,1,1589774400,1589774400,1
notjustfloob,0,1,0,21,1609218000,1609218000,1
halfpizza,0,1,0,1,1567569600,1567569600,1
TyeeBird,0,1,0,4,1606971600,1606971600,1
rickster_,0,1,0,12,1603598400,1603598400,1
oldschoolzoomer,0,1,0,5,1596254400,1596254400,1
Jake_Smiley,0,1,0,0,1580360400,1580360400,1
foxandowl,0,1,0,1,1561521600,1561521600,1
ZazzooGaming,0,1,0,3,1605502800,1605502800,1
madali0,0,1,0,3,1598155200,1598155200,1
smirnoffutt,0,1,0,1,1591329600,1591329600,1
lylimapanda,0,1,0,3,1572753600,1572753600,1
jimmycal213,0,1,0,5,1568260800,1568260800,1
AdamF1337,0,1,0,8,1586232000,1586232000,1
neverforget1453,0,1,0,23,1564632000,1564632000,1
LizardOrgMember5,1,0,15,0,1599278400,1599278400,1
NaiveNotOptimistic,0,1,0,2,1611896400,1611896400,1
VeteranConnection,1,0,0,0,1592452800,1592452800,1
raikumori,0,1,0,9,1605070800,1605070800,1
-CheddarGoblin-,0,1,0,1,1575262800,1575262800,1
Lady_and_the_Cat,0,1,0,1,1562040000,1562040000,1
inf4nticide,0,1,0,7,1600401600,1600401600,1
Solemdeath,0,1,0,21,1568174400,1568174400,1
LotharLandru,0,1,0,4,1588737600,1588737600,1
100thomas001,0,1,0,7,1576818000,1576818000,1
AfterGlow882,0,1,0,1,1603512000,1603512000,1
Tinker-Knight,0,1,0,6,1557201600,1557201600,1
vicissitoods,0,1,0,2,1587182400,1587182400,1
MakePaladinsGreatpls,0,1,0,6,1602388800,1602388800,1
Ultima2876,0,1,0,7,1605589200,1605589200,1
poohbearclassic,0,1,0,23,1591070400,1591070400,1
Reyhin,0,1,0,34,1589774400,1589774400,1
BLTheArmyGuy,0,1,0,1,1581051600,1581051600,1
freediecol,1,0,1,0,1608094800,1608094800,1
Tordek_Battlebeard,0,1,0,16,1562817600,1562817600,1
gazellemeat,0,1,0,1,1608181200,1608181200,1
PeepingTonin,0,1,0,2,1611896400,1611896400,1
RedHotPepperrr,0,1,0,1,1594440000,1594440000,1
BigAppendage,0,1,0,1,1599883200,1599883200,1
IucyIopez,0,1,0,13,1608440400,1608440400,1
snarkistheway666,0,1,0,20,1609390800,1609390800,1
soft-sci-fi,0,1,0,18,1578200400,1578200400,1
chewie36,0,1,0,1,1560830400,1560830400,1
myphonesdying,0,1,0,6,1564286400,1564286400,1
noithinkyourewrong,0,1,0,2,1595649600,1595649600,1
zoopi4,0,1,0,1,1604638800,1604638800,1
throwaway00101201020,0,1,0,18,1575090000,1575090000,1
Cache_or_bust,0,1,0,6,1598068800,1598068800,1
ArhymeW_Oreason,0,1,0,1,1603512000,1603512000,1
jmoshoginis,0,1,0,1,1567915200,1567915200,1
anarchomailman,1,0,237,0,1593835200,1593835200,1
j0324ch,0,1,0,2,1603598400,1603598400,1
bladeofcrimson,0,1,0,4,1603684800,1603684800,1
THP_and_Me,0,1,0,18,1590552000,1590552000,1
Tomato_Soupe,0,1,0,1,1578373200,1578373200,1
civattebodies,0,1,0,6,1553572800,1553572800,1
etoilescintillante,1,0,28,0,1583985600,1583985600,1
Techno87,0,1,0,2,1589342400,1589342400,1
thedude3600,1,0,16,0,1590552000,1590552000,1
grasswahl2-furiouser,0,1,0,69,1578200400,1578200400,1
ICU4whoyouR,0,1,0,32,1569556800,1569556800,1
BeigeKeebWhore,0,1,0,1,1583985600,1583985600,1
GlimmyGlam2001,0,1,0,8,1593748800,1593748800,1
AllThatRazzmatazz,0,1,0,4,1589860800,1589860800,1
benjacob30,0,1,0,0,1585454400,1585454400,1
bigbrownbanjo,0,1,0,2,1592280000,1592280000,1
peachcobblerincident,0,1,0,2,1597896000,1597896000,1
MyIsland,0,1,0,30,1572062400,1572062400,1
Corporal-Hicks,0,1,0,2,1584331200,1584331200,1
Jester471,0,1,0,3,1608786000,1608786000,1
ephenssta,0,1,0,2,1602820800,1602820800,1
insomniacaesthetic,0,1,0,1,1609650000,1609650000,1
neicifjenks,0,1,0,27,1599969600,1599969600,1
patukkaboi,0,1,0,1,1601870400,1601870400,1
nerdymya,0,1,0,1,1591243200,1591243200,1
theinvertedform,1,0,24,0,1605589200,1605589200,1
mpvint,0,1,0,7,1577854800,1577854800,1
RahBear,0,1,0,6,1562644800,1562644800,1
TheRealGreenArrow,0,1,0,7,1599105600,1599105600,1
untss,0,1,0,1,1554609600,1554609600,1
Your_Ex_Boyfriend,0,1,0,3,1588824000,1588824000,1
66itstreasonthen66,0,1,0,0,1607662800,1607662800,1
hiimred2,0,1,0,17,1596686400,1596686400,1
-Sty-,0,1,0,5,1607317200,1607317200,1
AcceptableDocument4,0,1,0,3,1599019200,1599019200,1
Simphonia,0,1,0,9,1607576400,1607576400,1
heretobefriends,0,1,0,1,1601784000,1601784000,1
siymjbd,0,1,0,1,1599364800,1599364800,1
Dreadknot84,0,1,0,5,1582261200,1582261200,1
A55W3CK3R9000,0,1,0,4,1589860800,1589860800,1
rbmcgow,0,1,0,1,1592625600,1592625600,1
maroonhaze,0,1,0,9,1599192000,1599192000,1
Blushii-Cake,0,1,0,1,1573189200,1573189200,1
EdwardNeegma,0,1,0,25,1602907200,1602907200,1
TastelessCookie,0,1,0,19,1605675600,1605675600,1
the-mountaintop,0,1,0,2,1587182400,1587182400,1
Dreams_of_Eagles,0,1,0,9,1612069200,1612069200,1
thebackedburner,0,1,0,12,1571198400,1571198400,1
Dubito_Ergo,0,1,0,9,1573102800,1573102800,1
XecuteFire,0,1,0,44,1579064400,1579064400,1
LawyerAvocado,0,1,0,7,1609131600,1609131600,1
Mani0770,1,0,4,0,1600920000,1600920000,1
TheScariestSkeleton4,0,1,0,1,1602734400,1602734400,1
grumpydumpah,0,1,0,0,1607317200,1607317200,1
MagnitskysGhost,0,1,0,9,1594958400,1594958400,1
FxHVivious,0,1,0,1,1573621200,1573621200,1
MattFinnigan15,0,1,0,1,1591329600,1591329600,1
Erik-P99,0,1,0,9,1603598400,1603598400,1
meyoubefriends,1,0,968,0,1603512000,1603512000,1
-frxsty,0,1,0,2,1605243600,1605243600,1
wrv505,1,0,7,0,1565236800,1565236800,1
gotodefcon62,0,1,0,19,1579755600,1579755600,1
DwedPiwateWoberts,0,1,0,5,1602043200,1602043200,1
Fuckonedosee,0,1,0,2,1607317200,1607317200,1
unclecashmere,0,1,0,11,1598760000,1598760000,1
FaerunSausageParty,0,1,0,2,1588219200,1588219200,1
jimothy2w,0,1,0,7,1611637200,1611637200,1
dogscatsph,0,1,0,1,1587528000,1587528000,1
fu_capitalism,1,0,103,0,1606712400,1606712400,1
ogbobbysloths,0,1,0,3,1598760000,1598760000,1
koko969ww,0,1,0,0,1569643200,1569643200,1
shyuura,0,1,0,4,1547787600,1547787600,1
nukezrainz,1,0,855,0,1605934800,1605934800,1
sunnycloud2020,0,1,0,1,1580446800,1580446800,1
lurkensteinsmonster,0,1,0,28,1576645200,1576645200,1
SpaceDave00,0,1,0,-7,1600747200,1600747200,1
user0628,0,1,0,4,1568865600,1568865600,1
oldstonecottage,0,1,0,5,1556078400,1556078400,1
_Roark,0,1,0,1,1580965200,1580965200,1
hoebag420,0,1,0,1,1595995200,1595995200,1
Daanvann,0,1,0,17,1583125200,1583125200,1
Hoistthecolors225,1,0,211,0,1570507200,1570507200,1
inthenameofmine,0,1,0,3,1603425600,1603425600,1
jfenserty,0,1,0,85,1598414400,1598414400,1
irmaincollisat,0,1,0,28,1572062400,1572062400,1
Mush-,0,1,0,14,1596945600,1596945600,1
FranDankly,0,1,0,69,1603339200,1603339200,1
realworldeditor,0,1,0,8,1600660800,1600660800,1
_McDrew,0,1,0,2,1580274000,1580274000,1
tomasnevim,0,1,0,11,1602993600,1602993600,1
Abc098123,0,1,0,1,1600833600,1600833600,1
tsaurn,0,1,0,1,1606712400,1606712400,1
Doctor_Pho_Real,0,1,0,1,1606539600,1606539600,1
FredBullRacing,0,1,0,0,1608699600,1608699600,1
poolparty90019,0,1,0,1,1498536000,1498536000,1
xanroeld,0,1,0,14,1549515600,1549515600,1
Incorrect_Oymoron,0,1,0,22,1546405200,1546405200,1
Uranato,0,1,0,1,1599105600,1599105600,1
Psauceyo,0,1,0,-4,1596600000,1596600000,1
Holzlampe,1,0,9372,0,1602043200,1602043200,1
phard003,0,1,0,1,1575954000,1575954000,1
JKCooke,0,1,0,6,1574398800,1574398800,1
LukyLucaz,0,1,0,24,1605157200,1605157200,1
TonyTontanaSanta,0,1,0,0,1608786000,1608786000,1
TheWurstTard,0,1,0,3,1595131200,1595131200,1
aqualily6,0,1,0,53,1576126800,1576126800,1
SuperLuxuryHobo,1,0,2,0,1585972800,1585972800,1
F_Dingo,0,1,0,3,1603512000,1603512000,1
DylanKing1999,0,1,0,1,1555905600,1555905600,1
trademeple,0,1,0,2,1604898000,1604898000,1
Scarscape,0,1,0,7,1604293200,1604293200,1
kellytawni,0,1,0,10,1602648000,1602648000,1
clumsyKitten143,0,1,0,11,1600747200,1600747200,1
SavaDoom,0,1,0,3,1606798800,1606798800,1
AlienFunkBand,0,1,0,2,1604984400,1604984400,1
syntarsus_reborn,0,1,0,1,1576645200,1576645200,1
wellywoodlad,0,1,0,6,1585454400,1585454400,1
celereyspelledwrong,0,1,0,4,1585627200,1585627200,1
Mr_jon3s,0,1,0,13,1585454400,1585454400,1
seiknip,0,1,0,2,1573880400,1573880400,1
suburbansail,0,1,0,1,1608872400,1608872400,1
NammRoxo,0,1,0,1,1597118400,1597118400,1
FutileDeathStar,0,1,0,7,1589428800,1589428800,1
brianelrwci,0,1,0,3,1578114000,1578114000,1
GrandmasterMGK,0,1,0,1,1566532800,1566532800,1
fluffypanduh,0,1,0,41,1605675600,1605675600,1
ktlbzn,0,1,0,3,1609218000,1609218000,1
TheAccount99,0,1,0,1,1588305600,1588305600,1
jininberry,0,1,0,9,1609045200,1609045200,1
barksallday,0,1,0,36,1591416000,1591416000,1
new_dorp,0,1,0,4,1571544000,1571544000,1
MapOfEurasia910,0,1,0,21,1566792000,1566792000,1
thehammerismypen1s,0,1,0,2,1585454400,1585454400,1
MonsieurHedge,0,1,0,18,1593230400,1593230400,1
BigJuicyBalls,0,1,0,-2,1591243200,1591243200,1
sghTKO,0,1,0,19,1602475200,1602475200,1
jpe1969,0,1,0,9,1555646400,1555646400,1
AlwaysDialedIn,0,1,0,2,1591675200,1591675200,1
Chingona89,0,1,0,6,1581656400,1581656400,1
oldmanyellsatcloud-,0,1,0,3,1571025600,1571025600,1
bloodreigna-87,0,1,0,1,1598241600,1598241600,1
silverdweller88,0,1,0,7,1595390400,1595390400,1
Zheoy,1,0,30,0,1578891600,1578891600,1
gallygally297,0,1,0,2,1604898000,1604898000,1
consmap,0,1,0,4,1555300800,1555300800,1
Autsin,1,0,58,0,1581051600,1581051600,1
NwordPenis69,0,1,0,3,1574658000,1574658000,1
CH2016,0,1,0,1,1575954000,1575954000,1
tryingtobecheeky,0,1,0,3,1593576000,1593576000,1
wstusa,0,1,0,32,1594180800,1594180800,1
product420,0,1,0,1,1573621200,1573621200,1
OutScreamer,0,1,0,1,1612069200,1612069200,1
Mariioosh,0,1,0,1,1608872400,1608872400,1
BlandQuirkyCzech,1,0,10,0,1587960000,1587960000,1
TerryMckenna,0,1,0,1,1606626000,1606626000,1
kokikokiko,0,1,0,1,1602475200,1602475200,1
chintukali,0,1,0,2,1605070800,1605070800,1
Doktor_S,0,1,0,3,1600833600,1600833600,1
subversive_cyborg,1,0,9,0,1597118400,1597118400,1
megnut3,0,1,0,1,1573794000,1573794000,1
randomtakenuser,0,1,0,1,1612069200,1612069200,1
wlutz83,0,1,0,59,1579755600,1579755600,1
madam_sedentary,0,1,0,1,1606971600,1606971600,1
Mycroft_canner,0,1,0,1,1608267600,1608267600,1
TriggerHappy_NZ,0,1,0,2,1600833600,1600833600,1
smilingmayfly,0,1,0,2,1543381200,1543381200,1
Sheloveslucid,0,1,0,1,1599624000,1599624000,1
God-Emperor-Lizard,0,1,0,3,1598846400,1598846400,1
clairenthebox,1,0,6,0,1596254400,1596254400,1
TheDijon69,0,1,0,1,1596772800,1596772800,1
Etizolamnotworkinb,0,1,0,1,1579496400,1579496400,1
etienne_8425,0,1,0,-1,1565668800,1565668800,1
toofortyEssex,0,1,0,60,1551243600,1551243600,1
Zorbles,0,1,0,3,1608699600,1608699600,1
JuDGe3690,0,1,0,9,1567051200,1567051200,1
FrankAdamGabe,0,1,0,5,1602820800,1602820800,1
BewareOfShills,0,1,0,1,1562904000,1562904000,1
Tito_Las_Vegas,0,1,0,9,1592107200,1592107200,1
vivalaivy,0,1,0,3,1579496400,1579496400,1
vaping_puglord,0,1,0,1,1600660800,1600660800,1
Carochio,0,1,0,1,1603512000,1603512000,1
1Commentator,0,1,0,1,1607230800,1607230800,1
tasselpen,0,1,0,2,1574485200,1574485200,1
ITS-A-JACKAL,0,1,0,1,1573534800,1573534800,1
Ratfacedkilla,0,1,0,9,1592107200,1592107200,1
Reasonable-Wall,0,1,0,2,1587182400,1587182400,1
REM_ember,0,1,0,18,1601352000,1601352000,1
The__Froth,0,1,0,1,1556337600,1556337600,1
Snax96,0,1,0,1,1608699600,1608699600,1
flcwerings,0,1,0,7,1599537600,1599537600,1
TomboyNationalism,0,1,0,-2,1599710400,1599710400,1
shallwefollow,0,1,0,0,1607576400,1607576400,1
Nova_Physika,0,1,0,5,1576645200,1576645200,1
onsidekick,0,1,0,-4,1606453200,1606453200,1
kindarusty,0,1,0,4,1606453200,1606453200,1
maybalien,0,1,0,19,1540872000,1540872000,1
IntelligentHuman,0,1,0,1,1606626000,1606626000,1
rodiel001,0,1,0,19,1602388800,1602388800,1
macelad,0,1,0,2,1603771200,1603771200,1
pjoneninerone,0,1,0,3,1605675600,1605675600,1
Winhert,0,1,0,1,1555819200,1555819200,1
hydrogenatedboils,0,1,0,2,1608699600,1608699600,1
Monoking2,1,0,14,0,1587614400,1587614400,1
CallMeMikeil,0,1,0,3,1585368000,1585368000,1
Alcvvv,0,1,0,1,1594267200,1594267200,1
LimpHandshakes,0,1,0,1,1606626000,1606626000,1
EntitledBeachBum,0,1,0,2,1607835600,1607835600,1
msaltion,0,1,0,3,1558584000,1558584000,1
DICKCHEESE42O,0,1,0,52,1587182400,1587182400,1
javaxcore,0,1,0,1,1573966800,1573966800,1
Dwarf-Room-Universe,0,1,0,14,1591502400,1591502400,1
armypainter,0,1,0,2,1600056000,1600056000,1
atheistaustin1,0,1,0,7,1592798400,1592798400,1
Am__I__Sam,0,1,0,3,1603598400,1603598400,1
ibettershutupagain,0,1,0,11,1594699200,1594699200,1
sunandskyandrainbows,0,1,0,2,1608699600,1608699600,1
rowdygregg,0,1,0,4,1594440000,1594440000,1
the_assembled_sway,0,1,0,19,1581397200,1581397200,1
Sanrio_Princess,0,1,0,1,1599969600,1599969600,1
BluApex,0,1,0,17,1547960400,1547960400,1
nihilistatari,0,1,0,12,1585454400,1585454400,1
mmmountaingoat,0,1,0,4,1586491200,1586491200,1
motsanciens,0,1,0,10,1597377600,1597377600,1
Flakey_Felatio,0,1,0,1,1608267600,1608267600,1
RazorPhishJ,0,1,0,2,1591329600,1591329600,1
TheRoomFan1000,0,1,0,1,1595995200,1595995200,1
OutsideDAuniverse,0,1,0,1,1605934800,1605934800,1
topaz342,0,1,0,8,1582779600,1582779600,1
boop_attack,0,1,0,2,1606021200,1606021200,1
AyJaySimon,0,1,0,0,1571803200,1571803200,1
SlappyAppy,0,1,0,7,1572408000,1572408000,1
jealouskaren,0,1,0,1,1599710400,1599710400,1
pm_me_something_meh,0,1,0,-6,1597550400,1597550400,1
GreenLikeNader,0,1,0,7,1604030400,1604030400,1
Koonboi,0,1,0,58,1581138000,1581138000,1
SkinHead2,0,1,0,1,1600747200,1600747200,1
herosmm,0,1,0,5,1603771200,1603771200,1
Notuana,0,1,0,10,1593230400,1593230400,1
Live-Rush,0,1,0,1,1599969600,1599969600,1
leaflover28,1,0,0,0,1606626000,1606626000,1
FabulouslyFatFarts,0,1,0,28,1585454400,1585454400,1
BrutalBob1384,0,1,0,1,1603512000,1603512000,1
tardistravelee,0,1,0,1,1603512000,1603512000,1
yalsonbaka,0,1,0,1,1597464000,1597464000,1
bradford68,0,1,0,18,1570852800,1570852800,1
Korbie13,0,1,0,1,1593576000,1593576000,1
DoubledDenDen,0,1,0,1,1606021200,1606021200,1
1dadadaaa,0,1,0,1,1569124800,1569124800,1
Killerwill9000,0,1,0,3,1566878400,1566878400,1
KittyKatzB,0,1,0,135,1599537600,1599537600,1
Pandelein,0,1,0,2,1606021200,1606021200,1
bananafishu,0,1,0,8,1605762000,1605762000,1
areyougoodatmath,0,1,0,56,1605502800,1605502800,1
alecww3,0,1,0,1,1596772800,1596772800,1
CoolMetropolisBird,0,1,0,2,1592193600,1592193600,1
harmlesshumanist,0,1,0,13,1592366400,1592366400,1
scienceguy9515,0,1,0,-5,1589688000,1589688000,1
bigWAXmfinBADDEST,0,1,0,1,1585454400,1585454400,1
h1k4r1-0000,0,1,0,1,1601352000,1601352000,1
ATHfiend,0,1,0,-6,1595217600,1595217600,1
SuspiciousSquirtle,0,1,0,3,1578978000,1578978000,1
bruce20011,0,1,0,3,1554955200,1554955200,1
fiddlybones,0,1,0,7,1586145600,1586145600,1
DammitDan,0,1,0,-2,1562731200,1562731200,1
glibglube22,0,1,0,1,1598932800,1598932800,1
tayway8246,0,1,0,1,1570939200,1570939200,1
Quitchy,0,1,0,5,1606021200,1606021200,1
lunarfrogg,1,0,0,0,1609477200,1609477200,1
Mature_Elf_Boi,0,1,0,1,1587009600,1587009600,1
Lost_Ensueno,0,1,0,-6,1606626000,1606626000,1
scarcityflow,0,1,0,1,1599796800,1599796800,1
Starshitlord,0,1,0,1,1580101200,1580101200,1
LilySeki,0,1,0,33,1577422800,1577422800,1
gnostalgick,0,1,0,4,1562040000,1562040000,1
Mythosaurus,0,1,0,1,1591329600,1591329600,1
ianw2w,0,1,0,1,1603598400,1603598400,1
7-broken-fans,0,1,0,107,1596600000,1596600000,1
I_make_things,0,1,0,20,1572843600,1572843600,1
dactom357,0,1,0,3,1584590400,1584590400,1
FastidiousRex2113,0,1,0,1,1608267600,1608267600,1
LetsGoFlyers17,0,1,0,2,1556596800,1556596800,1
RightOfMiddle,0,1,0,-1,1592798400,1592798400,1
mushupunisher,0,1,0,2,1553486400,1553486400,1
shroomshrooom,0,1,0,5,1554004800,1554004800,1
sulf569,0,1,0,6,1608181200,1608181200,1
ngarjuna,0,1,0,10,1600660800,1600660800,1
quattrophile,0,1,0,11,1600401600,1600401600,1
Not_So_Slim_Shady_,0,1,0,1,1553140800,1553140800,1
ShiftyFish75,0,1,0,3,1601611200,1601611200,1
Fribuldi,0,1,0,-1,1582952400,1582952400,1
Tyger2212,0,1,0,0,1585454400,1585454400,1
Natravedrova,0,1,0,20,1567483200,1567483200,1
birdpoop042,0,1,0,1,1600660800,1600660800,1
tunacanoil,1,0,487,0,1583038800,1583038800,1
Gargalhar,0,1,0,2,1586491200,1586491200,1
crunchylimestones,0,1,0,-1,1602216000,1602216000,1
SteelOverseer,0,1,0,6,1568952000,1568952000,1
atkins_re,0,1,0,2,1605589200,1605589200,1
milk-is-for-babies,1,0,212,0,1591934400,1591934400,1
lllldddd01,0,1,0,20,1574744400,1574744400,1
ZucchiniDude,0,1,0,8,1576040400,1576040400,1
hardfu,0,1,0,3,1605243600,1605243600,1
tyaak,0,1,0,1,1605243600,1605243600,1
grumgrum0,0,1,0,2,1574917200,1574917200,1
AlpacaBigBowl,0,1,0,-11,1605157200,1605157200,1
vicncak,0,1,0,-2,1607576400,1607576400,1
TheStoicSlab,0,1,0,4,1603598400,1603598400,1
NoImagination90,0,1,0,9,1547182800,1547182800,1
throw-me-away-right-,0,1,0,1,1595476800,1595476800,1
domeDUDE89,0,1,0,2,1609477200,1609477200,1
marchsaddness,0,1,0,1,1598587200,1598587200,1
gawkgawkslurp,0,1,0,3,1574485200,1574485200,1
geneticgrool,0,1,0,2,1603598400,1603598400,1
Garrett00,0,1,0,1,1606626000,1606626000,1
Blashmir,0,1,0,17,1596686400,1596686400,1
Supermansadak,0,1,0,1,1585454400,1585454400,1
allisonmaybe,0,1,0,1,1605243600,1605243600,1
waitwotNO,0,1,0,1,1594699200,1594699200,1
LilyAlways,0,1,0,0,1606885200,1606885200,1
walidmorocking,0,1,0,4,1606626000,1606626000,1
Ganymedian-Owl,0,1,0,1,1608267600,1608267600,1
frenchpotatoedip,0,1,0,6,1608699600,1608699600,1
shooler00,0,1,0,20,1609304400,1609304400,1
darkwingduck487,0,1,0,1,1598932800,1598932800,1
bcampbell238,0,1,0,4,1587787200,1587787200,1
ezk3626,0,1,0,1,1579323600,1579323600,1
we_appreciate_power,0,1,0,11,1574658000,1574658000,1
SciVibes,0,1,0,12,1603512000,1603512000,1
Hyronious,0,1,0,5,1609304400,1609304400,1
did_it_for_the_clout,0,1,0,-1,1582779600,1582779600,1
willrobot,0,1,0,2,1564027200,1564027200,1
emsolarfan,0,1,0,56,1582434000,1582434000,1
N3WD4Y,0,1,0,2,1635307200,1635307200,1
strog91,0,1,0,11,1552795200,1552795200,1
A_CleanLivingKing,0,1,0,1,1612069200,1612069200,1
Johnhemlock,0,1,0,64,1611810000,1611810000,1
the_chomskinator,1,0,12,0,1606453200,1606453200,1
itsameepa,0,1,0,0,1595217600,1595217600,1
Strawberry-Whorecake,0,1,0,1,1603512000,1603512000,1
Monster__,0,1,0,6,1605070800,1605070800,1
SpoaMaster,0,1,0,1,1609390800,1609390800,1
Magnus_H,0,1,0,5,1571371200,1571371200,1
Saarnath,0,1,0,2,1589947200,1589947200,1
jarrose37,0,1,0,22,1594180800,1594180800,1
pink-kitkat,0,1,0,18,1581397200,1581397200,1
mergays,0,1,0,2,1584504000,1584504000,1
whatkindofred,0,1,0,7,1574571600,1574571600,1
machineghostmembrane,0,1,0,1,1606971600,1606971600,1
PecanLake734,0,1,0,11,1608008400,1608008400,1
vkwin32,1,0,0,0,1603771200,1603771200,1
DingleMomMcGee13,0,1,0,4,1590206400,1590206400,1
icebrn,0,1,0,3,1603339200,1603339200,1
annxelise,0,1,0,1,1591934400,1591934400,1
willsuckfordonuts,0,1,0,48,1598155200,1598155200,1
shalashaskasec,0,1,0,0,1597291200,1597291200,1
ehxildebwga,0,1,0,83,1566619200,1566619200,1
clearing_,0,1,0,1,1557547200,1557547200,1
I_Hate_Reddit,0,1,0,13,1594612800,1594612800,1
friedeggandchips,0,1,0,2,1605502800,1605502800,1
encounteredbug,0,1,0,-4,1605502800,1605502800,1
ancientgnome,0,1,0,1,1598932800,1598932800,1
FuckyouYatch,0,1,0,4,1592798400,1592798400,1
theoneandonlycatman0,0,1,0,1,1603598400,1603598400,1
SappyGradient,0,1,0,17,1584936000,1584936000,1
Hip_Hazard,0,1,0,1,1606021200,1606021200,1
finallyfreeallalong,0,1,0,3,1553918400,1553918400,1
pbjars,0,1,0,1,1594353600,1594353600,1
Corvo0101,0,1,0,2,1595476800,1595476800,1
Lord_Derpington_,0,1,0,2,1605589200,1605589200,1
TheTeammates_1,0,1,0,11,1587441600,1587441600,1
modified_bear,0,1,0,1,1590984000,1590984000,1
yournannycam,0,1,0,4,1608526800,1608526800,1
matzo_baller,0,1,0,8,1598155200,1598155200,1
FartMcPooppants,0,1,0,2,1483678800,1483678800,1
gentlegiant69,0,1,0,-4,1591156800,1591156800,1
megalink5713,0,1,0,30,1597896000,1597896000,1
AlexanderChippel,0,1,0,1,1624852800,1624852800,1
TheRabidBadger1,0,1,0,1,1585454400,1585454400,1
TheChamFam,0,1,0,1,1605675600,1605675600,1
grumpyfucka,0,1,0,-12,1600747200,1600747200,1
MightyAxel,0,1,0,-1,1608613200,1608613200,1
DarkArcherMerlyn,0,1,0,4,1570680000,1570680000,1
CABstreet,0,1,0,30,1585195200,1585195200,1
DudeRanch_isCum,0,1,0,19,1581570000,1581570000,1
AlanTheTimeTraveller,0,1,0,4,1601870400,1601870400,1
JayPlenty24,0,1,0,3,1603598400,1603598400,1
RequiemLullaby,0,1,0,2,1578027600,1578027600,1
GarbieBirl,0,1,0,6,1584676800,1584676800,1
waxingnotwaning,0,1,0,1,1585454400,1585454400,1
obeidmax,0,1,0,41,1577768400,1577768400,1
panchovilla_,0,1,0,30,1575176400,1575176400,1
Lonit69,0,1,0,19,1589428800,1589428800,1
BrassicaPsychedelia,1,0,31,0,1597291200,1597291200,1
Warprince01,0,1,0,7,1607576400,1607576400,1
boromirfeminist,0,1,0,4,1601524800,1601524800,1
Novel-Bison,0,1,0,1,1580533200,1580533200,1
TheKingOfLemonGrab,0,1,0,28,1600142400,1600142400,1
nemtudod,0,1,0,-16,1584590400,1584590400,1
Sitheral,0,1,0,1,1612155600,1612155600,1
1van5,0,1,0,3,1598414400,1598414400,1
mubagel,0,1,0,1,1588737600,1588737600,1
PlopKitties,0,1,0,3,1562990400,1562990400,1
SuperPedro2020,0,1,0,0,1568347200,1568347200,1
Whytfbuddy,0,1,0,1,1591329600,1591329600,1
jonivaio,0,1,0,5,1601265600,1601265600,1
Crewarookie,0,1,0,23,1592366400,1592366400,1
Ramon033,0,1,0,1,1585195200,1585195200,1
Tealtyler,1,0,313,0,1591416000,1591416000,1
FukcTheUSA,0,1,0,-1,1611982800,1611982800,1
ringtingfing,0,1,0,2,1603598400,1603598400,1
AirCincy,0,1,0,2,1595995200,1595995200,1
is-numberfive,0,1,0,1,1608354000,1608354000,1
Carburetors_are_evil,0,1,0,1,1603252800,1603252800,1
Clarke311,0,1,0,3,1603512000,1603512000,1
Philogelos,0,1,0,4,1573534800,1573534800,1
blackcatglitching,0,1,0,3,1603512000,1603512000,1
devilmagic,0,1,0,25,1546578000,1546578000,1
madmerrick,0,1,0,11,1595649600,1595649600,1
IzziLikesOatmeal,0,1,0,2,1580101200,1580101200,1
LumpGarden,1,0,19,0,1588305600,1588305600,1
2016canfuckitself,0,1,0,76,1584244800,1584244800,1
podcaster300,1,0,3,0,1592539200,1592539200,1
Clean_Hedgehog9559,0,1,0,1,1608872400,1608872400,1
cuzwithfreshbuzz,0,1,0,2,1573534800,1573534800,1
DeusEst,0,1,0,8,1581138000,1581138000,1
Sara_jin,0,1,0,5,1604811600,1604811600,1
shrekitralph2,0,1,0,19,1581397200,1581397200,1
Big-Photo,1,0,7,0,1584417600,1584417600,1
itsameeethedeepstate,1,0,91,0,1607317200,1607317200,1
rash101010,0,1,0,1,1603857600,1603857600,1
YaWankers,0,1,0,-1,1589342400,1589342400,1
Tellmehowyouare,0,1,0,2,1573794000,1573794000,1
Halfassedtrophywife,0,1,0,3,1567310400,1567310400,1
MEA267,0,1,0,7,1576126800,1576126800,1
Esterosa69,0,1,0,0,1608872400,1608872400,1
celestiantv-499,0,1,0,1,1591848000,1591848000,1
MetaCalm,0,1,0,3,1581656400,1581656400,1
Pandaslap-245,0,1,0,10,1601524800,1601524800,1
TheGreatNecromancer,0,1,0,1,1643259600,1643259600,1
ChaseH9499,0,1,0,10,1570075200,1570075200,1
struc_func_devel,1,0,22,0,1608094800,1608094800,1
__WhatIsLife__,0,1,0,1,1598155200,1598155200,1
jHamdemon,0,1,0,1,1608872400,1608872400,1
TigerStripedDog,0,1,0,1,1567569600,1567569600,1
Rad_E_Cool,0,1,0,2,1601179200,1601179200,1
sluethmeister,0,1,0,1,1602561600,1602561600,1
jcordine,0,1,0,-10,1583812800,1583812800,1
thekingofbeans42,0,1,0,10,1605934800,1605934800,1
MrPijus123,0,1,0,1,1574830800,1574830800,1
Zlatil,0,1,0,1,1589688000,1589688000,1
anavolimilovana,0,1,0,4,1575435600,1575435600,1
lemonNherb,0,1,0,4,1592020800,1592020800,1
reyman521,0,1,0,1,1590033600,1590033600,1
Scooter419,0,1,0,0,1582088400,1582088400,1
RonnieVanDan,0,1,0,1,1603512000,1603512000,1
scummydummy07,0,1,0,5,1584763200,1584763200,1
sondre69,0,1,0,1,1597377600,1597377600,1
EconomyArcher4,1,0,13,0,1595995200,1595995200,1
sxb1831,1,0,1,0,1408420800,1408420800,1
113534281,0,1,0,3,1596772800,1596772800,1
Choogly,0,1,0,6,1605848400,1605848400,1
vaas19,0,1,0,2,1568001600,1568001600,1
Dingbat1967,0,1,0,16,1563508800,1563508800,1
eyamos,0,1,0,3,1582261200,1582261200,1
theinvisiblenobody,0,1,0,1,1611982800,1611982800,1
kb3rry,0,1,0,2,1608267600,1608267600,1
newyorksourdiesel,0,1,0,7,1596600000,1596600000,1
MrSlyFox007,0,1,0,2,1603512000,1603512000,1
m9e9s,0,1,0,15,1606626000,1606626000,1
Circle_Trigonist,0,1,0,2,1606626000,1606626000,1
010125,0,1,0,2,1591329600,1591329600,1
Lapamasa,1,0,22,0,1557633600,1557633600,1
TheRagingScientist,0,1,0,1,1572235200,1572235200,1
naq98,0,1,0,3,1594872000,1594872000,1
runaway_sigga,0,1,0,1,1606453200,1606453200,1
_faraleth_,0,1,0,1,1609304400,1609304400,1
Katsunyan,0,1,0,3,1545022800,1545022800,1
ThrowAwayAnotherYear,0,1,0,11,1607922000,1607922000,1
Iamthewilrus,0,1,0,9,1604984400,1604984400,1
Throw_away05367,0,1,0,2,1600660800,1600660800,1
samemother,0,1,0,3,1482728400,1482728400,1
Chuuubawca,0,1,0,5,1584331200,1584331200,1
Zoulz,0,1,0,3,1580014800,1580014800,1
Beedlam,0,1,0,1,1607835600,1607835600,1
Miroble,0,1,0,6,1603252800,1603252800,1
slothlevel,0,1,0,38,1608267600,1608267600,1
Xiao25,0,1,0,6,1600920000,1600920000,1
Tomhas2legs,0,1,0,3,1572843600,1572843600,1
whatafknmess,1,0,116,0,1597377600,1597377600,1
the_young_commie,0,1,0,26,1591502400,1591502400,1
soda-ex,0,1,0,1,1606366800,1606366800,1
Lachigan,0,1,0,3,1581829200,1581829200,1
BadSheet68,1,0,116,0,1590033600,1590033600,1
MyrtleAv,0,1,0,147,1597982400,1597982400,1
Ratazana5124,0,1,0,4,1520312400,1520312400,1
Rdns,0,1,0,1,1606280400,1606280400,1
Immediate_Amoeba_518,0,1,0,13,1609218000,1609218000,1
Azulalu,0,1,0,1,1599883200,1599883200,1
behemoth710,0,1,0,8,1583470800,1583470800,1
Fahqbyach,0,1,0,1,1603512000,1603512000,1
SovietRussiaBot,0,1,0,2,1560484800,1560484800,1
Laidback133,0,1,0,2,1598760000,1598760000,1
troyer14,1,0,9,0,1599796800,1599796800,1
AdSalt24,0,1,0,1,1608267600,1608267600,1
JokeCasual,0,1,0,0,1571544000,1571544000,1
kmckenzie256,0,1,0,38,1569211200,1569211200,1
dashstrokesgen,0,1,0,11,1575349200,1575349200,1
NL_Gray-Fox,0,1,0,1,1598846400,1598846400,1
eddeddie,0,1,0,2,1562817600,1562817600,1
malum68,0,1,0,1,1638853200,1638853200,1
BloodMossHunter,0,1,0,1,1605589200,1605589200,1
WilliZara,0,1,0,5,1590379200,1590379200,1
Determinator11,0,1,0,11,1558670400,1558670400,1
ComanderRO,0,1,0,1,1607144400,1607144400,1
burning-busch,0,1,0,1,1606021200,1606021200,1
BeatingUpWeaklings,0,1,0,1,1600660800,1600660800,1
lGoSpursGol,0,1,0,2,1603857600,1603857600,1
flak12,0,1,0,1,1589515200,1589515200,1
loathsome_pear,0,1,0,4,1604379600,1604379600,1
ChronicallyBirdlove,0,1,0,63,1572235200,1572235200,1
ScubaSteve12345,0,1,0,20,1576645200,1576645200,1
Reigand,0,1,0,9,1578114000,1578114000,1
GoingOnTheRightWay,0,1,0,18,1603512000,1603512000,1
planethaley,0,1,0,83,1589774400,1589774400,1
camTHRWY,0,1,0,2,1605243600,1605243600,1
RedGrobo,0,1,0,48,1585281600,1585281600,1
czokletmuss,0,1,0,0,1602302400,1602302400,1
KimJongJer,0,1,0,16,1575954000,1575954000,1
Imaydestroyyoufirst,0,1,0,2,1607662800,1607662800,1
SwagSorcerer,0,1,0,1,1586577600,1586577600,1
Sunny_Psy_Op,0,1,0,19,1582952400,1582952400,1
glossuser,0,1,0,7,1584072000,1584072000,1
thebefus,0,1,0,2,1578805200,1578805200,1
andy-in-ny,0,1,0,2,1586232000,1586232000,1
Sofagirrl79,0,1,0,75,1589860800,1589860800,1
feistybulldog,0,1,0,1,1593144000,1593144000,1
ylwoni,1,0,3485,0,1574398800,1574398800,1
ekjohnson9,0,1,0,1,1603598400,1603598400,1
oldhagbag,0,1,0,2,1607058000,1607058000,1
swims_with_the_fishe,0,1,0,3,1566360000,1566360000,1
WellInhindsight,0,1,0,7,1599192000,1599192000,1
robf168,0,1,0,19,1596945600,1596945600,1
Levyathyn,0,1,0,2,1567396800,1567396800,1
Jack-Planet,0,1,0,1,1603512000,1603512000,1
Bag_Chan,0,1,0,1,1606626000,1606626000,1
erktle,0,1,0,28,1584072000,1584072000,1
superfudging,0,1,0,1,1607662800,1607662800,1
kellyjj1919,0,1,0,1,1604379600,1604379600,1
miniantelop201,0,1,0,1,1589428800,1589428800,1
IBetOnLosingDogs7,0,1,0,2,1594267200,1594267200,1
ciroc__obama,0,1,0,1,1585454400,1585454400,1
sneakyfeet13,0,1,0,0,1572580800,1572580800,1
lovestheasianladies,0,1,0,12,1572062400,1572062400,1
neox99x,0,1,0,1,1585454400,1585454400,1
miranto,0,1,0,0,1585454400,1585454400,1
throwthrowandaway16,0,1,0,1,1618804800,1618804800,1
alexbarbershop,1,0,18,0,1606107600,1606107600,1
trees907,0,1,0,3,1599796800,1599796800,1
d3fenestrator,0,1,0,2,1607662800,1607662800,1
Mickeymackey,0,1,0,12,1611810000,1611810000,1
TastyRancidLemons,0,1,0,6,1601179200,1601179200,1
LoveCatually,0,1,0,57,1604293200,1604293200,1
Bdi89,0,1,0,6,1593403200,1593403200,1
gerritzalm420,0,1,0,3,1608699600,1608699600,1
Jirallyna,0,1,0,7,1576386000,1576386000,1
wellbutrin_witch,1,0,97,0,1608267600,1608267600,1
Different-Western730,0,1,0,-8,1608267600,1608267600,1
Smutok,0,1,0,5,1583038800,1583038800,1
Danuta-It-Is-Me,0,1,0,27,1594612800,1594612800,1
IsItTheChad1990,0,1,0,10,1603598400,1603598400,1
Gandah,0,1,0,1,1585713600,1585713600,1
louieadmin,0,1,0,3,1563336000,1563336000,1
graypapermoon,0,1,0,3,1566100800,1566100800,1
or_just_brian,0,1,0,1,1596600000,1596600000,1
dbwoi,0,1,0,1,1608354000,1608354000,1
Weed4Quarantine,0,1,0,2,1605589200,1605589200,1
bucketofhorseradish,0,1,0,2,1572753600,1572753600,1
owlcoholik,1,0,19,0,1572494400,1572494400,1
ArmoredLunchbox,0,1,0,1,1599710400,1599710400,1
big_hearted_lion,0,1,0,6,1546578000,1546578000,1
Hans_the_Frisian,0,1,0,6,1601352000,1601352000,1
Nicenightforawalk01,0,1,0,2,1600660800,1600660800,1
Minnesotahcky,0,1,0,3,1569729600,1569729600,1
indonesianfurrycum,0,1,0,1,1573275600,1573275600,1
ratemycockreddit,0,1,0,109,1586750400,1586750400,1
uchuunoryuu,1,0,38,0,1589342400,1589342400,1
NoTrickWick,0,1,0,-3,1586404800,1586404800,1
RedditWhileImWorking,0,1,0,-4,1588824000,1588824000,1
toastycheeze,0,1,0,16,1603512000,1603512000,1
ZotiBulku,0,1,0,1,1442548800,1442548800,1
hamdmamd,0,1,0,5,1604638800,1604638800,1
stayinglooseandweird,0,1,0,5,1563595200,1563595200,1
dontbothermeimatwork,0,1,0,0,1546405200,1546405200,1
principle_fbundle,0,1,0,6,1608267600,1608267600,1
DCINTERNATIONAL,0,1,0,2,1578373200,1578373200,1
ApolloX-2,0,1,0,1,1599105600,1599105600,1
International-Cat757,0,1,0,1,1606539600,1606539600,1
Atrocity_unknown,0,1,0,1,1589860800,1589860800,1
SoftweirInc,0,1,0,5,1540180800,1540180800,1
WorkingOnIt_1,0,1,0,1,1608267600,1608267600,1
MasterPlanPenguin,0,1,0,2,1600833600,1600833600,1
12temp,0,1,0,1,1602129600,1602129600,1
DanLightning3018,0,1,0,4,1578459600,1578459600,1
NewVegetable4,0,1,0,1,1573621200,1573621200,1
slammich28,0,1,0,1,1591329600,1591329600,1
SamIwas118,0,1,0,0,1585454400,1585454400,1
cancerousjoe1,1,0,14,0,1580187600,1580187600,1
fuckworking94949,0,1,0,0,1572408000,1572408000,1
Open-hole,0,1,0,2,1594180800,1594180800,1
Cobblestone-boner,0,1,0,4,1643259600,1643259600,1
BlindMidget,0,1,0,11,1573102800,1573102800,1
Deathsoundssweet,1,0,816,0,1578459600,1578459600,1
anotherthrowaway7624,0,1,0,-6,1595908800,1595908800,1
maxman575,0,1,0,0,1546405200,1546405200,1
chefsteph77,0,1,0,1,1612069200,1612069200,1
andrewsghost,0,1,0,2,1604984400,1604984400,1
kavien,0,1,0,12,1582952400,1582952400,1
hydromies,0,1,0,1,1596427200,1596427200,1
Kuronan,0,1,0,9,1609131600,1609131600,1
rxd94,0,1,0,1,1605675600,1605675600,1
gourmetjellybeans,0,1,0,1,1594440000,1594440000,1
sxzm,0,1,0,1,1603512000,1603512000,1
Quinniffer,0,1,0,9,1607317200,1607317200,1
weemungo,0,1,0,1,1573362000,1573362000,1
ladyavocadose,0,1,0,3,1573966800,1573966800,1
yesIamamillenial,0,1,0,2,1584676800,1584676800,1
housebythesideofroad,0,1,0,4,1606280400,1606280400,1
GriffithMeow,0,1,0,2,1595995200,1595995200,1
samandruk,0,1,0,0,1600488000,1600488000,1
dramforadamn,0,1,0,1,1597118400,1597118400,1
ree___e,0,1,0,5,1596254400,1596254400,1
ExplodingSofa,0,1,0,3,1607749200,1607749200,1
Red-Shifts,0,1,0,1,1598760000,1598760000,1
The_Frenchiest_Fry84,0,1,0,4,1599192000,1599192000,1
talking-oyster,0,1,0,10,1608267600,1608267600,1
Izzy-E,0,1,0,2,1547182800,1547182800,1
SCEtoAux1,0,1,0,30,1597896000,1597896000,1
CaglanT,0,1,0,31,1606021200,1606021200,1
Halasham,0,1,0,3,1585540800,1585540800,1
NotAHueman,0,1,0,-2,1569297600,1569297600,1
DrFloyd5,0,1,0,1,1586664000,1586664000,1
ExitWoundSlade,0,1,0,2,1566014400,1566014400,1
FuckTuckDuckTruck,1,0,16,0,1578632400,1578632400,1
AkephalosAtecture,0,1,0,4,1611896400,1611896400,1
MKevinR,0,1,0,4,1603598400,1603598400,1
GermanLc,0,1,0,1,1577336400,1577336400,1
duffman7050,0,1,0,-1,1603512000,1603512000,1
DesignerKey,0,1,0,1,1603684800,1603684800,1
Garloo333,0,1,0,4,1608181200,1608181200,1
AbbathaJayne,0,1,0,13,1604898000,1604898000,1
BDRohr,0,1,0,1,1604466000,1604466000,1
Unkn0wn-G0d,0,1,0,1,1621742400,1621742400,1
lowtierdeity,0,1,0,0,1608958800,1608958800,1
sharpbutterflybitch,0,1,0,2,1600228800,1600228800,1
JamesKSK13,0,1,0,1,1595390400,1595390400,1
space-pilot3000,0,1,0,1,1612069200,1612069200,1
Camping_is_intense,0,1,0,-4,1550552400,1550552400,1
looksLikeAMonk,0,1,0,1,1608267600,1608267600,1
RealHausFrau,0,1,0,2,1590206400,1590206400,1
ThanklessAmputation,0,1,0,7,1601956800,1601956800,1
dewayneestes,0,1,0,8,1553918400,1553918400,1
Abraham_DeLacey,0,1,0,-6,1594440000,1594440000,1
AdvertisingHot7878,0,1,0,1,1598414400,1598414400,1
mixmix4,0,1,0,10,1607230800,1607230800,1
furtivepigmyso,0,1,0,2,1598241600,1598241600,1
SunshineRainbow426,0,1,0,7,1578027600,1578027600,1
WaitForTheSkymall,0,1,0,27,1591243200,1591243200,1
stevay_b,0,1,0,9,1564718400,1564718400,1
reservedaswin,0,1,0,7,1607749200,1607749200,1
Barklad,0,1,0,3,1603598400,1603598400,1
DiddykongOMG,0,1,0,-10,1605934800,1605934800,1
iNisaok,0,1,0,2,1581224400,1581224400,1
hdue1776,0,1,0,1,1608267600,1608267600,1
FreudzBoyzz,0,1,0,2,1608786000,1608786000,1
carlosgman1,0,1,0,1,1603684800,1603684800,1
myacacct,0,1,0,7,1543035600,1543035600,1
WizardBelly,0,1,0,13,1559016000,1559016000,1
redditorinalabama,0,1,0,4,1608872400,1608872400,1
Chickenboyinhell,0,1,0,1,1587009600,1587009600,1
FDaHBDY8XF7,0,1,0,21,1601870400,1601870400,1
KrimzsonTv,0,1,0,5,1575435600,1575435600,1
iani63,0,1,0,104,1599451200,1599451200,1
atworktemp,0,1,0,1,1548997200,1548997200,1
WatchontheRhine,0,1,0,1,1551848400,1551848400,1
aqua_chem,0,1,0,3,1580446800,1580446800,1
hannah-journals,0,1,0,2,1605157200,1605157200,1
dsac,0,1,0,5,1572148800,1572148800,1
ryangarone,0,1,0,1,1585454400,1585454400,1
OriginalWorldliness,0,1,0,21,1572494400,1572494400,1
Phantom_Absolute,0,1,0,8,1599019200,1599019200,1
thehikinlichen,0,1,0,35,1605157200,1605157200,1
Due_Training_9782,0,1,0,1,1612155600,1612155600,1
HydroponicGirrafe,0,1,0,2,1562990400,1562990400,1
tapdancingkomodo,0,1,0,4,1599451200,1599451200,1
ededandfreddy,0,1,0,1,1599364800,1599364800,1
Brandenburg42,0,1,0,38,1601352000,1601352000,1
wannabechrispratt_,0,1,0,0,1562731200,1562731200,1
BooleanAlgebra,0,1,0,5,1603512000,1603512000,1
newpua_bie,0,1,0,3,1603512000,1603512000,1
Awdvr491,0,1,0,1,1603512000,1603512000,1
Inside_Rain,1,0,10,0,1608699600,1608699600,1
tha_bungablo,0,1,0,32,1597982400,1597982400,1
CantHardly,0,1,0,2,1573794000,1573794000,1
sheeppasture,0,1,0,1,1561262400,1561262400,1
deputyshitbat,0,1,0,1,1582088400,1582088400,1
ModulatedDickSpasms,0,1,0,13,1597464000,1597464000,1
elsieburgers,0,1,0,1,1608872400,1608872400,1
CinekMZ,1,0,2,0,1605416400,1605416400,1
octropos,0,1,0,1,1609045200,1609045200,1
onilla,0,1,0,3,1575176400,1575176400,1
teems,0,1,0,9,1603512000,1603512000,1
settlerking,0,1,0,4,1571371200,1571371200,1
Csdsmallville,0,1,0,3,1603598400,1603598400,1
ImperialAerosol_Kid,0,1,0,-23,1576299600,1576299600,1
Zerem601,1,0,1,0,1591588800,1591588800,1
TorqueWheelmaker,0,1,0,8,1598846400,1598846400,1
Glow354,0,1,0,20,1589688000,1589688000,1
LoneStarDev,0,1,0,1,1598846400,1598846400,1
4-Hydroxy-METalAF,0,1,0,1,1580014800,1580014800,1
null0x,0,1,0,4,1582606800,1582606800,1
cyberneticunicorns,1,0,44,0,1581310800,1581310800,1
justbleedgod,0,1,0,1,1608267600,1608267600,1
Manmikezupp,0,1,0,7,1575349200,1575349200,1
davidhluther,0,1,0,6,1581915600,1581915600,1
koala218,0,1,0,12,1584676800,1584676800,1
THEJONO_,0,1,0,21,1600660800,1600660800,1
ScatterBrain54321,1,0,108,0,1601179200,1601179200,1
Salabaster,0,1,0,1,1589947200,1589947200,1
Satin-rules,0,1,0,7,1611896400,1611896400,1
IWishIWasVeroz,0,1,0,1,1601438400,1601438400,1
LiterallySharing,0,1,0,26,1587268800,1587268800,1
crashingtingler,0,1,0,4,1608008400,1608008400,1
theusganger,0,1,0,7,1572753600,1572753600,1
i_forgot_wha,0,1,0,-6,1579323600,1579323600,1
usernamehw2,0,1,0,38,1598932800,1598932800,1
alexalienn,0,1,0,15,1600488000,1600488000,1
sosig101,0,1,0,1,1586664000,1586664000,1
12491625,0,1,0,8,1600660800,1600660800,1
Huab_,0,1,0,1,1598760000,1598760000,1
greenthree90,0,1,0,0,1594353600,1594353600,1
i_am_a_toaster,0,1,0,33,1572235200,1572235200,1
freedom_jazz_dancer,0,1,0,23,1599624000,1599624000,1
Bendybenji,0,1,0,2,1561694400,1561694400,1
ARussianW0lf,0,1,0,6,1545022800,1545022800,1
42069pokego,0,1,0,3,1600920000,1600920000,1
UrPrettyMuchNuthin,0,1,0,4,1556856000,1556856000,1
duffelbug,0,1,0,5,1590379200,1590379200,1
Broadsky,0,1,0,1,1584504000,1584504000,1
enjoy07,0,1,0,10,1569124800,1569124800,1
eyehatestuff,0,1,0,102,1606971600,1606971600,1
ChordFunc,1,0,16,0,1488258000,1488258000,1
HumanPanacea,0,1,0,3,1597118400,1597118400,1
StephenH321,0,1,0,1,1586491200,1586491200,1
number2chevyfan,0,1,0,-12,1594612800,1594612800,1
Lomomba,0,1,0,2,1599019200,1599019200,1
GoannaGames-Joe,0,1,0,1,1608699600,1608699600,1
WinnieTheWhoow,0,1,0,1,1608526800,1608526800,1
Breadbox25,0,1,0,211,1580706000,1580706000,1
BlazedAstronaut,0,1,0,99,1607403600,1607403600,1
Jakail,0,1,0,1,1606194000,1606194000,1
carsoncho,0,1,0,16,1605589200,1605589200,1
SlyDemonicFox,1,0,7725,0,1605416400,1605416400,1
bitches_be,0,1,0,1,1605589200,1605589200,1
tonedass9,0,1,0,5,1601956800,1601956800,1
PalmBreezy,0,1,0,1,1604552400,1604552400,1
Psykram,0,1,0,3,1609045200,1609045200,1
Little_Citron,0,1,0,6,1589947200,1589947200,1
sapajul,0,1,0,1,1606021200,1606021200,1
unmondeparfait,0,1,0,8,1602993600,1602993600,1
Nirutam_is_Eternal,0,1,0,2,1637557200,1637557200,1
SimilarSurround715,0,1,0,1,1641013200,1641013200,1
ChadTheNomad,0,1,0,1,1605243600,1605243600,1
drawingxflies,0,1,0,32,1611810000,1611810000,1
carrieactually,0,1,0,1,1605934800,1605934800,1
FlackoJay9,0,1,0,37,1590120000,1590120000,1
username00722,0,1,0,11,1564804800,1564804800,1
Rocklobsta11,0,1,0,4,1607922000,1607922000,1
thecrius,0,1,0,7,1605502800,1605502800,1
Temporary-Yak-570,0,1,0,8,1605416400,1605416400,1
team_jj,0,1,0,1,1605157200,1605157200,1
Anchorictor,0,1,0,2,1578805200,1578805200,1
djcecil2,0,1,0,39,1576126800,1576126800,1
Wisemithrandir,0,1,0,2,1603598400,1603598400,1
premacyman,0,1,0,3,1603771200,1603771200,1
KingJon85,0,1,0,6,1605589200,1605589200,1
HarkMeLobster,0,1,0,0,1576731600,1576731600,1
angeredpremed,0,1,0,7,1602820800,1602820800,1
Raegilbert,0,1,0,5,1571544000,1571544000,1
LoneWolfPeridot,0,1,0,5,1603598400,1603598400,1
adventurebush,0,1,0,-11,1604379600,1604379600,1
Anonyd,0,1,0,1,1418533200,1418533200,1
temporally_misplaced,0,1,0,6,1603512000,1603512000,1
_Devil_Man_,0,1,0,2,1608440400,1608440400,1
Babble-Fisher,0,1,0,11,1564545600,1564545600,1
Skull_Kandy,0,1,0,3,1585454400,1585454400,1
ParadiseRegaind,0,1,0,1,1605589200,1605589200,1
DereckChisoraisGOD,0,1,0,2,1603425600,1603425600,1
weside73,0,1,0,12,1592798400,1592798400,1
_gvenom_,0,1,0,1,1593662400,1593662400,1
cambium_comestibles,0,1,0,5,1607403600,1607403600,1
Phteven_with_a_v,0,1,0,4,1607835600,1607835600,1
magener,0,1,0,1,1557633600,1557633600,1
BabaSherif,0,1,0,3,1577509200,1577509200,1
RecentRequirement852,0,1,0,-14,1597982400,1597982400,1
Sailor_Gloom,0,1,0,2,1591243200,1591243200,1
shadow336k,0,1,0,-24,1578546000,1578546000,1
Obinego,1,0,51,0,1605416400,1605416400,1
tedkasynthski,0,1,0,1,1605243600,1605243600,1
KbCA_knup,0,1,0,1,1572321600,1572321600,1
Jibbyjab123,0,1,0,8,1604293200,1604293200,1
pillmore,0,1,0,28,1600056000,1600056000,1
aiehsa,0,1,0,1,1607144400,1607144400,1
PinXan,0,1,0,-52,1553918400,1553918400,1
not_a_duck_I_promise,0,1,0,14,1576040400,1576040400,1
yungPH,0,1,0,1,1607230800,1607230800,1
umatterokay,1,0,827,0,1606885200,1606885200,1
CrunchyLight,0,1,0,-1,1598760000,1598760000,1
NeuronGalaxy,0,1,0,10,1584244800,1584244800,1
ciroluiro,0,1,0,6,1582002000,1582002000,1
butt_huffer42069,0,1,0,2,1582952400,1582952400,1
Terroristics,0,1,0,8,1547182800,1547182800,1
Bcarnell,0,1,0,8,1601956800,1601956800,1
FlimsySand,0,1,0,1,1608267600,1608267600,1
wrex08,0,1,0,1,1576645200,1576645200,1
SgtSilverLining,0,1,0,2,1585368000,1585368000,1
Smallp0x_,0,1,0,1,1606366800,1606366800,1
GoonerWaffle,0,1,0,3,1580274000,1580274000,1
TV4ELP,0,1,0,2,1603512000,1603512000,1
sgtbubbles,0,1,0,11,1597032000,1597032000,1
silverraptures,0,1,0,2,1590379200,1590379200,1
neilhattrickparis978,0,1,0,6,1601611200,1601611200,1
ViolettPapillon,0,1,0,47,1592280000,1592280000,1
Lost_electron,0,1,0,1,1608094800,1608094800,1
SolarPanalist,0,1,0,3,1599451200,1599451200,1
donttouchmyplumbob,0,1,0,5,1593921600,1593921600,1
ksk8s,0,1,0,10,1600142400,1600142400,1
inoculum38,0,1,0,41,1601438400,1601438400,1
Zchanlee,0,1,0,-1,1582779600,1582779600,1
HabaneroUndrsyn,0,1,0,2,1592452800,1592452800,1
wytsep,0,1,0,29,1606539600,1606539600,1
yelloworchid,0,1,0,36,1606626000,1606626000,1
Ok_Obligation2559,0,1,0,1,1607922000,1607922000,1
scotch--bingington,1,0,4545,0,1608094800,1608094800,1
immaluckez,0,1,0,2,1565150400,1565150400,1
bnwebm-123,0,1,0,3,1555905600,1555905600,1
politsturm,1,0,0,0,1575954000,1575954000,1
SoggyCanary,0,1,0,1,1583211600,1583211600,1
MarketBasketShopper,0,1,0,1,1610082000,1610082000,1
Oscar_El_Groucho,0,1,0,2,1582779600,1582779600,1
chiefs312001,0,1,0,5,1563681600,1563681600,1
MysteryLie,0,1,0,9,1593144000,1593144000,1
TheGreat_N8,0,1,0,2,1591588800,1591588800,1
boyfricker420,0,1,0,2,1577595600,1577595600,1
Tony-At-Large,0,1,0,1,1589083200,1589083200,1
0w3nR,0,1,0,10,1595390400,1595390400,1
YeetYourBoss,1,0,8,0,1585540800,1585540800,1
TerribleToeHair,0,1,0,32,1605416400,1605416400,1
righteochap,0,1,0,1,1601438400,1601438400,1
Timageness,0,1,0,2,1603512000,1603512000,1
Mircea_123,0,1,0,1,1607662800,1607662800,1
anfisafan1234,0,1,0,47,1571716800,1571716800,1
fyrefocks,0,1,0,3,1585454400,1585454400,1
atheistium,0,1,0,1,1598932800,1598932800,1
drdr3ad,0,1,0,7,1606366800,1606366800,1
Premedpotato,0,1,0,2,1606885200,1606885200,1
Altailar,0,1,0,9,1606021200,1606021200,1
YourManGR,0,1,0,-12,1605416400,1605416400,1
Starflamevoid,0,1,0,0,1607576400,1607576400,1
maracay1999,0,1,0,-10,1605416400,1605416400,1
xtc333,0,1,0,1,1571976000,1571976000,1
Smighton1171,0,1,0,13,1598673600,1598673600,1
Terminus_terror,0,1,0,3,1600401600,1600401600,1
thesecretbang,0,1,0,0,1608267600,1608267600,1
Mcncnnbbfii,0,1,0,9,1565323200,1565323200,1
FernandaSLucas,0,1,0,2,1574485200,1574485200,1
russianphotograph,0,1,0,3,1434600000,1434600000,1
Strange-Score,0,1,0,2,1606539600,1606539600,1
Oblivionous,0,1,0,-6,1604984400,1604984400,1
ExileOnBroadStreet,0,1,0,3,1595131200,1595131200,1
TinyRedMushroom,0,1,0,35,1612069200,1612069200,1
voldy555,0,1,0,1,1570334400,1570334400,1
shfjcurjs,0,1,0,2,1587960000,1587960000,1
Pachyrhino_lakustai,0,1,0,8,1581224400,1581224400,1
knicksfan222,0,1,0,3,1603252800,1603252800,1
Indominablesnowplow,0,1,0,3,1599019200,1599019200,1
OutsmartBullet,0,1,0,20,1595822400,1595822400,1
Thompson_S_Sweetback,0,1,0,1,1603512000,1603512000,1
NateUrM8,0,1,0,2,1565150400,1565150400,1
aizmirst,1,0,14,0,1567396800,1567396800,1
Clockblocker124,0,1,0,6,1586232000,1586232000,1
thotnothot,0,1,0,2,1585454400,1585454400,1
CaptainSwaggerJagger,0,1,0,3,1560571200,1560571200,1
lord_Liot,0,1,0,-10,1598155200,1598155200,1
beomeansbee,0,1,0,5,1596945600,1596945600,1
Dr-Zoidberg14,0,1,0,9,1607490000,1607490000,1
Va3Victis,0,1,0,76,1593748800,1593748800,1
XMrIvyX,0,1,0,1,1606626000,1606626000,1
NorthGateNobody,0,1,0,86,1607058000,1607058000,1
butterwerkbatch,0,1,0,15,1604379600,1604379600,1
macmuffinpro,0,1,0,4,1606626000,1606626000,1
LikeBloodFromAStone,0,1,0,33,1555041600,1555041600,1
Minute_Man23,0,1,0,-2,1609390800,1609390800,1
Brodongulous,0,1,0,3,1595563200,1595563200,1
CharizardsDad,1,0,123,0,1578632400,1578632400,1
slxtr,0,1,0,2,1609390800,1609390800,1
corfish77,0,1,0,1,1585454400,1585454400,1
venus_in_faux_furs,0,1,0,12,1549429200,1549429200,1
iamreddituserx,0,1,0,10,1558584000,1558584000,1
DefNotMyAltIfYouCare,0,1,0,1,1607576400,1607576400,1
veryverydarkblue,0,1,0,2,1569902400,1569902400,1
pia06rp,0,1,0,7,1589083200,1589083200,1
aferalkitten,1,0,15,0,1593057600,1593057600,1
Lord_Melonhead,0,1,0,1,1608354000,1608354000,1
uniqueplant,1,0,167,0,1595476800,1595476800,1
ThatIsATastyBurger12,0,1,0,4,1606626000,1606626000,1
KommunistKitty,0,1,0,30,1600056000,1600056000,1
h4pp1c4t,0,1,0,9,1607317200,1607317200,1
Fog1510,0,1,0,35,1587873600,1587873600,1
ScooterWheelies,0,1,0,2,1609304400,1609304400,1
fuckfuckfuckfuck100,1,0,11,0,1578632400,1578632400,1
Godvivec1,0,1,0,3,1603598400,1603598400,1
UncharacteristicHyla,0,1,0,6,1601524800,1601524800,1
oOTheLastDragonOo,0,1,0,2,1563681600,1563681600,1
dylanmeme,0,1,0,7,1560052800,1560052800,1
yellowlilacindigo,0,1,0,28,1605330000,1605330000,1
Sir_Edward_Norton,0,1,0,6,1608872400,1608872400,1
giantsfan143,0,1,0,2,1571544000,1571544000,1
yourideas-suck,0,1,0,3,1541653200,1541653200,1
TamHtab,0,1,0,3,1603080000,1603080000,1
filsofolf,0,1,0,1,1584590400,1584590400,1
Unonium198YT,0,1,0,2,1603598400,1603598400,1
oscaarwtf,0,1,0,23,1608267600,1608267600,1
SerenityRvr,0,1,0,32,1590033600,1590033600,1
HorizontalPotato,0,1,0,1,1639285200,1639285200,1
Jdavies44,0,1,0,-12,1598760000,1598760000,1
torquelesswonder,0,1,0,28,1581483600,1581483600,1
horsedestroyer,0,1,0,4,1587096000,1587096000,1
Potato3Ways,0,1,0,7,1589947200,1589947200,1
JustHere4anime,0,1,0,-10,1590206400,1590206400,1
SixPipSiege,0,1,0,2,1599451200,1599451200,1
that-guy505,0,1,0,1,1602993600,1602993600,1
EyImmaFredo,0,1,0,2,1565841600,1565841600,1
turtlemaster942,0,1,0,1,1598846400,1598846400,1
cleetus_mccool,0,1,0,1,1608354000,1608354000,1
illcoloryoublind,0,1,0,3,1560916800,1560916800,1
phillyt009,0,1,0,5,1577422800,1577422800,1
MissyAlice,0,1,0,9,1568606400,1568606400,1
catmeowstoomany,0,1,0,8,1600747200,1600747200,1
Ragnar09,0,1,0,3,1575781200,1575781200,1
WalnutYT__,0,1,0,1,1600142400,1600142400,1
dego8mybaby,0,1,0,1,1607922000,1607922000,1
plantbased98,1,0,478,0,1605330000,1605330000,1
Sublime7870,0,1,0,2,1604293200,1604293200,1
shroudsringfinger,0,1,0,0,1585454400,1585454400,1
Captcha654654,0,1,0,1,1576386000,1576386000,1
Nathan-16BeAch,0,1,0,0,1606798800,1606798800,1
DrDripii,0,1,0,2,1594872000,1594872000,1
daimposter,0,1,0,1,1567483200,1567483200,1
properown,1,0,8,0,1446613200,1446613200,1
SpaceCampShep,0,1,0,0,1589947200,1589947200,1
fezha,0,1,0,1,1609390800,1609390800,1
CptSmackThat,0,1,0,1,1602388800,1602388800,1
churchchannel,0,1,0,1,1561435200,1561435200,1
I-Eat-Books,0,1,0,7,1609131600,1609131600,1
cookiemonster2222,0,1,0,1,1574571600,1574571600,1
cupajaffer,0,1,0,1,1568174400,1568174400,1
murkymist,0,1,0,5,1553918400,1553918400,1
Jarte3,0,1,0,16,1608699600,1608699600,1
methnbeer,0,1,0,2,1608786000,1608786000,1
superfiendyt,0,1,0,1,1603598400,1603598400,1
ChopyChapy,0,1,0,2,1606366800,1606366800,1
_Cheesus_crust_,1,0,0,0,1608699600,1608699600,1
Forever_Change,0,1,0,3,1582174800,1582174800,1
jesseschalken,0,1,0,1,1581051600,1581051600,1
Omahunek,0,1,0,23,1612155600,1612155600,1
shipoopi29,0,1,0,-41,1601784000,1601784000,1
SavePeanut,0,1,0,2,1576818000,1576818000,1
acatinasweater,0,1,0,6,1598155200,1598155200,1
Manos_de_tortuga,0,1,0,2,1600574400,1600574400,1
Digital_Beagle,0,1,0,1,1593921600,1593921600,1
raymelliott,1,0,28,0,1548738000,1548738000,1
nodddingham,0,1,0,4,1607922000,1607922000,1
policharizard,0,1,0,3,1598241600,1598241600,1
c0d3ster,0,1,0,4,1540958400,1540958400,1
YNKWTSF,0,1,0,1,1605675600,1605675600,1
hmmmmguy,0,1,0,15,1545195600,1545195600,1
doomjuice,0,1,0,5,1599278400,1599278400,1
Didiathon,0,1,0,1,1569902400,1569902400,1
umimimorin,0,1,0,1,1572580800,1572580800,1
CankerLord,0,1,0,1,1591243200,1591243200,1
impressivekeyst,0,1,0,1,1589947200,1589947200,1
vwert,0,1,0,0,1600833600,1600833600,1
Pecuthegreat,0,1,0,-1,1595390400,1595390400,1
asdeff,0,1,0,2,1602302400,1602302400,1
prolixdreams,0,1,0,2,1473220800,1473220800,1
orphanpipe,0,1,0,3,1607403600,1607403600,1
Lentex,1,0,5,0,1607317200,1607317200,1
Netr1us,0,1,0,3,1572321600,1572321600,1
Shapeshiftedcow,0,1,0,8,1598414400,1598414400,1
brocolipomme,0,1,0,4,1566878400,1566878400,1
painis,0,1,0,12,1596772800,1596772800,1
omccaff3,0,1,0,1,1573534800,1573534800,1
swi_llah68,0,1,0,7,1585886400,1585886400,1
burritohead,0,1,0,1,1599019200,1599019200,1
NewAccount971,0,1,0,54,1596600000,1596600000,1
Imverysadsad,0,1,0,2,1603771200,1603771200,1
RevFook,0,1,0,2,1601784000,1601784000,1
Mr_TheGuy,0,1,0,1,1576731600,1576731600,1
bbqutie28,0,1,0,5,1587873600,1587873600,1
angelicious1989,0,1,0,1,1590292800,1590292800,1
69things,0,1,0,1,1563940800,1563940800,1
BruthaFro,0,1,0,0,1579669200,1579669200,1
Devi_916,0,1,0,7,1560657600,1560657600,1
taidaid,0,1,0,5,1608094800,1608094800,1
spaceapeatespace,0,1,0,1,1585195200,1585195200,1
Xijth,0,1,0,1,1592798400,1592798400,1
imhere2downvote,0,1,0,10,1607317200,1607317200,1
bennothemad,0,1,0,13,1581224400,1581224400,1
aidsmann,0,1,0,-6,1571284800,1571284800,1
GuyNamedSteve94,0,1,0,3,1605848400,1605848400,1
curiosity676,0,1,0,3,1604984400,1604984400,1
DeltaMate,0,1,0,5,1603512000,1603512000,1
eynnh,1,0,1,0,1593576000,1593576000,1
Akon_DumbRapper,1,0,50,0,1587700800,1587700800,1
Graceful_Disaster,0,1,0,15,1605589200,1605589200,1
EndaEttBrukernavn,0,1,0,2,1576990800,1576990800,1
MrDanger,0,1,0,1,1587960000,1587960000,1
juniorredditorrr,0,1,0,2,1571457600,1571457600,1
BillyJoelHole,0,1,0,1,1598760000,1598760000,1
lunchteam11,0,1,0,1,1606107600,1606107600,1
SortOfaTaco,0,1,0,1,1565409600,1565409600,1
LucidNytemare,0,1,0,3,1562126400,1562126400,1
gopnik14,0,1,0,-5,1607576400,1607576400,1
TheArcticFox44,0,1,0,1,1596772800,1596772800,1
Visuddhi_Vimutti,0,1,0,6,1607835600,1607835600,1
verymuchtired,0,1,0,5,1591243200,1591243200,1
Simpsfan,0,1,0,2,1552194000,1552194000,1
iiScourge,0,1,0,3,1572062400,1572062400,1
Forever_Renegade,0,1,0,4,1600488000,1600488000,1
NapalmBBQ,0,1,0,3,1571889600,1571889600,1
Jay1313,0,1,0,1,1603512000,1603512000,1
coolhandjennie,0,1,0,2,1600488000,1600488000,1
octopossible,0,1,0,2,1582779600,1582779600,1
blek_side,1,0,3,0,1607058000,1607058000,1
___oliver,1,0,94,0,1605157200,1605157200,1
comradecamboy,1,0,10,0,1570075200,1570075200,1
KickBassColonyDrop,0,1,0,1,1606021200,1606021200,1
Abadab21,0,1,0,16,1563076800,1563076800,1
snackfromthedead,0,1,0,6,1564977600,1564977600,1
Skumdog_Packleader,0,1,0,25,1598673600,1598673600,1
flag-lover,0,1,0,-2,1608267600,1608267600,1
Special_Actual,1,0,3,0,1606539600,1606539600,1
Wump2,0,1,0,20,1557720000,1557720000,1
sassycatastrophe,0,1,0,48,1584590400,1584590400,1
Transfatcarbokin,0,1,0,2,1574571600,1574571600,1
fat-bIack-bitches,0,1,0,0,1608699600,1608699600,1
tunapig,0,1,0,1,1607058000,1607058000,1
StanleyDarsh22,0,1,0,4,1591243200,1591243200,1
Olivuvu,0,1,0,6,1579496400,1579496400,1
Doritosaurus,0,1,0,30,1602043200,1602043200,1
CoffeeJunior,0,1,0,3,1597032000,1597032000,1
thestrongcheese,0,1,0,7,1546405200,1546405200,1
HatlyHats,0,1,0,11,1598846400,1598846400,1
4tsixn2,0,1,0,13,1604116800,1604116800,1
HoodieGalore,0,1,0,1,1573621200,1573621200,1
mirmsss,0,1,0,1,1595822400,1595822400,1
hushpuppy2019,0,1,0,1,1607317200,1607317200,1
wafflecorner,0,1,0,4,1589774400,1589774400,1
chinkkink,0,1,0,2,1589256000,1589256000,1
Calm-Down-Boomer,0,1,0,0,1582520400,1582520400,1
CAPTA1NxCLUTCHx,0,1,0,1,1585540800,1585540800,1
The_Finglonger,0,1,0,-2,1556683200,1556683200,1
Darth__Potato,0,1,0,2,1602475200,1602475200,1
pommeG03,0,1,0,7,1579410000,1579410000,1
Ok-Jackfruit37,1,0,32,0,1611810000,1611810000,1
Demonthrall22,0,1,0,1,1603512000,1603512000,1
RealisticAutism,0,1,0,3,1592452800,1592452800,1
elasticpweebpuller,0,1,0,17,1600747200,1600747200,1
Dundee1993,0,1,0,1,1585627200,1585627200,1
hipster-named-kukai,0,1,0,11,1591502400,1591502400,1
baker_44,0,1,0,27,1600056000,1600056000,1
mewco_,0,1,0,1,1591243200,1591243200,1
Stunst,0,1,0,3,1603080000,1603080000,1
Factsmattermmmkayy,0,1,0,1,1607662800,1607662800,1
Hyperian,0,1,0,2,1600142400,1600142400,1
Lightnyn,0,1,0,3,1601179200,1601179200,1
XHeraclitusX,0,1,0,5,1606798800,1606798800,1
Deep-Zucchini,0,1,0,3,1598760000,1598760000,1
Apple_Empanada,0,1,0,5,1598500800,1598500800,1
potandcoffee,0,1,0,4,1609131600,1609131600,1
four_graves,0,1,0,8,1560398400,1560398400,1
glemnar,0,1,0,6,1598760000,1598760000,1
Deep_Reaction_5961,0,1,0,1,1601611200,1601611200,1
thugnificent856,0,1,0,1,1604466000,1604466000,1
revolvingdoor,0,1,0,11,1590465600,1590465600,1
benjick,0,1,0,8,1605330000,1605330000,1
Goddamnpassword,0,1,0,3,1608267600,1608267600,1
TyphoidMira,0,1,0,4,1602302400,1602302400,1
GreekPartisan,0,1,0,1,1600056000,1600056000,1
thesocialpenguin,0,1,0,1,1607835600,1607835600,1
DaOsoMan,1,0,298,0,1575435600,1575435600,1
Chris55730,0,1,0,1,1569124800,1569124800,1
AmIReySkywalker,0,1,0,1,1545022800,1545022800,1
Banjaxed404,0,1,0,1,1590638400,1590638400,1
kelseycloud,1,0,17,0,1608181200,1608181200,1
fjmcarthur93,0,1,0,1,1586318400,1586318400,1
wexpyke,0,1,0,31,1604203200,1604203200,1
Imjuststrollinalong,0,1,0,2,1576472400,1576472400,1
warmmilks,0,1,0,6,1594440000,1594440000,1
Deicidalmaniac41,0,1,0,2,1607922000,1607922000,1
SolidSnakeT1,0,1,0,-8,1554436800,1554436800,1
therealvanmorrison,0,1,0,0,1606021200,1606021200,1
frischizzle,0,1,0,1,1608699600,1608699600,1
daemna,0,1,0,3,1578286800,1578286800,1
steinsparda,0,1,0,2,1579237200,1579237200,1
other_benefits,0,1,0,1,1586232000,1586232000,1
Crutheth,0,1,0,-13,1600401600,1600401600,1
EmiliusReturns,0,1,0,5,1569816000,1569816000,1
jmuszynski16,0,1,0,1,1587960000,1587960000,1
flipsometits,0,1,0,0,1609304400,1609304400,1
nkei0,0,1,0,7,1596600000,1596600000,1
hereiwashereigo,1,0,13,0,1597982400,1597982400,1
gachiHYP3R,1,0,183,0,1593057600,1593057600,1
TheFailer99,0,1,0,7,1570420800,1570420800,1
slypredator33,0,1,0,20,1597204800,1597204800,1
MrGunny94,0,1,0,1,1593144000,1593144000,1
Buddhamon2020,0,1,0,1,1613624400,1613624400,1
sejmikFCB,0,1,0,3,1600833600,1600833600,1
markyrocks,0,1,0,-12,1590033600,1590033600,1
_valpi,0,1,0,2,1598760000,1598760000,1
ObviouslyFuckingNot,0,1,0,13,1594094400,1594094400,1
Ladripper47874,0,1,0,5,1595217600,1595217600,1
DecemberMommy,0,1,0,4,1608354000,1608354000,1
aintnoprophet,0,1,0,14,1584936000,1584936000,1
American_Buddy,0,1,0,-2,1580274000,1580274000,1
Shwingbatta,0,1,0,1,1603598400,1603598400,1
eddyPfe,0,1,0,2,1603512000,1603512000,1
i-like-robots,0,1,0,2,1548133200,1548133200,1
loony-cat,0,1,0,3,1582779600,1582779600,1
lllttt9,0,1,0,1,1612501200,1612501200,1
princess-cry-baby,0,1,0,7,1581915600,1581915600,1
AirfixEnthusiast,0,1,0,1,1584331200,1584331200,1
cowardly-banana,0,1,0,25,1594180800,1594180800,1
ez2009,0,1,0,3,1600920000,1600920000,1
Xanderoga,0,1,0,0,1604379600,1604379600,1
UpWithTheDownvote,0,1,0,24,1579496400,1579496400,1
areyouhungryforapple,0,1,0,3,1611810000,1611810000,1
Melihoney,0,1,0,1,1602302400,1602302400,1
htownclyde,0,1,0,20,1573707600,1573707600,1
CEOofCapitalism1776,0,1,0,1,1597550400,1597550400,1
Etradez,0,1,0,1,1603512000,1603512000,1
qazedc0987,0,1,0,4,1568088000,1568088000,1
Newkular_Balm,0,1,0,-2,1584331200,1584331200,1
jkcasemt91,0,1,0,2,1581138000,1581138000,1
NandoVilches,0,1,0,1,1572235200,1572235200,1
clockfire1,0,1,0,1,1602129600,1602129600,1
Islands-of-Time,0,1,0,1,1608872400,1608872400,1
bobfromholland,0,1,0,1,1578978000,1578978000,1
jkgirluwu,0,1,0,1,1600747200,1600747200,1
SimpleName001,0,1,0,1,1608008400,1608008400,1
CFClarke7,0,1,0,4,1598414400,1598414400,1
tonebender999,0,1,0,7,1582779600,1582779600,1
i4gotten,0,1,0,2,1609304400,1609304400,1
revachol69,0,1,0,2,1601352000,1601352000,1
muchm001,0,1,0,4,1591156800,1591156800,1
flargenhargen,0,1,0,10,1612069200,1612069200,1
bAllinh0,0,1,0,4,1581138000,1581138000,1
gangweed_2020,0,1,0,1,1584158400,1584158400,1
tha5t,0,1,0,17,1557979200,1557979200,1
MrsItsMeAgain,0,1,0,1,1591243200,1591243200,1
stud92muffin,0,1,0,0,1575608400,1575608400,1
snorkiebarbados,0,1,0,1,1609045200,1609045200,1
gnex30,0,1,0,67,1591243200,1591243200,1
ChadoWookie,0,1,0,-7,1603339200,1603339200,1
Mediocre_Try,0,1,0,6,1596859200,1596859200,1
bumpugly,0,1,0,30,1595995200,1595995200,1
callunquirka,0,1,0,12,1591243200,1591243200,1
asilentmangostares,0,1,0,4,1578459600,1578459600,1
Babyglockable,0,1,0,7,1571630400,1571630400,1
dsteinbrecher83,0,1,0,1,1603339200,1603339200,1
plantingisfun,0,1,0,2,1577422800,1577422800,1
Furbertaway,0,1,0,1,1604379600,1604379600,1
mermaidbae,0,1,0,1,1612242000,1612242000,1
tropicalhamster,0,1,0,1,1608613200,1608613200,1
achillea4,0,1,0,4,1572580800,1572580800,1
873LLC,0,1,0,1,1599883200,1599883200,1
spoonperson,0,1,0,5,1585368000,1585368000,1
RaTheRealGod,0,1,0,2,1577941200,1577941200,1
sevenandwater,0,1,0,1,1601611200,1601611200,1
anyonecare,0,1,0,1,1600574400,1600574400,1
Serathe_Squared,0,1,0,6,1590120000,1590120000,1
juanargie,0,1,0,5,1572235200,1572235200,1
SnacheezeBoogaloo,0,1,0,5,1590897600,1590897600,1
yurei_kage,0,1,0,1,1606626000,1606626000,1
CircumferentialJig,0,1,0,1,1600747200,1600747200,1
dodilly,0,1,0,5,1608267600,1608267600,1
Santos129,0,1,0,92,1594872000,1594872000,1
throw_me_away2020_2,0,1,0,3,1605762000,1605762000,1
Crizzli,0,1,0,4,1584244800,1584244800,1
lonelylamb1814,0,1,0,9,1591761600,1591761600,1
Xikyel,0,1,0,1,1578373200,1578373200,1
SipcyPro,1,0,0,0,1611896400,1611896400,1
mjMjawy,0,1,0,20,1605502800,1605502800,1
Gmosphere,0,1,0,1,1603339200,1603339200,1
deadinsidelol69,0,1,0,1,1573189200,1573189200,1
NemosGhost,0,1,0,1,1572062400,1572062400,1
yelnats25,0,1,0,2,1588219200,1588219200,1
Beastie71,0,1,0,4,1600574400,1600574400,1
Upstatethrowawaybj,1,0,18,0,1605675600,1605675600,1
MagnumMiracles,0,1,0,1,1596168000,1596168000,1
Ennesia,0,1,0,7,1597032000,1597032000,1
crann777,0,1,0,1,1602820800,1602820800,1
WolfofLawlStreet,0,1,0,-1,1585454400,1585454400,1
HarteandSoul,0,1,0,17,1611723600,1611723600,1
BlackDoritos65,0,1,0,1,1603512000,1603512000,1
viteri23,0,1,0,1,1600660800,1600660800,1
JonathanIyere2,0,1,0,2,1585454400,1585454400,1
Do__Math__Not__Meth,0,1,0,2,1562817600,1562817600,1
mrsamus101,0,1,0,2,1608872400,1608872400,1
bossbozo,0,1,0,3,1605589200,1605589200,1
fridayj1,0,1,0,2,1607317200,1607317200,1
TheSarcasticGyphtrot,0,1,0,2,1607576400,1607576400,1
haloumiplease,0,1,0,14,1578027600,1578027600,1
PitifulView,0,1,0,1,1606021200,1606021200,1
jimothy-raemos,0,1,0,8,1574312400,1574312400,1
Sirtemmie,0,1,0,13,1594440000,1594440000,1
NotSabre,1,0,1289,0,1570420800,1570420800,1
cocksucker9001xX,0,1,0,-5,1594699200,1594699200,1
CoS2112,0,1,0,7,1612069200,1612069200,1
peridotXlapis,0,1,0,7,1585281600,1585281600,1
JustOneAvailableName,0,1,0,3,1603512000,1603512000,1
ashenblade,0,1,0,17,1589947200,1589947200,1
must-love-bogs,0,1,0,1,1580274000,1580274000,1
zankiser3762,0,1,0,21,1552536000,1552536000,1
Barren_Jenton,0,1,0,8,1606885200,1606885200,1
leo90660,0,1,0,5,1594440000,1594440000,1
ConstableMaynard,0,1,0,2,1612242000,1612242000,1
callouscoroner,0,1,0,1,1514696400,1514696400,1
thebzksjsj5688,0,1,0,2,1602302400,1602302400,1
Thumpermc83,0,1,0,31,1592193600,1592193600,1
PieGuy1793,0,1,0,-9,1583726400,1583726400,1
BlackHairedBloodElf,0,1,0,1,1598932800,1598932800,1
negronanashi,0,1,0,1,1588046400,1588046400,1
runboyrun21,0,1,0,1,1594353600,1594353600,1
Mjh22799,0,1,0,8,1566187200,1566187200,1
pldgnoauthority,0,1,0,1,1401854400,1401854400,1
eureka3470,1,0,231,0,1608094800,1608094800,1
invisible-dave,0,1,0,5,1608267600,1608267600,1
circlejerkingdiiva,0,1,0,4,1571716800,1571716800,1
b_d_j8912,0,1,0,6,1582261200,1582261200,1
Iaminpain29102,0,1,0,1,1595822400,1595822400,1
AMK2201,0,1,0,2,1605675600,1605675600,1
sliptin4,0,1,0,1,1584158400,1584158400,1
Vaeius,1,0,19,0,1607144400,1607144400,1
AllomancerJack,0,1,0,1,1600574400,1600574400,1
TvonDegu,1,0,92,0,1603684800,1603684800,1
Zahand,0,1,0,1,1611982800,1611982800,1
Emily_Postal,0,1,0,1,1573621200,1573621200,1
RutwikPandit,0,1,0,5,1605502800,1605502800,1
Wisdom007,0,1,0,-3,1608354000,1608354000,1
Tychodragon,0,1,0,7,1605502800,1605502800,1
ItsSnow,0,1,0,2,1603857600,1603857600,1
PotatoBasedRobot,0,1,0,2,1605243600,1605243600,1
fathakks,1,0,35,0,1606280400,1606280400,1
readerino,1,0,6,0,1561608000,1561608000,1
cortexplorer,0,1,0,1,1608872400,1608872400,1
Whyintheworld2020,0,1,0,-9,1604984400,1604984400,1
DougieJones84,0,1,0,1,1590379200,1590379200,1
ChaosOpen,0,1,0,1,1594526400,1594526400,1
syme,0,1,0,7,1562299200,1562299200,1
AssociatesName,0,1,0,37,1572667200,1572667200,1
ScienceReplacedgod,0,1,0,7,1607490000,1607490000,1
Halo4ftw,1,0,82,0,1572148800,1572148800,1
goody7,0,1,0,15,1602129600,1602129600,1
QuantumSoda,0,1,0,13,1599019200,1599019200,1
Aquilarius,0,1,0,1,1594008000,1594008000,1
PassThePengMunch,0,1,0,2,1591329600,1591329600,1
FLY_HAMSTER_FLY,0,1,0,2,1552536000,1552536000,1
ASL_everyday,0,1,0,1,1604030400,1604030400,1
Friskyinthenight,0,1,0,7,1576904400,1576904400,1
GetThatSwaggBack,0,1,0,1,1583643600,1583643600,1
BucephalusOne,0,1,0,16,1578718800,1578718800,1
bustedaxles,0,1,0,4,1584244800,1584244800,1
IAmA_TheOneWhoKnocks,0,1,0,6,1584763200,1584763200,1
Cross7Spirit,0,1,0,7,1591934400,1591934400,1
Velokoraptus,0,1,0,1,1594353600,1594353600,1
Sleepydiscosloth,0,1,0,1,1557115200,1557115200,1
Ver599,0,1,0,6,1594872000,1594872000,1
bruhsimulator,0,1,0,-2,1599105600,1599105600,1
madde156x,0,1,0,6,1553140800,1553140800,1
path1999n,0,1,0,0,1608181200,1608181200,1
Le-Cheggs,0,1,0,3,1602820800,1602820800,1
oracle989,0,1,0,6,1599537600,1599537600,1
Redivivus,0,1,0,7,1611810000,1611810000,1
dumbredditor8358,0,1,0,1,1563681600,1563681600,1
NoCapNiebs,0,1,0,1,1601956800,1601956800,1
melody-nelson,0,1,0,2,1592798400,1592798400,1
chrisatmachine,0,1,0,0,1583643600,1583643600,1
metalgearsolid2,0,1,0,1,1605589200,1605589200,1
Federal-Consequence4,0,1,0,1,1605589200,1605589200,1
Pigflatus,0,1,0,8,1597550400,1597550400,1
ManlyB860,0,1,0,6,1582261200,1582261200,1
Isaak02-22,0,1,0,7,1588996800,1588996800,1
WillOCarrick,0,1,0,4,1572062400,1572062400,1
Anomalous_Arse,0,1,0,15,1564372800,1564372800,1
hydrallen,0,1,0,125,1561435200,1561435200,1
SpellChick,0,1,0,3,1581310800,1581310800,1
DarkPanda555,0,1,0,13,1569124800,1569124800,1
Blu3Army73,0,1,0,3,1597896000,1597896000,1
prjktphoto,0,1,0,3,1606971600,1606971600,1
Krungloid,0,1,0,17,1599710400,1599710400,1
leupboat420smkeit,0,1,0,-14,1605589200,1605589200,1
attica13,0,1,0,2,1606280400,1606280400,1
Bloodwrych72,1,0,27,0,1554350400,1554350400,1
Nyannakitten,0,1,0,2,1612069200,1612069200,1
claudebanks6326744,0,1,0,2,1597723200,1597723200,1
Gargantuas-L-taken,0,1,0,2,1561780800,1561780800,1
real_person_yes,1,0,0,0,1605157200,1605157200,1
EZRABRUTE,0,1,0,2,1578891600,1578891600,1
saffron25,0,1,0,2,1605070800,1605070800,1
ObiWanKaStoneMe,0,1,0,4,1602734400,1602734400,1
miss_peach94,0,1,0,11,1604552400,1604552400,1
JanMichaelVincent16,0,1,0,22,1609045200,1609045200,1
wh1t3birch,0,1,0,3,1548392400,1548392400,1
broad_rod,0,1,0,49,1589947200,1589947200,1
Verdantmoss,0,1,0,4,1551848400,1551848400,1
varyingopinions,0,1,0,29,1575522000,1575522000,1
nobasketball4me,0,1,0,2,1591243200,1591243200,1
Ellisace,0,1,0,-3,1582779600,1582779600,1
Jungle_Brain,0,1,0,3,1608613200,1608613200,1
Rugkrabber,0,1,0,6,1606021200,1606021200,1
povertyprincess,0,1,0,1,1549429200,1549429200,1
reubensauce,0,1,0,25,1581224400,1581224400,1
BotNumberBooB5,0,1,0,1,1605070800,1605070800,1
jtr99,0,1,0,15,1552107600,1552107600,1
iongnil,0,1,0,12,1606971600,1606971600,1
giganticpear,0,1,0,7,1571371200,1571371200,1
Stymphalia2,0,1,0,2,1584849600,1584849600,1
ArtivistVGang,0,1,0,7,1595908800,1595908800,1
biomacarena,0,1,0,3,1604725200,1604725200,1
_cocaine_jesus_,0,1,0,8,1570507200,1570507200,1
FittyTheBone,0,1,0,11,1606021200,1606021200,1
Feezec,0,1,0,17,1566187200,1566187200,1
FeistyPopTart,0,1,0,2,1606021200,1606021200,1
Ergok,0,1,0,1,1572062400,1572062400,1
MajorLudd,0,1,0,5,1588996800,1588996800,1
Bend-It-Like-Bakunin,0,1,0,7,1604203200,1604203200,1
jfreed43,0,1,0,10,1580014800,1580014800,1
sics2014,1,0,18,0,1568433600,1568433600,1
workingismiserable,0,1,0,14,1567051200,1567051200,1
DekkarMoonbootz,1,0,67,0,1597464000,1597464000,1
Dabsian,0,1,0,2,1605589200,1605589200,1
Krondon57,0,1,0,-8,1568865600,1568865600,1
DondoMidas,0,1,0,4,1567396800,1567396800,1
zezozosezadfrack,0,1,0,24,1581656400,1581656400,1
RedeemingChildhood,0,1,0,2,1605157200,1605157200,1
eviepayne,0,1,0,5,1586059200,1586059200,1
javajuicejoe,0,1,0,1,1606712400,1606712400,1
Azelphur,0,1,0,13,1559620800,1559620800,1
Gloom_core,0,1,0,4,1603944000,1603944000,1
R0MA2099,0,1,0,3,1603771200,1603771200,1
freeezingmoon,0,1,0,2,1612069200,1612069200,1
MojaveMauler,0,1,0,57,1563595200,1563595200,1
Honoikazuchi,0,1,0,4,1561089600,1561089600,1
existentialzebra,0,1,0,3,1605502800,1605502800,1
crok91,0,1,0,2,1594785600,1594785600,1
angelmoth,0,1,0,4,1595908800,1595908800,1
alderH,1,0,17,0,1594785600,1594785600,1
Coretteket,0,1,0,1,1592366400,1592366400,1
Fukcmoney,0,1,0,14,1579842000,1579842000,1
Sea-Channel23,0,1,0,-9,1597896000,1597896000,1
honeyblues212,1,0,196,0,1584504000,1584504000,1
KeepNappingElite,0,1,0,39,1568606400,1568606400,1
Ben_7,0,1,0,1,1612328400,1612328400,1
DocGeoJersey,0,1,0,36,1578114000,1578114000,1
mokwadesire,0,1,0,2,1607490000,1607490000,1
barefootBam,0,1,0,3,1599019200,1599019200,1
thephillyberto,0,1,0,11,1608267600,1608267600,1
wwaxwork,0,1,0,1,1591243200,1591243200,1
must_be_funny_bot,1,0,157,0,1600488000,1600488000,1
01111995,0,1,0,1,1574139600,1574139600,1
RegularKnot,0,1,0,2,1608008400,1608008400,1
C-3FO,0,1,0,1,1605934800,1605934800,1
Born-Entrepreneur,0,1,0,67,1604293200,1604293200,1
retiredPigeon,0,1,0,37,1606539600,1606539600,1
SquatPraxis,0,1,0,8,1550638800,1550638800,1
SecureValuable,0,1,0,1,1600574400,1600574400,1
CptKaba,1,0,21,0,1580446800,1580446800,1
Gigadweeb,0,1,0,7,1571198400,1571198400,1
ArbyntheChief117,0,1,0,1,1571544000,1571544000,1
free_dharma,0,1,0,6,1606626000,1606626000,1
trashworthsaving,0,1,0,4,1584849600,1584849600,1
1duntc4re,0,1,0,4,1581483600,1581483600,1
SSJ4Link,0,1,0,3,1600401600,1600401600,1
whereistherabbit,0,1,0,5,1592193600,1592193600,1
notmadatkate,0,1,0,4,1587528000,1587528000,1
lotuseye369,0,1,0,3,1597032000,1597032000,1
PublicMud,0,1,0,1,1578978000,1578978000,1
heavydirtysoul318,0,1,0,2,1617940800,1617940800,1
njean777,0,1,0,3,1603512000,1603512000,1
Hugh_Jampton,0,1,0,1,1603512000,1603512000,1
Niheru,0,1,0,2,1600747200,1600747200,1
hobnailboots04,0,1,0,1,1606712400,1606712400,1
lincjmill,0,1,0,1,1601956800,1601956800,1
blackasinc,0,1,0,0,1604203200,1604203200,1
kelpyturtles,0,1,0,4,1568520000,1568520000,1
lsrkjtls,0,1,0,1,1605243600,1605243600,1
eat-a-guy-kevin,0,1,0,1,1602734400,1602734400,1
fivestringsofbliss,0,1,0,4,1603598400,1603598400,1
theangrymurse,0,1,0,1,1608872400,1608872400,1
KeithWarhol,0,1,0,49,1611982800,1611982800,1
shidokanartist,0,1,0,1,1598068800,1598068800,1
lmgs37,1,0,25,0,1561435200,1561435200,1
TaejoTogokhan,0,1,0,12,1601784000,1601784000,1
pb263,0,1,0,9,1598587200,1598587200,1
DreaminSpielberg,0,1,0,1,1579237200,1579237200,1
throwawayRMM123,1,0,159,0,1579928400,1579928400,1
haoul,0,1,0,5,1473393600,1473393600,1
klappernderklaus,0,1,0,3,1605848400,1605848400,1
PelicanBiplane,0,1,0,34,1606280400,1606280400,1
showmeurtorts,0,1,0,3,1600228800,1600228800,1
DutchVanTe,0,1,0,1,1582088400,1582088400,1
ryan1257,0,1,0,6,1577336400,1577336400,1
thatTHICCness,1,0,0,0,1599883200,1599883200,1
Azzareo101,0,1,0,5,1606885200,1606885200,1
ItsJustMeJenn,0,1,0,6,1608267600,1608267600,1
anarchismisbest,0,1,0,1,1604552400,1604552400,1
Nightspade,0,1,0,6,1560916800,1560916800,1
whatsyourname369,0,1,0,1,1611982800,1611982800,1
JaRoc,0,1,0,3,1608526800,1608526800,1
JINJANUT,0,1,0,21,1599537600,1599537600,1
TheFalsePoetKing,0,1,0,1,1603512000,1603512000,1
smithers85,0,1,0,25,1607490000,1607490000,1
SpiritofJosefa,0,1,0,0,1556942400,1556942400,1
chinpokomon,0,1,0,3,1603598400,1603598400,1
FUSSYSPARROW,0,1,0,1,1611637200,1611637200,1
1-OhBelow,0,1,0,39,1602820800,1602820800,1
ntazap,0,1,0,68,1545541200,1545541200,1
The_NWah_Times,0,1,0,0,1585195200,1585195200,1
wangstarr03,0,1,0,1,1600660800,1600660800,1
totallykafkaesqueyo,0,1,0,4,1587960000,1587960000,1
freakin-meowt,0,1,0,3,1582779600,1582779600,1
MrWendal,0,1,0,1,1599019200,1599019200,1
xj_0461,1,0,55,0,1605502800,1605502800,1
Up2Beat,0,1,0,195,1579928400,1579928400,1
Yamatoman9,0,1,0,3,1608872400,1608872400,1
sveinsh,1,0,12,0,1571544000,1571544000,1
212testlink,0,1,0,1,1608958800,1608958800,1
Rc2124,0,1,0,3,1571630400,1571630400,1
PixelatedFractal,0,1,0,4,1596772800,1596772800,1
karimabduljabar,0,1,0,4,1592884800,1592884800,1
mysticned,0,1,0,33,1576040400,1576040400,1
lightseasonedguitar,0,1,0,2,1608440400,1608440400,1
GiordanoBruno23,0,1,0,7,1607749200,1607749200,1
bacardibarbie420,0,1,0,19,1572148800,1572148800,1
MuffyVonSchlitz,0,1,0,1,1636952400,1636952400,1
citizensec,0,1,0,1,1556510400,1556510400,1
ChopinSuey18,0,1,0,9,1608440400,1608440400,1
Stanek_guy,0,1,0,3,1603512000,1603512000,1
The-real-masterchief,0,1,0,0,1605502800,1605502800,1
ceaston3,0,1,0,8,1572843600,1572843600,1
Unwipedbuttinfection,0,1,0,2,1611982800,1611982800,1
9Point,0,1,0,1,1599105600,1599105600,1
HotlLava,0,1,0,1,1606798800,1606798800,1
menew100,0,1,0,2,1608181200,1608181200,1
facelesswolf_,0,1,0,8,1597377600,1597377600,1
taqfu,0,1,0,3,1487307600,1487307600,1
Reddit1127,0,1,0,1,1622433600,1622433600,1
alexandertorres01,0,1,0,1,1568001600,1568001600,1
dreat___,0,1,0,2,1596600000,1596600000,1
Iagi,0,1,0,3,1578718800,1578718800,1
nianticnectar23,0,1,0,1,1603512000,1603512000,1
lemonstixx,0,1,0,40,1596600000,1596600000,1
flufflesthemanly,0,1,0,1,1585195200,1585195200,1
rtnslnd,0,1,0,4,1608181200,1608181200,1
iowahawkeye2034,0,1,0,10,1608354000,1608354000,1
Odd_Luck_494,0,1,0,9,1608181200,1608181200,1
GoodPlayboy,0,1,0,216,1608699600,1608699600,1
youabsoluteminger,0,1,0,1,1593662400,1593662400,1
Steel_city917,0,1,0,14,1573362000,1573362000,1
Kookies3,0,1,0,1,1608094800,1608094800,1
AndryaDdreya,0,1,0,2,1594872000,1594872000,1
CaKeWeed,0,1,0,1,1577595600,1577595600,1
SisyphusRebel,0,1,0,3,1586577600,1586577600,1
